bioguide_id,crp_id,cand_name,cycle,ind_name,indivs,pacs,totals
M000087,N00000078,Carolyn B Maloney (D),2012,Securities & Investment,119850,64500,184350
M000087,N00000078,Carolyn B Maloney (D),2012,Real Estate,111450,49489,160939
M000087,N00000078,Carolyn B Maloney (D),2012,Lawyers/Law Firms,76550,38700,115250
M000087,N00000078,Carolyn B Maloney (D),2012,Insurance,24500,65000,89500
M000087,N00000078,Carolyn B Maloney (D),2012,Misc Finance,64600,23500,88100
M000087,N00000078,Carolyn B Maloney (D),2012,Public Sector Unions,0,65000,65000
M000087,N00000078,Carolyn B Maloney (D),2012,Commercial Banks,16050,45500,61550
M000087,N00000078,Carolyn B Maloney (D),2012,Health Professionals,25500,25000,50500
M000087,N00000078,Carolyn B Maloney (D),2012,Retired,48100,0,48100
M000087,N00000078,Carolyn B Maloney (D),2012,Accountants,200,42923,43123
C000380,N00000133,Donna Christian-Christensen (D),2012,Pharmaceuticals/Health Products,350,38615,38965
C000380,N00000133,Donna Christian-Christensen (D),2012,Accountants,23200,0,23200
C000380,N00000133,Donna Christian-Christensen (D),2012,Telephone Utilities,1500,20500,22000
C000380,N00000133,Donna Christian-Christensen (D),2012,Health Professionals,700,21000,21700
C000380,N00000133,Donna Christian-Christensen (D),2012,Health Services/HMOs,5000,10000,15000
C000380,N00000133,Donna Christian-Christensen (D),2012,Leadership PACs,0,13000,13000
C000380,N00000133,Donna Christian-Christensen (D),2012,Lawyers/Law Firms,5850,7000,12850
C000380,N00000133,Donna Christian-Christensen (D),2012,Telecom Services,0,11500,11500
C000380,N00000133,Donna Christian-Christensen (D),2012,Human Rights,900,10000,10900
C000380,N00000133,Donna Christian-Christensen (D),2012,Lobbyists,9200,1500,10700
N000015,N00000153,Richard E Neal (D),2012,Insurance,52400,177500,229900
N000015,N00000153,Richard E Neal (D),2012,Securities & Investment,52800,126250,179050
N000015,N00000153,Richard E Neal (D),2012,Health Professionals,4850,129000,133850
N000015,N00000153,Richard E Neal (D),2012,Pharmaceuticals/Health Products,2000,100573,102573
N000015,N00000153,Richard E Neal (D),2012,Real Estate,21800,46000,67800
N000015,N00000153,Richard E Neal (D),2012,Lobbyists,59993,2500,62493
N000015,N00000153,Richard E Neal (D),2012,Accountants,16000,40500,56500
N000015,N00000153,Richard E Neal (D),2012,Lawyers/Law Firms,27050,28968,56018
N000015,N00000153,Richard E Neal (D),2012,Commercial Banks,4000,42500,46500
N000015,N00000153,Richard E Neal (D),2012,Hospitals/Nursing Homes,10750,29000,39750
M000312,N00000179,James P McGovern (D),2012,Lobbyists,53065,3621,56686
M000312,N00000179,James P McGovern (D),2012,Lawyers/Law Firms,37050,19000,56050
M000312,N00000179,James P McGovern (D),2012,Railroads,1200,51500,52700
M000312,N00000179,James P McGovern (D),2012,Building Trade Unions,250,46500,46750
M000312,N00000179,James P McGovern (D),2012,Public Sector Unions,500,33500,34000
M000312,N00000179,James P McGovern (D),2012,Health Professionals,5450,25500,30950
M000312,N00000179,James P McGovern (D),2012,Industrial Unions,0,24500,24500
M000312,N00000179,James P McGovern (D),2012,Real Estate,13451,9000,22451
M000312,N00000179,James P McGovern (D),2012,Misc Unions,0,21000,21000
M000312,N00000179,James P McGovern (D),2012,Pharmaceuticals/Health Products,4000,17000,21000
T000266,N00000226,John F Tierney (D),2012,Lawyers/Law Firms,181254,27250,208504
T000266,N00000226,John F Tierney (D),2012,Leadership PACs,0,146000,146000
T000266,N00000226,John F Tierney (D),2012,Retired,109118,0,109118
T000266,N00000226,John F Tierney (D),2012,Public Sector Unions,0,109000,109000
T000266,N00000226,John F Tierney (D),2012,Candidate Committees,0,100709,100709
T000266,N00000226,John F Tierney (D),2012,Building Trade Unions,0,57000,57000
T000266,N00000226,John F Tierney (D),2012,Democratic/Liberal,39800,14000,53800
T000266,N00000226,John F Tierney (D),2012,Industrial Unions,0,47000,47000
T000266,N00000226,John F Tierney (D),2012,Real Estate,41500,4000,45500
T000266,N00000226,John F Tierney (D),2012,Misc Unions,0,41000,41000
K000148,N00000245,John Kerry (D),2012,Lawyers/Law Firms,516340,125278,641618
K000148,N00000245,John Kerry (D),2012,Securities & Investment,399400,37500,436900
K000148,N00000245,John Kerry (D),2012,Real Estate,228924,41010,269934
K000148,N00000245,John Kerry (D),2012,Lobbyists,187893,5000,192893
K000148,N00000245,John Kerry (D),2012,Health Professionals,74300,118300,192600
K000148,N00000245,John Kerry (D),2012,Pharmaceuticals/Health Products,60680,102200,162880
K000148,N00000245,John Kerry (D),2012,Electronics Mfg & Equip,96125,59496,155621
K000148,N00000245,John Kerry (D),2012,Hospitals/Nursing Homes,108000,26500,134500
K000148,N00000245,John Kerry (D),2012,Insurance,42275,81000,123275
K000148,N00000245,John Kerry (D),2012,Business Services,116425,3500,119925
C001037,N00000267,Michael E Capuano (D),2012,Insurance,3250,62000,65250
C001037,N00000267,Michael E Capuano (D),2012,Lawyers/Law Firms,48150,16250,64400
C001037,N00000267,Michael E Capuano (D),2012,Real Estate,33700,25500,59200
C001037,N00000267,Michael E Capuano (D),2012,Securities & Investment,15050,34500,49550
C001037,N00000267,Michael E Capuano (D),2012,Pharmaceuticals/Health Products,3500,38750,42250
C001037,N00000267,Michael E Capuano (D),2012,Transportation Unions,0,41500,41500
C001037,N00000267,Michael E Capuano (D),2012,Public Sector Unions,250,39750,40000
C001037,N00000267,Michael E Capuano (D),2012,Building Trade Unions,0,40000,40000
C001037,N00000267,Michael E Capuano (D),2012,Oil & Gas,21000,5000,26000
C001037,N00000267,Michael E Capuano (D),2012,Construction Services,7750,16500,24250
M000133,N00000270,Ed Markey (D),2012,Lawyers/Law Firms,62000,49914,111914
M000133,N00000270,Ed Markey (D),2012,Lobbyists,77450,4000,81450
M000133,N00000270,Ed Markey (D),2012,Telecom Services,2400,55500,57900
M000133,N00000270,Ed Markey (D),2012,Real Estate,27000,12500,39500
M000133,N00000270,Ed Markey (D),2012,Telephone Utilities,3000,31120,34120
M000133,N00000270,Ed Markey (D),2012,Securities & Investment,32650,0,32650
M000133,N00000270,Ed Markey (D),2012,Pharmaceuticals/Health Products,1000,30000,31000
M000133,N00000270,Ed Markey (D),2012,Electric Utilities,14250,15500,29750
M000133,N00000270,Ed Markey (D),2012,Health Services/HMOs,10450,14500,24950
M000133,N00000270,Ed Markey (D),2012,Hospitals/Nursing Homes,21750,1000,22750
R000122,N00000362,Jack Reed (D),2012,Securities & Investment,261450,213400,474850
R000122,N00000362,Jack Reed (D),2012,Lawyers/Law Firms,347698,71794,419492
R000122,N00000362,Jack Reed (D),2012,Real Estate,157600,97000,254600
R000122,N00000362,Jack Reed (D),2012,Insurance,21050,222100,243150
R000122,N00000362,Jack Reed (D),2012,Lobbyists,173330,10000,183330
R000122,N00000362,Jack Reed (D),2012,Health Professionals,41200,128850,170050
R000122,N00000362,Jack Reed (D),2012,Leadership PACs,0,139600,139600
R000122,N00000362,Jack Reed (D),2012,Commercial Banks,89400,46271,135671
R000122,N00000362,Jack Reed (D),2012,Retired,121930,0,121930
R000122,N00000362,Jack Reed (D),2012,Pro-Israel,58350,51500,109850
C001035,N00000491,Susan Collins (R),2012,Retired,501049,0,501049
C001035,N00000491,Susan Collins (R),2012,Lawyers/Law Firms,343714,142416,486130
C001035,N00000491,Susan Collins (R),2012,Securities & Investment,381615,80500,462115
C001035,N00000491,Susan Collins (R),2012,Health Professionals,106969,269300,376269
C001035,N00000491,Susan Collins (R),2012,Leadership PACs,0,365300,365300
C001035,N00000491,Susan Collins (R),2012,Lobbyists,343859,9031,352890
C001035,N00000491,Susan Collins (R),2012,Real Estate,248450,46500,294950
C001035,N00000491,Susan Collins (R),2012,Insurance,80150,170500,250650
C001035,N00000491,Susan Collins (R),2012,Health Services/HMOs,69000,120523,189523
C001035,N00000491,Susan Collins (R),2012,Misc Finance,176294,5500,181794
W000800,N00000515,Peter Welch (D),2012,Health Professionals,4400,47500,51900
W000800,N00000515,Peter Welch (D),2012,Public Sector Unions,500,51000,51500
W000800,N00000515,Peter Welch (D),2012,Retail Sales,2200,46500,48700
W000800,N00000515,Peter Welch (D),2012,Lawyers/Law Firms,29199,16000,45199
W000800,N00000515,Peter Welch (D),2012,Retired,44200,0,44200
W000800,N00000515,Peter Welch (D),2012,Real Estate,13717,26000,39717
W000800,N00000515,Peter Welch (D),2012,Building Trade Unions,0,31000,31000
W000800,N00000515,Peter Welch (D),2012,Misc Manufacturing & Distributing,11500,16000,27500
W000800,N00000515,Peter Welch (D),2012,Crop Production & Basic Processing,4450,23000,27450
W000800,N00000515,Peter Welch (D),2012,Telephone Utilities,10000,17000,27000
S000033,N00000528,Bernie Sanders (I),2012,Retired,498315,0,498315
S000033,N00000528,Bernie Sanders (I),2012,Democratic/Liberal,222960,6070,229030
S000033,N00000528,Bernie Sanders (I),2012,Public Sector Unions,600,113800,114400
S000033,N00000528,Bernie Sanders (I),2012,Lawyers/Law Firms,96249,12000,108249
S000033,N00000528,Bernie Sanders (I),2012,Health Professionals,42672,41500,84172
S000033,N00000528,Bernie Sanders (I),2012,Leadership PACs,0,71500,71500
S000033,N00000528,Bernie Sanders (I),2012,Education,57380,0,57380
S000033,N00000528,Bernie Sanders (I),2012,Building Trade Unions,0,49500,49500
S000033,N00000528,Bernie Sanders (I),2012,Environment,45640,3250,48890
S000033,N00000528,Bernie Sanders (I),2012,Industrial Unions,800,47650,48450
L000557,N00000575,John B Larson (D),2012,Insurance,50050,156000,206050
L000557,N00000575,John B Larson (D),2012,Lawyers/Law Firms,88178,31900,120078
L000557,N00000575,John B Larson (D),2012,Health Professionals,16500,90750,107250
L000557,N00000575,John B Larson (D),2012,Real Estate,47200,45398,92598
L000557,N00000575,John B Larson (D),2012,Securities & Investment,36679,55250,91929
L000557,N00000575,John B Larson (D),2012,Public Sector Unions,0,60500,60500
L000557,N00000575,John B Larson (D),2012,Defense Aerospace,24700,33500,58200
L000557,N00000575,John B Larson (D),2012,Lobbyists,50200,1500,51700
L000557,N00000575,John B Larson (D),2012,Building Trade Unions,0,50500,50500
L000557,N00000575,John B Larson (D),2012,Pharmaceuticals/Health Products,6300,41000,47300
D000216,N00000615,Rosa L DeLauro (D),2012,Health Professionals,18196,95000,113196
D000216,N00000615,Rosa L DeLauro (D),2012,Lobbyists,77043,1175,78218
D000216,N00000615,Rosa L DeLauro (D),2012,Public Sector Unions,0,73000,73000
D000216,N00000615,Rosa L DeLauro (D),2012,Lawyers/Law Firms,42652,30000,72652
D000216,N00000615,Rosa L DeLauro (D),2012,Democratic/Liberal,47250,2050,49300
D000216,N00000615,Rosa L DeLauro (D),2012,Building Trade Unions,0,48000,48000
D000216,N00000615,Rosa L DeLauro (D),2012,Industrial Unions,0,43000,43000
D000216,N00000615,Rosa L DeLauro (D),2012,Misc Unions,0,36500,36500
D000216,N00000615,Rosa L DeLauro (D),2012,Pharmaceuticals/Health Products,1500,33000,34500
D000216,N00000615,Rosa L DeLauro (D),2012,Misc Issues,2900,30000,32900
L000123,N00000659,Frank R Lautenberg (D),2012,Lawyers/Law Firms,669538,131679,801217
L000123,N00000659,Frank R Lautenberg (D),2012,Real Estate,687290,14000,701290
L000123,N00000659,Frank R Lautenberg (D),2012,Securities & Investment,573108,30000,603108
L000123,N00000659,Frank R Lautenberg (D),2012,Pro-Israel,209015,70518,279533
L000123,N00000659,Frank R Lautenberg (D),2012,Retired,258133,0,258133
L000123,N00000659,Frank R Lautenberg (D),2012,Lobbyists,212466,21200,233666
L000123,N00000659,Frank R Lautenberg (D),2012,Leadership PACs,0,214600,214600
L000123,N00000659,Frank R Lautenberg (D),2012,Pharmaceuticals/Health Products,34400,135800,170200
L000123,N00000659,Frank R Lautenberg (D),2012,TV/Movies/Music,112350,34000,146350
L000123,N00000659,Frank R Lautenberg (D),2012,Business Services,127007,1000,128007
F000372,N00000684,Rodney Frelinghuysen (R),2012,Pharmaceuticals/Health Products,3500,73000,76500
F000372,N00000684,Rodney Frelinghuysen (R),2012,Electric Utilities,5050,70500,75550
F000372,N00000684,Rodney Frelinghuysen (R),2012,Retired,72725,0,72725
F000372,N00000684,Rodney Frelinghuysen (R),2012,Defense Aerospace,5950,51000,56950
F000372,N00000684,Rodney Frelinghuysen (R),2012,Defense Electronics,2500,51500,54000
F000372,N00000684,Rodney Frelinghuysen (R),2012,Lobbyists,44625,6000,50625
F000372,N00000684,Rodney Frelinghuysen (R),2012,General Contractors,10650,32150,42800
F000372,N00000684,Rodney Frelinghuysen (R),2012,Securities & Investment,42300,0,42300
F000372,N00000684,Rodney Frelinghuysen (R),2012,Lawyers/Law Firms,18500,20749,39249
F000372,N00000684,Rodney Frelinghuysen (R),2012,Real Estate,23675,13000,36675
M000639,N00000699,Robert Menendez (D),2012,Lawyers/Law Firms,1655954,209226,1865180
M000639,N00000699,Robert Menendez (D),2012,Real Estate,1113017,101265,1214282
M000639,N00000699,Robert Menendez (D),2012,Securities & Investment,545901,150300,696201
M000639,N00000699,Robert Menendez (D),2012,Health Professionals,513910,142000,655910
M000639,N00000699,Robert Menendez (D),2012,Lobbyists,627362,26860,654222
M000639,N00000699,Robert Menendez (D),2012,Retired,522885,0,522885
M000639,N00000699,Robert Menendez (D),2012,Construction Services,364025,72500,436525
M000639,N00000699,Robert Menendez (D),2012,Pharmaceuticals/Health Products,173288,229250,402538
M000639,N00000699,Robert Menendez (D),2012,Insurance,244500,153000,397500
M000639,N00000699,Robert Menendez (D),2012,Leadership PACs,0,381244,381244
G000548,N00000743,Scott Garrett (R),2012,Securities & Investment,322895,227125,550020
G000548,N00000743,Scott Garrett (R),2012,Insurance,42522,137500,180022
G000548,N00000743,Scott Garrett (R),2012,Real Estate,61225,84472,145697
G000548,N00000743,Scott Garrett (R),2012,Commercial Banks,47150,81499,128649
G000548,N00000743,Scott Garrett (R),2012,Lawyers/Law Firms,59525,41500,101025
G000548,N00000743,Scott Garrett (R),2012,Misc Finance,50750,19000,69750
G000548,N00000743,Scott Garrett (R),2012,Retired,66850,0,66850
G000548,N00000743,Scott Garrett (R),2012,Accountants,36075,28000,64075
G000548,N00000743,Scott Garrett (R),2012,Finance/Credit Companies,6300,53150,59450
G000548,N00000743,Scott Garrett (R),2012,Lobbyists,45415,6000,51415
P000096,N00000751,Bill Pascrell Jr (D),2012,Lawyers/Law Firms,201021,39000,240021
P000096,N00000751,Bill Pascrell Jr (D),2012,Health Professionals,35650,140000,175650
P000096,N00000751,Bill Pascrell Jr (D),2012,Real Estate,73527,37000,110527
P000096,N00000751,Bill Pascrell Jr (D),2012,Insurance,30399,71000,101399
P000096,N00000751,Bill Pascrell Jr (D),2012,Lobbyists,93896,5000,98896
P000096,N00000751,Bill Pascrell Jr (D),2012,Leadership PACs,0,90227,90227
P000096,N00000751,Bill Pascrell Jr (D),2012,Pharmaceuticals/Health Products,8818,75000,83818
P000096,N00000751,Bill Pascrell Jr (D),2012,Health Services/HMOs,40350,41500,81850
P000096,N00000751,Bill Pascrell Jr (D),2012,Public Sector Unions,500,70300,70800
P000096,N00000751,Bill Pascrell Jr (D),2012,Building Trade Unions,2500,60500,63000
P000034,N00000781,Frank Pallone Jr (D),2012,Health Professionals,44552,298500,343052
P000034,N00000781,Frank Pallone Jr (D),2012,Pharmaceuticals/Health Products,22559,154000,176559
P000034,N00000781,Frank Pallone Jr (D),2012,Lobbyists,69961,7000,76961
P000034,N00000781,Frank Pallone Jr (D),2012,Lawyers/Law Firms,36050,36000,72050
P000034,N00000781,Frank Pallone Jr (D),2012,Hospitals/Nursing Homes,29800,34000,63800
P000034,N00000781,Frank Pallone Jr (D),2012,Health Services/HMOs,13800,41500,55300
P000034,N00000781,Frank Pallone Jr (D),2012,Building Trade Unions,0,50000,50000
P000034,N00000781,Frank Pallone Jr (D),2012,Real Estate,27000,17000,44000
P000034,N00000781,Frank Pallone Jr (D),2012,Casinos/Gambling,38150,5500,43650
P000034,N00000781,Frank Pallone Jr (D),2012,Public Sector Unions,0,43500,43500
A000210,N00000826,Robert E Andrews (D),2012,Lawyers/Law Firms,90612,52000,142612
A000210,N00000826,Robert E Andrews (D),2012,Education,85900,35101,121001
A000210,N00000826,Robert E Andrews (D),2012,Building Trade Unions,0,61000,61000
A000210,N00000826,Robert E Andrews (D),2012,Defense Aerospace,5200,54500,59700
A000210,N00000826,Robert E Andrews (D),2012,Public Sector Unions,0,58250,58250
A000210,N00000826,Robert E Andrews (D),2012,Pro-Israel,28775,21500,50275
A000210,N00000826,Robert E Andrews (D),2012,Lobbyists,42636,6750,49386
A000210,N00000826,Robert E Andrews (D),2012,Health Professionals,14500,34000,48500
A000210,N00000826,Robert E Andrews (D),2012,Insurance,6500,36441,42941
A000210,N00000826,Robert E Andrews (D),2012,Industrial Unions,0,39000,39000
L000554,N00000851,Frank A LoBiondo (R),2012,Sea Transport,21783,80000,101783
L000554,N00000851,Frank A LoBiondo (R),2012,Transportation Unions,0,84000,84000
L000554,N00000851,Frank A LoBiondo (R),2012,Building Trade Unions,0,65500,65500
L000554,N00000851,Frank A LoBiondo (R),2012,Public Sector Unions,0,53650,53650
L000554,N00000851,Frank A LoBiondo (R),2012,Air Transport,1750,39500,41250
L000554,N00000851,Frank A LoBiondo (R),2012,Casinos/Gambling,16250,22000,38250
L000554,N00000851,Frank A LoBiondo (R),2012,Defense Aerospace,0,35500,35500
L000554,N00000851,Frank A LoBiondo (R),2012,Health Professionals,11650,23000,34650
L000554,N00000851,Frank A LoBiondo (R),2012,Lobbyists,30300,2000,32300
L000554,N00000851,Frank A LoBiondo (R),2012,Lawyers/Law Firms,24550,7500,32050
H001032,N00000860,Rush Holt (D),2012,Retired,300945,0,300945
H001032,N00000860,Rush Holt (D),2012,Securities & Investment,52450,79000,131450
H001032,N00000860,Rush Holt (D),2012,Education,96510,0,96510
H001032,N00000860,Rush Holt (D),2012,Pharmaceuticals/Health Products,25200,56000,81200
H001032,N00000860,Rush Holt (D),2012,Insurance,2089,71500,73589
H001032,N00000860,Rush Holt (D),2012,Lawyers/Law Firms,38806,22500,61306
H001032,N00000860,Rush Holt (D),2012,Building Trade Unions,0,51500,51500
H001032,N00000860,Rush Holt (D),2012,Public Sector Unions,250,50000,50250
H001032,N00000860,Rush Holt (D),2012,Democratic/Liberal,34456,11000,45456
H001032,N00000860,Rush Holt (D),2012,Pro-Israel,43400,2000,45400
L000567,N00000898,Leonard Lance (R),2012,Pharmaceuticals/Health Products,49250,115500,164750
L000567,N00000898,Leonard Lance (R),2012,Health Professionals,8750,81800,90550
L000567,N00000898,Leonard Lance (R),2012,Leadership PACs,0,69500,69500
L000567,N00000898,Leonard Lance (R),2012,Insurance,11990,53000,64990
L000567,N00000898,Leonard Lance (R),2012,Lawyers/Law Firms,49270,11250,60520
L000567,N00000898,Leonard Lance (R),2012,Retired,48150,0,48150
L000567,N00000898,Leonard Lance (R),2012,Telephone Utilities,27000,19500,46500
L000567,N00000898,Leonard Lance (R),2012,Lobbyists,40059,3000,43059
L000567,N00000898,Leonard Lance (R),2012,Securities & Investment,29000,11500,40500
L000567,N00000898,Leonard Lance (R),2012,Electric Utilities,8750,29498,38248
N000002,N00000939,Jerrold Nadler (D),2012,Lawyers/Law Firms,125511,21500,147011
N000002,N00000939,Jerrold Nadler (D),2012,Securities & Investment,87710,11500,99210
N000002,N00000939,Jerrold Nadler (D),2012,Real Estate,73305,5000,78305
N000002,N00000939,Jerrold Nadler (D),2012,Construction Services,30100,36000,66100
N000002,N00000939,Jerrold Nadler (D),2012,Transportation Unions,0,52000,52000
N000002,N00000939,Jerrold Nadler (D),2012,Public Sector Unions,0,45000,45000
N000002,N00000939,Jerrold Nadler (D),2012,Building Trade Unions,0,42500,42500
N000002,N00000939,Jerrold Nadler (D),2012,TV/Movies/Music,13500,18000,31500
N000002,N00000939,Jerrold Nadler (D),2012,Business Services,24865,2500,27365
N000002,N00000939,Jerrold Nadler (D),2012,Health Professionals,13500,11000,24500
R000053,N00000964,Charles B Rangel (D),2012,Lawyers/Law Firms,92400,24500,116900
R000053,N00000964,Charles B Rangel (D),2012,Lobbyists,96939,1500,98439
R000053,N00000964,Charles B Rangel (D),2012,Real Estate,70200,19000,89200
R000053,N00000964,Charles B Rangel (D),2012,Insurance,40650,23500,64150
R000053,N00000964,Charles B Rangel (D),2012,Hospitals/Nursing Homes,47100,9527,56627
R000053,N00000964,Charles B Rangel (D),2012,Retired,47350,0,47350
R000053,N00000964,Charles B Rangel (D),2012,Building Trade Unions,0,47000,47000
R000053,N00000964,Charles B Rangel (D),2012,Public Sector Unions,0,44700,44700
R000053,N00000964,Charles B Rangel (D),2012,Candidate Committees,0,43700,43700
R000053,N00000964,Charles B Rangel (D),2012,Leadership PACs,0,40500,40500
E000179,N00001003,Eliot L Engel (D),2012,Health Professionals,13351,95000,108351
E000179,N00001003,Eliot L Engel (D),2012,Pro-Israel,53150,41000,94150
E000179,N00001003,Eliot L Engel (D),2012,Real Estate,67300,8000,75300
E000179,N00001003,Eliot L Engel (D),2012,Education,56125,0,56125
E000179,N00001003,Eliot L Engel (D),2012,Building Trade Unions,0,45000,45000
E000179,N00001003,Eliot L Engel (D),2012,Lawyers/Law Firms,22250,21500,43750
E000179,N00001003,Eliot L Engel (D),2012,Telephone Utilities,15360,17000,32360
E000179,N00001003,Eliot L Engel (D),2012,Pharmaceuticals/Health Products,750,31000,31750
E000179,N00001003,Eliot L Engel (D),2012,Public Sector Unions,0,28000,28000
E000179,N00001003,Eliot L Engel (D),2012,Hospitals/Nursing Homes,17600,9000,26600
L000480,N00001024,Nita M Lowey (D),2012,Securities & Investment,245250,10000,255250
L000480,N00001024,Nita M Lowey (D),2012,Retired,170150,0,170150
L000480,N00001024,Nita M Lowey (D),2012,Lawyers/Law Firms,144450,19000,163450
L000480,N00001024,Nita M Lowey (D),2012,Real Estate,140950,8000,148950
L000480,N00001024,Nita M Lowey (D),2012,Women's Issues,141910,5000,146910
L000480,N00001024,Nita M Lowey (D),2012,Pro-Israel,90800,26000,116800
L000480,N00001024,Nita M Lowey (D),2012,Health Professionals,32200,33500,65700
L000480,N00001024,Nita M Lowey (D),2012,Public Sector Unions,0,52000,52000
L000480,N00001024,Nita M Lowey (D),2012,Misc Finance,48250,0,48250
L000480,N00001024,Nita M Lowey (D),2012,Lobbyists,41750,2500,44250
S000148,N00001093,Charles E Schumer (D),2012,Securities & Investment,2857913,193300,3051213
S000148,N00001093,Charles E Schumer (D),2012,Lawyers/Law Firms,1978536,261013,2239549
S000148,N00001093,Charles E Schumer (D),2012,Real Estate,1245590,90500,1336090
S000148,N00001093,Charles E Schumer (D),2012,Lobbyists,589943,10420,600363
S000148,N00001093,Charles E Schumer (D),2012,Misc Finance,505600,16000,521600
S000148,N00001093,Charles E Schumer (D),2012,Insurance,271600,208400,480000
S000148,N00001093,Charles E Schumer (D),2012,Business Services,372665,40300,412965
S000148,N00001093,Charles E Schumer (D),2012,Retired,399200,0,399200
S000148,N00001093,Charles E Schumer (D),2012,TV/Movies/Music,293675,74500,368175
S000148,N00001093,Charles E Schumer (D),2012,Health Professionals,148000,208850,356850
V000081,N00001102,Nydia M Velazquez (D),2012,Securities & Investment,3750,51500,55250
V000081,N00001102,Nydia M Velazquez (D),2012,Lawyers/Law Firms,26750,10500,37250
V000081,N00001102,Nydia M Velazquez (D),2012,Accountants,2500,30000,32500
V000081,N00001102,Nydia M Velazquez (D),2012,Commercial Banks,500,30000,30500
V000081,N00001102,Nydia M Velazquez (D),2012,Public Sector Unions,0,28000,28000
V000081,N00001102,Nydia M Velazquez (D),2012,Insurance,0,25500,25500
V000081,N00001102,Nydia M Velazquez (D),2012,Leadership PACs,0,22500,22500
V000081,N00001102,Nydia M Velazquez (D),2012,Finance/Credit Companies,0,22000,22000
V000081,N00001102,Nydia M Velazquez (D),2012,Industrial Unions,0,22000,22000
V000081,N00001102,Nydia M Velazquez (D),2012,Real Estate,1750,18500,20250
C001038,N00001127,Joseph Crowley (D),2012,Securities & Investment,119399,164500,283899
C001038,N00001127,Joseph Crowley (D),2012,Insurance,31250,212500,243750
C001038,N00001127,Joseph Crowley (D),2012,Real Estate,96600,73096,169696
C001038,N00001127,Joseph Crowley (D),2012,Lawyers/Law Firms,65150,48750,113900
C001038,N00001127,Joseph Crowley (D),2012,Lobbyists,97551,2600,100151
C001038,N00001127,Joseph Crowley (D),2012,Pharmaceuticals/Health Products,5650,91500,97150
C001038,N00001127,Joseph Crowley (D),2012,Health Professionals,10250,70250,80500
C001038,N00001127,Joseph Crowley (D),2012,Commercial Banks,8000,68500,76500
C001038,N00001127,Joseph Crowley (D),2012,Accountants,11000,49000,60000
C001038,N00001127,Joseph Crowley (D),2012,Retail Sales,10501,45000,55501
M000309,N00001148,Carolyn McCarthy (D),2012,Securities & Investment,27000,123500,150500
M000309,N00001148,Carolyn McCarthy (D),2012,Insurance,3750,109750,113500
M000309,N00001148,Carolyn McCarthy (D),2012,Health Professionals,7800,86400,94200
M000309,N00001148,Carolyn McCarthy (D),2012,Education,58300,23500,81800
M000309,N00001148,Carolyn McCarthy (D),2012,Real Estate,38450,31900,70350
M000309,N00001148,Carolyn McCarthy (D),2012,Retired,65443,0,65443
M000309,N00001148,Carolyn McCarthy (D),2012,Women's Issues,60400,2500,62900
M000309,N00001148,Carolyn McCarthy (D),2012,Lawyers/Law Firms,37450,22900,60350
M000309,N00001148,Carolyn McCarthy (D),2012,Building Trade Unions,0,50000,50000
M000309,N00001148,Carolyn McCarthy (D),2012,Public Sector Unions,0,48000,48000
M001137,N00001171,Gregory W Meeks (D),2012,Securities & Investment,12500,82000,94500
M001137,N00001171,Gregory W Meeks (D),2012,Insurance,500,77250,77750
M001137,N00001171,Gregory W Meeks (D),2012,Finance/Credit Companies,18000,53500,71500
M001137,N00001171,Gregory W Meeks (D),2012,Air Transport,6400,28499,34899
M001137,N00001171,Gregory W Meeks (D),2012,Real Estate,6500,26000,32500
M001137,N00001171,Gregory W Meeks (D),2012,Commercial Banks,0,30500,30500
M001137,N00001171,Gregory W Meeks (D),2012,Lobbyists,27228,500,27728
M001137,N00001171,Gregory W Meeks (D),2012,Lawyers/Law Firms,9500,16109,25609
M001137,N00001171,Gregory W Meeks (D),2012,Electronics Mfg & Equip,1000,24000,25000
M001137,N00001171,Gregory W Meeks (D),2012,Pharmaceuticals/Health Products,500,20000,20500
K000210,N00001193,Pete King (R),2012,Securities & Investment,103750,43000,146750
K000210,N00001193,Pete King (R),2012,Real Estate,79800,10900,90700
K000210,N00001193,Pete King (R),2012,Retired,65850,0,65850
K000210,N00001193,Pete King (R),2012,Lawyers/Law Firms,33100,28662,61762
K000210,N00001193,Pete King (R),2012,Transportation Unions,0,50500,50500
K000210,N00001193,Pete King (R),2012,Building Trade Unions,0,49800,49800
K000210,N00001193,Pete King (R),2012,Business Services,35000,12500,47500
K000210,N00001193,Pete King (R),2012,Lobbyists,46845,0,46845
K000210,N00001193,Pete King (R),2012,Air Transport,10000,35070,45070
K000210,N00001193,Pete King (R),2012,Defense Aerospace,500,42000,42500
C001092,N00001285,Chris Collins (R),2012,Leadership PACs,0,96720,96720
C001092,N00001285,Chris Collins (R),2012,Health Professionals,19800,13500,33300
C001092,N00001285,Chris Collins (R),2012,Oil & Gas,10250,23000,33250
C001092,N00001285,Chris Collins (R),2012,Real Estate,31900,0,31900
C001092,N00001285,Chris Collins (R),2012,Candidate Committees,3500,27000,30500
C001092,N00001285,Chris Collins (R),2012,Retired,28800,0,28800
C001092,N00001285,Chris Collins (R),2012,General Contractors,18700,8500,27200
C001092,N00001285,Chris Collins (R),2012,Automotive,4600,17500,22100
C001092,N00001285,Chris Collins (R),2012,Misc Manufacturing & Distributing,15750,4000,19750
C001092,N00001285,Chris Collins (R),2012,Lawyers/Law Firms,16700,1000,17700
S000480,N00001311,Louise M Slaughter (D),2012,Leadership PACs,0,139000,139000
S000480,N00001311,Louise M Slaughter (D),2012,Women's Issues,90478,24409,114887
S000480,N00001311,Louise M Slaughter (D),2012,Candidate Committees,0,104268,104268
S000480,N00001311,Louise M Slaughter (D),2012,Public Sector Unions,1000,82000,83000
S000480,N00001311,Louise M Slaughter (D),2012,Retired,72781,0,72781
S000480,N00001311,Louise M Slaughter (D),2012,Transportation Unions,0,65000,65000
S000480,N00001311,Louise M Slaughter (D),2012,Building Trade Unions,0,63000,63000
S000480,N00001311,Louise M Slaughter (D),2012,Lawyers/Law Firms,38924,24000,62924
S000480,N00001311,Louise M Slaughter (D),2012,Industrial Unions,0,60000,60000
S000480,N00001311,Louise M Slaughter (D),2012,Health Professionals,6950,51100,58050
D000482,N00001373,Mike Doyle (D),2012,Electric Utilities,0,75500,75500
D000482,N00001373,Mike Doyle (D),2012,Industrial Unions,0,59000,59000
D000482,N00001373,Mike Doyle (D),2012,Building Trade Unions,0,50000,50000
D000482,N00001373,Mike Doyle (D),2012,Lawyers/Law Firms,25450,18750,44200
D000482,N00001373,Mike Doyle (D),2012,Telecom Services,0,40000,40000
D000482,N00001373,Mike Doyle (D),2012,Health Professionals,5500,31000,36500
D000482,N00001373,Mike Doyle (D),2012,Real Estate,23100,13000,36100
D000482,N00001373,Mike Doyle (D),2012,Public Sector Unions,0,35500,35500
D000482,N00001373,Mike Doyle (D),2012,Oil & Gas,1000,25250,26250
D000482,N00001373,Mike Doyle (D),2012,Telephone Utilities,0,24620,24620
T000461,N00001489,Pat Toomey (R),2012,Republican/Conservative,1274497,84673,1359170
T000461,N00001489,Pat Toomey (R),2012,Securities & Investment,1149668,122000,1271668
T000461,N00001489,Pat Toomey (R),2012,Retired,1244881,0,1244881
T000461,N00001489,Pat Toomey (R),2012,Lawyers/Law Firms,535699,84520,620219
T000461,N00001489,Pat Toomey (R),2012,Real Estate,570029,30500,600529
T000461,N00001489,Pat Toomey (R),2012,Business Services,581300,10000,591300
T000461,N00001489,Pat Toomey (R),2012,Insurance,213520,162650,376170
T000461,N00001489,Pat Toomey (R),2012,Health Professionals,304940,61000,365940
T000461,N00001489,Pat Toomey (R),2012,Oil & Gas,231366,132550,363916
T000461,N00001489,Pat Toomey (R),2012,Misc Finance,335970,17000,352970
S001162,N00001579,Allyson Schwartz (D),2012,Lawyers/Law Firms,248620,61238,309858
S001162,N00001579,Allyson Schwartz (D),2012,Health Professionals,62293,226250,288543
S001162,N00001579,Allyson Schwartz (D),2012,Pharmaceuticals/Health Products,40200,143500,183700
S001162,N00001579,Allyson Schwartz (D),2012,Securities & Investment,81000,55500,136500
S001162,N00001579,Allyson Schwartz (D),2012,Real Estate,91302,36750,128052
S001162,N00001579,Allyson Schwartz (D),2012,Insurance,11500,109000,120500
S001162,N00001579,Allyson Schwartz (D),2012,Retired,117200,0,117200
S001162,N00001579,Allyson Schwartz (D),2012,Hospitals/Nursing Homes,49075,36000,85075
S001162,N00001579,Allyson Schwartz (D),2012,Education,75900,0,75900
S001162,N00001579,Allyson Schwartz (D),2012,Lobbyists,70512,1000,71512
B001227,N00001619,Robert A Brady (D),2012,Lawyers/Law Firms,43950,23250,67200
B001227,N00001619,Robert A Brady (D),2012,Building Trade Unions,500,51150,51650
B001227,N00001619,Robert A Brady (D),2012,Industrial Unions,0,47000,47000
B001227,N00001619,Robert A Brady (D),2012,Transportation Unions,0,32500,32500
B001227,N00001619,Robert A Brady (D),2012,General Contractors,30900,0,30900
B001227,N00001619,Robert A Brady (D),2012,Misc Unions,0,24350,24350
B001227,N00001619,Robert A Brady (D),2012,Business Services,23700,0,23700
B001227,N00001619,Robert A Brady (D),2012,Real Estate,16750,1500,18250
B001227,N00001619,Robert A Brady (D),2012,Public Sector Unions,0,17500,17500
B001227,N00001619,Robert A Brady (D),2012,Automotive,5500,10000,15500
P000373,N00001633,Joe Pitts (R),2012,Health Professionals,35550,264050,299600
P000373,N00001633,Joe Pitts (R),2012,Pharmaceuticals/Health Products,23109,195250,218359
P000373,N00001633,Joe Pitts (R),2012,Health Services/HMOs,500,101689,102189
P000373,N00001633,Joe Pitts (R),2012,Lobbyists,40676,5000,45676
P000373,N00001633,Joe Pitts (R),2012,Hospitals/Nursing Homes,4000,40035,44035
P000373,N00001633,Joe Pitts (R),2012,Oil & Gas,0,41500,41500
P000373,N00001633,Joe Pitts (R),2012,Lawyers/Law Firms,9250,31000,40250
P000373,N00001633,Joe Pitts (R),2012,Insurance,3750,31500,35250
P000373,N00001633,Joe Pitts (R),2012,Electric Utilities,500,33000,33500
P000373,N00001633,Joe Pitts (R),2012,Food Processing & Sales,4000,19500,23500
R000361,N00001685,Jay Rockefeller (D),2012,Lawyers/Law Firms,547522,125300,672822
R000361,N00001685,Jay Rockefeller (D),2012,Securities & Investment,258550,41500,300050
R000361,N00001685,Jay Rockefeller (D),2012,Air Transport,82850,205250,288100
R000361,N00001685,Jay Rockefeller (D),2012,Telecom Services,91100,141500,232600
R000361,N00001685,Jay Rockefeller (D),2012,Health Professionals,102750,126400,229150
R000361,N00001685,Jay Rockefeller (D),2012,Lobbyists,195978,4685,200663
R000361,N00001685,Jay Rockefeller (D),2012,Real Estate,168750,21000,189750
R000361,N00001685,Jay Rockefeller (D),2012,Retired,189350,0,189350
R000361,N00001685,Jay Rockefeller (D),2012,Mining,75000,75300,150300
R000361,N00001685,Jay Rockefeller (D),2012,Electronics Mfg & Equip,66050,84236,150286
L000261,N00001691,Carl Levin (D),2012,Lawyers/Law Firms,671861,101241,773102
L000261,N00001691,Carl Levin (D),2012,Retired,400040,0,400040
L000261,N00001691,Carl Levin (D),2012,Real Estate,320649,28510,349159
L000261,N00001691,Carl Levin (D),2012,Pro-Israel,271878,71050,342928
L000261,N00001691,Carl Levin (D),2012,Securities & Investment,178890,29500,208390
L000261,N00001691,Carl Levin (D),2012,Business Services,163852,9596,173448
L000261,N00001691,Carl Levin (D),2012,Automotive,130350,41869,172219
L000261,N00001691,Carl Levin (D),2012,Health Professionals,95450,43500,138950
L000261,N00001691,Carl Levin (D),2012,Education,136050,2500,138550
L000261,N00001691,Carl Levin (D),2012,Misc Finance,124200,2000,126200
N000147,N00001692,Eleanor Holmes Norton (D),2012,Real Estate,52150,20000,72150
N000147,N00001692,Eleanor Holmes Norton (D),2012,Building Trade Unions,0,47500,47500
N000147,N00001692,Eleanor Holmes Norton (D),2012,Public Sector Unions,250,24000,24250
N000147,N00001692,Eleanor Holmes Norton (D),2012,Lawyers/Law Firms,11750,7750,19500
N000147,N00001692,Eleanor Holmes Norton (D),2012,Transportation Unions,0,16500,16500
N000147,N00001692,Eleanor Holmes Norton (D),2012,Industrial Unions,0,10000,10000
N000147,N00001692,Eleanor Holmes Norton (D),2012,Accountants,0,10000,10000
N000147,N00001692,Eleanor Holmes Norton (D),2012,Air Transport,0,9500,9500
N000147,N00001692,Eleanor Holmes Norton (D),2012,Construction Services,2750,5500,8250
N000147,N00001692,Eleanor Holmes Norton (D),2012,Railroads,0,7000,7000
F000043,N00001746,Chaka Fattah (D),2012,Lawyers/Law Firms,33400,33000,66400
F000043,N00001746,Chaka Fattah (D),2012,Public Sector Unions,0,43500,43500
F000043,N00001746,Chaka Fattah (D),2012,Defense Aerospace,0,31000,31000
F000043,N00001746,Chaka Fattah (D),2012,Building Trade Unions,0,27500,27500
F000043,N00001746,Chaka Fattah (D),2012,Real Estate,16500,10500,27000
F000043,N00001746,Chaka Fattah (D),2012,Lobbyists,21704,2000,23704
F000043,N00001746,Chaka Fattah (D),2012,Telecom Services,9250,12000,21250
F000043,N00001746,Chaka Fattah (D),2012,Pharmaceuticals/Health Products,1250,15000,16250
F000043,N00001746,Chaka Fattah (D),2012,Industrial Unions,0,16000,16000
F000043,N00001746,Chaka Fattah (D),2012,Air Transport,9750,5500,15250
G000386,N00001758,Chuck Grassley (R),2012,Health Professionals,107260,293710,400970
G000386,N00001758,Chuck Grassley (R),2012,Insurance,109302,275900,385202
G000386,N00001758,Chuck Grassley (R),2012,Leadership PACs,0,311300,311300
G000386,N00001758,Chuck Grassley (R),2012,Lobbyists,287050,12818,299868
G000386,N00001758,Chuck Grassley (R),2012,Securities & Investment,154150,129750,283900
G000386,N00001758,Chuck Grassley (R),2012,Pharmaceuticals/Health Products,61950,157700,219650
G000386,N00001758,Chuck Grassley (R),2012,Lawyers/Law Firms,102300,111873,214173
G000386,N00001758,Chuck Grassley (R),2012,Health Services/HMOs,57550,156600,214150
G000386,N00001758,Chuck Grassley (R),2012,Retired,208157,0,208157
G000386,N00001758,Chuck Grassley (R),2012,Hospitals/Nursing Homes,97037,107800,204837
D000355,N00001783,John D Dingell (D),2012,Health Professionals,3750,106000,109750
D000355,N00001783,John D Dingell (D),2012,Electric Utilities,14550,93500,108050
D000355,N00001783,John D Dingell (D),2012,Lobbyists,96366,4566,100932
D000355,N00001783,John D Dingell (D),2012,Lawyers/Law Firms,21400,64571,85971
D000355,N00001783,John D Dingell (D),2012,Pharmaceuticals/Health Products,1000,71500,72500
D000355,N00001783,John D Dingell (D),2012,Automotive,29550,37500,67050
D000355,N00001783,John D Dingell (D),2012,Building Trade Unions,0,55000,55000
D000355,N00001783,John D Dingell (D),2012,TV/Movies/Music,7550,43000,50550
D000355,N00001783,John D Dingell (D),2012,Industrial Unions,0,50000,50000
D000355,N00001783,John D Dingell (D),2012,Telephone Utilities,6500,37500,44000
S000583,N00001811,Lamar Smith (R),2012,Retired,96550,0,96550
S000583,N00001811,Lamar Smith (R),2012,TV/Movies/Music,42050,52000,94050
S000583,N00001811,Lamar Smith (R),2012,Oil & Gas,26750,57000,83750
S000583,N00001811,Lamar Smith (R),2012,Lawyers/Law Firms,31964,37185,69149
S000583,N00001811,Lamar Smith (R),2012,Telecom Services,12500,52500,65000
S000583,N00001811,Lamar Smith (R),2012,Real Estate,46100,15510,61610
S000583,N00001811,Lamar Smith (R),2012,Electronics Mfg & Equip,11500,47500,59000
S000583,N00001811,Lamar Smith (R),2012,Health Professionals,25950,27750,53700
S000583,N00001811,Lamar Smith (R),2012,Insurance,19000,34650,53650
S000583,N00001811,Lamar Smith (R),2012,Accountants,1000,49500,50500
S000248,N00001813,Jose E Serrano (D),2012,Public Sector Unions,0,53500,53500
S000248,N00001813,Jose E Serrano (D),2012,Building Trade Unions,0,17500,17500
S000248,N00001813,Jose E Serrano (D),2012,Industrial Unions,0,13000,13000
S000248,N00001813,Jose E Serrano (D),2012,Real Estate,1000,10000,11000
S000248,N00001813,Jose E Serrano (D),2012,Transportation Unions,0,10500,10500
S000248,N00001813,Jose E Serrano (D),2012,Accountants,0,10000,10000
S000248,N00001813,Jose E Serrano (D),2012,Crop Production & Basic Processing,0,9000,9000
S000248,N00001813,Jose E Serrano (D),2012,"Beer, Wine & Liquor",0,7500,7500
S000248,N00001813,Jose E Serrano (D),2012,Hospitals/Nursing Homes,5500,2000,7500
S000248,N00001813,Jose E Serrano (D),2012,Leadership PACs,0,7000,7000
S000248,N00001813,Jose E Serrano (D),2012,Lawyers/Law Firms,0,7000,7000
Y000031,N00001817,C W Bill Young (R),2012,Defense Aerospace,71000,50500,121500
Y000031,N00001817,C W Bill Young (R),2012,Securities & Investment,78890,10000,88890
Y000031,N00001817,C W Bill Young (R),2012,Defense Electronics,10060,76500,86560
Y000031,N00001817,C W Bill Young (R),2012,Lobbyists,77750,5452,83202
Y000031,N00001817,C W Bill Young (R),2012,Health Professionals,15500,41000,56500
Y000031,N00001817,C W Bill Young (R),2012,Real Estate,29150,9000,38150
Y000031,N00001817,C W Bill Young (R),2012,Misc Manufacturing & Distributing,2500,32500,35000
Y000031,N00001817,C W Bill Young (R),2012,Retired,32250,0,32250
Y000031,N00001817,C W Bill Young (R),2012,Air Transport,6200,23949,30149
Y000031,N00001817,C W Bill Young (R),2012,Leadership PACs,0,27000,27000
H000874,N00001821,Steny H Hoyer (D),2012,Securities & Investment,104760,141750,246510
H000874,N00001821,Steny H Hoyer (D),2012,Electric Utilities,10050,227500,237550
H000874,N00001821,Steny H Hoyer (D),2012,Health Professionals,27496,209075,236571
H000874,N00001821,Steny H Hoyer (D),2012,Insurance,45633,181500,227133
H000874,N00001821,Steny H Hoyer (D),2012,Lawyers/Law Firms,107250,85750,193000
H000874,N00001821,Steny H Hoyer (D),2012,Real Estate,76570,80020,156590
H000874,N00001821,Steny H Hoyer (D),2012,Lobbyists,145315,10600,155915
H000874,N00001821,Steny H Hoyer (D),2012,Pharmaceuticals/Health Products,13000,141000,154000
H000874,N00001821,Steny H Hoyer (D),2012,Pro-Israel,105925,37850,143775
H000874,N00001821,Steny H Hoyer (D),2012,Public Sector Unions,0,124500,124500
W000215,N00001861,Henry Waxman (D),2012,Health Professionals,8250,175000,183250
W000215,N00001861,Henry Waxman (D),2012,Telecom Services,25500,104500,130000
W000215,N00001861,Henry Waxman (D),2012,Lawyers/Law Firms,58630,69200,127830
W000215,N00001861,Henry Waxman (D),2012,TV/Movies/Music,36000,56000,92000
W000215,N00001861,Henry Waxman (D),2012,Hospitals/Nursing Homes,17750,64000,81750
W000215,N00001861,Henry Waxman (D),2012,Pharmaceuticals/Health Products,32000,43000,75000
W000215,N00001861,Henry Waxman (D),2012,Pro-Israel,49050,13100,62150
W000215,N00001861,Henry Waxman (D),2012,Lobbyists,55393,5000,60393
W000215,N00001861,Henry Waxman (D),2012,Real Estate,30250,22500,52750
W000215,N00001861,Henry Waxman (D),2012,Public Sector Unions,0,49500,49500
M000702,N00001945,Barbara A Mikulski (D),2012,Lawyers/Law Firms,227941,66650,294591
M000702,N00001945,Barbara A Mikulski (D),2012,Lobbyists,228218,20345,248563
M000702,N00001945,Barbara A Mikulski (D),2012,Pharmaceuticals/Health Products,7650,208871,216521
M000702,N00001945,Barbara A Mikulski (D),2012,Real Estate,170450,29500,199950
M000702,N00001945,Barbara A Mikulski (D),2012,Health Professionals,49234,144000,193234
M000702,N00001945,Barbara A Mikulski (D),2012,Leadership PACs,0,186250,186250
M000702,N00001945,Barbara A Mikulski (D),2012,Pro-Israel,131675,37500,169175
M000702,N00001945,Barbara A Mikulski (D),2012,Retired,168640,0,168640
M000702,N00001945,Barbara A Mikulski (D),2012,Misc Defense,76185,84900,161085
M000702,N00001945,Barbara A Mikulski (D),2012,Securities & Investment,105515,31000,136515
C000141,N00001955,Ben Cardin (D),2012,Lawyers/Law Firms,412226,118900,531126
C000141,N00001955,Ben Cardin (D),2012,Real Estate,383720,62500,446220
C000141,N00001955,Ben Cardin (D),2012,Health Professionals,141310,264399,405709
C000141,N00001955,Ben Cardin (D),2012,Securities & Investment,281833,117000,398833
C000141,N00001955,Ben Cardin (D),2012,Pro-Israel,218262,59280,277542
C000141,N00001955,Ben Cardin (D),2012,Retired,269660,0,269660
C000141,N00001955,Ben Cardin (D),2012,Lobbyists,251643,9366,261009
C000141,N00001955,Ben Cardin (D),2012,Insurance,52600,181000,233600
C000141,N00001955,Ben Cardin (D),2012,Leadership PACs,0,192000,192000
C000141,N00001955,Ben Cardin (D),2012,Health Services/HMOs,72550,114300,186850
C000984,N00001971,Elijah E Cummings (D),2012,Public Sector Unions,0,87500,87500
C000984,N00001971,Elijah E Cummings (D),2012,Transportation Unions,0,67100,67100
C000984,N00001971,Elijah E Cummings (D),2012,Sea Transport,8000,35500,43500
C000984,N00001971,Elijah E Cummings (D),2012,Health Professionals,12050,23000,35050
C000984,N00001971,Elijah E Cummings (D),2012,Air Transport,0,34000,34000
C000984,N00001971,Elijah E Cummings (D),2012,Industrial Unions,0,32000,32000
C000984,N00001971,Elijah E Cummings (D),2012,Railroads,0,31000,31000
C000984,N00001971,Elijah E Cummings (D),2012,Lawyers/Law Firms,11500,19000,30500
C000984,N00001971,Elijah E Cummings (D),2012,Real Estate,14000,9500,23500
C000984,N00001971,Elijah E Cummings (D),2012,Building Trade Unions,0,22000,22000
W000672,N00002073,Frank Wolf (R),2012,Retired,93100,0,93100
W000672,N00002073,Frank Wolf (R),2012,Electronics Mfg & Equip,9950,41000,50950
W000672,N00002073,Frank Wolf (R),2012,Real Estate,38950,10000,48950
W000672,N00002073,Frank Wolf (R),2012,Defense Aerospace,4750,34500,39250
W000672,N00002073,Frank Wolf (R),2012,Public Sector Unions,0,36600,36600
W000672,N00002073,Frank Wolf (R),2012,Lawyers/Law Firms,18350,16250,34600
W000672,N00002073,Frank Wolf (R),2012,Defense Electronics,1700,32000,33700
W000672,N00002073,Frank Wolf (R),2012,Lobbyists,31250,1000,32250
W000672,N00002073,Frank Wolf (R),2012,Construction Services,6700,20000,26700
W000672,N00002073,Frank Wolf (R),2012,Air Transport,5600,19900,25500
M000933,N00002083,Jim Moran (D),2012,Electronics Mfg & Equip,52750,43000,95750
M000933,N00002083,Jim Moran (D),2012,Real Estate,62200,20500,82700
M000933,N00002083,Jim Moran (D),2012,Defense Electronics,12500,58500,71000
M000933,N00002083,Jim Moran (D),2012,Lobbyists,56700,4500,61200
M000933,N00002083,Jim Moran (D),2012,Misc Defense,22750,30000,52750
M000933,N00002083,Jim Moran (D),2012,Defense Aerospace,4250,38500,42750
M000933,N00002083,Jim Moran (D),2012,Lawyers/Law Firms,25250,9000,34250
M000933,N00002083,Jim Moran (D),2012,Retired,32900,0,32900
M000933,N00002083,Jim Moran (D),2012,Public Sector Unions,0,32500,32500
M000933,N00002083,Jim Moran (D),2012,Automotive,5000,20500,25500
W000805,N00002097,Mark Warner (D),2012,Lawyers/Law Firms,1721249,186474,1907723
W000805,N00002097,Mark Warner (D),2012,Securities & Investment,1703032,132250,1835282
W000805,N00002097,Mark Warner (D),2012,Retired,955401,0,955401
W000805,N00002097,Mark Warner (D),2012,Real Estate,833304,45500,878804
W000805,N00002097,Mark Warner (D),2012,Lobbyists,532606,8500,541106
W000805,N00002097,Mark Warner (D),2012,Business Services,462983,39100,502083
W000805,N00002097,Mark Warner (D),2012,Misc Finance,447238,9500,456738
W000805,N00002097,Mark Warner (D),2012,Insurance,226800,217300,444100
W000805,N00002097,Mark Warner (D),2012,Electronics Mfg & Equip,312842,116869,429711
W000805,N00002097,Mark Warner (D),2012,Health Professionals,215380,162999,378379
S000185,N00002147,Bobby Scott (D),2012,Public Sector Unions,0,41500,41500
S000185,N00002147,Bobby Scott (D),2012,Lawyers/Law Firms,18850,15500,34350
S000185,N00002147,Bobby Scott (D),2012,Industrial Unions,0,31000,31000
S000185,N00002147,Bobby Scott (D),2012,Building Trade Unions,0,22000,22000
S000185,N00002147,Bobby Scott (D),2012,Misc Unions,0,17000,17000
S000185,N00002147,Bobby Scott (D),2012,Education,9250,7000,16250
S000185,N00002147,Bobby Scott (D),2012,Retired,14250,0,14250
S000185,N00002147,Bobby Scott (D),2012,Misc Defense,4500,9500,14000
S000185,N00002147,Bobby Scott (D),2012,Telecom Services,1000,10000,11000
S000185,N00002147,Bobby Scott (D),2012,Real Estate,6250,4000,10250
R000011,N00002198,Nick Rahall (D),2012,Transportation Unions,0,143250,143250
R000011,N00002198,Nick Rahall (D),2012,Air Transport,2000,124867,126867
R000011,N00002198,Nick Rahall (D),2012,Lobbyists,60049,5250,65299
R000011,N00002198,Nick Rahall (D),2012,Building Trade Unions,0,57250,57250
R000011,N00002198,Nick Rahall (D),2012,Railroads,5000,50000,55000
R000011,N00002198,Nick Rahall (D),2012,Lawyers/Law Firms,18750,34000,52750
R000011,N00002198,Nick Rahall (D),2012,Public Sector Unions,0,49500,49500
R000011,N00002198,Nick Rahall (D),2012,Industrial Unions,0,45000,45000
R000011,N00002198,Nick Rahall (D),2012,Sea Transport,10999,33500,44499
R000011,N00002198,Nick Rahall (D),2012,General Contractors,15000,29150,44150
B001135,N00002221,Richard Burr (R),2012,Retired,643631,0,643631
B001135,N00002221,Richard Burr (R),2012,Health Professionals,308239,209241,517480
B001135,N00002221,Richard Burr (R),2012,Lawyers/Law Firms,327550,140500,468050
B001135,N00002221,Richard Burr (R),2012,Insurance,209151,247000,456151
B001135,N00002221,Richard Burr (R),2012,Pharmaceuticals/Health Products,113250,326619,439869
B001135,N00002221,Richard Burr (R),2012,Securities & Investment,287802,107400,395202
B001135,N00002221,Richard Burr (R),2012,Lobbyists,334041,13000,347041
B001135,N00002221,Richard Burr (R),2012,Real Estate,283629,51000,334629
B001135,N00002221,Richard Burr (R),2012,Electric Utilities,142531,155999,298530
B001135,N00002221,Richard Burr (R),2012,Leadership PACs,0,295241,295241
C000556,N00002247,Howard Coble (R),2012,Lawyers/Law Firms,7500,22500,30000
C000556,N00002247,Howard Coble (R),2012,Air Transport,250,28000,28250
C000556,N00002247,Howard Coble (R),2012,Tobacco,14250,13498,27748
C000556,N00002247,Howard Coble (R),2012,Lobbyists,17000,2000,19000
C000556,N00002247,Howard Coble (R),2012,Leadership PACs,0,18000,18000
C000556,N00002247,Howard Coble (R),2012,"Beer, Wine & Liquor",6345,11000,17345
C000556,N00002247,Howard Coble (R),2012,Retired,17300,0,17300
C000556,N00002247,Howard Coble (R),2012,TV/Movies/Music,2000,14000,16000
C000556,N00002247,Howard Coble (R),2012,Trucking,2000,13000,15000
C000556,N00002247,Howard Coble (R),2012,Electric Utilities,0,15000,15000
P000523,N00002260,David Price (D),2012,Retired,88800,0,88800
P000523,N00002260,David Price (D),2012,Education,67250,0,67250
P000523,N00002260,David Price (D),2012,Pharmaceuticals/Health Products,2500,56500,59000
P000523,N00002260,David Price (D),2012,Lawyers/Law Firms,29950,27500,57450
P000523,N00002260,David Price (D),2012,Public Sector Unions,0,39500,39500
P000523,N00002260,David Price (D),2012,Electronics Mfg & Equip,18875,14500,33375
P000523,N00002260,David Price (D),2012,Health Professionals,11850,19800,31650
P000523,N00002260,David Price (D),2012,Defense Electronics,0,30500,30500
P000523,N00002260,David Price (D),2012,Defense Aerospace,350,29500,29850
P000523,N00002260,David Price (D),2012,Business Services,18400,10000,28400
J000255,N00002299,Walter B Jones Jr (R),2012,Retired,53500,0,53500
J000255,N00002299,Walter B Jones Jr (R),2012,Health Professionals,21300,29500,50800
J000255,N00002299,Walter B Jones Jr (R),2012,Real Estate,16750,14000,30750
J000255,N00002299,Walter B Jones Jr (R),2012,Lawyers/Law Firms,8300,22000,30300
J000255,N00002299,Walter B Jones Jr (R),2012,Leadership PACs,0,20000,20000
J000255,N00002299,Walter B Jones Jr (R),2012,Transportation Unions,0,19000,19000
J000255,N00002299,Walter B Jones Jr (R),2012,Defense Aerospace,0,19000,19000
J000255,N00002299,Walter B Jones Jr (R),2012,Crop Production & Basic Processing,2700,16000,18700
J000255,N00002299,Walter B Jones Jr (R),2012,Misc Manufacturing & Distributing,16500,2000,18500
J000255,N00002299,Walter B Jones Jr (R),2012,Commercial Banks,3000,15000,18000
W000207,N00002328,Melvin L Watt (D),2012,Insurance,250,58500,58750
W000207,N00002328,Melvin L Watt (D),2012,Commercial Banks,250,48500,48750
W000207,N00002328,Melvin L Watt (D),2012,Securities & Investment,0,47500,47500
W000207,N00002328,Melvin L Watt (D),2012,TV/Movies/Music,2500,37000,39500
W000207,N00002328,Melvin L Watt (D),2012,Pharmaceuticals/Health Products,6000,33250,39250
W000207,N00002328,Melvin L Watt (D),2012,Lawyers/Law Firms,8450,29000,37450
W000207,N00002328,Melvin L Watt (D),2012,Industrial Unions,0,34500,34500
W000207,N00002328,Melvin L Watt (D),2012,Real Estate,250,33000,33250
W000207,N00002328,Melvin L Watt (D),2012,Electronics Mfg & Equip,750,28000,28750
W000207,N00002328,Melvin L Watt (D),2012,Finance/Credit Companies,0,27500,27500
M000485,N00002356,Mike McIntyre (D),2012,Lawyers/Law Firms,70600,59434,130034
M000485,N00002356,Mike McIntyre (D),2012,Leadership PACs,0,115000,115000
M000485,N00002356,Mike McIntyre (D),2012,Retired,113106,0,113106
M000485,N00002356,Mike McIntyre (D),2012,Crop Production & Basic Processing,47184,60250,107434
M000485,N00002356,Mike McIntyre (D),2012,Health Professionals,42750,50500,93250
M000485,N00002356,Mike McIntyre (D),2012,Public Sector Unions,0,78000,78000
M000485,N00002356,Mike McIntyre (D),2012,Agricultural Services/Products,2300,64250,66550
M000485,N00002356,Mike McIntyre (D),2012,Real Estate,49150,14500,63650
M000485,N00002356,Mike McIntyre (D),2012,Candidate Committees,0,59500,59500
M000485,N00002356,Mike McIntyre (D),2012,Defense Aerospace,0,56624,56624
C000537,N00002408,James E Clyburn (D),2012,Health Professionals,4000,135000,139000
C000537,N00002408,James E Clyburn (D),2012,Electric Utilities,6250,130500,136750
C000537,N00002408,James E Clyburn (D),2012,Pharmaceuticals/Health Products,5250,118894,124144
C000537,N00002408,James E Clyburn (D),2012,Lawyers/Law Firms,50096,64359,114455
C000537,N00002408,James E Clyburn (D),2012,Insurance,3750,88500,92250
C000537,N00002408,James E Clyburn (D),2012,Public Sector Unions,0,88500,88500
C000537,N00002408,James E Clyburn (D),2012,Telecom Services,21000,63500,84500
C000537,N00002408,James E Clyburn (D),2012,Lobbyists,66029,5500,71529
C000537,N00002408,James E Clyburn (D),2012,Commercial Banks,6750,59000,65750
C000537,N00002408,James E Clyburn (D),2012,Securities & Investment,13000,52390,65390
L000287,N00002577,John Lewis (D),2012,Lawyers/Law Firms,56250,28900,85150
L000287,N00002577,John Lewis (D),2012,Health Professionals,2500,74500,77000
L000287,N00002577,John Lewis (D),2012,Insurance,1500,71000,72500
L000287,N00002577,John Lewis (D),2012,Securities & Investment,17550,25500,43050
L000287,N00002577,John Lewis (D),2012,Telecom Services,11000,25000,36000
L000287,N00002577,John Lewis (D),2012,Public Sector Unions,250,35000,35250
L000287,N00002577,John Lewis (D),2012,Industrial Unions,0,33000,33000
L000287,N00002577,John Lewis (D),2012,Real Estate,15000,14000,29000
L000287,N00002577,John Lewis (D),2012,Building Trade Unions,0,29000,29000
L000287,N00002577,John Lewis (D),2012,Misc Unions,500,27500,28000
L000287,N00002577,John Lewis (D),2012,Pharmaceuticals/Health Products,500,27500,28000
I000055,N00002593,Johnny Isakson (R),2012,Real Estate,674592,110000,784592
I000055,N00002593,Johnny Isakson (R),2012,Retired,474998,0,474998
I000055,N00002593,Johnny Isakson (R),2012,Lawyers/Law Firms,310516,101766,412282
I000055,N00002593,Johnny Isakson (R),2012,Insurance,129650,146500,276150
I000055,N00002593,Johnny Isakson (R),2012,Health Professionals,137066,133500,270566
I000055,N00002593,Johnny Isakson (R),2012,Leadership PACs,0,235604,235604
I000055,N00002593,Johnny Isakson (R),2012,Lobbyists,206161,14000,220161
I000055,N00002593,Johnny Isakson (R),2012,Securities & Investment,123950,92500,216450
I000055,N00002593,Johnny Isakson (R),2012,Misc Finance,141824,28000,169824
I000055,N00002593,Johnny Isakson (R),2012,Pharmaceuticals/Health Products,22450,145600,168050
K000220,N00002656,Jack Kingston (R),2012,Food Processing & Sales,12528,67255,79783
K000220,N00002656,Jack Kingston (R),2012,Crop Production & Basic Processing,20350,51500,71850
K000220,N00002656,Jack Kingston (R),2012,Lobbyists,69077,2136,71213
K000220,N00002656,Jack Kingston (R),2012,Agricultural Services/Products,3000,52500,55500
K000220,N00002656,Jack Kingston (R),2012,Defense Electronics,2000,50000,52000
K000220,N00002656,Jack Kingston (R),2012,Lawyers/Law Firms,7450,37412,44862
K000220,N00002656,Jack Kingston (R),2012,Defense Aerospace,0,39500,39500
K000220,N00002656,Jack Kingston (R),2012,Health Professionals,24070,13500,37570
K000220,N00002656,Jack Kingston (R),2012,Poultry & Eggs,11000,23500,34500
K000220,N00002656,Jack Kingston (R),2012,Food & Beverage,9750,24500,34250
B000490,N00002674,Sanford D Bishop Jr (D),2012,Lawyers/Law Firms,51150,28157,79307
B000490,N00002674,Sanford D Bishop Jr (D),2012,Crop Production & Basic Processing,11750,67000,78750
B000490,N00002674,Sanford D Bishop Jr (D),2012,Defense Aerospace,1000,41000,42000
B000490,N00002674,Sanford D Bishop Jr (D),2012,Lobbyists,38493,2243,40736
B000490,N00002674,Sanford D Bishop Jr (D),2012,Industrial Unions,0,37500,37500
B000490,N00002674,Sanford D Bishop Jr (D),2012,Agricultural Services/Products,250,37000,37250
B000490,N00002674,Sanford D Bishop Jr (D),2012,Public Sector Unions,0,37000,37000
B000490,N00002674,Sanford D Bishop Jr (D),2012,Insurance,19750,16500,36250
B000490,N00002674,Sanford D Bishop Jr (D),2012,Health Professionals,6980,25900,32880
B000490,N00002674,Sanford D Bishop Jr (D),2012,Real Estate,13250,18000,31250
C000286,N00002685,Saxby Chambliss (R),2012,Retired,785081,0,785081
C000286,N00002685,Saxby Chambliss (R),2012,Crop Production & Basic Processing,431194,250696,681890
C000286,N00002685,Saxby Chambliss (R),2012,Lawyers/Law Firms,488880,168188,657068
C000286,N00002685,Saxby Chambliss (R),2012,Real Estate,491920,66300,558220
C000286,N00002685,Saxby Chambliss (R),2012,Securities & Investment,428550,125400,553950
C000286,N00002685,Saxby Chambliss (R),2012,Leadership PACs,0,500349,500349
C000286,N00002685,Saxby Chambliss (R),2012,Insurance,256636,232500,489136
C000286,N00002685,Saxby Chambliss (R),2012,Health Professionals,272884,152500,425384
C000286,N00002685,Saxby Chambliss (R),2012,Agricultural Services/Products,125388,258070,383458
C000286,N00002685,Saxby Chambliss (R),2012,Lobbyists,349693,16045,365738
B000911,N00002713,Corrine Brown (D),2012,Transportation Unions,0,59000,59000
B000911,N00002713,Corrine Brown (D),2012,Railroads,6000,49500,55500
B000911,N00002713,Corrine Brown (D),2012,Lawyers/Law Firms,43050,5000,48050
B000911,N00002713,Corrine Brown (D),2012,Air Transport,0,29000,29000
B000911,N00002713,Corrine Brown (D),2012,Building Trade Unions,0,21000,21000
B000911,N00002713,Corrine Brown (D),2012,Sea Transport,5000,15000,20000
B000911,N00002713,Corrine Brown (D),2012,Real Estate,12500,7010,19510
B000911,N00002713,Corrine Brown (D),2012,Public Sector Unions,0,19500,19500
B000911,N00002713,Corrine Brown (D),2012,Lobbyists,12250,3000,15250
B000911,N00002713,Corrine Brown (D),2012,Leadership PACs,0,15000,15000
M000689,N00002793,John L Mica (R),2012,Air Transport,35000,156595,191595
M000689,N00002793,John L Mica (R),2012,Construction Services,54750,83368,138118
M000689,N00002793,John L Mica (R),2012,Lawyers/Law Firms,44510,63520,108030
M000689,N00002793,John L Mica (R),2012,Sea Transport,28498,69500,97998
M000689,N00002793,John L Mica (R),2012,Oil & Gas,4000,68500,72500
M000689,N00002793,John L Mica (R),2012,Lobbyists,63009,4250,67259
M000689,N00002793,John L Mica (R),2012,Real Estate,45800,15000,60800
M000689,N00002793,John L Mica (R),2012,General Contractors,33750,26750,60500
M000689,N00002793,John L Mica (R),2012,Railroads,9000,51000,60000
M000689,N00002793,John L Mica (R),2012,Trucking,19750,38662,58412
R000435,N00002858,Ileana Ros-Lehtinen (R),2012,Pro-Israel,166635,72050,238685
R000435,N00002858,Ileana Ros-Lehtinen (R),2012,Health Professionals,88750,24000,112750
R000435,N00002858,Ileana Ros-Lehtinen (R),2012,Lawyers/Law Firms,67249,27998,95247
R000435,N00002858,Ileana Ros-Lehtinen (R),2012,Real Estate,62650,18000,80650
R000435,N00002858,Ileana Ros-Lehtinen (R),2012,Lobbyists,57500,6750,64250
R000435,N00002858,Ileana Ros-Lehtinen (R),2012,Retired,61192,0,61192
R000435,N00002858,Ileana Ros-Lehtinen (R),2012,Securities & Investment,54900,5000,59900
R000435,N00002858,Ileana Ros-Lehtinen (R),2012,Human Rights,17400,33800,51200
R000435,N00002858,Ileana Ros-Lehtinen (R),2012,Transportation Unions,0,41000,41000
R000435,N00002858,Ileana Ros-Lehtinen (R),2012,Misc Finance,40750,0,40750
H000324,N00002884,Alcee L Hastings (D),2012,Education,38750,31250,70000
H000324,N00002884,Alcee L Hastings (D),2012,Crop Production & Basic Processing,17300,23500,40800
H000324,N00002884,Alcee L Hastings (D),2012,Lawyers/Law Firms,26426,13000,39426
H000324,N00002884,Alcee L Hastings (D),2012,Business Services,27400,0,27400
H000324,N00002884,Alcee L Hastings (D),2012,Building Trade Unions,0,27000,27000
H000324,N00002884,Alcee L Hastings (D),2012,Pro-Israel,18250,8000,26250
H000324,N00002884,Alcee L Hastings (D),2012,Industrial Unions,0,25250,25250
H000324,N00002884,Alcee L Hastings (D),2012,Transportation Unions,250,24500,24750
H000324,N00002884,Alcee L Hastings (D),2012,Retired,20550,0,20550
H000324,N00002884,Alcee L Hastings (D),2012,Public Sector Unions,0,20000,20000
F000462,N00002893,Lois J Frankel (D),2012,Lawyers/Law Firms,402104,14000,416104
F000462,N00002893,Lois J Frankel (D),2012,Retired,295600,0,295600
F000462,N00002893,Lois J Frankel (D),2012,Women's Issues,139686,26033,165719
F000462,N00002893,Lois J Frankel (D),2012,Real Estate,150504,0,150504
F000462,N00002893,Lois J Frankel (D),2012,Business Services,64550,5200,69750
F000462,N00002893,Lois J Frankel (D),2012,Health Professionals,62950,6000,68950
F000462,N00002893,Lois J Frankel (D),2012,Leadership PACs,0,61250,61250
F000462,N00002893,Lois J Frankel (D),2012,Public Sector Unions,0,56500,56500
F000462,N00002893,Lois J Frankel (D),2012,Pro-Israel,50790,4500,55290
F000462,N00002893,Lois J Frankel (D),2012,Building Trade Unions,0,45000,45000
A000055,N00003028,Robert B Aderholt (R),2012,Lawyers/Law Firms,24746,35500,60246
A000055,N00003028,Robert B Aderholt (R),2012,Defense Aerospace,3000,56500,59500
A000055,N00003028,Robert B Aderholt (R),2012,Misc Defense,23500,34500,58000
A000055,N00003028,Robert B Aderholt (R),2012,Electronics Mfg & Equip,15750,35000,50750
A000055,N00003028,Robert B Aderholt (R),2012,Defense Electronics,1000,39000,40000
A000055,N00003028,Robert B Aderholt (R),2012,Sea Transport,34500,1000,35500
A000055,N00003028,Robert B Aderholt (R),2012,Health Professionals,23635,10500,34135
A000055,N00003028,Robert B Aderholt (R),2012,Building Materials & Equipment,13500,17500,31000
A000055,N00003028,Robert B Aderholt (R),2012,Pharmaceuticals/Health Products,0,30000,30000
A000055,N00003028,Robert B Aderholt (R),2012,Accountants,12896,17000,29896
S001141,N00003062,Jeff Sessions (R),2012,Lawyers/Law Firms,261592,68859,330451
S001141,N00003062,Jeff Sessions (R),2012,Retired,294821,0,294821
S001141,N00003062,Jeff Sessions (R),2012,Real Estate,189534,28500,218034
S001141,N00003062,Jeff Sessions (R),2012,Health Professionals,128660,51500,180160
S001141,N00003062,Jeff Sessions (R),2012,Leadership PACs,0,175399,175399
S001141,N00003062,Jeff Sessions (R),2012,Insurance,83300,55200,138500
S001141,N00003062,Jeff Sessions (R),2012,Electric Utilities,82065,46250,128315
S001141,N00003062,Jeff Sessions (R),2012,Defense Aerospace,25900,90500,116400
S001141,N00003062,Jeff Sessions (R),2012,Oil & Gas,36700,78500,115200
S001141,N00003062,Jeff Sessions (R),2012,Lobbyists,108948,4800,113748
B001243,N00003105,Marsha Blackburn (R),2012,Health Professionals,36818,171000,207818
B001243,N00003105,Marsha Blackburn (R),2012,Pharmaceuticals/Health Products,9000,110433,119433
B001243,N00003105,Marsha Blackburn (R),2012,Oil & Gas,13250,81000,94250
B001243,N00003105,Marsha Blackburn (R),2012,TV/Movies/Music,26950,44500,71450
B001243,N00003105,Marsha Blackburn (R),2012,Hospitals/Nursing Homes,18000,51750,69750
B001243,N00003105,Marsha Blackburn (R),2012,Health Services/HMOs,19500,44250,63750
B001243,N00003105,Marsha Blackburn (R),2012,Automotive,26000,28500,54500
B001243,N00003105,Marsha Blackburn (R),2012,Insurance,5750,41913,47663
B001243,N00003105,Marsha Blackburn (R),2012,Retail Sales,12250,28500,40750
B001243,N00003105,Marsha Blackburn (R),2012,Telecom Services,0,39000,39000
C000754,N00003132,Jim Cooper (D),2012,Lawyers/Law Firms,111950,10750,122700
C000754,N00003132,Jim Cooper (D),2012,Retired,69925,0,69925
C000754,N00003132,Jim Cooper (D),2012,Securities & Investment,49900,4000,53900
C000754,N00003132,Jim Cooper (D),2012,Real Estate,41531,6000,47531
C000754,N00003132,Jim Cooper (D),2012,Accountants,9000,30344,39344
C000754,N00003132,Jim Cooper (D),2012,Insurance,18750,19000,37750
C000754,N00003132,Jim Cooper (D),2012,Education,35400,0,35400
C000754,N00003132,Jim Cooper (D),2012,"Beer, Wine & Liquor",19847,11500,31347
C000754,N00003132,Jim Cooper (D),2012,Business Services,24550,3000,27550
C000754,N00003132,Jim Cooper (D),2012,Misc Finance,26000,0,26000
D000533,N00003209,John J Duncan Jr (R),2012,Air Transport,4000,56947,60947
D000533,N00003209,John J Duncan Jr (R),2012,Railroads,4000,50750,54750
D000533,N00003209,John J Duncan Jr (R),2012,Construction Services,3000,45500,48500
D000533,N00003209,John J Duncan Jr (R),2012,Building Materials & Equipment,7000,41194,48194
D000533,N00003209,John J Duncan Jr (R),2012,General Contractors,8750,27150,35900
D000533,N00003209,John J Duncan Jr (R),2012,Lobbyists,32250,2000,34250
D000533,N00003209,John J Duncan Jr (R),2012,Lawyers/Law Firms,4250,28500,32750
D000533,N00003209,John J Duncan Jr (R),2012,Trucking,1000,20500,21500
D000533,N00003209,John J Duncan Jr (R),2012,Transportation Unions,0,20500,20500
D000533,N00003209,John J Duncan Jr (R),2012,Oil & Gas,0,16000,16000
C001068,N00003225,Steve Cohen (D),2012,Lawyers/Law Firms,28350,19000,47350
C001068,N00003225,Steve Cohen (D),2012,Transportation Unions,0,40000,40000
C001068,N00003225,Steve Cohen (D),2012,Health Professionals,17750,19000,36750
C001068,N00003225,Steve Cohen (D),2012,Real Estate,31750,5000,36750
C001068,N00003225,Steve Cohen (D),2012,Public Sector Unions,0,34500,34500
C001068,N00003225,Steve Cohen (D),2012,Railroads,250,33250,33500
C001068,N00003225,Steve Cohen (D),2012,Industrial Unions,0,32500,32500
C001068,N00003225,Steve Cohen (D),2012,Retired,25475,0,25475
C001068,N00003225,Steve Cohen (D),2012,Air Transport,1000,23000,24000
C001068,N00003225,Steve Cohen (D),2012,Automotive,3250,20000,23250
W000437,N00003280,Roger Wicker (R),2012,Lawyers/Law Firms,384538,194150,578688
W000437,N00003280,Roger Wicker (R),2012,Leadership PACs,0,526000,526000
W000437,N00003280,Roger Wicker (R),2012,Oil & Gas,251266,217800,469066
W000437,N00003280,Roger Wicker (R),2012,Health Professionals,295900,134500,430400
W000437,N00003280,Roger Wicker (R),2012,Lobbyists,380789,20000,400789
W000437,N00003280,Roger Wicker (R),2012,Insurance,134100,234050,368150
W000437,N00003280,Roger Wicker (R),2012,Securities & Investment,269245,94071,363316
W000437,N00003280,Roger Wicker (R),2012,Real Estate,284550,76000,360550
W000437,N00003280,Roger Wicker (R),2012,Retired,282163,0,282163
W000437,N00003280,Roger Wicker (R),2012,General Contractors,204983,42000,246983
T000193,N00003288,Bennie G Thompson (D),2012,Lawyers/Law Firms,42746,27500,70246
T000193,N00003288,Bennie G Thompson (D),2012,Transportation Unions,0,69500,69500
T000193,N00003288,Bennie G Thompson (D),2012,Public Sector Unions,0,51500,51500
T000193,N00003288,Bennie G Thompson (D),2012,Pharmaceuticals/Health Products,0,48000,48000
T000193,N00003288,Bennie G Thompson (D),2012,Industrial Unions,0,46500,46500
T000193,N00003288,Bennie G Thompson (D),2012,Electric Utilities,250,43500,43750
T000193,N00003288,Bennie G Thompson (D),2012,Sea Transport,14699,23500,38199
T000193,N00003288,Bennie G Thompson (D),2012,Defense Aerospace,0,35500,35500
T000193,N00003288,Bennie G Thompson (D),2012,Electronics Mfg & Equip,4000,26500,30500
T000193,N00003288,Bennie G Thompson (D),2012,Railroads,0,30000,30000
T000193,N00003288,Bennie G Thompson (D),2012,Building Trade Unions,0,30000,30000
C000567,N00003328,Thad Cochran (R),2012,Crop Production & Basic Processing,150844,65000,215844
C000567,N00003328,Thad Cochran (R),2012,Lawyers/Law Firms,124414,84500,208914
C000567,N00003328,Thad Cochran (R),2012,Lobbyists,114300,3800,118100
C000567,N00003328,Thad Cochran (R),2012,Agricultural Services/Products,15200,81500,96700
C000567,N00003328,Thad Cochran (R),2012,Health Professionals,32300,64000,96300
C000567,N00003328,Thad Cochran (R),2012,Oil & Gas,39156,48000,87156
C000567,N00003328,Thad Cochran (R),2012,Defense Aerospace,5800,71000,76800
C000567,N00003328,Thad Cochran (R),2012,Leadership PACs,0,71800,71800
C000567,N00003328,Thad Cochran (R),2012,Real Estate,53550,13010,66560
C000567,N00003328,Thad Cochran (R),2012,Pharmaceuticals/Health Products,6500,55500,62000
M000355,N00003389,Mitch McConnell (R),2012,Securities & Investment,1572484,214561,1787045
M000355,N00003389,Mitch McConnell (R),2012,Retired,1164757,0,1164757
M000355,N00003389,Mitch McConnell (R),2012,Lawyers/Law Firms,650691,313550,964241
M000355,N00003389,Mitch McConnell (R),2012,Health Professionals,621475,265800,887275
M000355,N00003389,Mitch McConnell (R),2012,Oil & Gas,540900,317000,857900
M000355,N00003389,Mitch McConnell (R),2012,Real Estate,731280,118510,849790
M000355,N00003389,Mitch McConnell (R),2012,Insurance,440808,379300,820108
M000355,N00003389,Mitch McConnell (R),2012,Lobbyists,697054,22761,719815
M000355,N00003389,Mitch McConnell (R),2012,Hospitals/Nursing Homes,351300,281400,632700
M000355,N00003389,Mitch McConnell (R),2012,Misc Finance,502384,46000,548384
W000413,N00003467,Ed Whitfield (R),2012,Health Professionals,66126,171700,237826
W000413,N00003467,Ed Whitfield (R),2012,Electric Utilities,500,205000,205500
W000413,N00003467,Ed Whitfield (R),2012,Oil & Gas,4750,126500,131250
W000413,N00003467,Ed Whitfield (R),2012,Mining,65200,55500,120700
W000413,N00003467,Ed Whitfield (R),2012,Pharmaceuticals/Health Products,1000,87250,88250
W000413,N00003467,Ed Whitfield (R),2012,Chemical & Related Manufacturing,4665,55000,59665
W000413,N00003467,Ed Whitfield (R),2012,Lobbyists,48975,4500,53475
W000413,N00003467,Ed Whitfield (R),2012,Misc Energy,4800,48000,52800
W000413,N00003467,Ed Whitfield (R),2012,Lawyers/Law Firms,6000,37030,43030
W000413,N00003467,Ed Whitfield (R),2012,Misc Manufacturing & Distributing,30500,11000,41500
R000395,N00003473,Hal Rogers (R),2012,Lobbyists,80000,2399,82399
R000395,N00003473,Hal Rogers (R),2012,Mining,10100,53999,64099
R000395,N00003473,Hal Rogers (R),2012,Air Transport,2999,59500,62499
R000395,N00003473,Hal Rogers (R),2012,Defense Aerospace,8750,53000,61750
R000395,N00003473,Hal Rogers (R),2012,Lawyers/Law Firms,18980,36750,55730
R000395,N00003473,Hal Rogers (R),2012,Defense Electronics,0,51000,51000
R000395,N00003473,Hal Rogers (R),2012,Railroads,7700,43000,50700
R000395,N00003473,Hal Rogers (R),2012,Health Professionals,7500,39500,47000
R000395,N00003473,Hal Rogers (R),2012,Electric Utilities,1500,41250,42750
R000395,N00003473,Hal Rogers (R),2012,Misc Defense,8000,34000,42000
K000009,N00003522,Marcy Kaptur (D),2012,Lawyers/Law Firms,44750,31100,75850
K000009,N00003522,Marcy Kaptur (D),2012,Public Sector Unions,0,70000,70000
K000009,N00003522,Marcy Kaptur (D),2012,Transportation Unions,200,66000,66200
K000009,N00003522,Marcy Kaptur (D),2012,Building Trade Unions,0,64400,64400
K000009,N00003522,Marcy Kaptur (D),2012,Industrial Unions,0,53500,53500
K000009,N00003522,Marcy Kaptur (D),2012,Retired,42510,0,42510
K000009,N00003522,Marcy Kaptur (D),2012,Misc Manufacturing & Distributing,8800,31500,40300
K000009,N00003522,Marcy Kaptur (D),2012,Defense Aerospace,0,38000,38000
K000009,N00003522,Marcy Kaptur (D),2012,Real Estate,24500,11500,36000
K000009,N00003522,Marcy Kaptur (D),2012,Lobbyists,27250,2000,29250
B000944,N00003535,Sherrod Brown (D),2012,Lawyers/Law Firms,1865503,195154,2060657
B000944,N00003535,Sherrod Brown (D),2012,Retired,1272358,0,1272358
B000944,N00003535,Sherrod Brown (D),2012,Health Professionals,447477,265300,712777
B000944,N00003535,Sherrod Brown (D),2012,Education,604739,6000,610739
B000944,N00003535,Sherrod Brown (D),2012,Real Estate,509062,78907,587969
B000944,N00003535,Sherrod Brown (D),2012,Lobbyists,454916,23850,478766
B000944,N00003535,Sherrod Brown (D),2012,Women's Issues,402684,1500,404184
B000944,N00003535,Sherrod Brown (D),2012,Leadership PACs,200,387605,387805
B000944,N00003535,Sherrod Brown (D),2012,Hospitals/Nursing Homes,329488,50250,379738
B000944,N00003535,Sherrod Brown (D),2012,Democratic/Liberal,341621,36071,377692
B000589,N00003675,John Boehner (R),2012,Securities & Investment,1393575,143250,1536825
B000589,N00003675,John Boehner (R),2012,Retired,1215279,0,1215279
B000589,N00003675,John Boehner (R),2012,Health Professionals,413997,183500,597497
B000589,N00003675,John Boehner (R),2012,Real Estate,540076,45500,585576
B000589,N00003675,John Boehner (R),2012,Misc Manufacturing & Distributing,406837,83500,490337
B000589,N00003675,John Boehner (R),2012,Oil & Gas,333099,146500,479599
B000589,N00003675,John Boehner (R),2012,Lawyers/Law Firms,389952,80106,470058
B000589,N00003675,John Boehner (R),2012,Insurance,272051,187800,459851
B000589,N00003675,John Boehner (R),2012,Republican/Conservative,444836,13500,458336
B000589,N00003675,John Boehner (R),2012,Lobbyists,411450,7300,418750
P000449,N00003682,Rob Portman (R),2012,Securities & Investment,1081981,96000,1177981
P000449,N00003682,Rob Portman (R),2012,Retired,1133362,0,1133362
P000449,N00003682,Rob Portman (R),2012,Lawyers/Law Firms,727777,110598,838375
P000449,N00003682,Rob Portman (R),2012,Insurance,484097,335300,819397
P000449,N00003682,Rob Portman (R),2012,Misc Manufacturing & Distributing,537035,134200,671235
P000449,N00003682,Rob Portman (R),2012,Real Estate,509801,33400,543201
P000449,N00003682,Rob Portman (R),2012,Lobbyists,530123,11450,541573
P000449,N00003682,Rob Portman (R),2012,Misc Finance,393647,45000,438647
P000449,N00003682,Rob Portman (R),2012,Oil & Gas,260594,123750,384344
P000449,N00003682,Rob Portman (R),2012,Leadership PACs,2900,356289,359189
C000266,N00003689,Steve Chabot (R),2012,Misc Manufacturing & Distributing,41300,25500,66800
C000266,N00003689,Steve Chabot (R),2012,Retired,64800,0,64800
C000266,N00003689,Steve Chabot (R),2012,Lawyers/Law Firms,44100,17250,61350
C000266,N00003689,Steve Chabot (R),2012,Leadership PACs,0,55052,55052
C000266,N00003689,Steve Chabot (R),2012,Health Professionals,31950,20000,51950
C000266,N00003689,Steve Chabot (R),2012,Insurance,32700,13300,46000
C000266,N00003689,Steve Chabot (R),2012,Automotive,10000,21500,31500
C000266,N00003689,Steve Chabot (R),2012,Electronics Mfg & Equip,19500,9000,28500
C000266,N00003689,Steve Chabot (R),2012,Real Estate,21750,6000,27750
C000266,N00003689,Steve Chabot (R),2012,Food Processing & Sales,17950,9000,26950
V000108,N00003813,Pete Visclosky (D),2012,Electric Utilities,10500,63000,73500
V000108,N00003813,Pete Visclosky (D),2012,Building Trade Unions,500,58382,58882
V000108,N00003813,Pete Visclosky (D),2012,Defense Aerospace,1000,43000,44000
V000108,N00003813,Pete Visclosky (D),2012,Industrial Unions,0,40000,40000
V000108,N00003813,Pete Visclosky (D),2012,Lobbyists,24600,12373,36973
V000108,N00003813,Pete Visclosky (D),2012,Defense Electronics,0,35000,35000
V000108,N00003813,Pete Visclosky (D),2012,Lawyers/Law Firms,11420,19000,30420
V000108,N00003813,Pete Visclosky (D),2012,Public Sector Unions,0,29500,29500
V000108,N00003813,Pete Visclosky (D),2012,Transportation Unions,0,26660,26660
V000108,N00003813,Pete Visclosky (D),2012,Misc Defense,11500,15000,26500
C000542,N00003845,Dan Coats (R),2012,Securities & Investment,244081,9500,253581
C000542,N00003845,Dan Coats (R),2012,Leadership PACs,0,216354,216354
C000542,N00003845,Dan Coats (R),2012,Lawyers/Law Firms,154554,46000,200554
C000542,N00003845,Dan Coats (R),2012,Retired,173996,0,173996
C000542,N00003845,Dan Coats (R),2012,Real Estate,126349,19000,145349
C000542,N00003845,Dan Coats (R),2012,Insurance,24850,113400,138250
C000542,N00003845,Dan Coats (R),2012,Lobbyists,126233,9500,135733
C000542,N00003845,Dan Coats (R),2012,Oil & Gas,21483,99750,121233
C000542,N00003845,Dan Coats (R),2012,Health Professionals,36300,80000,116300
C000542,N00003845,Dan Coats (R),2012,Pharmaceuticals/Health Products,19450,73949,93399
L000263,N00003950,Sander Levin (D),2012,Insurance,3600,143750,147350
L000263,N00003950,Sander Levin (D),2012,Health Professionals,2200,136500,138700
L000263,N00003950,Sander Levin (D),2012,Lawyers/Law Firms,50050,69500,119550
L000263,N00003950,Sander Levin (D),2012,Lobbyists,69300,3397,72697
L000263,N00003950,Sander Levin (D),2012,Securities & Investment,24050,48500,72550
L000263,N00003950,Sander Levin (D),2012,Public Sector Unions,0,67500,67500
L000263,N00003950,Sander Levin (D),2012,Real Estate,26350,33480,59830
L000263,N00003950,Sander Levin (D),2012,Building Trade Unions,0,55000,55000
L000263,N00003950,Sander Levin (D),2012,Pharmaceuticals/Health Products,0,47500,47500
L000263,N00003950,Sander Levin (D),2012,Retired,45685,0,45685
C000714,N00004029,John Conyers Jr (D),2012,Lawyers/Law Firms,79532,38250,117782
C000714,N00004029,John Conyers Jr (D),2012,Telecom Services,21500,75500,97000
C000714,N00004029,John Conyers Jr (D),2012,Lobbyists,60103,6000,66103
C000714,N00004029,John Conyers Jr (D),2012,TV/Movies/Music,13050,46500,59550
C000714,N00004029,John Conyers Jr (D),2012,Health Professionals,7032,34000,41032
C000714,N00004029,John Conyers Jr (D),2012,Public Sector Unions,0,40000,40000
C000714,N00004029,John Conyers Jr (D),2012,Industrial Unions,0,38000,38000
C000714,N00004029,John Conyers Jr (D),2012,Misc Unions,775,32000,32775
C000714,N00004029,John Conyers Jr (D),2012,Leadership PACs,0,29000,29000
C000714,N00004029,John Conyers Jr (D),2012,Building Trade Unions,0,28500,28500
S000770,N00004118,Debbie Stabenow (D),2012,Lawyers/Law Firms,527760,162239,689999
S000770,N00004118,Debbie Stabenow (D),2012,Securities & Investment,490720,161250,651970
S000770,N00004118,Debbie Stabenow (D),2012,Health Professionals,230358,303710,534068
S000770,N00004118,Debbie Stabenow (D),2012,Retired,448739,0,448739
S000770,N00004118,Debbie Stabenow (D),2012,Women's Issues,351105,13000,364105
S000770,N00004118,Debbie Stabenow (D),2012,Lobbyists,344254,16893,361147
S000770,N00004118,Debbie Stabenow (D),2012,Insurance,150800,190795,341595
S000770,N00004118,Debbie Stabenow (D),2012,Crop Production & Basic Processing,102111,239065,341176
S000770,N00004118,Debbie Stabenow (D),2012,Hospitals/Nursing Homes,214797,114000,328797
S000770,N00004118,Debbie Stabenow (D),2012,Leadership PACs,0,287500,287500
U000031,N00004133,Fred Upton (R),2012,Pharmaceuticals/Health Products,23575,281790,305365
U000031,N00004133,Fred Upton (R),2012,Health Professionals,16750,281500,298250
U000031,N00004133,Fred Upton (R),2012,Electric Utilities,44100,229400,273500
U000031,N00004133,Fred Upton (R),2012,Oil & Gas,35300,185500,220800
U000031,N00004133,Fred Upton (R),2012,Lobbyists,197243,14976,212219
U000031,N00004133,Fred Upton (R),2012,Lawyers/Law Firms,40200,104900,145100
U000031,N00004133,Fred Upton (R),2012,Health Services/HMOs,19400,115000,134400
U000031,N00004133,Fred Upton (R),2012,TV/Movies/Music,47450,59500,106950
U000031,N00004133,Fred Upton (R),2012,Telecom Services,27500,78500,106000
U000031,N00004133,Fred Upton (R),2012,Mining,54458,51000,105458
H000206,N00004207,Tom Harkin (D),2012,Lawyers/Law Firms,415226,156086,571312
H000206,N00004207,Tom Harkin (D),2012,Health Professionals,169650,354148,523798
H000206,N00004207,Tom Harkin (D),2012,Lobbyists,399251,7501,406752
H000206,N00004207,Tom Harkin (D),2012,Securities & Investment,327230,47500,374730
H000206,N00004207,Tom Harkin (D),2012,Pharmaceuticals/Health Products,107250,239816,347066
H000206,N00004207,Tom Harkin (D),2012,Retired,288663,0,288663
H000206,N00004207,Tom Harkin (D),2012,Hospitals/Nursing Homes,160000,74500,234500
H000206,N00004207,Tom Harkin (D),2012,Crop Production & Basic Processing,99810,109425,209235
H000206,N00004207,Tom Harkin (D),2012,Real Estate,183350,20400,203750
H000206,N00004207,Tom Harkin (D),2012,Insurance,74530,108500,183030
L000111,N00004227,Tom Latham (R),2012,Leadership PACs,0,301550,301550
L000111,N00004227,Tom Latham (R),2012,Lobbyists,149350,7100,156450
L000111,N00004227,Tom Latham (R),2012,Health Professionals,39500,99900,139400
L000111,N00004227,Tom Latham (R),2012,Insurance,25922,97250,123172
L000111,N00004227,Tom Latham (R),2012,Agricultural Services/Products,36750,80000,116750
L000111,N00004227,Tom Latham (R),2012,Pharmaceuticals/Health Products,13800,95500,109300
L000111,N00004227,Tom Latham (R),2012,Real Estate,52150,41500,93650
L000111,N00004227,Tom Latham (R),2012,Electric Utilities,15300,75900,91200
L000111,N00004227,Tom Latham (R),2012,Crop Production & Basic Processing,19400,63000,82400
L000111,N00004227,Tom Latham (R),2012,Lawyers/Law Firms,32900,44750,77650
S000244,N00004291,F James Sensenbrenner Jr (R),2012,Internet,21000,15500,36500
S000244,N00004291,F James Sensenbrenner Jr (R),2012,Telecom Services,0,30500,30500
S000244,N00004291,F James Sensenbrenner Jr (R),2012,Lobbyists,25806,2000,27806
S000244,N00004291,F James Sensenbrenner Jr (R),2012,Retired,27350,0,27350
S000244,N00004291,F James Sensenbrenner Jr (R),2012,Misc Manufacturing & Distributing,13500,10000,23500
S000244,N00004291,F James Sensenbrenner Jr (R),2012,Lawyers/Law Firms,2500,18250,20750
S000244,N00004291,F James Sensenbrenner Jr (R),2012,Oil & Gas,3750,17000,20750
S000244,N00004291,F James Sensenbrenner Jr (R),2012,Securities & Investment,20550,0,20550
S000244,N00004291,F James Sensenbrenner Jr (R),2012,Commercial Banks,500,18000,18500
S000244,N00004291,F James Sensenbrenner Jr (R),2012,"Beer, Wine & Liquor",0,16500,16500
R000570,N00004357,Paul Ryan (R),2012,Retired,467104,0,467104
R000570,N00004357,Paul Ryan (R),2012,Securities & Investment,259000,87000,346000
R000570,N00004357,Paul Ryan (R),2012,Insurance,57825,143000,200825
R000570,N00004357,Paul Ryan (R),2012,Health Professionals,46000,107500,153500
R000570,N00004357,Paul Ryan (R),2012,Real Estate,75700,50000,125700
R000570,N00004357,Paul Ryan (R),2012,Republican/Conservative,122010,2500,124510
R000570,N00004357,Paul Ryan (R),2012,Pharmaceuticals/Health Products,22300,92150,114450
R000570,N00004357,Paul Ryan (R),2012,Misc Manufacturing & Distributing,63225,28000,91225
R000570,N00004357,Paul Ryan (R),2012,Misc Finance,69000,17000,86000
R000570,N00004357,Paul Ryan (R),2012,Lawyers/Law Firms,46375,27250,73625
B001230,N00004367,Tammy Baldwin (D),2012,Women's Issues,882131,36972,919103
B001230,N00004367,Tammy Baldwin (D),2012,Retired,762873,0,762873
B001230,N00004367,Tammy Baldwin (D),2012,Lawyers/Law Firms,582657,18250,600907
B001230,N00004367,Tammy Baldwin (D),2012,Democratic/Liberal,388594,173765,562359
B001230,N00004367,Tammy Baldwin (D),2012,Leadership PACs,8750,300680,309430
B001230,N00004367,Tammy Baldwin (D),2012,Education,297525,0,297525
B001230,N00004367,Tammy Baldwin (D),2012,Human Rights,185468,29993,215461
B001230,N00004367,Tammy Baldwin (D),2012,Health Professionals,159704,40750,200454
B001230,N00004367,Tammy Baldwin (D),2012,Business Services,175688,0,175688
B001230,N00004367,Tammy Baldwin (D),2012,Pro-Israel,147665,24715,172380
K000188,N00004403,Ron Kind (D),2012,Insurance,26600,192300,218900
K000188,N00004403,Ron Kind (D),2012,Health Professionals,15626,135400,151026
K000188,N00004403,Ron Kind (D),2012,Pharmaceuticals/Health Products,2500,130649,133149
K000188,N00004403,Ron Kind (D),2012,Securities & Investment,10700,79000,89700
K000188,N00004403,Ron Kind (D),2012,Lawyers/Law Firms,25200,38806,64006
K000188,N00004403,Ron Kind (D),2012,Lobbyists,54603,806,55409
K000188,N00004403,Ron Kind (D),2012,Retail Sales,7750,44000,51750
K000188,N00004403,Ron Kind (D),2012,Electric Utilities,2000,46750,48750
K000188,N00004403,Ron Kind (D),2012,Health Services/HMOs,4200,41500,45700
K000188,N00004403,Ron Kind (D),2012,Misc Manufacturing & Distributing,2400,42000,44400
P000265,N00004426,Tom Petri (R),2012,Air Transport,1000,107838,108838
P000265,N00004426,Tom Petri (R),2012,Transportation Unions,0,41000,41000
P000265,N00004426,Tom Petri (R),2012,Building Trade Unions,0,33000,33000
P000265,N00004426,Tom Petri (R),2012,Railroads,0,30000,30000
P000265,N00004426,Tom Petri (R),2012,Lobbyists,25344,2000,27344
P000265,N00004426,Tom Petri (R),2012,Building Materials & Equipment,750,24250,25000
P000265,N00004426,Tom Petri (R),2012,Construction Services,750,24000,24750
P000265,N00004426,Tom Petri (R),2012,Lawyers/Law Firms,5750,15750,21500
P000265,N00004426,Tom Petri (R),2012,Trucking,250,20000,20250
P000265,N00004426,Tom Petri (R),2012,Republican/Conservative,900,17000,17900
K000363,N00004436,John Kline (R),2012,Education,206059,70500,276559
K000363,N00004436,John Kline (R),2012,Insurance,32050,95500,127550
K000363,N00004436,John Kline (R),2012,Securities & Investment,29250,82000,111250
K000363,N00004436,John Kline (R),2012,Lawyers/Law Firms,33800,37812,71612
K000363,N00004436,John Kline (R),2012,Retired,67150,0,67150
K000363,N00004436,John Kline (R),2012,Misc Manufacturing & Distributing,49800,15500,65300
K000363,N00004436,John Kline (R),2012,Retail Sales,14800,49500,64300
K000363,N00004436,John Kline (R),2012,Lobbyists,51050,6900,57950
K000363,N00004436,John Kline (R),2012,Food Processing & Sales,13000,44500,57500
K000363,N00004436,John Kline (R),2012,Food & Beverage,6650,49500,56150
P000258,N00004558,Collin C Peterson (D),2012,Crop Production & Basic Processing,54486,154832,209318
P000258,N00004558,Collin C Peterson (D),2012,Agricultural Services/Products,5000,157500,162500
P000258,N00004558,Collin C Peterson (D),2012,Food Processing & Sales,4500,47500,52000
P000258,N00004558,Collin C Peterson (D),2012,Dairy,750,39000,39750
P000258,N00004558,Collin C Peterson (D),2012,Forestry & Forest Products,0,34500,34500
P000258,N00004558,Collin C Peterson (D),2012,Accountants,0,33500,33500
P000258,N00004558,Collin C Peterson (D),2012,Securities & Investment,1000,29500,30500
P000258,N00004558,Collin C Peterson (D),2012,Lawyers/Law Firms,3300,24100,27400
P000258,N00004558,Collin C Peterson (D),2012,Electric Utilities,500,26000,26500
P000258,N00004558,Collin C Peterson (D),2012,Casinos/Gambling,21500,0,21500
T000250,N00004572,John Thune (R),2012,Retired,955284,0,955284
T000250,N00004572,John Thune (R),2012,Securities & Investment,310740,81000,391740
T000250,N00004572,John Thune (R),2012,Insurance,127210,244500,371710
T000250,N00004572,John Thune (R),2012,Real Estate,276377,49010,325387
T000250,N00004572,John Thune (R),2012,Lobbyists,291096,14398,305494
T000250,N00004572,John Thune (R),2012,Lawyers/Law Firms,189929,87422,277351
T000250,N00004572,John Thune (R),2012,Republican/Conservative,239766,19977,259743
T000250,N00004572,John Thune (R),2012,Health Professionals,176913,73500,250413
T000250,N00004572,John Thune (R),2012,Commercial Banks,141730,85700,227430
T000250,N00004572,John Thune (R),2012,Leadership PACs,0,199727,199727
C001096,N00004614,Kevin Cramer (R),2012,Oil & Gas,159000,49500,208500
C001096,N00004614,Kevin Cramer (R),2012,Leadership PACs,500,85000,85500
C001096,N00004614,Kevin Cramer (R),2012,Crop Production & Basic Processing,63540,17500,81040
C001096,N00004614,Kevin Cramer (R),2012,Retired,71860,0,71860
C001096,N00004614,Kevin Cramer (R),2012,Real Estate,31155,5000,36155
C001096,N00004614,Kevin Cramer (R),2012,Commercial Banks,21000,9500,30500
C001096,N00004614,Kevin Cramer (R),2012,General Contractors,25050,4000,29050
C001096,N00004614,Kevin Cramer (R),2012,Civil Servants/Public Officials,27860,0,27860
C001096,N00004614,Kevin Cramer (R),2012,Republican/Conservative,22429,4500,26929
C001096,N00004614,Kevin Cramer (R),2012,Misc Business,23600,0,23600
B000243,N00004643,Max Baucus (D),2012,Securities & Investment,735869,177400,913269
B000243,N00004643,Max Baucus (D),2012,Lawyers/Law Firms,459369,220978,680347
B000243,N00004643,Max Baucus (D),2012,Insurance,242450,368650,611100
B000243,N00004643,Max Baucus (D),2012,Lobbyists,571012,12625,583637
B000243,N00004643,Max Baucus (D),2012,Health Professionals,142529,417500,560029
B000243,N00004643,Max Baucus (D),2012,Health Services/HMOs,282018,271200,553218
B000243,N00004643,Max Baucus (D),2012,Pharmaceuticals/Health Products,177214,351218,528432
B000243,N00004643,Max Baucus (D),2012,Hospitals/Nursing Homes,234018,224950,458968
B000243,N00004643,Max Baucus (D),2012,Real Estate,375580,83250,458830
B000243,N00004643,Max Baucus (D),2012,Electric Utilities,28942,258700,287642
R000580,N00004719,Peter Roskam (R),2012,Securities & Investment,123402,104000,227402
R000580,N00004719,Peter Roskam (R),2012,Insurance,38450,184750,223200
R000580,N00004719,Peter Roskam (R),2012,Health Professionals,41000,135500,176500
R000580,N00004719,Peter Roskam (R),2012,Retired,129800,0,129800
R000580,N00004719,Peter Roskam (R),2012,Pharmaceuticals/Health Products,10700,111716,122416
R000580,N00004719,Peter Roskam (R),2012,Real Estate,44900,61000,105900
R000580,N00004719,Peter Roskam (R),2012,Misc Manufacturing & Distributing,50973,43500,94473
R000580,N00004719,Peter Roskam (R),2012,Lobbyists,86018,4862,90880
R000580,N00004719,Peter Roskam (R),2012,Health Services/HMOs,31850,51000,82850
R000580,N00004719,Peter Roskam (R),2012,Commercial Banks,15150,54000,69150
S001145,N00004724,Jan Schakowsky (D),2012,Lawyers/Law Firms,134525,26000,160525
S001145,N00004724,Jan Schakowsky (D),2012,Health Professionals,17800,75100,92900
S001145,N00004724,Jan Schakowsky (D),2012,Retired,73600,0,73600
S001145,N00004724,Jan Schakowsky (D),2012,Pro-Israel,63050,3103,66153
S001145,N00004724,Jan Schakowsky (D),2012,Industrial Unions,0,47500,47500
S001145,N00004724,Jan Schakowsky (D),2012,Business Services,40200,1000,41200
S001145,N00004724,Jan Schakowsky (D),2012,Public Sector Unions,0,39500,39500
S001145,N00004724,Jan Schakowsky (D),2012,Building Trade Unions,300,36500,36800
S001145,N00004724,Jan Schakowsky (D),2012,Real Estate,25800,8300,34100
S001145,N00004724,Jan Schakowsky (D),2012,Non-Profit Institutions,30475,1000,31475
G000535,N00004874,Luis V Gutierrez (D),2012,Building Trade Unions,0,29500,29500
G000535,N00004874,Luis V Gutierrez (D),2012,Real Estate,6750,21000,27750
G000535,N00004874,Luis V Gutierrez (D),2012,Securities & Investment,0,27000,27000
G000535,N00004874,Luis V Gutierrez (D),2012,Insurance,0,26000,26000
G000535,N00004874,Luis V Gutierrez (D),2012,Lawyers/Law Firms,14240,9000,23240
G000535,N00004874,Luis V Gutierrez (D),2012,Accountants,0,17911,17911
G000535,N00004874,Luis V Gutierrez (D),2012,Misc Services,2500,9000,11500
G000535,N00004874,Luis V Gutierrez (D),2012,Industrial Unions,0,10500,10500
G000535,N00004874,Luis V Gutierrez (D),2012,TV/Movies/Music,500,9000,9500
G000535,N00004874,Luis V Gutierrez (D),2012,Commercial Banks,500,7500,8000
D000096,N00004884,Danny K Davis (D),2012,Public Sector Unions,0,49500,49500
D000096,N00004884,Danny K Davis (D),2012,Building Trade Unions,0,21500,21500
D000096,N00004884,Danny K Davis (D),2012,Lawyers/Law Firms,3071,16500,19571
D000096,N00004884,Danny K Davis (D),2012,Pharmaceuticals/Health Products,0,16500,16500
D000096,N00004884,Danny K Davis (D),2012,Business Services,3650,10500,14150
D000096,N00004884,Danny K Davis (D),2012,Health Professionals,4350,9000,13350
D000096,N00004884,Danny K Davis (D),2012,Insurance,0,13000,13000
D000096,N00004884,Danny K Davis (D),2012,Food & Beverage,0,12500,12500
D000096,N00004884,Danny K Davis (D),2012,Industrial Unions,0,12500,12500
D000096,N00004884,Danny K Davis (D),2012,Printing & Publishing,0,11500,11500
D000096,N00004884,Danny K Davis (D),2012,Electric Utilities,0,11500,11500
R000515,N00004887,Bobby L Rush (D),2012,Electric Utilities,1000,51750,52750
R000515,N00004887,Bobby L Rush (D),2012,Telecom Services,8500,35500,44000
R000515,N00004887,Bobby L Rush (D),2012,Lawyers/Law Firms,24800,15000,39800
R000515,N00004887,Bobby L Rush (D),2012,Building Trade Unions,0,34000,34000
R000515,N00004887,Bobby L Rush (D),2012,Telephone Utilities,500,28120,28620
R000515,N00004887,Bobby L Rush (D),2012,TV/Movies/Music,500,24500,25000
R000515,N00004887,Bobby L Rush (D),2012,Public Sector Unions,0,23500,23500
R000515,N00004887,Bobby L Rush (D),2012,Industrial Unions,0,22000,22000
R000515,N00004887,Bobby L Rush (D),2012,Railroads,0,19000,19000
R000515,N00004887,Bobby L Rush (D),2012,Health Professionals,0,14800,14800
S000364,N00004961,John M Shimkus (R),2012,Health Professionals,3800,194050,197850
S000364,N00004961,John M Shimkus (R),2012,Pharmaceuticals/Health Products,2750,141550,144300
S000364,N00004961,John M Shimkus (R),2012,Electric Utilities,1500,134000,135500
S000364,N00004961,John M Shimkus (R),2012,Oil & Gas,3500,117500,121000
S000364,N00004961,John M Shimkus (R),2012,Mining,45659,37500,83159
S000364,N00004961,John M Shimkus (R),2012,Misc Energy,13750,52750,66500
S000364,N00004961,John M Shimkus (R),2012,Telecom Services,3000,62000,65000
S000364,N00004961,John M Shimkus (R),2012,Chemical & Related Manufacturing,6750,57499,64249
S000364,N00004961,John M Shimkus (R),2012,Insurance,5510,57500,63010
S000364,N00004961,John M Shimkus (R),2012,Crop Production & Basic Processing,8550,42000,50550
D000563,N00004981,Dick Durbin (D),2012,Lawyers/Law Firms,1535901,148088,1683989
D000563,N00004981,Dick Durbin (D),2012,Securities & Investment,650987,107500,758487
D000563,N00004981,Dick Durbin (D),2012,Real Estate,426396,36500,462896
D000563,N00004981,Dick Durbin (D),2012,Lobbyists,335696,16407,352103
D000563,N00004981,Dick Durbin (D),2012,Pro-Israel,296012,42000,338012
D000563,N00004981,Dick Durbin (D),2012,Health Professionals,133346,186191,319537
D000563,N00004981,Dick Durbin (D),2012,Retired,287774,0,287774
D000563,N00004981,Dick Durbin (D),2012,Insurance,72410,128900,201310
D000563,N00004981,Dick Durbin (D),2012,Business Services,174525,24500,199025
D000563,N00004981,Dick Durbin (D),2012,Hospitals/Nursing Homes,98625,95500,194125
E000172,N00005090,Jo Ann Emerson (R),2012,Crop Production & Basic Processing,56262,62004,118266
E000172,N00005090,Jo Ann Emerson (R),2012,Lobbyists,82729,2000,84729
E000172,N00005090,Jo Ann Emerson (R),2012,Public Sector Unions,0,59500,59500
E000172,N00005090,Jo Ann Emerson (R),2012,Building Trade Unions,0,55500,55500
E000172,N00005090,Jo Ann Emerson (R),2012,Health Professionals,25178,24500,49678
E000172,N00005090,Jo Ann Emerson (R),2012,Commercial Banks,8700,39000,47700
E000172,N00005090,Jo Ann Emerson (R),2012,Insurance,3200,40800,44000
E000172,N00005090,Jo Ann Emerson (R),2012,Agricultural Services/Products,12750,28500,41250
E000172,N00005090,Jo Ann Emerson (R),2012,Transportation Unions,0,39000,39000
E000172,N00005090,Jo Ann Emerson (R),2012,Lawyers/Law Firms,16300,21750,38050
B000575,N00005195,Roy Blunt (R),2012,Securities & Investment,760305,86500,846805
B000575,N00005195,Roy Blunt (R),2012,Retired,618249,0,618249
B000575,N00005195,Roy Blunt (R),2012,Leadership PACs,0,532203,532203
B000575,N00005195,Roy Blunt (R),2012,Lawyers/Law Firms,342347,122600,464947
B000575,N00005195,Roy Blunt (R),2012,Health Professionals,287280,166500,453780
B000575,N00005195,Roy Blunt (R),2012,Real Estate,383035,37900,420935
B000575,N00005195,Roy Blunt (R),2012,Lobbyists,391280,9000,400280
B000575,N00005195,Roy Blunt (R),2012,Oil & Gas,238885,160750,399635
B000575,N00005195,Roy Blunt (R),2012,Insurance,185734,185900,371634
B000575,N00005195,Roy Blunt (R),2012,Misc Manufacturing & Distributing,297900,62900,360800
M000934,N00005282,Jerry Moran (R),2012,Crop Production & Basic Processing,163613,138367,301980
M000934,N00005282,Jerry Moran (R),2012,Health Professionals,111350,90647,201997
M000934,N00005282,Jerry Moran (R),2012,Agricultural Services/Products,43300,141949,185249
M000934,N00005282,Jerry Moran (R),2012,Securities & Investment,99350,64600,163950
M000934,N00005282,Jerry Moran (R),2012,Commercial Banks,114590,47500,162090
M000934,N00005282,Jerry Moran (R),2012,Oil & Gas,107750,52500,160250
M000934,N00005282,Jerry Moran (R),2012,Retired,153480,0,153480
M000934,N00005282,Jerry Moran (R),2012,Insurance,58616,93300,151916
M000934,N00005282,Jerry Moran (R),2012,Lawyers/Law Firms,110441,32500,142941
M000934,N00005282,Jerry Moran (R),2012,Railroads,72660,69476,142136
R000307,N00005285,Pat Roberts (R),2012,Health Professionals,120400,260000,380400
R000307,N00005285,Pat Roberts (R),2012,Leadership PACs,0,335651,335651
R000307,N00005285,Pat Roberts (R),2012,Securities & Investment,157800,157150,314950
R000307,N00005285,Pat Roberts (R),2012,Agricultural Services/Products,34200,266617,300817
R000307,N00005285,Pat Roberts (R),2012,Pharmaceuticals/Health Products,58550,226349,284899
R000307,N00005285,Pat Roberts (R),2012,Retired,259413,0,259413
R000307,N00005285,Pat Roberts (R),2012,Oil & Gas,165900,71800,237700
R000307,N00005285,Pat Roberts (R),2012,Lobbyists,219451,7622,227073
R000307,N00005285,Pat Roberts (R),2012,Insurance,40900,179250,220150
R000307,N00005285,Pat Roberts (R),2012,Crop Production & Basic Processing,66431,152512,218943
T000459,N00005321,Lee Terry (R),2012,Telecom Services,24430,95350,119780
T000459,N00005321,Lee Terry (R),2012,Health Professionals,8200,108100,116300
T000459,N00005321,Lee Terry (R),2012,Electric Utilities,3250,98750,102000
T000459,N00005321,Lee Terry (R),2012,Insurance,21326,72500,93826
T000459,N00005321,Lee Terry (R),2012,Lawyers/Law Firms,44650,46250,90900
T000459,N00005321,Lee Terry (R),2012,Oil & Gas,5500,85000,90500
T000459,N00005321,Lee Terry (R),2012,Telephone Utilities,16850,67000,83850
T000459,N00005321,Lee Terry (R),2012,Leadership PACs,0,48500,48500
T000459,N00005321,Lee Terry (R),2012,Real Estate,31550,16000,47550
T000459,N00005321,Lee Terry (R),2012,Pharmaceuticals/Health Products,5500,41222,46722
L000550,N00005395,Mary L Landrieu (D),2012,Lawyers/Law Firms,1299683,257259,1556942
L000550,N00005395,Mary L Landrieu (D),2012,Oil & Gas,326540,285100,611640
L000550,N00005395,Mary L Landrieu (D),2012,Lobbyists,510749,34766,545515
L000550,N00005395,Mary L Landrieu (D),2012,Real Estate,446021,46800,492821
L000550,N00005395,Mary L Landrieu (D),2012,Retired,410994,0,410994
L000550,N00005395,Mary L Landrieu (D),2012,Leadership PACs,1350,404900,406250
L000550,N00005395,Mary L Landrieu (D),2012,Securities & Investment,280283,78000,358283
L000550,N00005395,Mary L Landrieu (D),2012,Health Professionals,185440,132248,317688
L000550,N00005395,Mary L Landrieu (D),2012,Pro-Israel,233740,82236,315976
L000550,N00005395,Mary L Landrieu (D),2012,Electric Utilities,86600,172744,259344
L000491,N00005559,Frank D Lucas (R),2012,Crop Production & Basic Processing,126675,198117,324792
L000491,N00005559,Frank D Lucas (R),2012,Agricultural Services/Products,12500,165000,177500
L000491,N00005559,Frank D Lucas (R),2012,Securities & Investment,4250,92000,96250
L000491,N00005559,Frank D Lucas (R),2012,Oil & Gas,15500,66000,81500
L000491,N00005559,Frank D Lucas (R),2012,Dairy,19500,58750,78250
L000491,N00005559,Frank D Lucas (R),2012,Commercial Banks,21000,46750,67750
L000491,N00005559,Frank D Lucas (R),2012,Food Processing & Sales,1000,57000,58000
L000491,N00005559,Frank D Lucas (R),2012,Lobbyists,53744,1000,54744
L000491,N00005559,Frank D Lucas (R),2012,Livestock,21200,30000,51200
L000491,N00005559,Frank D Lucas (R),2012,Electric Utilities,0,41000,41000
I000024,N00005582,James M Inhofe (R),2012,Oil & Gas,356000,243250,599250
I000024,N00005582,James M Inhofe (R),2012,Retired,347956,0,347956
I000024,N00005582,James M Inhofe (R),2012,Leadership PACs,500,346007,346507
I000024,N00005582,James M Inhofe (R),2012,Lobbyists,206080,9108,215188
I000024,N00005582,James M Inhofe (R),2012,Electric Utilities,32704,175950,208654
I000024,N00005582,James M Inhofe (R),2012,Lawyers/Law Firms,99943,74750,174693
I000024,N00005582,James M Inhofe (R),2012,Mining,103850,48500,152350
I000024,N00005582,James M Inhofe (R),2012,Building Materials & Equipment,65200,85000,150200
I000024,N00005582,James M Inhofe (R),2012,Misc Finance,136776,0,136776
I000024,N00005582,James M Inhofe (R),2012,Real Estate,120163,15500,135663
C000560,N00005601,Tom Coburn (R),2012,Health Professionals,93572,117500,211072
C000560,N00005601,Tom Coburn (R),2012,Oil & Gas,68300,106050,174350
C000560,N00005601,Tom Coburn (R),2012,Pharmaceuticals/Health Products,7452,122000,129452
C000560,N00005601,Tom Coburn (R),2012,Leadership PACs,200,125043,125243
C000560,N00005601,Tom Coburn (R),2012,Insurance,8150,106500,114650
C000560,N00005601,Tom Coburn (R),2012,Republican/Conservative,90900,9193,100093
C000560,N00005601,Tom Coburn (R),2012,Lobbyists,89100,9303,98403
C000560,N00005601,Tom Coburn (R),2012,Retired,98150,0,98150
C000560,N00005601,Tom Coburn (R),2012,Securities & Investment,66050,29000,95050
C000560,N00005601,Tom Coburn (R),2012,Lawyers/Law Firms,43350,45315,88665
H000067,N00005645,Ralph Hall (R),2012,Oil & Gas,20500,39000,59500
H000067,N00005645,Ralph Hall (R),2012,Health Professionals,23750,23000,46750
H000067,N00005645,Ralph Hall (R),2012,Defense Aerospace,3000,26500,29500
H000067,N00005645,Ralph Hall (R),2012,Electric Utilities,1000,28000,29000
H000067,N00005645,Ralph Hall (R),2012,Lawyers/Law Firms,15500,13000,28500
H000067,N00005645,Ralph Hall (R),2012,Leadership PACs,0,23500,23500
H000067,N00005645,Ralph Hall (R),2012,Air Transport,3204,15500,18704
H000067,N00005645,Ralph Hall (R),2012,Retired,16500,0,16500
H000067,N00005645,Ralph Hall (R),2012,Telephone Utilities,0,16000,16000
H000067,N00005645,Ralph Hall (R),2012,Real Estate,7000,8010,15010
B000213,N00005656,Joe Barton (R),2012,Oil & Gas,52150,114500,166650
B000213,N00005656,Joe Barton (R),2012,Electric Utilities,8450,116500,124950
B000213,N00005656,Joe Barton (R),2012,Health Professionals,27600,58500,86100
B000213,N00005656,Joe Barton (R),2012,Pharmaceuticals/Health Products,19200,35000,54200
B000213,N00005656,Joe Barton (R),2012,Lawyers/Law Firms,12050,32750,44800
B000213,N00005656,Joe Barton (R),2012,Misc Manufacturing & Distributing,37000,7000,44000
B000213,N00005656,Joe Barton (R),2012,Misc Finance,34250,0,34250
B000213,N00005656,Joe Barton (R),2012,Telecom Services,2500,27000,29500
B000213,N00005656,Joe Barton (R),2012,Lobbyists,26142,3000,29142
B000213,N00005656,Joe Barton (R),2012,TV/Movies/Music,13000,15500,28500
B000213,N00005656,Joe Barton (R),2012,Misc Energy,11500,17000,28500
S000250,N00005681,Pete Sessions (R),2012,Health Professionals,52950,150000,202950
S000250,N00005681,Pete Sessions (R),2012,Oil & Gas,44800,92500,137300
S000250,N00005681,Pete Sessions (R),2012,Insurance,18500,81500,100000
S000250,N00005681,Pete Sessions (R),2012,Commercial Banks,5000,74500,79500
S000250,N00005681,Pete Sessions (R),2012,Misc Finance,60150,18500,78650
S000250,N00005681,Pete Sessions (R),2012,Securities & Investment,43300,32500,75800
S000250,N00005681,Pete Sessions (R),2012,Lawyers/Law Firms,51850,23000,74850
S000250,N00005681,Pete Sessions (R),2012,Pharmaceuticals/Health Products,2000,62000,64000
S000250,N00005681,Pete Sessions (R),2012,Real Estate,33000,27000,60000
S000250,N00005681,Pete Sessions (R),2012,Retired,47750,0,47750
J000032,N00005818,Sheila Jackson Lee (D),2012,Education,54750,0,54750
J000032,N00005818,Sheila Jackson Lee (D),2012,Industrial Unions,0,31000,31000
J000032,N00005818,Sheila Jackson Lee (D),2012,Lawyers/Law Firms,5500,23535,29035
J000032,N00005818,Sheila Jackson Lee (D),2012,Building Trade Unions,0,27000,27000
J000032,N00005818,Sheila Jackson Lee (D),2012,Misc Business,25400,0,25400
J000032,N00005818,Sheila Jackson Lee (D),2012,Health Professionals,15050,10000,25050
J000032,N00005818,Sheila Jackson Lee (D),2012,Public Sector Unions,0,21000,21000
J000032,N00005818,Sheila Jackson Lee (D),2012,Transportation Unions,0,21000,21000
J000032,N00005818,Sheila Jackson Lee (D),2012,General Contractors,15100,5000,20100
J000032,N00005818,Sheila Jackson Lee (D),2012,Oil & Gas,750,19000,19750
G000410,N00005870,Gene Green (D),2012,Oil & Gas,1500,95200,96700
G000410,N00005870,Gene Green (D),2012,Health Professionals,6200,89500,95700
G000410,N00005870,Gene Green (D),2012,Chemical & Related Manufacturing,3100,58000,61100
G000410,N00005870,Gene Green (D),2012,Building Trade Unions,0,61000,61000
G000410,N00005870,Gene Green (D),2012,Electric Utilities,6000,54800,60800
G000410,N00005870,Gene Green (D),2012,Lawyers/Law Firms,22000,34000,56000
G000410,N00005870,Gene Green (D),2012,Pharmaceuticals/Health Products,10700,44000,54700
G000410,N00005870,Gene Green (D),2012,Industrial Unions,0,51000,51000
G000410,N00005870,Gene Green (D),2012,Transportation Unions,1400,38500,39900
G000410,N00005870,Gene Green (D),2012,TV/Movies/Music,4750,25500,30250
B000755,N00005883,Kevin Brady (R),2012,Oil & Gas,8165,159000,167165
B000755,N00005883,Kevin Brady (R),2012,Insurance,5300,104000,109300
B000755,N00005883,Kevin Brady (R),2012,Health Professionals,12250,54250,66500
B000755,N00005883,Kevin Brady (R),2012,Securities & Investment,6000,49000,55000
B000755,N00005883,Kevin Brady (R),2012,Pharmaceuticals/Health Products,16500,37500,54000
B000755,N00005883,Kevin Brady (R),2012,Electronics Mfg & Equip,2750,49000,51750
B000755,N00005883,Kevin Brady (R),2012,Real Estate,4000,43000,47000
B000755,N00005883,Kevin Brady (R),2012,Lawyers/Law Firms,15750,29250,45000
B000755,N00005883,Kevin Brady (R),2012,Health Services/HMOs,5750,34000,39750
B000755,N00005883,Kevin Brady (R),2012,Hospitals/Nursing Homes,1000,38500,39500
S000937,N00005918,Steve Stockman (R),2012,Leadership PACs,0,38250,38250
S000937,N00005918,Steve Stockman (R),2012,Oil & Gas,4000,16500,20500
S000937,N00005918,Steve Stockman (R),2012,Gun Rights,0,20449,20449
S000937,N00005918,Steve Stockman (R),2012,Republican/Conservative,250,11300,11550
S000937,N00005918,Steve Stockman (R),2012,General Contractors,4000,6000,10000
S000937,N00005918,Steve Stockman (R),2012,Lawyers/Law Firms,9000,1000,10000
S000937,N00005918,Steve Stockman (R),2012,Real Estate,4500,5000,9500
S000937,N00005918,Steve Stockman (R),2012,Business Services,8700,0,8700
S000937,N00005918,Steve Stockman (R),2012,Misc Business,8000,0,8000
S000937,N00005918,Steve Stockman (R),2012,Retired,7750,0,7750
H000636,N00006008,Ruben Hinojosa (D),2012,Health Professionals,67000,8800,75800
H000636,N00006008,Ruben Hinojosa (D),2012,"Beer, Wine & Liquor",21800,12000,33800
H000636,N00006008,Ruben Hinojosa (D),2012,Lawyers/Law Firms,24100,8000,32100
H000636,N00006008,Ruben Hinojosa (D),2012,Public Sector Unions,0,28500,28500
H000636,N00006008,Ruben Hinojosa (D),2012,Insurance,1550,24000,25550
H000636,N00006008,Ruben Hinojosa (D),2012,Building Trade Unions,0,25000,25000
H000636,N00006008,Ruben Hinojosa (D),2012,Hospitals/Nursing Homes,13350,10000,23350
H000636,N00006008,Ruben Hinojosa (D),2012,Crop Production & Basic Processing,500,21500,22000
H000636,N00006008,Ruben Hinojosa (D),2012,Oil & Gas,2500,18000,20500
H000636,N00006008,Ruben Hinojosa (D),2012,Real Estate,2950,17000,19950
D000399,N00006023,Lloyd Doggett (D),2012,Lawyers/Law Firms,347309,27750,375059
D000399,N00006023,Lloyd Doggett (D),2012,Retired,123972,0,123972
D000399,N00006023,Lloyd Doggett (D),2012,Health Professionals,28568,42300,70868
D000399,N00006023,Lloyd Doggett (D),2012,Building Trade Unions,0,60500,60500
D000399,N00006023,Lloyd Doggett (D),2012,Industrial Unions,0,48000,48000
D000399,N00006023,Lloyd Doggett (D),2012,Real Estate,22500,17000,39500
D000399,N00006023,Lloyd Doggett (D),2012,Public Sector Unions,0,35500,35500
D000399,N00006023,Lloyd Doggett (D),2012,Transportation Unions,0,35500,35500
D000399,N00006023,Lloyd Doggett (D),2012,Misc Finance,34500,0,34500
D000399,N00006023,Lloyd Doggett (D),2012,Securities & Investment,26500,6500,33000
T000238,N00006052,Mac Thornberry (R),2012,Defense Aerospace,2850,87500,90350
T000238,N00006052,Mac Thornberry (R),2012,Retired,71000,0,71000
T000238,N00006052,Mac Thornberry (R),2012,Oil & Gas,52800,15500,68300
T000238,N00006052,Mac Thornberry (R),2012,Livestock,62475,4550,67025
T000238,N00006052,Mac Thornberry (R),2012,Defense Electronics,250,46500,46750
T000238,N00006052,Mac Thornberry (R),2012,Health Professionals,24400,20500,44900
T000238,N00006052,Mac Thornberry (R),2012,Crop Production & Basic Processing,15200,29500,44700
T000238,N00006052,Mac Thornberry (R),2012,Electronics Mfg & Equip,1500,39750,41250
T000238,N00006052,Mac Thornberry (R),2012,Commercial Banks,17150,10000,27150
T000238,N00006052,Mac Thornberry (R),2012,Misc Defense,200,24500,24700
D000197,N00006134,Diana DeGette (D),2012,Pharmaceuticals/Health Products,750,97159,97909
D000197,N00006134,Diana DeGette (D),2012,Lawyers/Law Firms,51600,34500,86100
D000197,N00006134,Diana DeGette (D),2012,Health Professionals,6250,76500,82750
D000197,N00006134,Diana DeGette (D),2012,Democratic/Liberal,80883,1755,82638
D000197,N00006134,Diana DeGette (D),2012,Retired,54450,0,54450
D000197,N00006134,Diana DeGette (D),2012,Telecom Services,6245,45500,51745
D000197,N00006134,Diana DeGette (D),2012,Real Estate,27700,12500,40200
D000197,N00006134,Diana DeGette (D),2012,Telephone Utilities,0,32000,32000
D000197,N00006134,Diana DeGette (D),2012,Building Trade Unions,0,31000,31000
D000197,N00006134,Diana DeGette (D),2012,Transportation Unions,0,30000,30000
B001261,N00006236,John A Barrasso (R),2012,Health Professionals,531643,333450,865093
B001261,N00006236,John A Barrasso (R),2012,Oil & Gas,208816,337900,546716
B001261,N00006236,John A Barrasso (R),2012,Leadership PACs,0,455228,455228
B001261,N00006236,John A Barrasso (R),2012,Pharmaceuticals/Health Products,60350,222089,282439
B001261,N00006236,John A Barrasso (R),2012,Securities & Investment,206310,71571,277881
B001261,N00006236,John A Barrasso (R),2012,Lobbyists,269773,6625,276398
B001261,N00006236,John A Barrasso (R),2012,Electric Utilities,15050,261000,276050
B001261,N00006236,John A Barrasso (R),2012,Mining,131781,99000,230781
B001261,N00006236,John A Barrasso (R),2012,Insurance,38750,173875,212625
B001261,N00006236,John A Barrasso (R),2012,Retired,169434,0,169434
E000285,N00006249,Mike Enzi (R),2012,Pharmaceuticals/Health Products,13400,257250,270650
E000285,N00006249,Mike Enzi (R),2012,Health Professionals,10050,143499,153549
E000285,N00006249,Mike Enzi (R),2012,Securities & Investment,26050,106434,132484
E000285,N00006249,Mike Enzi (R),2012,Oil & Gas,28500,97800,126300
E000285,N00006249,Mike Enzi (R),2012,Insurance,1250,122500,123750
E000285,N00006249,Mike Enzi (R),2012,Leadership PACs,0,108550,108550
E000285,N00006249,Mike Enzi (R),2012,Lobbyists,76806,3750,80556
E000285,N00006249,Mike Enzi (R),2012,Health Services/HMOs,18500,45500,64000
E000285,N00006249,Mike Enzi (R),2012,Commercial Banks,11400,41500,52900
E000285,N00006249,Mike Enzi (R),2012,Real Estate,11500,41000,52500
S001148,N00006263,Mike Simpson (R),2012,Lobbyists,73950,2050,76000
S001148,N00006263,Mike Simpson (R),2012,Health Professionals,15600,53500,69100
S001148,N00006263,Mike Simpson (R),2012,Electric Utilities,6000,54249,60249
S001148,N00006263,Mike Simpson (R),2012,Crop Production & Basic Processing,5400,49000,54400
S001148,N00006263,Mike Simpson (R),2012,Forestry & Forest Products,11050,40000,51050
S001148,N00006263,Mike Simpson (R),2012,Casinos/Gambling,41000,1000,42000
S001148,N00006263,Mike Simpson (R),2012,Oil & Gas,3000,39000,42000
S001148,N00006263,Mike Simpson (R),2012,Dairy,3450,37350,40800
S001148,N00006263,Mike Simpson (R),2012,Real Estate,3200,35000,38200
S001148,N00006263,Mike Simpson (R),2012,Lawyers/Law Firms,6750,31250,38000
C000880,N00006267,Mike Crapo (R),2012,Securities & Investment,189165,237350,426515
C000880,N00006267,Mike Crapo (R),2012,Insurance,65300,308750,374050
C000880,N00006267,Mike Crapo (R),2012,Lobbyists,190400,4169,194569
C000880,N00006267,Mike Crapo (R),2012,Pharmaceuticals/Health Products,31750,137871,169621
C000880,N00006267,Mike Crapo (R),2012,Leadership PACs,0,168484,168484
C000880,N00006267,Mike Crapo (R),2012,Real Estate,79204,82010,161214
C000880,N00006267,Mike Crapo (R),2012,Health Professionals,23844,123000,146844
C000880,N00006267,Mike Crapo (R),2012,Hospitals/Nursing Homes,21900,112200,134100
C000880,N00006267,Mike Crapo (R),2012,Retired,129147,0,129147
C000880,N00006267,Mike Crapo (R),2012,Lawyers/Law Firms,55018,71822,126840
P000099,N00006397,Ed Pastor (D),2012,Lobbyists,72899,2000,74899
P000099,N00006397,Ed Pastor (D),2012,Electric Utilities,27650,41000,68650
P000099,N00006397,Ed Pastor (D),2012,Air Transport,14000,50000,64000
P000099,N00006397,Ed Pastor (D),2012,Transportation Unions,0,60500,60500
P000099,N00006397,Ed Pastor (D),2012,Defense Aerospace,0,41500,41500
P000099,N00006397,Ed Pastor (D),2012,Industrial Unions,0,38000,38000
P000099,N00006397,Ed Pastor (D),2012,Public Sector Unions,0,36500,36500
P000099,N00006397,Ed Pastor (D),2012,Lawyers/Law Firms,19650,14000,33650
P000099,N00006397,Ed Pastor (D),2012,Building Trade Unions,0,30000,30000
P000099,N00006397,Ed Pastor (D),2012,Real Estate,18000,6000,24000
K000352,N00006406,Jon L Kyl (R),2012,Pharmaceuticals/Health Products,200,59000,59200
K000352,N00006406,Jon L Kyl (R),2012,Securities & Investment,33900,16500,50400
K000352,N00006406,Jon L Kyl (R),2012,Hospitals/Nursing Homes,4150,46000,50150
K000352,N00006406,Jon L Kyl (R),2012,Food & Beverage,28044,16000,44044
K000352,N00006406,Jon L Kyl (R),2012,Health Professionals,7800,32500,40300
K000352,N00006406,Jon L Kyl (R),2012,Commercial Banks,22500,13000,35500
K000352,N00006406,Jon L Kyl (R),2012,Insurance,1300,27000,28300
K000352,N00006406,Jon L Kyl (R),2012,Lawyers/Law Firms,6200,17000,23200
K000352,N00006406,Jon L Kyl (R),2012,Lobbyists,25200,-2500,22700
K000352,N00006406,Jon L Kyl (R),2012,Health Services/HMOs,9700,12500,22200
F000448,N00006423,Trent Franks (R),2012,Defense Aerospace,1000,37500,38500
F000448,N00006423,Trent Franks (R),2012,Lobbyists,22500,0,22500
F000448,N00006423,Trent Franks (R),2012,Retired,21550,0,21550
F000448,N00006423,Trent Franks (R),2012,Defense Electronics,3000,15000,18000
F000448,N00006423,Trent Franks (R),2012,Oil & Gas,3400,11500,14900
F000448,N00006423,Trent Franks (R),2012,Real Estate,5400,6000,11400
F000448,N00006423,Trent Franks (R),2012,Republican/Conservative,5600,5000,10600
F000448,N00006423,Trent Franks (R),2012,Telecom Services,0,10500,10500
F000448,N00006423,Trent Franks (R),2012,Electric Utilities,0,10000,10000
F000448,N00006423,Trent Franks (R),2012,Construction Services,6500,3000,9500
F000448,N00006423,Trent Franks (R),2012,Internet,0,9500,9500
M000303,N00006424,John McCain (R),2012,Retired,1054260,0,1054260
M000303,N00006424,John McCain (R),2012,Securities & Investment,332725,17000,349725
M000303,N00006424,John McCain (R),2012,Real Estate,284145,35000,319145
M000303,N00006424,John McCain (R),2012,Lawyers/Law Firms,226856,77650,304506
M000303,N00006424,John McCain (R),2012,Leadership PACs,250,218700,218950
M000303,N00006424,John McCain (R),2012,Health Professionals,133529,73500,207029
M000303,N00006424,John McCain (R),2012,Misc Finance,162625,12500,175125
M000303,N00006424,John McCain (R),2012,Republican/Conservative,153393,15000,168393
M000303,N00006424,John McCain (R),2012,Business Services,146619,15000,161619
M000303,N00006424,John McCain (R),2012,Lobbyists,151550,4733,156283
S000018,N00006446,Matt Salmon (R),2012,Retired,79400,0,79400
S000018,N00006446,Matt Salmon (R),2012,Real Estate,66835,10000,76835
S000018,N00006446,Matt Salmon (R),2012,Republican/Conservative,51701,18000,69701
S000018,N00006446,Matt Salmon (R),2012,Lawyers/Law Firms,40353,9000,49353
S000018,N00006446,Matt Salmon (R),2012,Oil & Gas,26050,17089,43139
S000018,N00006446,Matt Salmon (R),2012,Electric Utilities,16525,22500,39025
S000018,N00006446,Matt Salmon (R),2012,Health Professionals,14050,23500,37550
S000018,N00006446,Matt Salmon (R),2012,Lobbyists,35799,0,35799
S000018,N00006446,Matt Salmon (R),2012,Leadership PACs,0,31500,31500
S000018,N00006446,Matt Salmon (R),2012,Misc Finance,28053,0,28053
S001183,N00006460,David Schweikert (R),2012,Real Estate,105830,61500,167330
S001183,N00006460,David Schweikert (R),2012,Retired,143745,0,143745
S001183,N00006460,David Schweikert (R),2012,Securities & Investment,19750,91000,110750
S001183,N00006460,David Schweikert (R),2012,Insurance,19450,90300,109750
S001183,N00006460,David Schweikert (R),2012,Health Professionals,28962,51000,79962
S001183,N00006460,David Schweikert (R),2012,Commercial Banks,9300,56100,65400
S001183,N00006460,David Schweikert (R),2012,Health Services/HMOs,15900,34000,49900
S001183,N00006460,David Schweikert (R),2012,Republican/Conservative,29150,17550,46700
S001183,N00006460,David Schweikert (R),2012,Leadership PACs,0,45624,45624
S001183,N00006460,David Schweikert (R),2012,Lawyers/Law Firms,25900,14500,40400
U000039,N00006561,Tom Udall (D),2012,Lawyers/Law Firms,832235,65192,897427
U000039,N00006561,Tom Udall (D),2012,Retired,659545,0,659545
U000039,N00006561,Tom Udall (D),2012,Securities & Investment,368454,22500,390954
U000039,N00006561,Tom Udall (D),2012,Leadership PACs,0,332449,332449
U000039,N00006561,Tom Udall (D),2012,Real Estate,299607,17760,317367
U000039,N00006561,Tom Udall (D),2012,Health Professionals,154053,88000,242053
U000039,N00006561,Tom Udall (D),2012,Lobbyists,231581,941,232522
U000039,N00006561,Tom Udall (D),2012,Business Services,187962,3000,190962
U000039,N00006561,Tom Udall (D),2012,TV/Movies/Music,167321,19000,186321
U000039,N00006561,Tom Udall (D),2012,Casinos/Gambling,133350,24000,157350
R000486,N00006671,Lucille Roybal-Allard (D),2012,Lobbyists,40291,0,40291
R000486,N00006671,Lucille Roybal-Allard (D),2012,Public Sector Unions,0,38500,38500
R000486,N00006671,Lucille Roybal-Allard (D),2012,Real Estate,29350,9000,38350
R000486,N00006671,Lucille Roybal-Allard (D),2012,Building Trade Unions,0,33500,33500
R000486,N00006671,Lucille Roybal-Allard (D),2012,Health Professionals,750,29500,30250
R000486,N00006671,Lucille Roybal-Allard (D),2012,Transportation Unions,0,24700,24700
R000486,N00006671,Lucille Roybal-Allard (D),2012,Industrial Unions,0,23500,23500
R000486,N00006671,Lucille Roybal-Allard (D),2012,Hospitals/Nursing Homes,19300,4000,23300
R000486,N00006671,Lucille Roybal-Allard (D),2012,Lawyers/Law Firms,11100,10500,21600
R000486,N00006671,Lucille Roybal-Allard (D),2012,Pharmaceuticals/Health Products,250,18500,18750
W000187,N00006690,Maxine Waters (D),2012,Real Estate,35000,24500,59500
W000187,N00006690,Maxine Waters (D),2012,TV/Movies/Music,16200,23820,40020
W000187,N00006690,Maxine Waters (D),2012,Lobbyists,31574,2000,33574
W000187,N00006690,Maxine Waters (D),2012,Securities & Investment,15750,16000,31750
W000187,N00006690,Maxine Waters (D),2012,Lawyers/Law Firms,11550,13000,24550
W000187,N00006690,Maxine Waters (D),2012,Public Sector Unions,0,23500,23500
W000187,N00006690,Maxine Waters (D),2012,Transportation Unions,0,23000,23000
W000187,N00006690,Maxine Waters (D),2012,Credit Unions,550,21500,22050
W000187,N00006690,Maxine Waters (D),2012,Construction Services,20500,0,20500
W000187,N00006690,Maxine Waters (D),2012,Building Trade Unions,0,18500,18500
B000711,N00006692,Barbara Boxer (D),2012,Lawyers/Law Firms,1983749,144721,2128470
B000711,N00006692,Barbara Boxer (D),2012,Retired,1461995,0,1461995
B000711,N00006692,Barbara Boxer (D),2012,Women's Issues,1284001,30895,1314896
B000711,N00006692,Barbara Boxer (D),2012,TV/Movies/Music,936545,76300,1012845
B000711,N00006692,Barbara Boxer (D),2012,Real Estate,566755,25681,592436
B000711,N00006692,Barbara Boxer (D),2012,Securities & Investment,541124,21300,562424
B000711,N00006692,Barbara Boxer (D),2012,Health Professionals,394110,67900,462010
B000711,N00006692,Barbara Boxer (D),2012,Education,445639,1000,446639
B000711,N00006692,Barbara Boxer (D),2012,Business Services,438375,6500,444875
B000711,N00006692,Barbara Boxer (D),2012,Leadership PACs,0,428910,428910
T000472,N00006701,Mark Takano (D),2012,Retired,91878,0,91878
T000472,N00006701,Mark Takano (D),2012,Human Rights,39900,37247,77147
T000472,N00006701,Mark Takano (D),2012,Leadership PACs,0,77000,77000
T000472,N00006701,Mark Takano (D),2012,Lawyers/Law Firms,65942,11000,76942
T000472,N00006701,Mark Takano (D),2012,Public Sector Unions,950,61000,61950
T000472,N00006701,Mark Takano (D),2012,Building Trade Unions,0,58000,58000
T000472,N00006701,Mark Takano (D),2012,Candidate Committees,0,57500,57500
T000472,N00006701,Mark Takano (D),2012,Democratic/Liberal,37600,17803,55403
T000472,N00006701,Mark Takano (D),2012,Education,48302,0,48302
T000472,N00006701,Mark Takano (D),2012,Industrial Unions,597,46000,46597
N000179,N00006789,Grace Napolitano (D),2012,Lobbyists,34450,1000,35450
N000179,N00006789,Grace Napolitano (D),2012,Air Transport,3750,28500,32250
N000179,N00006789,Grace Napolitano (D),2012,Transportation Unions,0,30500,30500
N000179,N00006789,Grace Napolitano (D),2012,Construction Services,6750,20000,26750
N000179,N00006789,Grace Napolitano (D),2012,Public Sector Unions,0,24500,24500
N000179,N00006789,Grace Napolitano (D),2012,Building Trade Unions,0,23000,23000
N000179,N00006789,Grace Napolitano (D),2012,Industrial Unions,0,23000,23000
N000179,N00006789,Grace Napolitano (D),2012,Health Professionals,4000,16650,20650
N000179,N00006789,Grace Napolitano (D),2012,Lawyers/Law Firms,6650,13250,19900
N000179,N00006789,Grace Napolitano (D),2012,Real Estate,11700,8000,19700
H001063,N00006806,Janice Hahn (D),2012,Real Estate,108650,26500,135150
H001063,N00006806,Janice Hahn (D),2012,Building Trade Unions,1500,109499,110999
H001063,N00006806,Janice Hahn (D),2012,Lawyers/Law Firms,89450,20500,109950
H001063,N00006806,Janice Hahn (D),2012,Public Sector Unions,0,91000,91000
H001063,N00006806,Janice Hahn (D),2012,Retired,87418,0,87418
H001063,N00006806,Janice Hahn (D),2012,Women's Issues,71401,15500,86901
H001063,N00006806,Janice Hahn (D),2012,Transportation Unions,750,83500,84250
H001063,N00006806,Janice Hahn (D),2012,Industrial Unions,0,81000,81000
H001063,N00006806,Janice Hahn (D),2012,Lobbyists,57450,0,57450
H001063,N00006806,Janice Hahn (D),2012,Leadership PACs,0,55000,55000
M001177,N00006863,Tom McClintock (R),2012,Retired,115159,0,115159
M001177,N00006863,Tom McClintock (R),2012,Republican/Conservative,49988,7050,57038
M001177,N00006863,Tom McClintock (R),2012,Oil & Gas,8800,26500,35300
M001177,N00006863,Tom McClintock (R),2012,Real Estate,23539,4000,27539
M001177,N00006863,Tom McClintock (R),2012,Retail Sales,25000,0,25000
M001177,N00006863,Tom McClintock (R),2012,Crop Production & Basic Processing,16575,5000,21575
M001177,N00006863,Tom McClintock (R),2012,Electronics Mfg & Equip,21400,0,21400
M001177,N00006863,Tom McClintock (R),2012,Securities & Investment,20000,0,20000
M001177,N00006863,Tom McClintock (R),2012,Insurance,11400,5500,16900
M001177,N00006863,Tom McClintock (R),2012,Casinos/Gambling,13250,0,13250
M000508,N00006882,Buck Mckeon (R),2012,Defense Aerospace,141000,144500,285500
M000508,N00006882,Buck Mckeon (R),2012,Defense Electronics,75000,89500,164500
M000508,N00006882,Buck Mckeon (R),2012,Misc Defense,34450,90000,124450
M000508,N00006882,Buck Mckeon (R),2012,Lobbyists,62584,2965,65549
M000508,N00006882,Buck Mckeon (R),2012,Health Professionals,19501,36000,55501
M000508,N00006882,Buck Mckeon (R),2012,Education,31750,23500,55250
M000508,N00006882,Buck Mckeon (R),2012,Misc Manufacturing & Distributing,31500,22000,53500
M000508,N00006882,Buck Mckeon (R),2012,Construction Services,26825,18000,44825
M000508,N00006882,Buck Mckeon (R),2012,Insurance,22751,21500,44251
M000508,N00006882,Buck Mckeon (R),2012,Lawyers/Law Firms,21000,22500,43500
S000344,N00006897,Brad Sherman (D),2012,Real Estate,88200,68200,156400
S000344,N00006897,Brad Sherman (D),2012,Lawyers/Law Firms,83250,24500,107750
S000344,N00006897,Brad Sherman (D),2012,Retired,105300,0,105300
S000344,N00006897,Brad Sherman (D),2012,Misc Issues,69050,3000,72050
S000344,N00006897,Brad Sherman (D),2012,Accountants,27050,43500,70550
S000344,N00006897,Brad Sherman (D),2012,Pro-Israel,44700,18000,62700
S000344,N00006897,Brad Sherman (D),2012,Credit Unions,13800,45000,58800
S000344,N00006897,Brad Sherman (D),2012,TV/Movies/Music,45150,10000,55150
S000344,N00006897,Brad Sherman (D),2012,Building Trade Unions,0,54500,54500
S000344,N00006897,Brad Sherman (D),2012,Insurance,3000,50700,53700
M001139,N00006954,Gary Miller (R),2012,Real Estate,158859,56739,215598
M001139,N00006954,Gary Miller (R),2012,Leadership PACs,0,97500,97500
M001139,N00006954,Gary Miller (R),2012,Misc Issues,78000,2600,80600
M001139,N00006954,Gary Miller (R),2012,Insurance,9500,41000,50500
M001139,N00006954,Gary Miller (R),2012,Health Professionals,9500,39500,49000
M001139,N00006954,Gary Miller (R),2012,Home Builders,15000,23000,38000
M001139,N00006954,Gary Miller (R),2012,Securities & Investment,6000,26750,32750
M001139,N00006954,Gary Miller (R),2012,Commercial Banks,1500,30500,32000
M001139,N00006954,Gary Miller (R),2012,Air Transport,0,32000,32000
M001139,N00006954,Gary Miller (R),2012,General Contractors,6000,25999,31999
I000056,N00007017,Darrell Issa (R),2012,Retired,130950,0,130950
I000056,N00007017,Darrell Issa (R),2012,Lawyers/Law Firms,60800,35000,95800
I000056,N00007017,Darrell Issa (R),2012,Republican/Conservative,83340,6000,89340
I000056,N00007017,Darrell Issa (R),2012,Pharmaceuticals/Health Products,10500,63500,74000
I000056,N00007017,Darrell Issa (R),2012,Oil & Gas,13950,60000,73950
I000056,N00007017,Darrell Issa (R),2012,Securities & Investment,53950,12000,65950
I000056,N00007017,Darrell Issa (R),2012,Electronics Mfg & Equip,15950,43936,59886
I000056,N00007017,Darrell Issa (R),2012,Health Professionals,47280,12500,59780
I000056,N00007017,Darrell Issa (R),2012,Telecom Services,11500,39000,50500
I000056,N00007017,Darrell Issa (R),2012,Lobbyists,40345,7500,47845
V000130,N00007021,Juan Vargas (D),2012,Insurance,11500,107500,119000
V000130,N00007021,Juan Vargas (D),2012,Real Estate,68250,14500,82750
V000130,N00007021,Juan Vargas (D),2012,Health Professionals,8550,54000,62550
V000130,N00007021,Juan Vargas (D),2012,Public Sector Unions,0,54000,54000
V000130,N00007021,Juan Vargas (D),2012,Building Trade Unions,0,52000,52000
V000130,N00007021,Juan Vargas (D),2012,Commercial Banks,0,32000,32000
V000130,N00007021,Juan Vargas (D),2012,Casinos/Gambling,24500,2500,27000
V000130,N00007021,Juan Vargas (D),2012,Industrial Unions,0,26500,26500
V000130,N00007021,Juan Vargas (D),2012,Health Services/HMOs,0,26000,26000
V000130,N00007021,Juan Vargas (D),2012,Accountants,0,24000,24000
C000059,N00007099,Ken Calvert (R),2012,Real Estate,39640,12000,51640
C000059,N00007099,Ken Calvert (R),2012,Lobbyists,48801,2000,50801
C000059,N00007099,Ken Calvert (R),2012,Air Transport,3500,43500,47000
C000059,N00007099,Ken Calvert (R),2012,Defense Electronics,2150,44000,46150
C000059,N00007099,Ken Calvert (R),2012,Defense Aerospace,0,46000,46000
C000059,N00007099,Ken Calvert (R),2012,Misc Manufacturing & Distributing,16986,24884,41870
C000059,N00007099,Ken Calvert (R),2012,Construction Services,25250,15500,40750
C000059,N00007099,Ken Calvert (R),2012,Building Materials & Equipment,30300,9500,39800
C000059,N00007099,Ken Calvert (R),2012,Casinos/Gambling,34000,0,34000
C000059,N00007099,Ken Calvert (R),2012,Republican/Conservative,20600,13000,33600
R000409,N00007151,Dana Rohrabacher (R),2012,Real Estate,38200,4010,42210
R000409,N00007151,Dana Rohrabacher (R),2012,Retired,27200,0,27200
R000409,N00007151,Dana Rohrabacher (R),2012,Health Professionals,14950,11650,26600
R000409,N00007151,Dana Rohrabacher (R),2012,Misc Manufacturing & Distributing,22500,2500,25000
R000409,N00007151,Dana Rohrabacher (R),2012,Air Transport,17400,6000,23400
R000409,N00007151,Dana Rohrabacher (R),2012,Lawyers/Law Firms,13400,1675,15075
R000409,N00007151,Dana Rohrabacher (R),2012,Business Services,14050,0,14050
R000409,N00007151,Dana Rohrabacher (R),2012,Misc Finance,12100,250,12350
R000409,N00007151,Dana Rohrabacher (R),2012,Health Services/HMOs,10200,0,10200
R000409,N00007151,Dana Rohrabacher (R),2012,Electric Utilities,0,10000,10000
R000409,N00007151,Dana Rohrabacher (R),2012,Pro-Israel,0,10000,10000
C001036,N00007232,Lois Capps (D),2012,Retired,303750,0,303750
C001036,N00007232,Lois Capps (D),2012,Health Professionals,65175,214500,279675
C001036,N00007232,Lois Capps (D),2012,Women's Issues,147017,29130,176147
C001036,N00007232,Lois Capps (D),2012,Leadership PACs,2750,125973,128723
C001036,N00007232,Lois Capps (D),2012,Lawyers/Law Firms,87945,34500,122445
C001036,N00007232,Lois Capps (D),2012,Democratic/Liberal,58105,22026,80131
C001036,N00007232,Lois Capps (D),2012,Candidate Committees,0,80000,80000
C001036,N00007232,Lois Capps (D),2012,Public Sector Unions,0,74500,74500
C001036,N00007232,Lois Capps (D),2012,Pro-Israel,56893,10450,67343
C001036,N00007232,Lois Capps (D),2012,Education,63700,0,63700
N000181,N00007248,Devin Nunes (R),2012,Crop Production & Basic Processing,208600,52250,260850
N000181,N00007248,Devin Nunes (R),2012,Dairy,58250,31000,89250
N000181,N00007248,Devin Nunes (R),2012,Insurance,9750,75000,84750
N000181,N00007248,Devin Nunes (R),2012,Pharmaceuticals/Health Products,3000,75500,78500
N000181,N00007248,Devin Nunes (R),2012,Health Professionals,17050,56500,73550
N000181,N00007248,Devin Nunes (R),2012,Securities & Investment,8500,55000,63500
N000181,N00007248,Devin Nunes (R),2012,Agricultural Services/Products,31250,22500,53750
N000181,N00007248,Devin Nunes (R),2012,Casinos/Gambling,38450,12500,50950
N000181,N00007248,Devin Nunes (R),2012,Oil & Gas,250,48250,48500
N000181,N00007248,Devin Nunes (R),2012,"Beer, Wine & Liquor",0,41248,41248
F000030,N00007312,Sam Farr (D),2012,Crop Production & Basic Processing,32991,54500,87491
F000030,N00007312,Sam Farr (D),2012,Retired,48965,0,48965
F000030,N00007312,Sam Farr (D),2012,Health Professionals,13200,27500,40700
F000030,N00007312,Sam Farr (D),2012,Agricultural Services/Products,3000,30023,33023
F000030,N00007312,Sam Farr (D),2012,Public Sector Unions,0,27500,27500
F000030,N00007312,Sam Farr (D),2012,Lodging/Tourism,3750,19500,23250
F000030,N00007312,Sam Farr (D),2012,Lawyers/Law Firms,4360,17000,21360
F000030,N00007312,Sam Farr (D),2012,Building Trade Unions,0,17000,17000
F000030,N00007312,Sam Farr (D),2012,"Beer, Wine & Liquor",4238,12300,16538
F000030,N00007312,Sam Farr (D),2012,Transportation Unions,0,16000,16000
E000215,N00007335,Anna Eshoo (D),2012,Pharmaceuticals/Health Products,67678,141300,208978
E000215,N00007335,Anna Eshoo (D),2012,Electronics Mfg & Equip,86300,83331,169631
E000215,N00007335,Anna Eshoo (D),2012,Retired,107750,0,107750
E000215,N00007335,Anna Eshoo (D),2012,Telecom Services,0,86500,86500
E000215,N00007335,Anna Eshoo (D),2012,Securities & Investment,71500,12500,84000
E000215,N00007335,Anna Eshoo (D),2012,Lawyers/Law Firms,50610,16500,67110
E000215,N00007335,Anna Eshoo (D),2012,Telephone Utilities,2000,41620,43620
E000215,N00007335,Anna Eshoo (D),2012,Health Professionals,3520,38400,41920
E000215,N00007335,Anna Eshoo (D),2012,Lobbyists,39000,2000,41000
E000215,N00007335,Anna Eshoo (D),2012,Real Estate,27500,8000,35500
P000197,N00007360,Nancy Pelosi (D),2012,Health Professionals,17500,183500,201000
P000197,N00007360,Nancy Pelosi (D),2012,Securities & Investment,122850,33000,155850
P000197,N00007360,Nancy Pelosi (D),2012,Lawyers/Law Firms,93167,20500,113667
P000197,N00007360,Nancy Pelosi (D),2012,Real Estate,74550,35000,109550
P000197,N00007360,Nancy Pelosi (D),2012,Retired,95225,0,95225
P000197,N00007360,Nancy Pelosi (D),2012,Public Sector Unions,0,88000,88000
P000197,N00007360,Nancy Pelosi (D),2012,Pro-Israel,60050,10500,70550
P000197,N00007360,Nancy Pelosi (D),2012,Misc Finance,60600,0,60600
P000197,N00007360,Nancy Pelosi (D),2012,Building Trade Unions,0,56000,56000
P000197,N00007360,Nancy Pelosi (D),2012,Transportation Unions,0,55500,55500
F000062,N00007364,Dianne Feinstein (D),2012,Lawyers/Law Firms,430579,136500,567079
F000062,N00007364,Dianne Feinstein (D),2012,Retired,454358,0,454358
F000062,N00007364,Dianne Feinstein (D),2012,Crop Production & Basic Processing,262633,113499,376132
F000062,N00007364,Dianne Feinstein (D),2012,Securities & Investment,339357,26850,366207
F000062,N00007364,Dianne Feinstein (D),2012,Real Estate,325471,35000,360471
F000062,N00007364,Dianne Feinstein (D),2012,Lobbyists,307072,14874,321946
F000062,N00007364,Dianne Feinstein (D),2012,Electric Utilities,205800,105150,310950
F000062,N00007364,Dianne Feinstein (D),2012,TV/Movies/Music,194965,54400,249365
F000062,N00007364,Dianne Feinstein (D),2012,Women's Issues,201449,11000,212449
F000062,N00007364,Dianne Feinstein (D),2012,Electronics Mfg & Equip,92750,106789,199539
M000725,N00007390,George Miller (D),2012,Building Trade Unions,0,81875,81875
M000725,N00007390,George Miller (D),2012,Industrial Unions,0,69000,69000
M000725,N00007390,George Miller (D),2012,Public Sector Unions,250,60517,60767
M000725,N00007390,George Miller (D),2012,Transportation Unions,250,45050,45300
M000725,N00007390,George Miller (D),2012,Misc Unions,250,32000,32250
M000725,N00007390,George Miller (D),2012,Health Professionals,0,31500,31500
M000725,N00007390,George Miller (D),2012,Lawyers/Law Firms,14800,12000,26800
M000725,N00007390,George Miller (D),2012,Retired,25517,0,25517
M000725,N00007390,George Miller (D),2012,Insurance,250,22000,22250
M000725,N00007390,George Miller (D),2012,Real Estate,11180,10000,21180
T000460,N00007419,Mike Thompson (D),2012,"Beer, Wine & Liquor",154715,40500,195215
T000460,N00007419,Mike Thompson (D),2012,Insurance,8860,116255,125115
T000460,N00007419,Mike Thompson (D),2012,Health Professionals,11925,111350,123275
T000460,N00007419,Mike Thompson (D),2012,Pharmaceuticals/Health Products,250,89300,89550
T000460,N00007419,Mike Thompson (D),2012,Securities & Investment,14730,62000,76730
T000460,N00007419,Mike Thompson (D),2012,Real Estate,18755,32000,50755
T000460,N00007419,Mike Thompson (D),2012,Electric Utilities,2500,46103,48603
T000460,N00007419,Mike Thompson (D),2012,Retail Sales,1000,47500,48500
T000460,N00007419,Mike Thompson (D),2012,Lobbyists,42951,5298,48249
T000460,N00007419,Mike Thompson (D),2012,Accountants,200,46500,46700
L000397,N00007479,Zoe Lofgren (D),2012,Electronics Mfg & Equip,79250,67051,146301
L000397,N00007479,Zoe Lofgren (D),2012,Lawyers/Law Firms,49200,26250,75450
L000397,N00007479,Zoe Lofgren (D),2012,Retired,47680,0,47680
L000397,N00007479,Zoe Lofgren (D),2012,Internet,17000,26500,43500
L000397,N00007479,Zoe Lofgren (D),2012,Securities & Investment,29000,10000,39000
L000397,N00007479,Zoe Lofgren (D),2012,Pharmaceuticals/Health Products,0,34500,34500
L000397,N00007479,Zoe Lofgren (D),2012,Real Estate,21500,9000,30500
L000397,N00007479,Zoe Lofgren (D),2012,Accountants,0,28344,28344
L000397,N00007479,Zoe Lofgren (D),2012,Lobbyists,26750,500,27250
L000397,N00007479,Zoe Lofgren (D),2012,Telecom Services,0,26000,26000
F000010,N00007632,Eni F H Faleomavaega (D),2012,Misc Business,15000,0,15000
F000010,N00007632,Eni F H Faleomavaega (D),2012,Food & Beverage,13000,0,13000
F000010,N00007632,Eni F H Faleomavaega (D),2012,Transportation Unions,0,5000,5000
F000010,N00007632,Eni F H Faleomavaega (D),2012,Fisheries & Wildlife,4500,0,4500
F000010,N00007632,Eni F H Faleomavaega (D),2012,Misc Finance,4500,0,4500
F000010,N00007632,Eni F H Faleomavaega (D),2012,Business Services,3000,0,3000
F000010,N00007632,Eni F H Faleomavaega (D),2012,General Contractors,2500,0,2500
F000010,N00007632,Eni F H Faleomavaega (D),2012,Health Professionals,2500,0,2500
F000010,N00007632,Eni F H Faleomavaega (D),2012,Retired,2500,0,2500
F000010,N00007632,Eni F H Faleomavaega (D),2012,Health Services/HMOs,2000,0,2000
F000010,N00007632,Eni F H Faleomavaega (D),2012,Securities & Investment,2000,0,2000
F000010,N00007632,Eni F H Faleomavaega (D),2012,Lobbyists,2000,0,2000
W000791,N00007690,Greg Walden (R),2012,Telecom Services,23750,129000,152750
W000791,N00007690,Greg Walden (R),2012,Health Professionals,31100,108900,140000
W000791,N00007690,Greg Walden (R),2012,Electric Utilities,3570,131250,134820
W000791,N00007690,Greg Walden (R),2012,Lobbyists,112782,3000,115782
W000791,N00007690,Greg Walden (R),2012,TV/Movies/Music,50650,61000,111650
W000791,N00007690,Greg Walden (R),2012,Telephone Utilities,15250,92500,107750
W000791,N00007690,Greg Walden (R),2012,Pharmaceuticals/Health Products,6500,91394,97894
W000791,N00007690,Greg Walden (R),2012,Retired,91710,0,91710
W000791,N00007690,Greg Walden (R),2012,Forestry & Forest Products,51350,31750,83100
W000791,N00007690,Greg Walden (R),2012,Oil & Gas,8500,70900,79400
W000779,N00007724,Ron Wyden (D),2012,Lawyers/Law Firms,469118,120809,589927
W000779,N00007724,Ron Wyden (D),2012,Securities & Investment,465150,57579,522729
W000779,N00007724,Ron Wyden (D),2012,Health Professionals,269010,224215,493225
W000779,N00007724,Ron Wyden (D),2012,Real Estate,288730,35010,323740
W000779,N00007724,Ron Wyden (D),2012,Hospitals/Nursing Homes,173000,127900,300900
W000779,N00007724,Ron Wyden (D),2012,Retired,235035,0,235035
W000779,N00007724,Ron Wyden (D),2012,Pro-Israel,161391,72900,234291
W000779,N00007724,Ron Wyden (D),2012,Insurance,81800,136999,218799
W000779,N00007724,Ron Wyden (D),2012,Misc Manufacturing & Distributing,152485,59500,211985
W000779,N00007724,Ron Wyden (D),2012,Lobbyists,191952,6500,198452
B000574,N00007727,Earl Blumenauer (D),2012,Health Professionals,2600,92250,94850
B000574,N00007727,Earl Blumenauer (D),2012,Construction Services,28410,53000,81410
B000574,N00007727,Earl Blumenauer (D),2012,Railroads,16425,64165,80590
B000574,N00007727,Earl Blumenauer (D),2012,Real Estate,32850,28000,60850
B000574,N00007727,Earl Blumenauer (D),2012,Public Sector Unions,0,53000,53000
B000574,N00007727,Earl Blumenauer (D),2012,Misc Manufacturing & Distributing,21900,30750,52650
B000574,N00007727,Earl Blumenauer (D),2012,Lawyers/Law Firms,22750,27250,50000
B000574,N00007727,Earl Blumenauer (D),2012,Transportation Unions,0,43500,43500
B000574,N00007727,Earl Blumenauer (D),2012,Securities & Investment,36999,4500,41499
B000574,N00007727,Earl Blumenauer (D),2012,General Contractors,2550,35500,38050
D000191,N00007781,Peter DeFazio (D),2012,Transportation Unions,0,78500,78500
D000191,N00007781,Peter DeFazio (D),2012,Retired,73995,0,73995
D000191,N00007781,Peter DeFazio (D),2012,Air Transport,0,58000,58000
D000191,N00007781,Peter DeFazio (D),2012,Railroads,3500,44500,48000
D000191,N00007781,Peter DeFazio (D),2012,Lawyers/Law Firms,16000,26500,42500
D000191,N00007781,Peter DeFazio (D),2012,Industrial Unions,0,42000,42000
D000191,N00007781,Peter DeFazio (D),2012,Public Sector Unions,0,40000,40000
D000191,N00007781,Peter DeFazio (D),2012,Building Trade Unions,0,39500,39500
D000191,N00007781,Peter DeFazio (D),2012,Leadership PACs,0,29500,29500
D000191,N00007781,Peter DeFazio (D),2012,Construction Services,2000,26500,28500
S000510,N00007833,Adam Smith (D),2012,Defense Aerospace,26500,79000,105500
S000510,N00007833,Adam Smith (D),2012,Lobbyists,67360,2000,69360
S000510,N00007833,Adam Smith (D),2012,Electronics Mfg & Equip,37250,30250,67500
S000510,N00007833,Adam Smith (D),2012,Lawyers/Law Firms,43100,22200,65300
S000510,N00007833,Adam Smith (D),2012,Defense Electronics,500,54000,54500
S000510,N00007833,Adam Smith (D),2012,Misc Defense,5800,42000,47800
S000510,N00007833,Adam Smith (D),2012,Pharmaceuticals/Health Products,6600,33000,39600
S000510,N00007833,Adam Smith (D),2012,Building Trade Unions,0,35500,35500
S000510,N00007833,Adam Smith (D),2012,Pro-Israel,18500,14750,33250
S000510,N00007833,Adam Smith (D),2012,Public Sector Unions,0,32000,32000
C000127,N00007836,Maria Cantwell (D),2012,Lawyers/Law Firms,765319,8000,773319
C000127,N00007836,Maria Cantwell (D),2012,Retired,713191,0,713191
C000127,N00007836,Maria Cantwell (D),2012,Lobbyists,585315,250,585565
C000127,N00007836,Maria Cantwell (D),2012,Securities & Investment,376837,0,376837
C000127,N00007836,Maria Cantwell (D),2012,Real Estate,230985,0,230985
C000127,N00007836,Maria Cantwell (D),2012,Electronics Mfg & Equip,211499,2512,214011
C000127,N00007836,Maria Cantwell (D),2012,Health Professionals,194463,15000,209463
C000127,N00007836,Maria Cantwell (D),2012,Casinos/Gambling,206550,0,206550
C000127,N00007836,Maria Cantwell (D),2012,Business Services,200077,0,200077
C000127,N00007836,Maria Cantwell (D),2012,Misc Finance,140832,0,140832
M001111,N00007876,Patty Murray (D),2012,Lawyers/Law Firms,720377,156150,876527
M001111,N00007876,Patty Murray (D),2012,Retired,857163,0,857163
M001111,N00007876,Patty Murray (D),2012,Lobbyists,697830,33848,731678
M001111,N00007876,Patty Murray (D),2012,Health Professionals,202413,261998,464411
M001111,N00007876,Patty Murray (D),2012,Women's Issues,436608,18048,454656
M001111,N00007876,Patty Murray (D),2012,Electronics Mfg & Equip,313700,102358,416058
M001111,N00007876,Patty Murray (D),2012,Leadership PACs,2000,408950,410950
M001111,N00007876,Patty Murray (D),2012,Securities & Investment,286715,44900,331615
M001111,N00007876,Patty Murray (D),2012,Business Services,282706,39250,321956
M001111,N00007876,Patty Murray (D),2012,Real Estate,241928,46500,288428
Y000033,N00007999,Don Young (R),2012,Casinos/Gambling,118549,7109,125658
Y000033,N00007999,Don Young (R),2012,Oil & Gas,43000,39500,82500
Y000033,N00007999,Don Young (R),2012,Lobbyists,53140,0,53140
Y000033,N00007999,Don Young (R),2012,Transportation Unions,0,51000,51000
Y000033,N00007999,Don Young (R),2012,Lawyers/Law Firms,17000,20219,37219
Y000033,N00007999,Don Young (R),2012,Building Trade Unions,250,34500,34750
Y000033,N00007999,Don Young (R),2012,Real Estate,29050,4000,33050
Y000033,N00007999,Don Young (R),2012,Sea Transport,17499,15000,32499
Y000033,N00007999,Don Young (R),2012,Air Transport,8400,19000,27400
Y000033,N00007999,Don Young (R),2012,Construction Services,2750,22500,25250
J000174,N00008028,Sam Johnson (R),2012,Health Professionals,46650,69050,115700
J000174,N00008028,Sam Johnson (R),2012,Insurance,6250,89300,95550
J000174,N00008028,Sam Johnson (R),2012,Retired,51755,0,51755
J000174,N00008028,Sam Johnson (R),2012,Real Estate,25914,24000,49914
J000174,N00008028,Sam Johnson (R),2012,Securities & Investment,15150,30000,45150
J000174,N00008028,Sam Johnson (R),2012,Oil & Gas,21850,21900,43750
J000174,N00008028,Sam Johnson (R),2012,Automotive,21300,16000,37300
J000174,N00008028,Sam Johnson (R),2012,Commercial Banks,7200,29000,36200
J000174,N00008028,Sam Johnson (R),2012,Misc Finance,24100,7900,32000
J000174,N00008028,Sam Johnson (R),2012,Pharmaceuticals/Health Products,2000,28545,30545
L000551,N00008046,Barbara Lee (D),2012,Lawyers/Law Firms,48672,20262,68934
L000551,N00008046,Barbara Lee (D),2012,Retired,62370,0,62370
L000551,N00008046,Barbara Lee (D),2012,Building Trade Unions,0,47500,47500
L000551,N00008046,Barbara Lee (D),2012,Health Professionals,25060,21000,46060
L000551,N00008046,Barbara Lee (D),2012,Real Estate,37300,8010,45310
L000551,N00008046,Barbara Lee (D),2012,Public Sector Unions,0,42500,42500
L000551,N00008046,Barbara Lee (D),2012,Business Services,37650,0,37650
L000551,N00008046,Barbara Lee (D),2012,Transportation Unions,0,31600,31600
L000551,N00008046,Barbara Lee (D),2012,Lobbyists,29995,0,29995
L000551,N00008046,Barbara Lee (D),2012,Industrial Unions,2500,24000,26500
U000038,N00008051,Mark Udall (D),2012,Lawyers/Law Firms,1243625,137638,1381263
U000038,N00008051,Mark Udall (D),2012,Retired,900089,0,900089
U000038,N00008051,Mark Udall (D),2012,Securities & Investment,692677,40500,733177
U000038,N00008051,Mark Udall (D),2012,Real Estate,470301,36500,506801
U000038,N00008051,Mark Udall (D),2012,Lobbyists,403941,11240,415181
U000038,N00008051,Mark Udall (D),2012,Health Professionals,162623,208000,370623
U000038,N00008051,Mark Udall (D),2012,Leadership PACs,0,360300,360300
U000038,N00008051,Mark Udall (D),2012,Business Services,314015,5500,319515
U000038,N00008051,Mark Udall (D),2012,TV/Movies/Music,275906,29750,305656
U000038,N00008051,Mark Udall (D),2012,Environment,280865,20390,301255
C000071,N00008086,Dave Camp (R),2012,Health Professionals,43273,295500,338773
C000071,N00008086,Dave Camp (R),2012,Securities & Investment,147800,153750,301550
C000071,N00008086,Dave Camp (R),2012,Insurance,38000,252508,290508
C000071,N00008086,Dave Camp (R),2012,Oil & Gas,82300,156300,238600
C000071,N00008086,Dave Camp (R),2012,Pharmaceuticals/Health Products,25400,212500,237900
C000071,N00008086,Dave Camp (R),2012,Lobbyists,181350,14001,195351
C000071,N00008086,Dave Camp (R),2012,Health Services/HMOs,16950,151400,168350
C000071,N00008086,Dave Camp (R),2012,Electric Utilities,1500,162500,164000
C000071,N00008086,Dave Camp (R),2012,Hospitals/Nursing Homes,50572,105000,155572
C000071,N00008086,Dave Camp (R),2012,Commercial Banks,30150,104500,134650
B000013,N00008091,Spencer Bachus (R),2012,Securities & Investment,88177,199500,287677
B000013,N00008091,Spencer Bachus (R),2012,Commercial Banks,115700,164500,280200
B000013,N00008091,Spencer Bachus (R),2012,Insurance,46710,222500,269210
B000013,N00008091,Spencer Bachus (R),2012,Real Estate,122700,95000,217700
B000013,N00008091,Spencer Bachus (R),2012,Finance/Credit Companies,36708,87500,124208
B000013,N00008091,Spencer Bachus (R),2012,Lawyers/Law Firms,40384,83304,123688
B000013,N00008091,Spencer Bachus (R),2012,Misc Finance,42000,45000,87000
B000013,N00008091,Spencer Bachus (R),2012,Leadership PACs,0,81000,81000
B000013,N00008091,Spencer Bachus (R),2012,Accountants,13250,52000,65250
B000013,N00008091,Spencer Bachus (R),2012,Lobbyists,64050,0,64050
J000126,N00008122,Eddie Bernice Johnson (D),2012,Lawyers/Law Firms,42750,19250,62000
J000126,N00008122,Eddie Bernice Johnson (D),2012,Transportation Unions,0,55000,55000
J000126,N00008122,Eddie Bernice Johnson (D),2012,Air Transport,1250,46999,48249
J000126,N00008122,Eddie Bernice Johnson (D),2012,Railroads,0,43000,43000
J000126,N00008122,Eddie Bernice Johnson (D),2012,Public Sector Unions,0,42500,42500
J000126,N00008122,Eddie Bernice Johnson (D),2012,Construction Services,4500,27250,31750
J000126,N00008122,Eddie Bernice Johnson (D),2012,Building Trade Unions,0,29500,29500
J000126,N00008122,Eddie Bernice Johnson (D),2012,Health Professionals,4755,23000,27755
J000126,N00008122,Eddie Bernice Johnson (D),2012,Leadership PACs,0,22500,22500
J000126,N00008122,Eddie Bernice Johnson (D),2012,Candidate Committees,0,18500,18500
R000487,N00008264,Ed Royce (R),2012,Securities & Investment,92350,145500,237850
R000487,N00008264,Ed Royce (R),2012,Insurance,31590,205200,236790
R000487,N00008264,Ed Royce (R),2012,Retired,195049,0,195049
R000487,N00008264,Ed Royce (R),2012,Real Estate,122685,71892,194577
R000487,N00008264,Ed Royce (R),2012,Lawyers/Law Firms,65655,34000,99655
R000487,N00008264,Ed Royce (R),2012,Commercial Banks,19450,73500,92950
R000487,N00008264,Ed Royce (R),2012,Credit Unions,46975,41000,87975
R000487,N00008264,Ed Royce (R),2012,Health Professionals,66500,13000,79500
R000487,N00008264,Ed Royce (R),2012,Republican/Conservative,72500,5500,78000
R000487,N00008264,Ed Royce (R),2012,Accountants,21550,55999,77549
S000030,N00008274,Loretta Sanchez (D),2012,Lawyers/Law Firms,120000,31000,151000
S000030,N00008274,Loretta Sanchez (D),2012,Leadership PACs,500,58000,58500
S000030,N00008274,Loretta Sanchez (D),2012,TV/Movies/Music,37500,18500,56000
S000030,N00008274,Loretta Sanchez (D),2012,Building Trade Unions,0,54000,54000
S000030,N00008274,Loretta Sanchez (D),2012,Retired,53560,0,53560
S000030,N00008274,Loretta Sanchez (D),2012,Democratic/Liberal,32990,20000,52990
S000030,N00008274,Loretta Sanchez (D),2012,Real Estate,46500,6010,52510
S000030,N00008274,Loretta Sanchez (D),2012,Pharmaceuticals/Health Products,20500,30000,50500
S000030,N00008274,Loretta Sanchez (D),2012,Defense Electronics,5750,41000,46750
S000030,N00008274,Loretta Sanchez (D),2012,Public Sector Unions,0,45500,45500
G000377,N00008799,Kay Granger (R),2012,Defense Aerospace,54950,56000,110950
G000377,N00008799,Kay Granger (R),2012,Oil & Gas,63500,16000,79500
G000377,N00008799,Kay Granger (R),2012,Real Estate,49245,20500,69745
G000377,N00008799,Kay Granger (R),2012,Retired,60825,0,60825
G000377,N00008799,Kay Granger (R),2012,Lobbyists,58260,2500,60760
G000377,N00008799,Kay Granger (R),2012,Lawyers/Law Firms,31222,26990,58212
G000377,N00008799,Kay Granger (R),2012,Securities & Investment,36700,15000,51700
G000377,N00008799,Kay Granger (R),2012,Misc Manufacturing & Distributing,23750,23500,47250
G000377,N00008799,Kay Granger (R),2012,Air Transport,2000,45100,47100
G000377,N00008799,Kay Granger (R),2012,Misc Defense,500,37000,37500
G000289,N00009154,Bob Goodlatte (R),2012,Retired,87672,0,87672
G000289,N00009154,Bob Goodlatte (R),2012,Electronics Mfg & Equip,5000,75093,80093
G000289,N00009154,Bob Goodlatte (R),2012,TV/Movies/Music,19000,60000,79000
G000289,N00009154,Bob Goodlatte (R),2012,Lawyers/Law Firms,28793,35250,64043
G000289,N00009154,Bob Goodlatte (R),2012,Food Processing & Sales,6500,45566,52066
G000289,N00009154,Bob Goodlatte (R),2012,Lobbyists,48400,2000,50400
G000289,N00009154,Bob Goodlatte (R),2012,Telecom Services,4750,42400,47150
G000289,N00009154,Bob Goodlatte (R),2012,Internet,18250,26000,44250
G000289,N00009154,Bob Goodlatte (R),2012,Railroads,750,40760,41510
G000289,N00009154,Bob Goodlatte (R),2012,Agricultural Services/Products,1750,32762,34512
H000329,N00009157,Doc Hastings (R),2012,Oil & Gas,65050,112499,177549
H000329,N00009157,Doc Hastings (R),2012,Mining,69128,48000,117128
H000329,N00009157,Doc Hastings (R),2012,Crop Production & Basic Processing,52720,30500,83220
H000329,N00009157,Doc Hastings (R),2012,Casinos/Gambling,58499,0,58499
H000329,N00009157,Doc Hastings (R),2012,Retired,55950,0,55950
H000329,N00009157,Doc Hastings (R),2012,Forestry & Forest Products,18499,26620,45119
H000329,N00009157,Doc Hastings (R),2012,Lobbyists,44000,1000,45000
H000329,N00009157,Doc Hastings (R),2012,Lawyers/Law Firms,11978,28000,39978
H000329,N00009157,Doc Hastings (R),2012,Electric Utilities,5300,33261,38561
H000329,N00009157,Doc Hastings (R),2012,Misc Manufacturing & Distributing,27475,7500,34975
F000444,N00009573,Jeff Flake (R),2012,Republican/Conservative,1259937,59843,1319780
F000444,N00009573,Jeff Flake (R),2012,Retired,608043,0,608043
F000444,N00009573,Jeff Flake (R),2012,Securities & Investment,326329,13000,339329
F000444,N00009573,Jeff Flake (R),2012,Leadership PACs,0,325868,325868
F000444,N00009573,Jeff Flake (R),2012,Real Estate,300322,17500,317822
F000444,N00009573,Jeff Flake (R),2012,Misc Finance,199622,2500,202122
F000444,N00009573,Jeff Flake (R),2012,Lawyers/Law Firms,164952,33500,198452
F000444,N00009573,Jeff Flake (R),2012,Mining,124102,52000,176102
F000444,N00009573,Jeff Flake (R),2012,Health Professionals,131807,42500,174307
F000444,N00009573,Jeff Flake (R),2012,Oil & Gas,70860,96000,166860
S001150,N00009585,Adam Schiff (D),2012,Lawyers/Law Firms,139550,28000,167550
S001150,N00009585,Adam Schiff (D),2012,Health Professionals,39210,27375,66585
S001150,N00009585,Adam Schiff (D),2012,TV/Movies/Music,36750,26500,63250
S001150,N00009585,Adam Schiff (D),2012,Real Estate,50050,8000,58050
S001150,N00009585,Adam Schiff (D),2012,Retired,53950,0,53950
S001150,N00009585,Adam Schiff (D),2012,Securities & Investment,37250,5000,42250
S001150,N00009585,Adam Schiff (D),2012,Building Trade Unions,0,41500,41500
S001150,N00009585,Adam Schiff (D),2012,Public Sector Unions,0,35500,35500
S001150,N00009585,Adam Schiff (D),2012,Pro-Israel,16600,13500,30100
S001150,N00009585,Adam Schiff (D),2012,Defense Aerospace,0,30000,30000
D000598,N00009604,Susan A Davis (D),2012,Women's Issues,27550,7500,35050
D000598,N00009604,Susan A Davis (D),2012,Electronics Mfg & Equip,17250,16000,33250
D000598,N00009604,Susan A Davis (D),2012,Retired,31600,0,31600
D000598,N00009604,Susan A Davis (D),2012,Public Sector Unions,0,31550,31550
D000598,N00009604,Susan A Davis (D),2012,Health Professionals,5894,22500,28394
D000598,N00009604,Susan A Davis (D),2012,Pharmaceuticals/Health Products,500,27500,28000
D000598,N00009604,Susan A Davis (D),2012,Defense Aerospace,250,23000,23250
D000598,N00009604,Susan A Davis (D),2012,Misc Defense,9800,12000,21800
D000598,N00009604,Susan A Davis (D),2012,Lawyers/Law Firms,6750,12500,19250
D000598,N00009604,Susan A Davis (D),2012,Defense Electronics,0,18500,18500
V000127,N00009659,David Vitter (R),2012,Oil & Gas,466350,206200,672550
V000127,N00009659,David Vitter (R),2012,Health Professionals,456626,83000,539626
V000127,N00009659,David Vitter (R),2012,Lawyers/Law Firms,338011,126999,465010
V000127,N00009659,David Vitter (R),2012,Retired,450809,0,450809
V000127,N00009659,David Vitter (R),2012,Real Estate,359400,50500,409900
V000127,N00009659,David Vitter (R),2012,Leadership PACs,0,285257,285257
V000127,N00009659,David Vitter (R),2012,Insurance,146775,129500,276275
V000127,N00009659,David Vitter (R),2012,Sea Transport,179457,92500,271957
V000127,N00009659,David Vitter (R),2012,Lobbyists,228118,12000,240118
V000127,N00009659,David Vitter (R),2012,Securities & Investment,156140,81000,237140
S001176,N00009660,Steve Scalise (R),2012,Oil & Gas,59975,94000,153975
S001176,N00009660,Steve Scalise (R),2012,Health Professionals,26850,59000,85850
S001176,N00009660,Steve Scalise (R),2012,Sea Transport,42600,31000,73600
S001176,N00009660,Steve Scalise (R),2012,Real Estate,56972,12000,68972
S001176,N00009660,Steve Scalise (R),2012,Telecom Services,3250,60500,63750
S001176,N00009660,Steve Scalise (R),2012,Pharmaceuticals/Health Products,11450,43000,54450
S001176,N00009660,Steve Scalise (R),2012,Lobbyists,42794,0,42794
S001176,N00009660,Steve Scalise (R),2012,Insurance,24678,18000,42678
S001176,N00009660,Steve Scalise (R),2012,Telephone Utilities,3000,38100,41100
S001176,N00009660,Steve Scalise (R),2012,General Contractors,30550,10500,41050
R000572,N00009668,Mike Rogers (R),2012,Health Professionals,8150,160750,168900
R000572,N00009668,Mike Rogers (R),2012,Pharmaceuticals/Health Products,10000,135749,145749
R000572,N00009668,Mike Rogers (R),2012,Insurance,14940,105000,119940
R000572,N00009668,Mike Rogers (R),2012,Telecom Services,8500,68500,77000
R000572,N00009668,Mike Rogers (R),2012,Health Services/HMOs,41500,27500,69000
R000572,N00009668,Mike Rogers (R),2012,Electric Utilities,2000,57250,59250
R000572,N00009668,Mike Rogers (R),2012,Defense Electronics,250,51000,51250
R000572,N00009668,Mike Rogers (R),2012,Electronics Mfg & Equip,13500,37000,50500
R000572,N00009668,Mike Rogers (R),2012,Oil & Gas,1850,48500,50350
R000572,N00009668,Mike Rogers (R),2012,Real Estate,27550,18877,46427
T000462,N00009699,Pat Tiberi (R),2012,Insurance,109050,218800,327850
T000462,N00009699,Pat Tiberi (R),2012,Securities & Investment,75498,124500,199998
T000462,N00009699,Pat Tiberi (R),2012,Real Estate,78799,67000,145799
T000462,N00009699,Pat Tiberi (R),2012,Health Professionals,17850,117725,135575
T000462,N00009699,Pat Tiberi (R),2012,Lawyers/Law Firms,66100,63725,129825
T000462,N00009699,Pat Tiberi (R),2012,Pharmaceuticals/Health Products,17750,103300,121050
T000462,N00009699,Pat Tiberi (R),2012,Lobbyists,102582,3000,105582
T000462,N00009699,Pat Tiberi (R),2012,Electric Utilities,13200,91500,104700
T000462,N00009699,Pat Tiberi (R),2012,Commercial Banks,17200,85100,102300
T000462,N00009699,Pat Tiberi (R),2012,Food & Beverage,12115,74000,86115
L000559,N00009724,Jim Langevin (D),2012,Lawyers/Law Firms,72883,23500,96383
L000559,N00009724,Jim Langevin (D),2012,Health Professionals,22550,42500,65050
L000559,N00009724,Jim Langevin (D),2012,Building Trade Unions,0,55050,55050
L000559,N00009724,Jim Langevin (D),2012,Public Sector Unions,800,47400,48200
L000559,N00009724,Jim Langevin (D),2012,Defense Aerospace,250,46000,46250
L000559,N00009724,Jim Langevin (D),2012,Retired,45545,0,45545
L000559,N00009724,Jim Langevin (D),2012,Defense Electronics,7300,34500,41800
L000559,N00009724,Jim Langevin (D),2012,Real Estate,26100,10000,36100
L000559,N00009724,Jim Langevin (D),2012,Misc Defense,23200,8500,31700
L000559,N00009724,Jim Langevin (D),2012,Pro-Israel,17944,10500,28444
C001048,N00009738,John Culberson (R),2012,Oil & Gas,29850,71000,100850
C001048,N00009738,John Culberson (R),2012,Real Estate,52200,15500,67700
C001048,N00009738,John Culberson (R),2012,Retired,50900,0,50900
C001048,N00009738,John Culberson (R),2012,Health Professionals,22000,21000,43000
C001048,N00009738,John Culberson (R),2012,Construction Services,21000,15000,36000
C001048,N00009738,John Culberson (R),2012,Defense Aerospace,0,32500,32500
C001048,N00009738,John Culberson (R),2012,Lawyers/Law Firms,21316,10500,31816
C001048,N00009738,John Culberson (R),2012,Misc Manufacturing & Distributing,12900,12000,24900
C001048,N00009738,John Culberson (R),2012,Misc Finance,22700,0,22700
C001048,N00009738,John Culberson (R),2012,Air Transport,2500,20000,22500
M001142,N00009753,Jim Matheson (D),2012,Health Professionals,17501,211000,228501
M001142,N00009753,Jim Matheson (D),2012,Pharmaceuticals/Health Products,5250,164746,169996
M001142,N00009753,Jim Matheson (D),2012,Leadership PACs,7500,137490,144990
M001142,N00009753,Jim Matheson (D),2012,Oil & Gas,3750,102400,106150
M001142,N00009753,Jim Matheson (D),2012,Insurance,1250,89500,90750
M001142,N00009753,Jim Matheson (D),2012,Health Services/HMOs,25050,52500,77550
M001142,N00009753,Jim Matheson (D),2012,Electric Utilities,1500,71000,72500
M001142,N00009753,Jim Matheson (D),2012,Securities & Investment,18400,43000,61400
M001142,N00009753,Jim Matheson (D),2012,Candidate Committees,0,58500,58500
M001142,N00009753,Jim Matheson (D),2012,Public Sector Unions,0,56750,56750
L000560,N00009759,Rick Larsen (D),2012,Sea Transport,10120,68500,78620
L000560,N00009759,Rick Larsen (D),2012,Transportation Unions,0,75500,75500
L000560,N00009759,Rick Larsen (D),2012,Retired,71800,0,71800
L000560,N00009759,Rick Larsen (D),2012,Health Professionals,15500,38050,53550
L000560,N00009759,Rick Larsen (D),2012,Building Trade Unions,0,51500,51500
L000560,N00009759,Rick Larsen (D),2012,Lobbyists,45142,1000,46142
L000560,N00009759,Rick Larsen (D),2012,Defense Aerospace,0,45000,45000
L000560,N00009759,Rick Larsen (D),2012,Air Transport,0,40498,40498
L000560,N00009759,Rick Larsen (D),2012,Lawyers/Law Firms,16040,19250,35290
L000560,N00009759,Rick Larsen (D),2012,Public Sector Unions,250,34500,34750
C001047,N00009771,Shelley Moore Capito (R),2012,Commercial Banks,22750,165750,188500
C001047,N00009771,Shelley Moore Capito (R),2012,Mining,127187,50749,177936
C001047,N00009771,Shelley Moore Capito (R),2012,Insurance,16000,117300,133300
C001047,N00009771,Shelley Moore Capito (R),2012,Securities & Investment,18400,107000,125400
C001047,N00009771,Shelley Moore Capito (R),2012,Lawyers/Law Firms,108963,15000,123963
C001047,N00009771,Shelley Moore Capito (R),2012,Real Estate,44400,55500,99900
C001047,N00009771,Shelley Moore Capito (R),2012,Retired,99850,0,99850
C001047,N00009771,Shelley Moore Capito (R),2012,Finance/Credit Companies,22000,56800,78800
C001047,N00009771,Shelley Moore Capito (R),2012,Health Professionals,28200,46500,74700
C001047,N00009771,Shelley Moore Capito (R),2012,General Contractors,60550,7000,67550
B000287,N00009774,Xavier Becerra (D),2012,Health Professionals,14600,173000,187600
B000287,N00009774,Xavier Becerra (D),2012,Securities & Investment,60600,59500,120100
B000287,N00009774,Xavier Becerra (D),2012,Insurance,12500,98500,111000
B000287,N00009774,Xavier Becerra (D),2012,Health Services/HMOs,43673,52000,95673
B000287,N00009774,Xavier Becerra (D),2012,Real Estate,63774,29500,93274
B000287,N00009774,Xavier Becerra (D),2012,Pharmaceuticals/Health Products,17049,63992,81041
B000287,N00009774,Xavier Becerra (D),2012,Lawyers/Law Firms,31250,38285,69535
B000287,N00009774,Xavier Becerra (D),2012,Public Sector Unions,0,69000,69000
B000287,N00009774,Xavier Becerra (D),2012,Hospitals/Nursing Homes,7300,58000,65300
B000287,N00009774,Xavier Becerra (D),2012,Lobbyists,57005,2500,59505
M001150,N00009795,Candice S Miller (R),2012,Transportation Unions,0,69000,69000
M001150,N00009795,Candice S Miller (R),2012,Automotive,30600,26000,56600
M001150,N00009795,Candice S Miller (R),2012,Air Transport,3000,37000,40000
M001150,N00009795,Candice S Miller (R),2012,Electric Utilities,14850,21000,35850
M001150,N00009795,Candice S Miller (R),2012,Railroads,700,30500,31200
M001150,N00009795,Candice S Miller (R),2012,Crop Production & Basic Processing,200,26000,26200
M001150,N00009795,Candice S Miller (R),2012,Health Professionals,3200,22500,25700
M001150,N00009795,Candice S Miller (R),2012,Leadership PACs,0,22000,22000
M001150,N00009795,Candice S Miller (R),2012,Lawyers/Law Firms,4550,15528,20078
M001150,N00009795,Candice S Miller (R),2012,Building Trade Unions,0,19000,19000
S000522,N00009816,Chris Smith (R),2012,Building Trade Unions,0,37500,37500
S000522,N00009816,Chris Smith (R),2012,Retired,36800,0,36800
S000522,N00009816,Chris Smith (R),2012,Transportation Unions,0,29500,29500
S000522,N00009816,Chris Smith (R),2012,Lawyers/Law Firms,14100,9000,23100
S000522,N00009816,Chris Smith (R),2012,Real Estate,10000,12000,22000
S000522,N00009816,Chris Smith (R),2012,Securities & Investment,18750,1000,19750
S000522,N00009816,Chris Smith (R),2012,Lobbyists,12000,5584,17584
S000522,N00009816,Chris Smith (R),2012,Health Professionals,6700,8400,15100
S000522,N00009816,Chris Smith (R),2012,Public Sector Unions,0,14800,14800
S000522,N00009816,Chris Smith (R),2012,Abortion Policy/Anti-Abortion,2800,12000,14800
M000404,N00009829,Jim McDermott (D),2012,Building Trade Unions,0,46500,46500
M000404,N00009829,Jim McDermott (D),2012,Public Sector Unions,0,30850,30850
M000404,N00009829,Jim McDermott (D),2012,Lawyers/Law Firms,11050,19500,30550
M000404,N00009829,Jim McDermott (D),2012,Insurance,0,26500,26500
M000404,N00009829,Jim McDermott (D),2012,Health Professionals,9200,17000,26200
M000404,N00009829,Jim McDermott (D),2012,Retired,24700,0,24700
M000404,N00009829,Jim McDermott (D),2012,Industrial Unions,0,21500,21500
M000404,N00009829,Jim McDermott (D),2012,Misc Unions,700,18500,19200
M000404,N00009829,Jim McDermott (D),2012,Real Estate,3500,15000,18500
M000404,N00009829,Jim McDermott (D),2012,Electric Utilities,1500,13350,14850
H000338,N00009869,Orrin G Hatch (R),2012,Securities & Investment,966875,208071,1174946
H000338,N00009869,Orrin G Hatch (R),2012,Pharmaceuticals/Health Products,284360,563641,848001
H000338,N00009869,Orrin G Hatch (R),2012,Lobbyists,507317,12500,519817
H000338,N00009869,Orrin G Hatch (R),2012,Insurance,154194,352174,506368
H000338,N00009869,Orrin G Hatch (R),2012,Lawyers/Law Firms,252640,221081,473721
H000338,N00009869,Orrin G Hatch (R),2012,Health Professionals,106115,350500,456615
H000338,N00009869,Orrin G Hatch (R),2012,Real Estate,303492,108900,412392
H000338,N00009869,Orrin G Hatch (R),2012,Health Services/HMOs,168982,234500,403482
H000338,N00009869,Orrin G Hatch (R),2012,Leadership PACs,0,391878,391878
H000338,N00009869,Orrin G Hatch (R),2012,Oil & Gas,153650,235500,389150
A000360,N00009888,Lamar Alexander (R),2012,Real Estate,323633,30500,354133
A000360,N00009888,Lamar Alexander (R),2012,Retired,345966,0,345966
A000360,N00009888,Lamar Alexander (R),2012,Lawyers/Law Firms,269100,73750,342850
A000360,N00009888,Lamar Alexander (R),2012,Leadership PACs,0,291550,291550
A000360,N00009888,Lamar Alexander (R),2012,Securities & Investment,237549,37000,274549
A000360,N00009888,Lamar Alexander (R),2012,Health Professionals,127800,60500,188300
A000360,N00009888,Lamar Alexander (R),2012,Misc Finance,178200,9000,187200
A000360,N00009888,Lamar Alexander (R),2012,Education,142950,21900,164850
A000360,N00009888,Lamar Alexander (R),2012,Pharmaceuticals/Health Products,23300,134400,157700
A000360,N00009888,Lamar Alexander (R),2012,Oil & Gas,61750,91000,152750
L000174,N00009918,Patrick Leahy (D),2012,Lawyers/Law Firms,514481,125459,639940
L000174,N00009918,Patrick Leahy (D),2012,TV/Movies/Music,250056,81550,331606
L000174,N00009918,Patrick Leahy (D),2012,Lobbyists,290400,4000,294400
L000174,N00009918,Patrick Leahy (D),2012,Electronics Mfg & Equip,195500,78711,274211
L000174,N00009918,Patrick Leahy (D),2012,Leadership PACs,0,212400,212400
L000174,N00009918,Patrick Leahy (D),2012,Securities & Investment,106000,22000,128000
L000174,N00009918,Patrick Leahy (D),2012,Public Sector Unions,0,94000,94000
L000174,N00009918,Patrick Leahy (D),2012,Retired,87100,0,87100
L000174,N00009918,Patrick Leahy (D),2012,Pro-Israel,48851,27711,76562
L000174,N00009918,Patrick Leahy (D),2012,Real Estate,61400,13500,74900
S000320,N00009920,Richard C Shelby (R),2012,Securities & Investment,580588,284900,865488
S000320,N00009920,Richard C Shelby (R),2012,Insurance,149550,333749,483299
S000320,N00009920,Richard C Shelby (R),2012,Lawyers/Law Firms,267400,144050,411450
S000320,N00009920,Richard C Shelby (R),2012,Finance/Credit Companies,198500,145400,343900
S000320,N00009920,Richard C Shelby (R),2012,Real Estate,204600,119300,323900
S000320,N00009920,Richard C Shelby (R),2012,Lobbyists,252389,6000,258389
S000320,N00009920,Richard C Shelby (R),2012,Commercial Banks,134550,116000,250550
S000320,N00009920,Richard C Shelby (R),2012,Electronics Mfg & Equip,153400,60030,213430
S000320,N00009920,Richard C Shelby (R),2012,Misc Defense,118650,70900,189550
S000320,N00009920,Richard C Shelby (R),2012,Defense Aerospace,40300,144800,185100
R000146,N00009922,Harry Reid (D),2012,Lawyers/Law Firms,3428207,384745,3812952
R000146,N00009922,Harry Reid (D),2012,Securities & Investment,1205618,192000,1397618
R000146,N00009922,Harry Reid (D),2012,Lobbyists,1127110,34170,1161280
R000146,N00009922,Harry Reid (D),2012,Real Estate,843895,102176,946071
R000146,N00009922,Harry Reid (D),2012,Health Professionals,512706,350400,863106
R000146,N00009922,Harry Reid (D),2012,Retired,791798,0,791798
R000146,N00009922,Harry Reid (D),2012,Casinos/Gambling,719450,66422,785872
R000146,N00009922,Harry Reid (D),2012,Business Services,543840,48000,591840
R000146,N00009922,Harry Reid (D),2012,Leadership PACs,0,531449,531449
R000146,N00009922,Harry Reid (D),2012,Insurance,270750,259500,530250
N000032,N00009926,Bill Nelson (D),2012,Lawyers/Law Firms,2184262,223219,2407481
N000032,N00009926,Bill Nelson (D),2012,Retired,904580,0,904580
N000032,N00009926,Bill Nelson (D),2012,Real Estate,560653,58800,619453
N000032,N00009926,Bill Nelson (D),2012,Health Professionals,470382,65050,535432
N000032,N00009926,Bill Nelson (D),2012,Lobbyists,483522,23315,506837
N000032,N00009926,Bill Nelson (D),2012,Securities & Investment,465565,35500,501065
N000032,N00009926,Bill Nelson (D),2012,Hospitals/Nursing Homes,242295,129000,371295
N000032,N00009926,Bill Nelson (D),2012,Leadership PACs,0,337000,337000
N000032,N00009926,Bill Nelson (D),2012,Insurance,187888,147150,335038
N000032,N00009926,Bill Nelson (D),2012,Health Services/HMOs,110300,171762,282062
G000359,N00009975,Lindsey Graham (R),2012,Lawyers/Law Firms,796566,75250,871816
G000359,N00009975,Lindsey Graham (R),2012,Electric Utilities,221510,147952,369462
G000359,N00009975,Lindsey Graham (R),2012,Real Estate,298880,19500,318380
G000359,N00009975,Lindsey Graham (R),2012,Retired,283264,0,283264
G000359,N00009975,Lindsey Graham (R),2012,Securities & Investment,258244,21000,279244
G000359,N00009975,Lindsey Graham (R),2012,Leadership PACs,0,233500,233500
G000359,N00009975,Lindsey Graham (R),2012,Lobbyists,198358,4953,203311
G000359,N00009975,Lindsey Graham (R),2012,General Contractors,103338,45000,148338
G000359,N00009975,Lindsey Graham (R),2012,Health Professionals,103562,38000,141562
G000359,N00009975,Lindsey Graham (R),2012,Business Services,129199,10500,139699
J000177,N00010084,Tim Johnson (D),2012,Securities & Investment,212150,246750,458900
J000177,N00010084,Tim Johnson (D),2012,Insurance,53700,359636,413336
J000177,N00010084,Tim Johnson (D),2012,Lawyers/Law Firms,240869,98589,339458
J000177,N00010084,Tim Johnson (D),2012,Commercial Banks,175898,155407,331305
J000177,N00010084,Tim Johnson (D),2012,Leadership PACs,0,287500,287500
J000177,N00010084,Tim Johnson (D),2012,Finance/Credit Companies,149600,121400,271000
J000177,N00010084,Tim Johnson (D),2012,Lobbyists,241783,9250,251033
J000177,N00010084,Tim Johnson (D),2012,Health Professionals,67340,154750,222090
J000177,N00010084,Tim Johnson (D),2012,Real Estate,89550,104009,193559
J000177,N00010084,Tim Johnson (D),2012,Electric Utilities,11200,147069,158269
L000566,N00012233,Robert E Latta (R),2012,Electric Utilities,18550,44000,62550
L000566,N00012233,Robert E Latta (R),2012,Oil & Gas,15650,40000,55650
L000566,N00012233,Robert E Latta (R),2012,Health Professionals,10550,37500,48050
L000566,N00012233,Robert E Latta (R),2012,Pharmaceuticals/Health Products,1000,45000,46000
L000566,N00012233,Robert E Latta (R),2012,Telecom Services,1250,42500,43750
L000566,N00012233,Robert E Latta (R),2012,Retired,41850,0,41850
L000566,N00012233,Robert E Latta (R),2012,Insurance,23250,17500,40750
L000566,N00012233,Robert E Latta (R),2012,Telephone Utilities,500,36900,37400
L000566,N00012233,Robert E Latta (R),2012,Leadership PACs,0,34250,34250
L000566,N00012233,Robert E Latta (R),2012,Commercial Banks,6750,21000,27750
C001049,N00012460,William L Clay Jr (D),2012,Lawyers/Law Firms,34750,16000,50750
C001049,N00012460,William L Clay Jr (D),2012,Public Sector Unions,0,42000,42000
C001049,N00012460,William L Clay Jr (D),2012,Misc Services,9750,30000,39750
C001049,N00012460,William L Clay Jr (D),2012,Building Trade Unions,0,38700,38700
C001049,N00012460,William L Clay Jr (D),2012,Real Estate,14950,20900,35850
C001049,N00012460,William L Clay Jr (D),2012,Industrial Unions,0,32000,32000
C001049,N00012460,William L Clay Jr (D),2012,Insurance,500,29500,30000
C001049,N00012460,William L Clay Jr (D),2012,Transportation Unions,0,28500,28500
C001049,N00012460,William L Clay Jr (D),2012,Securities & Investment,2000,26000,28000
C001049,N00012460,William L Clay Jr (D),2012,Retired,25450,0,25450
C000174,N00012508,Tom Carper (D),2012,Insurance,94070,292840,386910
C000174,N00012508,Tom Carper (D),2012,Lawyers/Law Firms,180879,132231,313110
C000174,N00012508,Tom Carper (D),2012,Securities & Investment,135700,173500,309200
C000174,N00012508,Tom Carper (D),2012,Lobbyists,215375,9220,224595
C000174,N00012508,Tom Carper (D),2012,Pharmaceuticals/Health Products,50900,150250,201150
C000174,N00012508,Tom Carper (D),2012,Commercial Banks,83930,111500,195430
C000174,N00012508,Tom Carper (D),2012,Chemical & Related Manufacturing,59287,105370,164657
C000174,N00012508,Tom Carper (D),2012,Leadership PACs,0,162500,162500
C000174,N00012508,Tom Carper (D),2012,Health Professionals,29300,118150,147450
C000174,N00012508,Tom Carper (D),2012,Retired,134200,0,134200
K000360,N00012539,Mark Kirk (R),2012,Securities & Investment,1784961,63900,1848861
K000360,N00012539,Mark Kirk (R),2012,Retired,1251555,0,1251555
K000360,N00012539,Mark Kirk (R),2012,Lawyers/Law Firms,751997,57439,809436
K000360,N00012539,Mark Kirk (R),2012,Pro-Israel,539456,115904,655360
K000360,N00012539,Mark Kirk (R),2012,Health Professionals,327713,313050,640763
K000360,N00012539,Mark Kirk (R),2012,Real Estate,508094,20300,528394
K000360,N00012539,Mark Kirk (R),2012,Misc Finance,422452,31000,453452
K000360,N00012539,Mark Kirk (R),2012,Business Services,305488,23500,328988
K000360,N00012539,Mark Kirk (R),2012,Insurance,163139,152500,315639
K000360,N00012539,Mark Kirk (R),2012,Misc Manufacturing & Distributing,227200,70900,298100
M001189,N00012546,Luke Messer (R),2012,Retired,66886,0,66886
M001189,N00012546,Luke Messer (R),2012,Lawyers/Law Firms,57465,2500,59965
M001189,N00012546,Luke Messer (R),2012,Leadership PACs,0,55000,55000
M001189,N00012546,Luke Messer (R),2012,Real Estate,32800,20000,52800
M001189,N00012546,Luke Messer (R),2012,Health Professionals,16187,26500,42687
M001189,N00012546,Luke Messer (R),2012,Insurance,22050,9000,31050
M001189,N00012546,Luke Messer (R),2012,Oil & Gas,8500,22000,30500
M001189,N00012546,Luke Messer (R),2012,Business Services,30000,0,30000
M001189,N00012546,Luke Messer (R),2012,Electronics Mfg & Equip,27000,2000,29000
M001189,N00012546,Luke Messer (R),2012,Misc Manufacturing & Distributing,24325,4000,28325
H001034,N00012611,Mike Honda (D),2012,Electronics Mfg & Equip,49250,25250,74500
H001034,N00012611,Mike Honda (D),2012,Building Trade Unions,0,47400,47400
H001034,N00012611,Mike Honda (D),2012,Human Rights,37700,6000,43700
H001034,N00012611,Mike Honda (D),2012,Lawyers/Law Firms,26650,14500,41150
H001034,N00012611,Mike Honda (D),2012,Real Estate,32550,8000,40550
H001034,N00012611,Mike Honda (D),2012,Retired,39200,0,39200
H001034,N00012611,Mike Honda (D),2012,Public Sector Unions,0,33000,33000
H001034,N00012611,Mike Honda (D),2012,Pharmaceuticals/Health Products,1450,30500,31950
H001034,N00012611,Mike Honda (D),2012,Industrial Unions,0,27700,27700
H001034,N00012611,Mike Honda (D),2012,Business Services,26410,0,26410
P000588,N00012672,Steve Pearce (R),2012,Oil & Gas,156350,79500,235850
P000588,N00012672,Steve Pearce (R),2012,Retired,92770,0,92770
P000588,N00012672,Steve Pearce (R),2012,Livestock,68055,5500,73555
P000588,N00012672,Steve Pearce (R),2012,Real Estate,32250,19000,51250
P000588,N00012672,Steve Pearce (R),2012,Commercial Banks,20600,27000,47600
P000588,N00012672,Steve Pearce (R),2012,Crop Production & Basic Processing,32350,13000,45350
P000588,N00012672,Steve Pearce (R),2012,Insurance,9250,26310,35560
P000588,N00012672,Steve Pearce (R),2012,Leadership PACs,0,32892,32892
P000588,N00012672,Steve Pearce (R),2012,Automotive,19250,13000,32250
P000588,N00012672,Steve Pearce (R),2012,Mining,9000,19500,28500
C001045,N00012739,Ander Crenshaw (R),2012,Defense Aerospace,0,48500,48500
C001045,N00012739,Ander Crenshaw (R),2012,Real Estate,23500,14466,37966
C001045,N00012739,Ander Crenshaw (R),2012,Defense Electronics,0,29500,29500
C001045,N00012739,Ander Crenshaw (R),2012,Retired,27950,0,27950
C001045,N00012739,Ander Crenshaw (R),2012,Misc Manufacturing & Distributing,0,25000,25000
C001045,N00012739,Ander Crenshaw (R),2012,Lawyers/Law Firms,4000,13250,17250
C001045,N00012739,Ander Crenshaw (R),2012,Air Transport,0,14500,14500
C001045,N00012739,Ander Crenshaw (R),2012,Insurance,4500,9500,14000
C001045,N00012739,Ander Crenshaw (R),2012,Health Professionals,10450,3000,13450
C001045,N00012739,Ander Crenshaw (R),2012,Securities & Investment,10250,3000,13250
M001143,N00012942,Betty McCollum (D),2012,Casinos/Gambling,62100,4000,66100
M001143,N00012942,Betty McCollum (D),2012,Retired,64950,0,64950
M001143,N00012942,Betty McCollum (D),2012,Lawyers/Law Firms,27886,28657,56543
M001143,N00012942,Betty McCollum (D),2012,Health Professionals,8986,47000,55986
M001143,N00012942,Betty McCollum (D),2012,Industrial Unions,0,55250,55250
M001143,N00012942,Betty McCollum (D),2012,Public Sector Unions,0,49500,49500
M001143,N00012942,Betty McCollum (D),2012,Building Trade Unions,500,40500,41000
M001143,N00012942,Betty McCollum (D),2012,Transportation Unions,0,27000,27000
M001143,N00012942,Betty McCollum (D),2012,Women's Issues,20650,5000,25650
M001143,N00012942,Betty McCollum (D),2012,Real Estate,14600,9000,23600
C001046,N00013131,Eric Cantor (R),2012,Securities & Investment,852132,153000,1005132
C001046,N00013131,Eric Cantor (R),2012,Real Estate,321000,86000,407000
C001046,N00013131,Eric Cantor (R),2012,Insurance,174550,191600,366150
C001046,N00013131,Eric Cantor (R),2012,Retired,315157,0,315157
C001046,N00013131,Eric Cantor (R),2012,Health Professionals,70410,240900,311310
C001046,N00013131,Eric Cantor (R),2012,Lawyers/Law Firms,201781,69750,271531
C001046,N00013131,Eric Cantor (R),2012,Oil & Gas,76450,181000,257450
C001046,N00013131,Eric Cantor (R),2012,Pharmaceuticals/Health Products,81000,139800,220800
C001046,N00013131,Eric Cantor (R),2012,Pro-Israel,202210,9600,211810
C001046,N00013131,Eric Cantor (R),2012,Misc Finance,153850,31500,185350
G000546,N00013323,Sam Graves (R),2012,Air Transport,500,83200,83700
G000546,N00013323,Sam Graves (R),2012,Health Professionals,2500,60500,63000
G000546,N00013323,Sam Graves (R),2012,Automotive,27750,30000,57750
G000546,N00013323,Sam Graves (R),2012,Agricultural Services/Products,2000,49750,51750
G000546,N00013323,Sam Graves (R),2012,Trucking,7500,39488,46988
G000546,N00013323,Sam Graves (R),2012,General Contractors,18900,25499,44399
G000546,N00013323,Sam Graves (R),2012,Construction Services,0,38500,38500
G000546,N00013323,Sam Graves (R),2012,Crop Production & Basic Processing,6430,32000,38430
G000546,N00013323,Sam Graves (R),2012,Commercial Banks,2250,34700,36950
G000546,N00013323,Sam Graves (R),2012,Public Sector Unions,0,36500,36500
I000057,N00013345,Steve Israel (D),2012,Real Estate,233400,50175,283575
I000057,N00013345,Steve Israel (D),2012,Securities & Investment,175507,45500,221007
I000057,N00013345,Steve Israel (D),2012,Lawyers/Law Firms,137600,25473,163073
I000057,N00013345,Steve Israel (D),2012,Health Professionals,73000,69000,142000
I000057,N00013345,Steve Israel (D),2012,Public Sector Unions,0,95600,95600
I000057,N00013345,Steve Israel (D),2012,Business Services,89800,0,89800
I000057,N00013345,Steve Israel (D),2012,Misc Manufacturing & Distributing,66000,22000,88000
I000057,N00013345,Steve Israel (D),2012,Misc Finance,77050,3500,80550
I000057,N00013345,Steve Israel (D),2012,Pro-Israel,74800,3953,78753
I000057,N00013345,Steve Israel (D),2012,Insurance,26750,49000,75750
S001154,N00013770,Bill Shuster (R),2012,Construction Services,40150,70500,110650
S001154,N00013770,Bill Shuster (R),2012,Building Materials & Equipment,62550,38500,101050
S001154,N00013770,Bill Shuster (R),2012,Air Transport,6500,91000,97500
S001154,N00013770,Bill Shuster (R),2012,Oil & Gas,4400,91000,95400
S001154,N00013770,Bill Shuster (R),2012,General Contractors,64000,25721,89721
S001154,N00013770,Bill Shuster (R),2012,Lawyers/Law Firms,39662,31629,71291
S001154,N00013770,Bill Shuster (R),2012,Railroads,11495,59650,71145
S001154,N00013770,Bill Shuster (R),2012,Lobbyists,61672,2648,64320
S001154,N00013770,Bill Shuster (R),2012,Trucking,15000,43000,58000
S001154,N00013770,Bill Shuster (R),2012,Electric Utilities,2500,52000,54500
F000445,N00013799,Randy Forbes (R),2012,Retired,66008,0,66008
F000445,N00013799,Randy Forbes (R),2012,Misc Defense,25500,20500,46000
F000445,N00013799,Randy Forbes (R),2012,Defense Electronics,500,44000,44500
F000445,N00013799,Randy Forbes (R),2012,Defense Aerospace,300,43500,43800
F000445,N00013799,Randy Forbes (R),2012,Automotive,22000,10000,32000
F000445,N00013799,Randy Forbes (R),2012,General Contractors,25383,3000,28383
F000445,N00013799,Randy Forbes (R),2012,Real Estate,24300,4000,28300
F000445,N00013799,Randy Forbes (R),2012,Electric Utilities,15250,9500,24750
F000445,N00013799,Randy Forbes (R),2012,Commercial Banks,7450,17000,24450
F000445,N00013799,Randy Forbes (R),2012,Lawyers/Law Firms,16533,7250,23783
P000597,N00013817,Chellie Pingree (D),2012,Retired,109525,0,109525
P000597,N00013817,Chellie Pingree (D),2012,Securities & Investment,69150,0,69150
P000597,N00013817,Chellie Pingree (D),2012,Business Services,63250,0,63250
P000597,N00013817,Chellie Pingree (D),2012,Building Trade Unions,0,37500,37500
P000597,N00013817,Chellie Pingree (D),2012,Real Estate,23000,7000,30000
P000597,N00013817,Chellie Pingree (D),2012,Lawyers/Law Firms,23450,4500,27950
P000597,N00013817,Chellie Pingree (D),2012,Public Sector Unions,1500,23500,25000
P000597,N00013817,Chellie Pingree (D),2012,Environment,15500,7000,22500
P000597,N00013817,Chellie Pingree (D),2012,Construction Services,21715,0,21715
P000597,N00013817,Chellie Pingree (D),2012,Defense Aerospace,0,21000,21000
V000128,N00013820,Chris Van Hollen (D),2012,Lawyers/Law Firms,145887,43253,189140
V000128,N00013820,Chris Van Hollen (D),2012,Health Professionals,22112,108250,130362
V000128,N00013820,Chris Van Hollen (D),2012,Retired,107025,0,107025
V000128,N00013820,Chris Van Hollen (D),2012,Insurance,36783,55500,92283
V000128,N00013820,Chris Van Hollen (D),2012,Real Estate,50125,28800,78925
V000128,N00013820,Chris Van Hollen (D),2012,Public Sector Unions,500,75500,76000
V000128,N00013820,Chris Van Hollen (D),2012,Lobbyists,48650,2000,50650
V000128,N00013820,Chris Van Hollen (D),2012,Health Services/HMOs,3200,35700,38900
V000128,N00013820,Chris Van Hollen (D),2012,Business Services,30550,3000,33550
V000128,N00013820,Chris Van Hollen (D),2012,Defense Aerospace,0,31500,31500
P000590,N00013823,Mark Pryor (D),2012,Lawyers/Law Firms,643215,92022,735237
P000590,N00013823,Mark Pryor (D),2012,Securities & Investment,208150,71500,279650
P000590,N00013823,Mark Pryor (D),2012,Lobbyists,244415,15452,259867
P000590,N00013823,Mark Pryor (D),2012,Leadership PACs,2000,220249,222249
P000590,N00013823,Mark Pryor (D),2012,Real Estate,157000,26100,183100
P000590,N00013823,Mark Pryor (D),2012,Health Professionals,85195,82000,167195
P000590,N00013823,Mark Pryor (D),2012,Oil & Gas,90900,70000,160900
P000590,N00013823,Mark Pryor (D),2012,Insurance,37900,111000,148900
P000590,N00013823,Mark Pryor (D),2012,Telecom Services,48850,93600,142450
P000590,N00013823,Mark Pryor (D),2012,Pro-Israel,89300,52000,141300
M001144,N00013846,Jeff Miller (R),2012,Real Estate,60150,11000,71150
M001144,N00013846,Jeff Miller (R),2012,Defense Aerospace,1500,55500,57000
M001144,N00013846,Jeff Miller (R),2012,Defense Electronics,0,42500,42500
M001144,N00013846,Jeff Miller (R),2012,Health Professionals,9275,24500,33775
M001144,N00013846,Jeff Miller (R),2012,Electric Utilities,0,25750,25750
M001144,N00013846,Jeff Miller (R),2012,General Contractors,21500,3500,25000
M001144,N00013846,Jeff Miller (R),2012,Lawyers/Law Firms,10250,11500,21750
M001144,N00013846,Jeff Miller (R),2012,Leadership PACs,0,21500,21500
M001144,N00013846,Jeff Miller (R),2012,Education,14250,7250,21500
M001144,N00013846,Jeff Miller (R),2012,Crop Production & Basic Processing,0,17000,17000
L000562,N00013855,Stephen F Lynch (D),2012,Public Sector Unions,0,131000,131000
L000562,N00013855,Stephen F Lynch (D),2012,Building Trade Unions,0,69500,69500
L000562,N00013855,Stephen F Lynch (D),2012,Lawyers/Law Firms,32683,15250,47933
L000562,N00013855,Stephen F Lynch (D),2012,Securities & Investment,6750,35000,41750
L000562,N00013855,Stephen F Lynch (D),2012,Real Estate,23300,17500,40800
L000562,N00013855,Stephen F Lynch (D),2012,Industrial Unions,0,38000,38000
L000562,N00013855,Stephen F Lynch (D),2012,Insurance,3850,31500,35350
L000562,N00013855,Stephen F Lynch (D),2012,Transportation Unions,0,29500,29500
L000562,N00013855,Stephen F Lynch (D),2012,General Contractors,13300,5000,18300
L000562,N00013855,Stephen F Lynch (D),2012,Hospitals/Nursing Homes,12250,2000,14250
B001236,N00013873,John Boozman (R),2012,Retired,286426,0,286426
B001236,N00013873,John Boozman (R),2012,Health Professionals,195714,57000,252714
B001236,N00013873,John Boozman (R),2012,Securities & Investment,199829,15000,214829
B001236,N00013873,John Boozman (R),2012,Leadership PACs,0,213036,213036
B001236,N00013873,John Boozman (R),2012,Real Estate,87933,7500,95433
B001236,N00013873,John Boozman (R),2012,Oil & Gas,65202,28000,93202
B001236,N00013873,John Boozman (R),2012,Retail Sales,72900,19000,91900
B001236,N00013873,John Boozman (R),2012,Commercial Banks,58780,28500,87280
B001236,N00013873,John Boozman (R),2012,Lawyers/Law Firms,60941,20298,81239
B001236,N00013873,John Boozman (R),2012,Misc Finance,69803,7500,77303
N000127,N00021207,Rick Nolan (D),2012,Retired,137965,0,137965
N000127,N00021207,Rick Nolan (D),2012,Leadership PACs,0,94000,94000
N000127,N00021207,Rick Nolan (D),2012,Lawyers/Law Firms,73850,20110,93960
N000127,N00021207,Rick Nolan (D),2012,Public Sector Unions,250,58000,58250
N000127,N00021207,Rick Nolan (D),2012,Industrial Unions,5000,43500,48500
N000127,N00021207,Rick Nolan (D),2012,Candidate Committees,0,47583,47583
N000127,N00021207,Rick Nolan (D),2012,Transportation Unions,750,43000,43750
N000127,N00021207,Rick Nolan (D),2012,Real Estate,33450,0,33450
N000127,N00021207,Rick Nolan (D),2012,Democratic/Liberal,21350,8147,29497
N000127,N00021207,Rick Nolan (D),2012,Building Trade Unions,0,28500,28500
C001077,N00024753,Mike Coffman (R),2012,Leadership PACs,0,261341,261341
C001077,N00024753,Mike Coffman (R),2012,Retired,243365,0,243365
C001077,N00024753,Mike Coffman (R),2012,Oil & Gas,98725,92750,191475
C001077,N00024753,Mike Coffman (R),2012,Real Estate,125325,19000,144325
C001077,N00024753,Mike Coffman (R),2012,Lawyers/Law Firms,89903,8250,98153
C001077,N00024753,Mike Coffman (R),2012,Candidate Committees,0,72250,72250
C001077,N00024753,Mike Coffman (R),2012,Commercial Banks,41950,21500,63450
C001077,N00024753,Mike Coffman (R),2012,Securities & Investment,54834,5000,59834
C001077,N00024753,Mike Coffman (R),2012,Republican/Conservative,46735,13000,59735
C001077,N00024753,Mike Coffman (R),2012,Automotive,40675,19000,59675
R000575,N00024759,Mike D Rogers (R),2012,Health Professionals,40000,27500,67500
R000575,N00024759,Mike D Rogers (R),2012,Defense Aerospace,500,63500,64000
R000575,N00024759,Mike D Rogers (R),2012,Air Transport,1000,46000,47000
R000575,N00024759,Mike D Rogers (R),2012,Defense Electronics,3000,39500,42500
R000575,N00024759,Mike D Rogers (R),2012,Lawyers/Law Firms,16465,26000,42465
R000575,N00024759,Mike D Rogers (R),2012,Misc Defense,15200,20500,35700
R000575,N00024759,Mike D Rogers (R),2012,Electric Utilities,17000,17500,34500
R000575,N00024759,Mike D Rogers (R),2012,Insurance,9500,24500,34000
R000575,N00024759,Mike D Rogers (R),2012,Railroads,0,33000,33000
R000575,N00024759,Mike D Rogers (R),2012,Crop Production & Basic Processing,500,31500,32000
G000550,N00024760,Phil Gingrey (R),2012,Health Professionals,116700,193750,310450
G000550,N00024760,Phil Gingrey (R),2012,Pharmaceuticals/Health Products,8000,99000,107000
G000550,N00024760,Phil Gingrey (R),2012,Insurance,23750,35000,58750
G000550,N00024760,Phil Gingrey (R),2012,Retired,56450,0,56450
G000550,N00024760,Phil Gingrey (R),2012,Hospitals/Nursing Homes,36700,18500,55200
G000550,N00024760,Phil Gingrey (R),2012,Real Estate,37500,17000,54500
G000550,N00024760,Phil Gingrey (R),2012,Lawyers/Law Firms,30950,20750,51700
G000550,N00024760,Phil Gingrey (R),2012,Oil & Gas,5000,44500,49500
G000550,N00024760,Phil Gingrey (R),2012,Health Services/HMOs,9950,37900,47850
G000550,N00024760,Phil Gingrey (R),2012,Telephone Utilities,1250,43600,44850
M001149,N00024770,Mike Michaud (D),2012,Health Professionals,12125,72300,84425
M001149,N00024770,Mike Michaud (D),2012,Transportation Unions,0,77500,77500
M001149,N00024770,Mike Michaud (D),2012,Public Sector Unions,0,62250,62250
M001149,N00024770,Mike Michaud (D),2012,Industrial Unions,0,59500,59500
M001149,N00024770,Mike Michaud (D),2012,Lawyers/Law Firms,29825,22250,52075
M001149,N00024770,Mike Michaud (D),2012,Building Trade Unions,0,50000,50000
M001149,N00024770,Mike Michaud (D),2012,Forestry & Forest Products,12750,27500,40250
M001149,N00024770,Mike Michaud (D),2012,Insurance,1000,27000,28000
M001149,N00024770,Mike Michaud (D),2012,Real Estate,19250,8500,27750
M001149,N00024770,Mike Michaud (D),2012,Air Transport,0,27000,27000
S001181,N00024790,Jeanne Shaheen (D),2012,Women's Issues,932096,35358,967454
S001181,N00024790,Jeanne Shaheen (D),2012,Lawyers/Law Firms,649764,58266,708030
S001181,N00024790,Jeanne Shaheen (D),2012,Securities & Investment,390697,18900,409597
S001181,N00024790,Jeanne Shaheen (D),2012,Retired,408038,0,408038
S001181,N00024790,Jeanne Shaheen (D),2012,Leadership PACs,2100,382598,384698
S001181,N00024790,Jeanne Shaheen (D),2012,Real Estate,268431,23040,291471
S001181,N00024790,Jeanne Shaheen (D),2012,Democratic/Liberal,130759,91066,221825
S001181,N00024790,Jeanne Shaheen (D),2012,Lobbyists,211181,3000,214181
S001181,N00024790,Jeanne Shaheen (D),2012,Health Professionals,88897,120589,209486
S001181,N00024790,Jeanne Shaheen (D),2012,Education,191801,0,191801
W000795,N00024809,Joe Wilson (R),2012,Health Professionals,10250,41500,51750
W000795,N00024809,Joe Wilson (R),2012,Defense Aerospace,0,50500,50500
W000795,N00024809,Joe Wilson (R),2012,Insurance,14150,35000,49150
W000795,N00024809,Joe Wilson (R),2012,Misc Defense,23900,17000,40900
W000795,N00024809,Joe Wilson (R),2012,Lobbyists,35665,0,35665
W000795,N00024809,Joe Wilson (R),2012,Lawyers/Law Firms,17257,15866,33123
W000795,N00024809,Joe Wilson (R),2012,Electric Utilities,3750,21500,25250
W000795,N00024809,Joe Wilson (R),2012,Real Estate,15900,9000,24900
W000795,N00024809,Joe Wilson (R),2012,General Contractors,5250,15500,20750
W000795,N00024809,Joe Wilson (R),2012,Automotive,4500,15000,19500
C001069,N00024842,Joe Courtney (D),2012,Lawyers/Law Firms,93829,14250,108079
C001069,N00024842,Joe Courtney (D),2012,Health Professionals,12750,78800,91550
C001069,N00024842,Joe Courtney (D),2012,Retired,65312,0,65312
C001069,N00024842,Joe Courtney (D),2012,Defense Aerospace,6000,56500,62500
C001069,N00024842,Joe Courtney (D),2012,Real Estate,34650,22000,56650
C001069,N00024842,Joe Courtney (D),2012,Public Sector Unions,0,53500,53500
C001069,N00024842,Joe Courtney (D),2012,Securities & Investment,37900,7000,44900
C001069,N00024842,Joe Courtney (D),2012,Industrial Unions,0,44000,44000
C001069,N00024842,Joe Courtney (D),2012,Pharmaceuticals/Health Products,9050,33500,42550
C001069,N00024842,Joe Courtney (D),2012,Building Trade Unions,500,40000,40500
C001056,N00024852,John Cornyn (R),2012,Oil & Gas,912725,197700,1110425
C001056,N00024852,John Cornyn (R),2012,Lawyers/Law Firms,955406,146890,1102296
C001056,N00024852,John Cornyn (R),2012,Retired,1030308,0,1030308
C001056,N00024852,John Cornyn (R),2012,Health Professionals,669613,172050,841663
C001056,N00024852,John Cornyn (R),2012,Real Estate,693065,68310,761375
C001056,N00024852,John Cornyn (R),2012,Misc Finance,638846,37000,675846
C001056,N00024852,John Cornyn (R),2012,Securities & Investment,572745,97500,670245
C001056,N00024852,John Cornyn (R),2012,Insurance,296730,179114,475844
C001056,N00024852,John Cornyn (R),2012,Lobbyists,319892,9785,329677
C001056,N00024852,John Cornyn (R),2012,Pharmaceuticals/Health Products,120500,198496,318996
B001245,N00024866,Madeleine Z Bordallo (D),2012,Misc Defense,9950,3700,13650
B001245,N00024866,Madeleine Z Bordallo (D),2012,Retail Sales,12590,0,12590
B001245,N00024866,Madeleine Z Bordallo (D),2012,Food Processing & Sales,10650,0,10650
B001245,N00024866,Madeleine Z Bordallo (D),2012,Defense Aerospace,0,9500,9500
B001245,N00024866,Madeleine Z Bordallo (D),2012,Insurance,8350,0,8350
B001245,N00024866,Madeleine Z Bordallo (D),2012,Commercial Banks,8250,0,8250
B001245,N00024866,Madeleine Z Bordallo (D),2012,Misc Business,8050,0,8050
B001245,N00024866,Madeleine Z Bordallo (D),2012,Real Estate,5824,2000,7824
B001245,N00024866,Madeleine Z Bordallo (D),2012,Retired,7350,0,7350
B001245,N00024866,Madeleine Z Bordallo (D),2012,Misc Finance,5350,0,5350
S001156,N00024870,Linda Sanchez (D),2012,Leadership PACs,0,59500,59500
S001156,N00024870,Linda Sanchez (D),2012,Building Trade Unions,0,58500,58500
S001156,N00024870,Linda Sanchez (D),2012,Lawyers/Law Firms,23100,29750,52850
S001156,N00024870,Linda Sanchez (D),2012,Public Sector Unions,0,52500,52500
S001156,N00024870,Linda Sanchez (D),2012,Real Estate,23500,28500,52000
S001156,N00024870,Linda Sanchez (D),2012,Pharmaceuticals/Health Products,15000,36166,51166
S001156,N00024870,Linda Sanchez (D),2012,Health Professionals,10350,37900,48250
S001156,N00024870,Linda Sanchez (D),2012,Industrial Unions,0,46500,46500
S001156,N00024870,Linda Sanchez (D),2012,Lobbyists,44750,1000,45750
S001156,N00024870,Linda Sanchez (D),2012,Transportation Unions,0,39500,39500
S001157,N00024871,David Scott (D),2012,Health Professionals,19600,87500,107100
S001157,N00024871,David Scott (D),2012,Securities & Investment,9250,72500,81750
S001157,N00024871,David Scott (D),2012,Insurance,10000,67000,77000
S001157,N00024871,David Scott (D),2012,Commercial Banks,5000,62500,67500
S001157,N00024871,David Scott (D),2012,Accountants,2500,46860,49360
S001157,N00024871,David Scott (D),2012,Industrial Unions,0,35000,35000
S001157,N00024871,David Scott (D),2012,Transportation Unions,0,34000,34000
S001157,N00024871,David Scott (D),2012,Real Estate,8750,19500,28250
S001157,N00024871,David Scott (D),2012,Building Trade Unions,0,27000,27000
S001157,N00024871,David Scott (D),2012,Lawyers/Law Firms,10650,14500,25150
H001036,N00024922,Jeb Hensarling (R),2012,Securities & Investment,123250,188000,311250
H001036,N00024922,Jeb Hensarling (R),2012,Insurance,71897,227500,299397
H001036,N00024922,Jeb Hensarling (R),2012,Commercial Banks,66009,155500,221509
H001036,N00024922,Jeb Hensarling (R),2012,Oil & Gas,75800,76000,151800
H001036,N00024922,Jeb Hensarling (R),2012,Real Estate,58500,85000,143500
H001036,N00024922,Jeb Hensarling (R),2012,Misc Finance,120900,21500,142400
H001036,N00024922,Jeb Hensarling (R),2012,Health Professionals,32750,96500,129250
H001036,N00024922,Jeb Hensarling (R),2012,Finance/Credit Companies,26750,78150,104900
H001036,N00024922,Jeb Hensarling (R),2012,Lawyers/Law Firms,45800,57150,102950
H001036,N00024922,Jeb Hensarling (R),2012,Retired,102500,0,102500
C001063,N00024978,Henry Cuellar (D),2012,Oil & Gas,18375,78000,96375
C001063,N00024978,Henry Cuellar (D),2012,Health Professionals,44700,45500,90200
C001063,N00024978,Henry Cuellar (D),2012,Lawyers/Law Firms,54287,19000,73287
C001063,N00024978,Henry Cuellar (D),2012,Construction Services,50100,16250,66350
C001063,N00024978,Henry Cuellar (D),2012,Business Services,47150,6000,53150
C001063,N00024978,Henry Cuellar (D),2012,Crop Production & Basic Processing,9250,38000,47250
C001063,N00024978,Henry Cuellar (D),2012,Commercial Banks,16775,25000,41775
C001063,N00024978,Henry Cuellar (D),2012,Retail Sales,13200,25499,38699
C001063,N00024978,Henry Cuellar (D),2012,Agricultural Services/Products,0,37647,37647
C001063,N00024978,Henry Cuellar (D),2012,Insurance,11000,24500,35500
M001151,N00024992,Tim Murphy (R),2012,Health Professionals,21900,169500,191400
M001151,N00024992,Tim Murphy (R),2012,Oil & Gas,27700,107300,135000
M001151,N00024992,Tim Murphy (R),2012,Mining,74933,29500,104433
M001151,N00024992,Tim Murphy (R),2012,Electric Utilities,10000,86200,96200
M001151,N00024992,Tim Murphy (R),2012,Lawyers/Law Firms,48618,40500,89118
M001151,N00024992,Tim Murphy (R),2012,Pharmaceuticals/Health Products,6500,75000,81500
M001151,N00024992,Tim Murphy (R),2012,Special Trade Contractors,45850,23000,68850
M001151,N00024992,Tim Murphy (R),2012,Chemical & Related Manufacturing,15050,49500,64550
M001151,N00024992,Tim Murphy (R),2012,Steel Production,25050,38000,63050
M001151,N00024992,Tim Murphy (R),2012,Misc Manufacturing & Distributing,30375,26000,56375
G000549,N00025025,Jim Gerlach (R),2012,Insurance,33900,155778,189678
G000549,N00025025,Jim Gerlach (R),2012,Health Professionals,10500,151000,161500
G000549,N00025025,Jim Gerlach (R),2012,Pharmaceuticals/Health Products,25450,122500,147950
G000549,N00025025,Jim Gerlach (R),2012,Lawyers/Law Firms,63300,47250,110550
G000549,N00025025,Jim Gerlach (R),2012,Securities & Investment,35500,49500,85000
G000549,N00025025,Jim Gerlach (R),2012,Hospitals/Nursing Homes,27250,43245,70495
G000549,N00025025,Jim Gerlach (R),2012,Lobbyists,65199,1000,66199
G000549,N00025025,Jim Gerlach (R),2012,Electric Utilities,750,51500,52250
G000549,N00025025,Jim Gerlach (R),2012,Health Services/HMOs,11250,38500,49750
G000549,N00025025,Jim Gerlach (R),2012,Real Estate,11200,37500,48700
C001051,N00025095,John Carter (R),2012,Real Estate,52150,18000,70150
C001051,N00025095,John Carter (R),2012,Oil & Gas,11000,48800,59800
C001051,N00025095,John Carter (R),2012,Electronics Mfg & Equip,7250,32000,39250
C001051,N00025095,John Carter (R),2012,Defense Aerospace,500,36000,36500
C001051,N00025095,John Carter (R),2012,Health Professionals,25375,10000,35375
C001051,N00025095,John Carter (R),2012,Commercial Banks,15800,16000,31800
C001051,N00025095,John Carter (R),2012,Lawyers/Law Firms,21769,7000,28769
C001051,N00025095,John Carter (R),2012,Special Trade Contractors,28000,0,28000
C001051,N00025095,John Carter (R),2012,"Beer, Wine & Liquor",14000,13500,27500
C001051,N00025095,John Carter (R),2012,Retired,24500,0,24500
T000463,N00025175,Michael R Turner (R),2012,Real Estate,33750,27000,60750
T000463,N00025175,Michael R Turner (R),2012,Defense Electronics,12275,48000,60275
T000463,N00025175,Michael R Turner (R),2012,Misc Manufacturing & Distributing,48000,11000,59000
T000463,N00025175,Michael R Turner (R),2012,Defense Aerospace,5500,49000,54500
T000463,N00025175,Michael R Turner (R),2012,General Contractors,37950,11000,48950
T000463,N00025175,Michael R Turner (R),2012,Food Processing & Sales,48500,0,48500
T000463,N00025175,Michael R Turner (R),2012,Misc Defense,18000,27000,45000
T000463,N00025175,Michael R Turner (R),2012,Building Trade Unions,0,43500,43500
T000463,N00025175,Michael R Turner (R),2012,Retired,43400,0,43400
T000463,N00025175,Michael R Turner (R),2012,Lawyers/Law Firms,18000,18625,36625
B001248,N00025219,Michael Burgess (R),2012,Health Professionals,32388,259000,291388
B001248,N00025219,Michael Burgess (R),2012,Pharmaceuticals/Health Products,500,159750,160250
B001248,N00025219,Michael Burgess (R),2012,Health Services/HMOs,4500,69000,73500
B001248,N00025219,Michael Burgess (R),2012,Oil & Gas,3000,65000,68000
B001248,N00025219,Michael Burgess (R),2012,Hospitals/Nursing Homes,5750,32000,37750
B001248,N00025219,Michael Burgess (R),2012,Lobbyists,34594,0,34594
B001248,N00025219,Michael Burgess (R),2012,Lawyers/Law Firms,7550,23500,31050
B001248,N00025219,Michael Burgess (R),2012,Electric Utilities,500,30000,30500
B001248,N00025219,Michael Burgess (R),2012,Insurance,1200,23500,24700
B001248,N00025219,Michael Burgess (R),2012,Chemical & Related Manufacturing,5000,16000,21000
K000362,N00025237,Steven A King (R),2012,Republican/Conservative,304691,77000,381691
K000362,N00025237,Steven A King (R),2012,Retired,217199,0,217199
K000362,N00025237,Steven A King (R),2012,Crop Production & Basic Processing,120194,38250,158444
K000362,N00025237,Steven A King (R),2012,Misc Business,107745,0,107745
K000362,N00025237,Steven A King (R),2012,Agricultural Services/Products,48850,52300,101150
K000362,N00025237,Steven A King (R),2012,Health Professionals,59440,14000,73440
K000362,N00025237,Steven A King (R),2012,Leadership PACs,0,68388,68388
K000362,N00025237,Steven A King (R),2012,Insurance,28700,31500,60200
K000362,N00025237,Steven A King (R),2012,General Contractors,31240,12500,43740
K000362,N00025237,Steven A King (R),2012,Commercial Banks,29750,10000,39750
R000577,N00025280,Tim Ryan (D),2012,Lawyers/Law Firms,55400,34000,89400
R000577,N00025280,Tim Ryan (D),2012,Building Trade Unions,0,55000,55000
R000577,N00025280,Tim Ryan (D),2012,Industrial Unions,0,51000,51000
R000577,N00025280,Tim Ryan (D),2012,Public Sector Unions,0,47500,47500
R000577,N00025280,Tim Ryan (D),2012,Electric Utilities,400,38000,38400
R000577,N00025280,Tim Ryan (D),2012,Defense Aerospace,0,30500,30500
R000577,N00025280,Tim Ryan (D),2012,Lobbyists,24000,5000,29000
R000577,N00025280,Tim Ryan (D),2012,Transportation Unions,0,28000,28000
R000577,N00025280,Tim Ryan (D),2012,Chemical & Related Manufacturing,12000,14500,26500
R000577,N00025280,Tim Ryan (D),2012,Misc Unions,0,21000,21000
G000551,N00025284,Raul M Grijalva (D),2012,Public Sector Unions,1745,51500,53245
G000551,N00025284,Raul M Grijalva (D),2012,Casinos/Gambling,52900,41,52941
G000551,N00025284,Raul M Grijalva (D),2012,Retired,49500,0,49500
G000551,N00025284,Raul M Grijalva (D),2012,Industrial Unions,0,38000,38000
G000551,N00025284,Raul M Grijalva (D),2012,Misc Unions,0,32000,32000
G000551,N00025284,Raul M Grijalva (D),2012,Lawyers/Law Firms,20950,10500,31450
G000551,N00025284,Raul M Grijalva (D),2012,Lobbyists,30750,0,30750
G000551,N00025284,Raul M Grijalva (D),2012,Building Trade Unions,0,29500,29500
G000551,N00025284,Raul M Grijalva (D),2012,Transportation Unions,0,29000,29000
G000551,N00025284,Raul M Grijalva (D),2012,Candidate Committees,0,22500,22500
B001250,N00025292,Rob Bishop (R),2012,Oil & Gas,4000,50000,54000
B001250,N00025292,Rob Bishop (R),2012,Defense Aerospace,0,20000,20000
B001250,N00025292,Rob Bishop (R),2012,Lobbyists,19250,0,19250
B001250,N00025292,Rob Bishop (R),2012,Real Estate,8500,10000,18500
B001250,N00025292,Rob Bishop (R),2012,Mining,0,18000,18000
B001250,N00025292,Rob Bishop (R),2012,Insurance,8750,7000,15750
B001250,N00025292,Rob Bishop (R),2012,Misc Manufacturing & Distributing,0,15000,15000
B001250,N00025292,Rob Bishop (R),2012,Electronics Mfg & Equip,14000,0,14000
B001250,N00025292,Rob Bishop (R),2012,Leadership PACs,0,12000,12000
B001250,N00025292,Rob Bishop (R),2012,Livestock,2250,8500,10750
B001244,N00025330,Jo Bonner (R),2012,Real Estate,58000,8000,66000
B001244,N00025330,Jo Bonner (R),2012,Health Professionals,31125,33500,64625
B001244,N00025330,Jo Bonner (R),2012,Lawyers/Law Firms,31200,30000,61200
B001244,N00025330,Jo Bonner (R),2012,Leadership PACs,0,52000,52000
B001244,N00025330,Jo Bonner (R),2012,Retired,50300,0,50300
B001244,N00025330,Jo Bonner (R),2012,Defense Aerospace,1350,45500,46850
B001244,N00025330,Jo Bonner (R),2012,Lobbyists,30850,0,30850
B001244,N00025330,Jo Bonner (R),2012,Insurance,7250,22000,29250
B001244,N00025330,Jo Bonner (R),2012,Education,25250,0,25250
B001244,N00025330,Jo Bonner (R),2012,Commercial Banks,10000,14000,24000
D000600,N00025337,Mario Diaz-Balart (R),2012,Building Trade Unions,0,50500,50500
D000600,N00025337,Mario Diaz-Balart (R),2012,Health Professionals,43000,5500,48500
D000600,N00025337,Mario Diaz-Balart (R),2012,Real Estate,22700,21500,44200
D000600,N00025337,Mario Diaz-Balart (R),2012,Pro-Israel,31750,9750,41500
D000600,N00025337,Mario Diaz-Balart (R),2012,Lawyers/Law Firms,23000,13250,36250
D000600,N00025337,Mario Diaz-Balart (R),2012,Transportation Unions,0,28000,28000
D000600,N00025337,Mario Diaz-Balart (R),2012,Railroads,1000,26000,27000
D000600,N00025337,Mario Diaz-Balart (R),2012,Automotive,22500,4000,26500
D000600,N00025337,Mario Diaz-Balart (R),2012,Commercial Banks,5000,18500,23500
D000600,N00025337,Mario Diaz-Balart (R),2012,Air Transport,1000,21500,22500
B001242,N00025413,Timothy H Bishop (D),2012,Retired,183675,0,183675
B001242,N00025413,Timothy H Bishop (D),2012,Leadership PACs,2500,154134,156634
B001242,N00025413,Timothy H Bishop (D),2012,Lawyers/Law Firms,107149,19750,126899
B001242,N00025413,Timothy H Bishop (D),2012,Transportation Unions,0,108500,108500
B001242,N00025413,Timothy H Bishop (D),2012,Securities & Investment,86846,14000,100846
B001242,N00025413,Timothy H Bishop (D),2012,Health Professionals,36900,59500,96400
B001242,N00025413,Timothy H Bishop (D),2012,Public Sector Unions,250,88600,88850
B001242,N00025413,Timothy H Bishop (D),2012,Education,73861,4750,78611
B001242,N00025413,Timothy H Bishop (D),2012,Candidate Committees,0,74000,74000
B001242,N00025413,Timothy H Bishop (D),2012,Building Trade Unions,0,60650,60650
A000361,N00025464,Rodney Alexander (R),2012,Oil & Gas,31638,41000,72638
A000361,N00025464,Rodney Alexander (R),2012,Health Professionals,47000,23000,70000
A000361,N00025464,Rodney Alexander (R),2012,Crop Production & Basic Processing,36950,32500,69450
A000361,N00025464,Rodney Alexander (R),2012,Lawyers/Law Firms,37133,25750,62883
A000361,N00025464,Rodney Alexander (R),2012,Hospitals/Nursing Homes,45516,16000,61516
A000361,N00025464,Rodney Alexander (R),2012,Lobbyists,55448,1979,57427
A000361,N00025464,Rodney Alexander (R),2012,General Contractors,33890,16000,49890
A000361,N00025464,Rodney Alexander (R),2012,Commercial Banks,25750,20500,46250
A000361,N00025464,Rodney Alexander (R),2012,Real Estate,33106,8000,41106
A000361,N00025464,Rodney Alexander (R),2012,Retired,38900,0,38900
R000576,N00025482,Dutch Ruppersberger (D),2012,Real Estate,86500,18000,104500
R000576,N00025482,Dutch Ruppersberger (D),2012,Defense Aerospace,22900,76600,99500
R000576,N00025482,Dutch Ruppersberger (D),2012,Defense Electronics,1250,74500,75750
R000576,N00025482,Dutch Ruppersberger (D),2012,Misc Defense,13600,61500,75100
R000576,N00025482,Dutch Ruppersberger (D),2012,Health Professionals,8250,48200,56450
R000576,N00025482,Dutch Ruppersberger (D),2012,Lawyers/Law Firms,31550,21204,52754
R000576,N00025482,Dutch Ruppersberger (D),2012,Electronics Mfg & Equip,11750,36250,48000
R000576,N00025482,Dutch Ruppersberger (D),2012,Electric Utilities,35000,13000,48000
R000576,N00025482,Dutch Ruppersberger (D),2012,Public Sector Unions,0,46250,46250
R000576,N00025482,Dutch Ruppersberger (D),2012,Industrial Unions,0,45000,45000
B001269,N00025495,Lou Barletta (R),2012,Leadership PACs,0,90187,90187
B001269,N00025495,Lou Barletta (R),2012,Railroads,14125,36265,50390
B001269,N00025495,Lou Barletta (R),2012,Health Professionals,25000,16000,41000
B001269,N00025495,Lou Barletta (R),2012,Retired,40730,0,40730
B001269,N00025495,Lou Barletta (R),2012,Oil & Gas,3050,32500,35550
B001269,N00025495,Lou Barletta (R),2012,Insurance,5050,29500,34550
B001269,N00025495,Lou Barletta (R),2012,Securities & Investment,23444,9000,32444
B001269,N00025495,Lou Barletta (R),2012,Air Transport,0,31499,31499
B001269,N00025495,Lou Barletta (R),2012,General Contractors,13850,17000,30850
B001269,N00025495,Lou Barletta (R),2012,Construction Services,12425,17000,29425
C001053,N00025726,Tom Cole (R),2012,Oil & Gas,49200,67000,116200
C001053,N00025726,Tom Cole (R),2012,Human Rights,101690,6000,107690
C001053,N00025726,Tom Cole (R),2012,Defense Aerospace,250,47000,47250
C001053,N00025726,Tom Cole (R),2012,Misc Finance,42850,0,42850
C001053,N00025726,Tom Cole (R),2012,Commercial Banks,25750,12500,38250
C001053,N00025726,Tom Cole (R),2012,Lobbyists,34642,1000,35642
C001053,N00025726,Tom Cole (R),2012,Electric Utilities,2000,28500,30500
C001053,N00025726,Tom Cole (R),2012,Retired,30250,0,30250
C001053,N00025726,Tom Cole (R),2012,Real Estate,12550,17000,29550
C001053,N00025726,Tom Cole (R),2012,Lawyers/Law Firms,13200,13250,26450
H001050,N00025881,Colleen Hanabusa (D),2012,Lawyers/Law Firms,65400,17000,82400
H001050,N00025881,Colleen Hanabusa (D),2012,Real Estate,56960,19000,75960
H001050,N00025881,Colleen Hanabusa (D),2012,Retired,73400,0,73400
H001050,N00025881,Colleen Hanabusa (D),2012,Building Trade Unions,4000,69000,73000
H001050,N00025881,Colleen Hanabusa (D),2012,Transportation Unions,1400,54500,55900
H001050,N00025881,Colleen Hanabusa (D),2012,Defense Aerospace,8300,46000,54300
H001050,N00025881,Colleen Hanabusa (D),2012,Sea Transport,18000,28500,46500
H001050,N00025881,Colleen Hanabusa (D),2012,General Contractors,41150,0,41150
H001050,N00025881,Colleen Hanabusa (D),2012,Public Sector Unions,0,41000,41000
H001050,N00025881,Colleen Hanabusa (D),2012,Health Professionals,17050,15000,32050
C001062,N00026041,Mike Conaway (R),2012,Oil & Gas,110300,50500,160800
C001062,N00026041,Mike Conaway (R),2012,Crop Production & Basic Processing,46700,103250,149950
C001062,N00026041,Mike Conaway (R),2012,Securities & Investment,22250,61000,83250
C001062,N00026041,Mike Conaway (R),2012,Accountants,17500,43499,60999
C001062,N00026041,Mike Conaway (R),2012,Livestock,41200,18500,59700
C001062,N00026041,Mike Conaway (R),2012,Retired,54175,0,54175
C001062,N00026041,Mike Conaway (R),2012,Agricultural Services/Products,750,52147,52897
C001062,N00026041,Mike Conaway (R),2012,Defense Aerospace,0,47500,47500
C001062,N00026041,Mike Conaway (R),2012,Lawyers/Law Firms,18049,15500,33549
C001062,N00026041,Mike Conaway (R),2012,Health Professionals,17850,11500,29350
N000182,N00026043,Randy Neugebauer (R),2012,Commercial Banks,40701,96000,136701
N000182,N00026043,Randy Neugebauer (R),2012,Insurance,16450,112500,128950
N000182,N00026043,Randy Neugebauer (R),2012,Securities & Investment,11000,114500,125500
N000182,N00026043,Randy Neugebauer (R),2012,Real Estate,32300,64500,96800
N000182,N00026043,Randy Neugebauer (R),2012,Oil & Gas,73000,23500,96500
N000182,N00026043,Randy Neugebauer (R),2012,Finance/Credit Companies,20500,48150,68650
N000182,N00026043,Randy Neugebauer (R),2012,Misc Finance,44001,12000,56001
N000182,N00026043,Randy Neugebauer (R),2012,Livestock,35500,18500,54000
N000182,N00026043,Randy Neugebauer (R),2012,Crop Production & Basic Processing,8750,43500,52250
N000182,N00026043,Randy Neugebauer (R),2012,Accountants,6202,44324,50526
M001153,N00026050,Lisa Murkowski (R),2012,Electric Utilities,87346,398250,485596
M001153,N00026050,Lisa Murkowski (R),2012,Oil & Gas,174785,265550,440335
M001153,N00026050,Lisa Murkowski (R),2012,Lobbyists,357197,6500,363697
M001153,N00026050,Lisa Murkowski (R),2012,Lawyers/Law Firms,105997,103750,209747
M001153,N00026050,Lisa Murkowski (R),2012,Leadership PACs,0,203500,203500
M001153,N00026050,Lisa Murkowski (R),2012,Real Estate,112644,32500,145144
M001153,N00026050,Lisa Murkowski (R),2012,Health Professionals,71208,58733,129941
M001153,N00026050,Lisa Murkowski (R),2012,Retired,112491,0,112491
M001153,N00026050,Lisa Murkowski (R),2012,Food & Beverage,49250,62600,111850
M001153,N00026050,Lisa Murkowski (R),2012,Misc Energy,25450,81368,106818
B001252,N00026080,John Barrow (D),2012,Lawyers/Law Firms,369680,51755,421435
B001252,N00026080,John Barrow (D),2012,Health Professionals,29500,148500,178000
B001252,N00026080,John Barrow (D),2012,Leadership PACs,500,136500,137000
B001252,N00026080,John Barrow (D),2012,Oil & Gas,10000,97400,107400
B001252,N00026080,John Barrow (D),2012,Insurance,6250,89500,95750
B001252,N00026080,John Barrow (D),2012,Electric Utilities,14979,80750,95729
B001252,N00026080,John Barrow (D),2012,Pharmaceuticals/Health Products,1000,91000,92000
B001252,N00026080,John Barrow (D),2012,Lobbyists,72690,5000,77690
B001252,N00026080,John Barrow (D),2012,Health Services/HMOs,9400,62000,71400
B001252,N00026080,John Barrow (D),2012,Candidate Committees,0,70000,70000
W000797,N00026106,Debbie Wasserman Schultz (D),2012,Lawyers/Law Firms,313160,29000,342160
W000797,N00026106,Debbie Wasserman Schultz (D),2012,Retired,177850,0,177850
W000797,N00026106,Debbie Wasserman Schultz (D),2012,Health Professionals,122950,39000,161950
W000797,N00026106,Debbie Wasserman Schultz (D),2012,Real Estate,116476,15000,131476
W000797,N00026106,Debbie Wasserman Schultz (D),2012,Pro-Israel,85750,19500,105250
W000797,N00026106,Debbie Wasserman Schultz (D),2012,Securities & Investment,90500,11500,102000
W000797,N00026106,Debbie Wasserman Schultz (D),2012,Public Sector Unions,250,80000,80250
W000797,N00026106,Debbie Wasserman Schultz (D),2012,"Beer, Wine & Liquor",36000,31000,67000
W000797,N00026106,Debbie Wasserman Schultz (D),2012,Business Services,61950,0,61950
W000797,N00026106,Debbie Wasserman Schultz (D),2012,Commercial Banks,10500,45500,56000
G000552,N00026148,Louis B Gohmert Jr (R),2012,Retired,105250,0,105250
G000552,N00026148,Louis B Gohmert Jr (R),2012,Health Professionals,54237,1500,55737
G000552,N00026148,Louis B Gohmert Jr (R),2012,Oil & Gas,38950,16500,55450
G000552,N00026148,Louis B Gohmert Jr (R),2012,Commercial Banks,34250,1000,35250
G000552,N00026148,Louis B Gohmert Jr (R),2012,Real Estate,21750,3000,24750
G000552,N00026148,Louis B Gohmert Jr (R),2012,Misc Finance,23000,0,23000
G000552,N00026148,Louis B Gohmert Jr (R),2012,Lawyers/Law Firms,20500,0,20500
G000552,N00026148,Louis B Gohmert Jr (R),2012,Construction Services,14750,0,14750
G000552,N00026148,Louis B Gohmert Jr (R),2012,Forestry & Forest Products,3250,11000,14250
G000552,N00026148,Louis B Gohmert Jr (R),2012,Food Processing & Sales,11500,2000,13500
P000591,N00026160,Tom Price (R),2012,Health Professionals,247557,215500,463057
P000591,N00026160,Tom Price (R),2012,Insurance,37100,124000,161100
P000591,N00026160,Tom Price (R),2012,Health Services/HMOs,23150,93200,116350
P000591,N00026160,Tom Price (R),2012,Real Estate,57500,52000,109500
P000591,N00026160,Tom Price (R),2012,Securities & Investment,25850,53000,78850
P000591,N00026160,Tom Price (R),2012,Retired,74050,0,74050
P000591,N00026160,Tom Price (R),2012,Pharmaceuticals/Health Products,3200,68150,71350
P000591,N00026160,Tom Price (R),2012,Hospitals/Nursing Homes,23550,46000,69550
P000591,N00026160,Tom Price (R),2012,Electronics Mfg & Equip,13201,35750,48951
P000591,N00026160,Tom Price (R),2012,Lawyers/Law Firms,20900,21000,41900
W000796,N00026163,Lynn A Westmoreland (R),2012,Real Estate,49000,47900,96900
W000796,N00026163,Lynn A Westmoreland (R),2012,Insurance,5250,68435,73685
W000796,N00026163,Lynn A Westmoreland (R),2012,Commercial Banks,5550,52750,58300
W000796,N00026163,Lynn A Westmoreland (R),2012,Food & Beverage,17750,20500,38250
W000796,N00026163,Lynn A Westmoreland (R),2012,Securities & Investment,2500,34000,36500
W000796,N00026163,Lynn A Westmoreland (R),2012,Retired,29125,0,29125
W000796,N00026163,Lynn A Westmoreland (R),2012,Finance/Credit Companies,0,29000,29000
W000796,N00026163,Lynn A Westmoreland (R),2012,Misc Issues,27475,145,27620
W000796,N00026163,Lynn A Westmoreland (R),2012,Health Professionals,8000,18500,26500
W000796,N00026163,Lynn A Westmoreland (R),2012,Leadership PACs,0,24921,24921
F000450,N00026166,Virginia Foxx (R),2012,Retired,129619,0,129619
F000450,N00026166,Virginia Foxx (R),2012,Education,27984,34084,62068
F000450,N00026166,Virginia Foxx (R),2012,Real Estate,25245,7569,32814
F000450,N00026166,Virginia Foxx (R),2012,Misc Manufacturing & Distributing,13840,11000,24840
F000450,N00026166,Virginia Foxx (R),2012,Lawyers/Law Firms,13140,11500,24640
F000450,N00026166,Virginia Foxx (R),2012,"Beer, Wine & Liquor",16250,7500,23750
F000450,N00026166,Virginia Foxx (R),2012,Food & Beverage,8230,14500,22730
F000450,N00026166,Virginia Foxx (R),2012,Health Professionals,18558,4000,22558
F000450,N00026166,Virginia Foxx (R),2012,Human Rights,10750,10000,20750
F000450,N00026166,Virginia Foxx (R),2012,Pharmaceuticals/Health Products,8000,10000,18000
D000604,N00026171,Charlie Dent (R),2012,Health Professionals,23750,97500,121250
D000604,N00026171,Charlie Dent (R),2012,Retired,106000,0,106000
D000604,N00026171,Charlie Dent (R),2012,Pharmaceuticals/Health Products,11406,69500,80906
D000604,N00026171,Charlie Dent (R),2012,Electric Utilities,36600,44000,80600
D000604,N00026171,Charlie Dent (R),2012,Chemical & Related Manufacturing,17500,44500,62000
D000604,N00026171,Charlie Dent (R),2012,Real Estate,46350,15000,61350
D000604,N00026171,Charlie Dent (R),2012,Lawyers/Law Firms,41000,17650,58650
D000604,N00026171,Charlie Dent (R),2012,Misc Manufacturing & Distributing,39000,18000,57000
D000604,N00026171,Charlie Dent (R),2012,Oil & Gas,6000,44500,50500
D000604,N00026171,Charlie Dent (R),2012,Automotive,33750,14500,48250
M001159,N00026314,Cathy McMorris Rodgers (R),2012,Health Professionals,22920,135250,158170
M001159,N00026314,Cathy McMorris Rodgers (R),2012,Retired,74670,0,74670
M001159,N00026314,Cathy McMorris Rodgers (R),2012,Real Estate,45950,19500,65450
M001159,N00026314,Cathy McMorris Rodgers (R),2012,Forestry & Forest Products,32924,31500,64424
M001159,N00026314,Cathy McMorris Rodgers (R),2012,Telecom Services,20000,43500,63500
M001159,N00026314,Cathy McMorris Rodgers (R),2012,Pharmaceuticals/Health Products,1500,59750,61250
M001159,N00026314,Cathy McMorris Rodgers (R),2012,Insurance,3250,56500,59750
M001159,N00026314,Cathy McMorris Rodgers (R),2012,Lobbyists,47736,1200,48936
M001159,N00026314,Cathy McMorris Rodgers (R),2012,Retail Sales,15140,31000,46140
M001159,N00026314,Cathy McMorris Rodgers (R),2012,Securities & Investment,28000,17500,45500
W000806,N00026335,Daniel Webster (R),2012,Real Estate,110350,24510,134860
W000806,N00026335,Daniel Webster (R),2012,Leadership PACs,0,95276,95276
W000806,N00026335,Daniel Webster (R),2012,Health Professionals,47630,23500,71130
W000806,N00026335,Daniel Webster (R),2012,Retired,69707,0,69707
W000806,N00026335,Daniel Webster (R),2012,Insurance,51500,17000,68500
W000806,N00026335,Daniel Webster (R),2012,Lawyers/Law Firms,45007,20964,65971
W000806,N00026335,Daniel Webster (R),2012,Food & Beverage,11250,42000,53250
W000806,N00026335,Daniel Webster (R),2012,Crop Production & Basic Processing,30950,9000,39950
W000806,N00026335,Daniel Webster (R),2012,General Contractors,23200,11500,34700
W000806,N00026335,Daniel Webster (R),2012,Misc Manufacturing & Distributing,17750,13500,31250
C001059,N00026341,Jim Costa (D),2012,Crop Production & Basic Processing,103475,85871,189346
C001059,N00026341,Jim Costa (D),2012,Oil & Gas,1000,78750,79750
C001059,N00026341,Jim Costa (D),2012,Real Estate,52550,10000,62550
C001059,N00026341,Jim Costa (D),2012,Health Professionals,52950,8000,60950
C001059,N00026341,Jim Costa (D),2012,Agricultural Services/Products,8000,44000,52000
C001059,N00026341,Jim Costa (D),2012,Dairy,19049,27000,46049
C001059,N00026341,Jim Costa (D),2012,Lawyers/Law Firms,34000,10750,44750
C001059,N00026341,Jim Costa (D),2012,Food Processing & Sales,19450,23771,43221
C001059,N00026341,Jim Costa (D),2012,Livestock,21100,18000,39100
C001059,N00026341,Jim Costa (D),2012,Building Trade Unions,0,39000,39000
W000798,N00026368,Tim Walberg (R),2012,Retired,104570,0,104570
W000798,N00026368,Tim Walberg (R),2012,Leadership PACs,0,82425,82425
W000798,N00026368,Tim Walberg (R),2012,Misc Manufacturing & Distributing,49150,16518,65668
W000798,N00026368,Tim Walberg (R),2012,Health Professionals,35447,22500,57947
W000798,N00026368,Tim Walberg (R),2012,Real Estate,41842,16000,57842
W000798,N00026368,Tim Walberg (R),2012,Insurance,21200,31000,52200
W000798,N00026368,Tim Walberg (R),2012,Automotive,23950,21500,45450
W000798,N00026368,Tim Walberg (R),2012,Trucking,42900,2000,44900
W000798,N00026368,Tim Walberg (R),2012,Republican/Conservative,35800,6500,42300
W000798,N00026368,Tim Walberg (R),2012,Securities & Investment,28900,8000,36900
P000592,N00026457,Ted Poe (R),2012,Oil & Gas,33100,45500,78600
P000592,N00026457,Ted Poe (R),2012,Health Professionals,37800,18500,56300
P000592,N00026457,Ted Poe (R),2012,Lawyers/Law Firms,26550,27227,53777
P000592,N00026457,Ted Poe (R),2012,Retired,43000,0,43000
P000592,N00026457,Ted Poe (R),2012,Real Estate,27612,10500,38112
P000592,N00026457,Ted Poe (R),2012,Construction Services,20750,4000,24750
P000592,N00026457,Ted Poe (R),2012,Crop Production & Basic Processing,0,24000,24000
P000592,N00026457,Ted Poe (R),2012,General Contractors,21250,2500,23750
P000592,N00026457,Ted Poe (R),2012,Misc Business,19350,1000,20350
P000592,N00026457,Ted Poe (R),2012,Lobbyists,19755,500,20255
M001157,N00026460,Michael McCaul (R),2012,Electronics Mfg & Equip,14500,71788,86288
M001157,N00026460,Michael McCaul (R),2012,Oil & Gas,14750,48500,63250
M001157,N00026460,Michael McCaul (R),2012,Real Estate,51200,11000,62200
M001157,N00026460,Michael McCaul (R),2012,Retired,61700,0,61700
M001157,N00026460,Michael McCaul (R),2012,Lawyers/Law Firms,21685,28250,49935
M001157,N00026460,Michael McCaul (R),2012,Defense Aerospace,250,39000,39250
M001157,N00026460,Michael McCaul (R),2012,Business Services,25327,12000,37327
M001157,N00026460,Michael McCaul (R),2012,Commercial Banks,23254,14000,37254
M001157,N00026460,Michael McCaul (R),2012,TV/Movies/Music,30000,6000,36000
M001157,N00026460,Michael McCaul (R),2012,Misc Finance,32699,0,32699
D000607,N00026586,Joe Donnelly (D),2012,Lawyers/Law Firms,600913,25500,626413
D000607,N00026586,Joe Donnelly (D),2012,Leadership PACs,2750,347750,350500
D000607,N00026586,Joe Donnelly (D),2012,Retired,277418,0,277418
D000607,N00026586,Joe Donnelly (D),2012,Securities & Investment,167955,26500,194455
D000607,N00026586,Joe Donnelly (D),2012,Lobbyists,122490,21000,143490
D000607,N00026586,Joe Donnelly (D),2012,Education,132713,1000,133713
D000607,N00026586,Joe Donnelly (D),2012,Real Estate,98218,24000,122218
D000607,N00026586,Joe Donnelly (D),2012,Pharmaceuticals/Health Products,44862,56421,101283
D000607,N00026586,Joe Donnelly (D),2012,Candidate Committees,0,96798,96798
D000607,N00026586,Joe Donnelly (D),2012,Building Trade Unions,3190,86000,89190
B001255,N00026595,Charles W Boustany Jr (R),2012,Health Professionals,186225,309100,495325
B001255,N00026595,Charles W Boustany Jr (R),2012,Oil & Gas,154200,141750,295950
B001255,N00026595,Charles W Boustany Jr (R),2012,Insurance,45350,241700,287050
B001255,N00026595,Charles W Boustany Jr (R),2012,Health Services/HMOs,61400,142000,203400
B001255,N00026595,Charles W Boustany Jr (R),2012,Lobbyists,155784,4167,159951
B001255,N00026595,Charles W Boustany Jr (R),2012,Lawyers/Law Firms,85425,62720,148145
B001255,N00026595,Charles W Boustany Jr (R),2012,Hospitals/Nursing Homes,40820,100500,141320
B001255,N00026595,Charles W Boustany Jr (R),2012,Pharmaceuticals/Health Products,5000,127805,132805
B001255,N00026595,Charles W Boustany Jr (R),2012,Securities & Investment,33750,94500,128250
B001255,N00026595,Charles W Boustany Jr (R),2012,Leadership PACs,0,102000,102000
M001156,N00026627,Patrick McHenry (R),2012,Finance/Credit Companies,35750,65999,101749
M001156,N00026627,Patrick McHenry (R),2012,Securities & Investment,18500,67000,85500
M001156,N00026627,Patrick McHenry (R),2012,Insurance,3250,81000,84250
M001156,N00026627,Patrick McHenry (R),2012,Commercial Banks,15500,62500,78000
M001156,N00026627,Patrick McHenry (R),2012,Health Professionals,37800,22000,59800
M001156,N00026627,Patrick McHenry (R),2012,Real Estate,19000,34500,53500
M001156,N00026627,Patrick McHenry (R),2012,Accountants,2000,42500,44500
M001156,N00026627,Patrick McHenry (R),2012,Retired,43336,0,43336
M001156,N00026627,Patrick McHenry (R),2012,Retail Sales,11250,21500,32750
M001156,N00026627,Patrick McHenry (R),2012,Hospitals/Nursing Homes,6000,25500,31500
F000449,N00026631,Jeff Fortenberry (R),2012,Health Professionals,42617,13500,56117
F000449,N00026631,Jeff Fortenberry (R),2012,Commercial Banks,10451,27000,37451
F000449,N00026631,Jeff Fortenberry (R),2012,Insurance,10400,23500,33900
F000449,N00026631,Jeff Fortenberry (R),2012,Crop Production & Basic Processing,6100,25500,31600
F000449,N00026631,Jeff Fortenberry (R),2012,Republican/Conservative,10850,18000,28850
F000449,N00026631,Jeff Fortenberry (R),2012,Retired,27800,0,27800
F000449,N00026631,Jeff Fortenberry (R),2012,Agricultural Services/Products,7750,15750,23500
F000449,N00026631,Jeff Fortenberry (R),2012,Lawyers/Law Firms,17250,5000,22250
F000449,N00026631,Jeff Fortenberry (R),2012,Electric Utilities,500,17000,17500
F000449,N00026631,Jeff Fortenberry (R),2012,Real Estate,7730,8500,16230
G000553,N00026686,Al Green (D),2012,Lawyers/Law Firms,44339,14250,58589
G000553,N00026686,Al Green (D),2012,Building Trade Unions,0,32500,32500
G000553,N00026686,Al Green (D),2012,Industrial Unions,0,30000,30000
G000553,N00026686,Al Green (D),2012,Real Estate,7850,19000,26850
G000553,N00026686,Al Green (D),2012,Commercial Banks,5300,14500,19800
G000553,N00026686,Al Green (D),2012,Securities & Investment,6500,5500,12000
G000553,N00026686,Al Green (D),2012,Public Sector Unions,0,10000,10000
G000553,N00026686,Al Green (D),2012,Oil & Gas,5100,3000,8100
G000553,N00026686,Al Green (D),2012,Lobbyists,7100,0,7100
G000553,N00026686,Al Green (D),2012,Transportation Unions,0,6000,6000
M001158,N00026710,Kenny Marchant (R),2012,Insurance,500,72712,73212
M001158,N00026710,Kenny Marchant (R),2012,Oil & Gas,8500,56000,64500
M001158,N00026710,Kenny Marchant (R),2012,Commercial Banks,9250,41000,50250
M001158,N00026710,Kenny Marchant (R),2012,Health Professionals,23500,21000,44500
M001158,N00026710,Kenny Marchant (R),2012,Real Estate,8250,29500,37750
M001158,N00026710,Kenny Marchant (R),2012,Securities & Investment,13000,24500,37500
M001158,N00026710,Kenny Marchant (R),2012,Leadership PACs,0,32500,32500
M001158,N00026710,Kenny Marchant (R),2012,Misc Issues,28250,100,28350
M001158,N00026710,Kenny Marchant (R),2012,Air Transport,3450,22000,25450
M001158,N00026710,Kenny Marchant (R),2012,Credit Unions,10350,15000,25350
C001061,N00026790,Emanuel Cleaver (D),2012,Lawyers/Law Firms,52950,40250,93200
C001061,N00026790,Emanuel Cleaver (D),2012,Building Trade Unions,5000,59500,64500
C001061,N00026790,Emanuel Cleaver (D),2012,Insurance,3050,52000,55050
C001061,N00026790,Emanuel Cleaver (D),2012,Securities & Investment,7000,44750,51750
C001061,N00026790,Emanuel Cleaver (D),2012,Industrial Unions,0,51500,51500
C001061,N00026790,Emanuel Cleaver (D),2012,Public Sector Unions,500,48000,48500
C001061,N00026790,Emanuel Cleaver (D),2012,Commercial Banks,1750,41000,42750
C001061,N00026790,Emanuel Cleaver (D),2012,Real Estate,8900,26500,35400
C001061,N00026790,Emanuel Cleaver (D),2012,Accountants,1500,32938,34438
C001061,N00026790,Emanuel Cleaver (D),2012,Misc Unions,0,30000,30000
R000578,N00026885,Dave Reichert (R),2012,Retired,131210,0,131210
R000578,N00026885,Dave Reichert (R),2012,Insurance,6250,98000,104250
R000578,N00026885,Dave Reichert (R),2012,Health Professionals,22825,65500,88325
R000578,N00026885,Dave Reichert (R),2012,Real Estate,49500,35500,85000
R000578,N00026885,Dave Reichert (R),2012,Securities & Investment,35684,24500,60184
R000578,N00026885,Dave Reichert (R),2012,Electronics Mfg & Equip,45750,13500,59250
R000578,N00026885,Dave Reichert (R),2012,Leadership PACs,0,48193,48193
R000578,N00026885,Dave Reichert (R),2012,Pharmaceuticals/Health Products,3500,38517,42017
R000578,N00026885,Dave Reichert (R),2012,General Contractors,23250,17500,40750
R000578,N00026885,Dave Reichert (R),2012,Business Services,27146,12500,39646
M001160,N00026914,Gwen Moore (D),2012,Insurance,2750,104350,107100
M001160,N00026914,Gwen Moore (D),2012,Securities & Investment,7400,61500,68900
M001160,N00026914,Gwen Moore (D),2012,Public Sector Unions,1950,47300,49250
M001160,N00026914,Gwen Moore (D),2012,Industrial Unions,0,47500,47500
M001160,N00026914,Gwen Moore (D),2012,Building Trade Unions,0,40000,40000
M001160,N00026914,Gwen Moore (D),2012,Commercial Banks,4000,35500,39500
M001160,N00026914,Gwen Moore (D),2012,Health Professionals,6500,25000,31500
M001160,N00026914,Gwen Moore (D),2012,Accountants,500,28813,29313
M001160,N00026914,Gwen Moore (D),2012,Retired,25800,0,25800
M001160,N00026914,Gwen Moore (D),2012,Education,24100,0,24100
M001166,N00026926,Jerry McNerney (D),2012,Retired,186637,0,186637
M001166,N00026926,Jerry McNerney (D),2012,Lawyers/Law Firms,157375,22750,180125
M001166,N00026926,Jerry McNerney (D),2012,Leadership PACs,500,135792,136292
M001166,N00026926,Jerry McNerney (D),2012,Public Sector Unions,0,76750,76750
M001166,N00026926,Jerry McNerney (D),2012,Building Trade Unions,0,76500,76500
M001166,N00026926,Jerry McNerney (D),2012,Education,74750,0,74750
M001166,N00026926,Jerry McNerney (D),2012,Candidate Committees,0,73500,73500
M001166,N00026926,Jerry McNerney (D),2012,Health Professionals,33019,32400,65419
M001166,N00026926,Jerry McNerney (D),2012,Democratic/Liberal,57650,6172,63822
M001166,N00026926,Jerry McNerney (D),2012,Electronics Mfg & Equip,48600,8500,57100
C001067,N00026961,Yvette D Clarke (D),2012,Building Trade Unions,0,53100,53100
C001067,N00026961,Yvette D Clarke (D),2012,Public Sector Unions,200,41600,41800
C001067,N00026961,Yvette D Clarke (D),2012,Health Professionals,28022,8500,36522
C001067,N00026961,Yvette D Clarke (D),2012,Electronics Mfg & Equip,0,25500,25500
C001067,N00026961,Yvette D Clarke (D),2012,Securities & Investment,11900,11000,22900
C001067,N00026961,Yvette D Clarke (D),2012,Industrial Unions,0,20000,20000
C001067,N00026961,Yvette D Clarke (D),2012,Insurance,7450,12500,19950
C001067,N00026961,Yvette D Clarke (D),2012,Transportation Unions,0,19500,19500
C001067,N00026961,Yvette D Clarke (D),2012,Lawyers/Law Firms,9600,8000,17600
C001067,N00026961,Yvette D Clarke (D),2012,Telephone Utilities,0,17000,17000
B001251,N00027035,G K Butterfield (D),2012,Pharmaceuticals/Health Products,1850,62500,64350
B001251,N00027035,G K Butterfield (D),2012,Health Professionals,33350,30300,63650
B001251,N00027035,G K Butterfield (D),2012,Electric Utilities,7500,36250,43750
B001251,N00027035,G K Butterfield (D),2012,Lawyers/Law Firms,15318,24032,39350
B001251,N00027035,G K Butterfield (D),2012,Telephone Utilities,0,29000,29000
B001251,N00027035,G K Butterfield (D),2012,TV/Movies/Music,0,26500,26500
B001251,N00027035,G K Butterfield (D),2012,Telecom Services,0,23500,23500
B001251,N00027035,G K Butterfield (D),2012,Industrial Unions,0,23500,23500
B001251,N00027035,G K Butterfield (D),2012,Public Sector Unions,0,23192,23192
B001251,N00027035,G K Butterfield (D),2012,Retired,22025,0,22025
H001038,N00027060,Brian M Higgins (D),2012,Lawyers/Law Firms,83790,12500,96290
H001038,N00027060,Brian M Higgins (D),2012,Public Sector Unions,500,63500,64000
H001038,N00027060,Brian M Higgins (D),2012,Industrial Unions,0,47750,47750
H001038,N00027060,Brian M Higgins (D),2012,Transportation Unions,250,46500,46750
H001038,N00027060,Brian M Higgins (D),2012,Real Estate,23149,14000,37149
H001038,N00027060,Brian M Higgins (D),2012,Building Trade Unions,0,35500,35500
H001038,N00027060,Brian M Higgins (D),2012,Securities & Investment,28000,1000,29000
H001038,N00027060,Brian M Higgins (D),2012,Health Professionals,18750,8500,27250
H001038,N00027060,Brian M Higgins (D),2012,Misc Manufacturing & Distributing,7750,19500,27250
H001038,N00027060,Brian M Higgins (D),2012,Special Trade Contractors,26000,0,26000
F000451,N00027229,Michael G Fitzpatrick (R),2012,Lawyers/Law Firms,114267,31625,145892
F000451,N00027229,Michael G Fitzpatrick (R),2012,Insurance,38200,97500,135700
F000451,N00027229,Michael G Fitzpatrick (R),2012,Securities & Investment,84700,49400,134100
F000451,N00027229,Michael G Fitzpatrick (R),2012,Leadership PACs,0,133550,133550
F000451,N00027229,Michael G Fitzpatrick (R),2012,Construction Services,78100,15500,93600
F000451,N00027229,Michael G Fitzpatrick (R),2012,Commercial Banks,23400,60000,83400
F000451,N00027229,Michael G Fitzpatrick (R),2012,Real Estate,21650,55000,76650
F000451,N00027229,Michael G Fitzpatrick (R),2012,Republican/Conservative,37050,36500,73550
F000451,N00027229,Michael G Fitzpatrick (R),2012,Retired,72912,0,72912
F000451,N00027229,Michael G Fitzpatrick (R),2012,Health Professionals,23326,44000,67326
L000563,N00027239,Daniel Lipinski (D),2012,Construction Services,30250,39000,69250
L000563,N00027239,Daniel Lipinski (D),2012,Transportation Unions,500,67500,68000
L000563,N00027239,Daniel Lipinski (D),2012,Building Trade Unions,0,61000,61000
L000563,N00027239,Daniel Lipinski (D),2012,Railroads,9950,44500,54450
L000563,N00027239,Daniel Lipinski (D),2012,Air Transport,0,49999,49999
L000563,N00027239,Daniel Lipinski (D),2012,Lawyers/Law Firms,24633,14500,39133
L000563,N00027239,Daniel Lipinski (D),2012,Industrial Unions,300,22500,22800
L000563,N00027239,Daniel Lipinski (D),2012,Lobbyists,19600,2000,21600
L000563,N00027239,Daniel Lipinski (D),2012,Building Materials & Equipment,3500,18000,21500
L000563,N00027239,Daniel Lipinski (D),2012,Business Services,19000,0,19000
C001071,N00027441,Bob Corker (R),2012,Securities & Investment,946334,234070,1180404
C001071,N00027441,Bob Corker (R),2012,Real Estate,652970,118100,771070
C001071,N00027441,Bob Corker (R),2012,Insurance,229213,352550,581763
C001071,N00027441,Bob Corker (R),2012,Retired,557495,0,557495
C001071,N00027441,Bob Corker (R),2012,Lawyers/Law Firms,422123,118870,540993
C001071,N00027441,Bob Corker (R),2012,Health Professionals,414763,109500,524263
C001071,N00027441,Bob Corker (R),2012,Misc Finance,442463,38500,480963
C001071,N00027441,Bob Corker (R),2012,Commercial Banks,274990,186800,461790
C001071,N00027441,Bob Corker (R),2012,Lobbyists,306694,8265,314959
C001071,N00027441,Bob Corker (R),2012,Oil & Gas,152928,156500,309428
M001163,N00027459,Doris O Matsui (D),2012,Telecom Services,3000,61750,64750
M001163,N00027459,Doris O Matsui (D),2012,Lawyers/Law Firms,25150,36500,61650
M001163,N00027459,Doris O Matsui (D),2012,Pharmaceuticals/Health Products,0,55200,55200
M001163,N00027459,Doris O Matsui (D),2012,Health Professionals,2000,46700,48700
M001163,N00027459,Doris O Matsui (D),2012,Electronics Mfg & Equip,6623,41000,47623
M001163,N00027459,Doris O Matsui (D),2012,Insurance,2900,41900,44800
M001163,N00027459,Doris O Matsui (D),2012,Lobbyists,33693,3000,36693
M001163,N00027459,Doris O Matsui (D),2012,Telephone Utilities,0,31120,31120
M001163,N00027459,Doris O Matsui (D),2012,Public Sector Unions,0,29450,29450
M001163,N00027459,Doris O Matsui (D),2012,Retired,27900,0,27900
B001257,N00027462,Gus Bilirakis (R),2012,Health Professionals,40015,27500,67515
B001257,N00027462,Gus Bilirakis (R),2012,Retired,41800,0,41800
B001257,N00027462,Gus Bilirakis (R),2012,Food & Beverage,7000,25500,32500
B001257,N00027462,Gus Bilirakis (R),2012,Real Estate,11199,20000,31199
B001257,N00027462,Gus Bilirakis (R),2012,Insurance,7200,19500,26700
B001257,N00027462,Gus Bilirakis (R),2012,Lawyers/Law Firms,17900,7750,25650
B001257,N00027462,Gus Bilirakis (R),2012,Misc Manufacturing & Distributing,16964,5000,21964
B001257,N00027462,Gus Bilirakis (R),2012,Health Services/HMOs,10000,9000,19000
B001257,N00027462,Gus Bilirakis (R),2012,TV/Movies/Music,10245,5500,15745
B001257,N00027462,Gus Bilirakis (R),2012,Oil & Gas,14500,0,14500
B001259,N00027464,Bruce Braley (D),2012,Lawyers/Law Firms,956931,32497,989428
B001259,N00027464,Bruce Braley (D),2012,Health Professionals,23400,97500,120900
B001259,N00027464,Bruce Braley (D),2012,Public Sector Unions,0,95500,95500
B001259,N00027464,Bruce Braley (D),2012,Leadership PACs,0,83500,83500
B001259,N00027464,Bruce Braley (D),2012,Pharmaceuticals/Health Products,27250,34884,62134
B001259,N00027464,Bruce Braley (D),2012,Building Trade Unions,250,58000,58250
B001259,N00027464,Bruce Braley (D),2012,Retired,57320,0,57320
B001259,N00027464,Bruce Braley (D),2012,Industrial Unions,650,55000,55650
B001259,N00027464,Bruce Braley (D),2012,Real Estate,22163,12500,34663
B001259,N00027464,Bruce Braley (D),2012,Lobbyists,29626,0,29626
W000799,N00027467,Tim Walz (D),2012,Retired,166113,0,166113
W000799,N00027467,Tim Walz (D),2012,Lawyers/Law Firms,92358,34786,127144
W000799,N00027467,Tim Walz (D),2012,Leadership PACs,500,100500,101000
W000799,N00027467,Tim Walz (D),2012,Crop Production & Basic Processing,7700,45250,52950
W000799,N00027467,Tim Walz (D),2012,Health Professionals,18300,34250,52550
W000799,N00027467,Tim Walz (D),2012,Hospitals/Nursing Homes,38100,13000,51100
W000799,N00027467,Tim Walz (D),2012,Building Trade Unions,1225,49500,50725
W000799,N00027467,Tim Walz (D),2012,Public Sector Unions,250,47200,47450
W000799,N00027467,Tim Walz (D),2012,Real Estate,35200,7030,42230
W000799,N00027467,Tim Walz (D),2012,Candidate Committees,0,41000,41000
B001256,N00027493,Michele Bachmann (R),2012,Retired,895856,0,895856
B001256,N00027493,Michele Bachmann (R),2012,Republican/Conservative,530331,55350,585681
B001256,N00027493,Michele Bachmann (R),2012,Health Professionals,93869,1500,95369
B001256,N00027493,Michele Bachmann (R),2012,Real Estate,73352,10010,83362
B001256,N00027493,Michele Bachmann (R),2012,Misc Finance,73700,2000,75700
B001256,N00027493,Michele Bachmann (R),2012,Securities & Investment,61925,0,61925
B001256,N00027493,Michele Bachmann (R),2012,General Contractors,55750,0,55750
B001256,N00027493,Michele Bachmann (R),2012,Oil & Gas,37723,17500,55223
B001256,N00027493,Michele Bachmann (R),2012,Misc Business,51452,0,51452
B001256,N00027493,Michele Bachmann (R),2012,Abortion Policy/Anti-Abortion,25742,23166,48908
K000367,N00027500,Amy Klobuchar (D),2012,Lawyers/Law Firms,861329,177083,1038412
K000367,N00027500,Amy Klobuchar (D),2012,Retired,483906,0,483906
K000367,N00027500,Amy Klobuchar (D),2012,Securities & Investment,289866,38000,327866
K000367,N00027500,Amy Klobuchar (D),2012,Leadership PACs,0,320677,320677
K000367,N00027500,Amy Klobuchar (D),2012,Lobbyists,288830,21100,309930
K000367,N00027500,Amy Klobuchar (D),2012,Women's Issues,204566,20000,224566
K000367,N00027500,Amy Klobuchar (D),2012,TV/Movies/Music,160611,52500,213111
K000367,N00027500,Amy Klobuchar (D),2012,Retail Sales,125433,68500,193933
K000367,N00027500,Amy Klobuchar (D),2012,Real Estate,152016,27500,179516
K000367,N00027500,Amy Klobuchar (D),2012,Pharmaceuticals/Health Products,80325,99150,179475
C001070,N00027503,Bob Casey (D),2012,Lawyers/Law Firms,1868910,226952,2095862
C001070,N00027503,Bob Casey (D),2012,Securities & Investment,321362,123500,444862
C001070,N00027503,Bob Casey (D),2012,Real Estate,327158,65500,392658
C001070,N00027503,Bob Casey (D),2012,Lobbyists,376241,8800,385041
C001070,N00027503,Bob Casey (D),2012,Health Professionals,219785,149000,368785
C001070,N00027503,Bob Casey (D),2012,Retired,352271,0,352271
C001070,N00027503,Bob Casey (D),2012,Pharmaceuticals/Health Products,118300,233830,352130
C001070,N00027503,Bob Casey (D),2012,Hospitals/Nursing Homes,204797,94750,299547
C001070,N00027503,Bob Casey (D),2012,Insurance,141800,126750,268550
C001070,N00027503,Bob Casey (D),2012,Leadership PACs,1000,258364,259364
T000470,N00027509,Scott Tipton (R),2012,Retired,272172,0,272172
T000470,N00027509,Scott Tipton (R),2012,Oil & Gas,74274,74000,148274
T000470,N00027509,Scott Tipton (R),2012,Leadership PACs,0,143250,143250
T000470,N00027509,Scott Tipton (R),2012,Real Estate,105709,17500,123209
T000470,N00027509,Scott Tipton (R),2012,Lawyers/Law Firms,64326,11547,75873
T000470,N00027509,Scott Tipton (R),2012,Misc Finance,54600,0,54600
T000470,N00027509,Scott Tipton (R),2012,Livestock,43000,10500,53500
T000470,N00027509,Scott Tipton (R),2012,Securities & Investment,48000,5000,53000
T000470,N00027509,Scott Tipton (R),2012,Health Professionals,31350,17000,48350
T000470,N00027509,Scott Tipton (R),2012,General Contractors,31898,13000,44898
P000593,N00027510,Edwin G Perlmutter (D),2012,Lawyers/Law Firms,200789,40500,241289
P000593,N00027510,Edwin G Perlmutter (D),2012,Real Estate,65411,97325,162736
P000593,N00027510,Edwin G Perlmutter (D),2012,Retired,159950,0,159950
P000593,N00027510,Edwin G Perlmutter (D),2012,Insurance,3950,136500,140450
P000593,N00027510,Edwin G Perlmutter (D),2012,Securities & Investment,24700,101500,126200
P000593,N00027510,Edwin G Perlmutter (D),2012,Commercial Banks,46157,79500,125657
P000593,N00027510,Edwin G Perlmutter (D),2012,Health Professionals,51800,68000,119800
P000593,N00027510,Edwin G Perlmutter (D),2012,Leadership PACs,0,105500,105500
P000593,N00027510,Edwin G Perlmutter (D),2012,Public Sector Unions,1000,86000,87000
P000593,N00027510,Edwin G Perlmutter (D),2012,Finance/Credit Companies,11450,65000,76450
C001066,N00027514,Kathy Castor (D),2012,Lawyers/Law Firms,79175,25000,104175
C001066,N00027514,Kathy Castor (D),2012,Health Professionals,22300,65300,87600
C001066,N00027514,Kathy Castor (D),2012,Public Sector Unions,0,42000,42000
C001066,N00027514,Kathy Castor (D),2012,Building Trade Unions,0,37500,37500
C001066,N00027514,Kathy Castor (D),2012,Hospitals/Nursing Homes,14650,22000,36650
C001066,N00027514,Kathy Castor (D),2012,Retired,35550,0,35550
C001066,N00027514,Kathy Castor (D),2012,Pro-Israel,11750,12500,24250
C001066,N00027514,Kathy Castor (D),2012,Insurance,10300,11000,21300
C001066,N00027514,Kathy Castor (D),2012,Industrial Unions,0,21000,21000
C001066,N00027514,Kathy Castor (D),2012,Tobacco,17000,3000,20000
H001041,N00027522,Dean Heller (R),2012,Retired,517342,0,517342
H001041,N00027522,Dean Heller (R),2012,Leadership PACs,500,433092,433592
H001041,N00027522,Dean Heller (R),2012,Securities & Investment,320865,74500,395365
H001041,N00027522,Dean Heller (R),2012,Insurance,82405,181500,263905
H001041,N00027522,Dean Heller (R),2012,Real Estate,237990,25500,263490
H001041,N00027522,Dean Heller (R),2012,Mining,162775,99825,262600
H001041,N00027522,Dean Heller (R),2012,Oil & Gas,105700,145750,251450
H001041,N00027522,Dean Heller (R),2012,Casinos/Gambling,171132,73500,244632
H001041,N00027522,Dean Heller (R),2012,Health Professionals,124934,98500,223434
H001041,N00027522,Dean Heller (R),2012,Lobbyists,175312,9000,184312
S001165,N00027523,Albio Sires (D),2012,Education,63700,0,63700
S001165,N00027523,Albio Sires (D),2012,Lawyers/Law Firms,37100,11000,48100
S001165,N00027523,Albio Sires (D),2012,Transportation Unions,0,45500,45500
S001165,N00027523,Albio Sires (D),2012,Public Sector Unions,0,32500,32500
S001165,N00027523,Albio Sires (D),2012,Real Estate,17300,8000,25300
S001165,N00027523,Albio Sires (D),2012,Telephone Utilities,1000,19000,20000
S001165,N00027523,Albio Sires (D),2012,Lobbyists,15750,3000,18750
S001165,N00027523,Albio Sires (D),2012,Building Trade Unions,0,18500,18500
S001165,N00027523,Albio Sires (D),2012,Securities & Investment,10000,7500,17500
S001165,N00027523,Albio Sires (D),2012,Civil Servants/Public Officials,17250,0,17250
W000802,N00027533,Sheldon Whitehouse (D),2012,Lawyers/Law Firms,646233,109480,755713
W000802,N00027533,Sheldon Whitehouse (D),2012,Securities & Investment,373041,16000,389041
W000802,N00027533,Sheldon Whitehouse (D),2012,Leadership PACs,0,316500,316500
W000802,N00027533,Sheldon Whitehouse (D),2012,Lobbyists,244121,4600,248721
W000802,N00027533,Sheldon Whitehouse (D),2012,Retired,235377,0,235377
W000802,N00027533,Sheldon Whitehouse (D),2012,TV/Movies/Music,174417,48000,222417
W000802,N00027533,Sheldon Whitehouse (D),2012,Real Estate,151037,31000,182037
W000802,N00027533,Sheldon Whitehouse (D),2012,Health Professionals,37983,102000,139983
W000802,N00027533,Sheldon Whitehouse (D),2012,Pro-Israel,71850,42500,114350
W000802,N00027533,Sheldon Whitehouse (D),2012,Misc Finance,98216,9000,107216
C001064,N00027565,John Campbell (R),2012,Real Estate,75489,66850,142339
C001064,N00027565,John Campbell (R),2012,Insurance,3750,101000,104750
C001064,N00027565,John Campbell (R),2012,Automotive,57000,34500,91500
C001064,N00027565,John Campbell (R),2012,Securities & Investment,18550,65500,84050
C001064,N00027565,John Campbell (R),2012,Retired,62177,0,62177
C001064,N00027565,John Campbell (R),2012,Accountants,750,58500,59250
C001064,N00027565,John Campbell (R),2012,Misc Issues,44000,7000,51000
C001064,N00027565,John Campbell (R),2012,Commercial Banks,4500,39500,44000
C001064,N00027565,John Campbell (R),2012,Pharmaceuticals/Health Products,2500,36500,39000
C001064,N00027565,John Campbell (R),2012,Misc Finance,16280,17000,33280
M001169,N00027566,Christopher S Murphy (D),2012,Retired,1002417,0,1002417
M001169,N00027566,Christopher S Murphy (D),2012,Lawyers/Law Firms,827008,49500,876508
M001169,N00027566,Christopher S Murphy (D),2012,Securities & Investment,569320,66500,635820
M001169,N00027566,Christopher S Murphy (D),2012,Real Estate,270466,57000,327466
M001169,N00027566,Christopher S Murphy (D),2012,Leadership PACs,15000,287500,302500
M001169,N00027566,Christopher S Murphy (D),2012,Insurance,117525,179500,297025
M001169,N00027566,Christopher S Murphy (D),2012,Health Professionals,155040,129910,284950
M001169,N00027566,Christopher S Murphy (D),2012,Democratic/Liberal,143271,124247,267518
M001169,N00027566,Christopher S Murphy (D),2012,Lobbyists,240459,7000,247459
M001169,N00027566,Christopher S Murphy (D),2012,Business Services,224750,13000,237750
T000464,N00027605,Jon Tester (D),2012,Lawyers/Law Firms,1238150,167871,1406021
T000464,N00027605,Jon Tester (D),2012,Retired,810906,0,810906
T000464,N00027605,Jon Tester (D),2012,Securities & Investment,543566,155500,699066
T000464,N00027605,Jon Tester (D),2012,Lobbyists,584826,17605,602431
T000464,N00027605,Jon Tester (D),2012,Leadership PACs,15750,408000,423750
T000464,N00027605,Jon Tester (D),2012,Real Estate,291834,72820,364654
T000464,N00027605,Jon Tester (D),2012,Commercial Banks,172818,164350,337168
T000464,N00027605,Jon Tester (D),2012,Health Professionals,155273,123400,278673
T000464,N00027605,Jon Tester (D),2012,Environment,248221,20814,269035
T000464,N00027605,Jon Tester (D),2012,Insurance,70633,192959,263592
S001172,N00027623,Adrian Smith (R),2012,Insurance,26017,73228,99245
S001172,N00027623,Adrian Smith (R),2012,Health Professionals,19750,61500,81250
S001172,N00027623,Adrian Smith (R),2012,Commercial Banks,19700,45500,65200
S001172,N00027623,Adrian Smith (R),2012,Agricultural Services/Products,5250,45650,50900
S001172,N00027623,Adrian Smith (R),2012,Real Estate,11750,32000,43750
S001172,N00027623,Adrian Smith (R),2012,Securities & Investment,22000,21500,43500
S001172,N00027623,Adrian Smith (R),2012,Crop Production & Basic Processing,6300,35000,41300
S001172,N00027623,Adrian Smith (R),2012,Accountants,5519,31000,36519
S001172,N00027623,Adrian Smith (R),2012,Lawyers/Law Firms,14250,17750,32000
S001172,N00027623,Adrian Smith (R),2012,Leadership PACs,0,30230,30230
B001260,N00027626,Vernon Buchanan (R),2012,Health Professionals,150195,116000,266195
B001260,N00027626,Vernon Buchanan (R),2012,Retired,172950,0,172950
B001260,N00027626,Vernon Buchanan (R),2012,Real Estate,94850,15000,109850
B001260,N00027626,Vernon Buchanan (R),2012,Insurance,44200,56000,100200
B001260,N00027626,Vernon Buchanan (R),2012,Leadership PACs,0,96500,96500
B001260,N00027626,Vernon Buchanan (R),2012,Food & Beverage,62050,30000,92050
B001260,N00027626,Vernon Buchanan (R),2012,General Contractors,65300,4500,69800
B001260,N00027626,Vernon Buchanan (R),2012,Pharmaceuticals/Health Products,53500,8150,61650
B001260,N00027626,Vernon Buchanan (R),2012,Hospitals/Nursing Homes,26400,34500,60900
B001260,N00027626,Vernon Buchanan (R),2012,Lobbyists,49250,4000,53250
H001057,N00027649,Tim Huelskamp (R),2012,Crop Production & Basic Processing,26759,41050,67809
H001057,N00027649,Tim Huelskamp (R),2012,Oil & Gas,46550,15000,61550
H001057,N00027649,Tim Huelskamp (R),2012,Health Professionals,15630,28000,43630
H001057,N00027649,Tim Huelskamp (R),2012,Agricultural Services/Products,2500,31500,34000
H001057,N00027649,Tim Huelskamp (R),2012,Leadership PACs,0,23886,23886
H001057,N00027649,Tim Huelskamp (R),2012,Railroads,11750,10000,21750
H001057,N00027649,Tim Huelskamp (R),2012,Commercial Banks,4550,17000,21550
H001057,N00027649,Tim Huelskamp (R),2012,Livestock,4750,16700,21450
H001057,N00027649,Tim Huelskamp (R),2012,Retired,20250,0,20250
H001057,N00027649,Tim Huelskamp (R),2012,Dairy,2500,17500,20000
G000555,N00027658,Kirsten Gillibrand (D),2012,Lawyers/Law Firms,3915999,305442,4221441
G000555,N00027658,Kirsten Gillibrand (D),2012,Securities & Investment,2840598,290800,3131398
G000555,N00027658,Kirsten Gillibrand (D),2012,Real Estate,1242502,117000,1359502
G000555,N00027658,Kirsten Gillibrand (D),2012,Women's Issues,968246,27500,995746
G000555,N00027658,Kirsten Gillibrand (D),2012,Retired,935633,0,935633
G000555,N00027658,Kirsten Gillibrand (D),2012,Lobbyists,747472,33674,781146
G000555,N00027658,Kirsten Gillibrand (D),2012,TV/Movies/Music,682267,74000,756267
G000555,N00027658,Kirsten Gillibrand (D),2012,Business Services,606203,45400,651603
G000555,N00027658,Kirsten Gillibrand (D),2012,Misc Finance,587853,14000,601853
G000555,N00027658,Kirsten Gillibrand (D),2012,Insurance,292350,288216,580566
M001170,N00027694,Claire McCaskill (D),2012,Lawyers/Law Firms,2329732,172023,2501755
M001170,N00027694,Claire McCaskill (D),2012,Retired,1324217,0,1324217
M001170,N00027694,Claire McCaskill (D),2012,Women's Issues,1172915,26500,1199415
M001170,N00027694,Claire McCaskill (D),2012,Securities & Investment,535934,35000,570934
M001170,N00027694,Claire McCaskill (D),2012,Education,404780,0,404780
M001170,N00027694,Claire McCaskill (D),2012,Real Estate,356714,43500,400214
M001170,N00027694,Claire McCaskill (D),2012,Business Services,327378,31525,358903
M001170,N00027694,Claire McCaskill (D),2012,Leadership PACs,0,356000,356000
M001170,N00027694,Claire McCaskill (D),2012,TV/Movies/Music,293934,61750,355684
M001170,N00027694,Claire McCaskill (D),2012,Health Professionals,263677,68500,332177
L000565,N00027741,David Loebsack (D),2012,Leadership PACs,0,111500,111500
L000565,N00027741,David Loebsack (D),2012,Health Professionals,12450,65800,78250
L000565,N00027741,David Loebsack (D),2012,Public Sector Unions,500,76500,77000
L000565,N00027741,David Loebsack (D),2012,Education,60900,10000,70900
L000565,N00027741,David Loebsack (D),2012,Lawyers/Law Firms,60020,9500,69520
L000565,N00027741,David Loebsack (D),2012,Building Trade Unions,250,64000,64250
L000565,N00027741,David Loebsack (D),2012,Candidate Committees,0,60500,60500
L000565,N00027741,David Loebsack (D),2012,Retired,58750,0,58750
L000565,N00027741,David Loebsack (D),2012,Industrial Unions,1000,48000,49000
L000565,N00027741,David Loebsack (D),2012,Hospitals/Nursing Homes,16975,28000,44975
S001168,N00027751,John Sarbanes (D),2012,Lawyers/Law Firms,150250,-5000,145250
S001168,N00027751,John Sarbanes (D),2012,Retired,124150,0,124150
S001168,N00027751,John Sarbanes (D),2012,Real Estate,77000,10,77010
S001168,N00027751,John Sarbanes (D),2012,Securities & Investment,76000,0,76000
S001168,N00027751,John Sarbanes (D),2012,Education,53050,0,53050
S001168,N00027751,John Sarbanes (D),2012,Health Professionals,37590,0,37590
S001168,N00027751,John Sarbanes (D),2012,Business Services,30000,0,30000
S001168,N00027751,John Sarbanes (D),2012,Printing & Publishing,29000,0,29000
S001168,N00027751,John Sarbanes (D),2012,General Contractors,23500,0,23500
S001168,N00027751,John Sarbanes (D),2012,Misc Manufacturing & Distributing,23000,0,23000
J000288,N00027848,Hank Johnson (D),2012,Industrial Unions,0,31500,31500
J000288,N00027848,Hank Johnson (D),2012,Lawyers/Law Firms,12550,17750,30300
J000288,N00027848,Hank Johnson (D),2012,Building Trade Unions,0,30050,30050
J000288,N00027848,Hank Johnson (D),2012,Transportation Unions,0,23000,23000
J000288,N00027848,Hank Johnson (D),2012,Defense Aerospace,0,22000,22000
J000288,N00027848,Hank Johnson (D),2012,Insurance,250,21500,21750
J000288,N00027848,Hank Johnson (D),2012,Public Sector Unions,0,21000,21000
J000288,N00027848,Hank Johnson (D),2012,Food & Beverage,0,17500,17500
J000288,N00027848,Hank Johnson (D),2012,"Beer, Wine & Liquor",0,17000,17000
J000288,N00027848,Hank Johnson (D),2012,Commercial Banks,0,15500,15500
D000622,N00027860,Tammy Duckworth (D),2012,Women's Issues,361967,24860,386827
D000622,N00027860,Tammy Duckworth (D),2012,Lawyers/Law Firms,325725,28000,353725
D000622,N00027860,Tammy Duckworth (D),2012,Retired,247571,0,247571
D000622,N00027860,Tammy Duckworth (D),2012,Pro-Israel,118850,8500,127350
D000622,N00027860,Tammy Duckworth (D),2012,Leadership PACs,1500,120500,122000
D000622,N00027860,Tammy Duckworth (D),2012,Securities & Investment,99628,4000,103628
D000622,N00027860,Tammy Duckworth (D),2012,Real Estate,101632,0,101632
D000622,N00027860,Tammy Duckworth (D),2012,Democratic/Liberal,70600,14500,85100
D000622,N00027860,Tammy Duckworth (D),2012,Health Professionals,42392,42500,84892
D000622,N00027860,Tammy Duckworth (D),2012,Education,63094,5000,68094
M001171,N00027891,Dan Maffei (D),2012,Lawyers/Law Firms,139283,13000,152283
M001171,N00027891,Dan Maffei (D),2012,Leadership PACs,1750,132071,133821
M001171,N00027891,Dan Maffei (D),2012,Lobbyists,102863,5000,107863
M001171,N00027891,Dan Maffei (D),2012,Securities & Investment,83961,2750,86711
M001171,N00027891,Dan Maffei (D),2012,Education,82700,500,83200
M001171,N00027891,Dan Maffei (D),2012,Public Sector Unions,0,81500,81500
M001171,N00027891,Dan Maffei (D),2012,Building Trade Unions,0,75000,75000
M001171,N00027891,Dan Maffei (D),2012,Retired,66981,0,66981
M001171,N00027891,Dan Maffei (D),2012,Candidate Committees,0,64500,64500
M001171,N00027891,Dan Maffei (D),2012,Democratic/Liberal,41090,14600,55690
J000289,N00027894,Jim Jordan (R),2012,Misc Manufacturing & Distributing,29500,30500,60000
J000289,N00027894,Jim Jordan (R),2012,Insurance,9232,36150,45382
J000289,N00027894,Jim Jordan (R),2012,Health Professionals,24150,17000,41150
J000289,N00027894,Jim Jordan (R),2012,Retired,29646,0,29646
J000289,N00027894,Jim Jordan (R),2012,Oil & Gas,10200,18000,28200
J000289,N00027894,Jim Jordan (R),2012,Accountants,5550,21500,27050
J000289,N00027894,Jim Jordan (R),2012,Pharmaceuticals/Health Products,0,25500,25500
J000289,N00027894,Jim Jordan (R),2012,Automotive,8800,15500,24300
J000289,N00027894,Jim Jordan (R),2012,Crop Production & Basic Processing,24250,0,24250
J000289,N00027894,Jim Jordan (R),2012,TV/Movies/Music,7000,16000,23000
Y000062,N00028073,John A Yarmuth (D),2012,Retired,92470,0,92470
Y000062,N00028073,John A Yarmuth (D),2012,Public Sector Unions,0,72500,72500
Y000062,N00028073,John A Yarmuth (D),2012,Industrial Unions,500,65000,65500
Y000062,N00028073,John A Yarmuth (D),2012,Lawyers/Law Firms,49700,8250,57950
Y000062,N00028073,John A Yarmuth (D),2012,Building Trade Unions,0,50000,50000
Y000062,N00028073,John A Yarmuth (D),2012,Health Professionals,18000,27000,45000
Y000062,N00028073,John A Yarmuth (D),2012,"Beer, Wine & Liquor",5750,31677,37427
Y000062,N00028073,John A Yarmuth (D),2012,Securities & Investment,8750,14500,23250
Y000062,N00028073,John A Yarmuth (D),2012,Real Estate,4750,18000,22750
Y000062,N00028073,John A Yarmuth (D),2012,Insurance,2500,20000,22500
S001170,N00028091,Carol Shea-Porter (D),2012,Women's Issues,118201,26250,144451
S001170,N00028091,Carol Shea-Porter (D),2012,Retired,112142,0,112142
S001170,N00028091,Carol Shea-Porter (D),2012,Leadership PACs,1000,80500,81500
S001170,N00028091,Carol Shea-Porter (D),2012,Democratic/Liberal,52434,25216,77650
S001170,N00028091,Carol Shea-Porter (D),2012,Public Sector Unions,250,75000,75250
S001170,N00028091,Carol Shea-Porter (D),2012,Building Trade Unions,0,70500,70500
S001170,N00028091,Carol Shea-Porter (D),2012,Industrial Unions,0,55000,55000
S001170,N00028091,Carol Shea-Porter (D),2012,Candidate Committees,0,52500,52500
S001170,N00028091,Carol Shea-Porter (D),2012,Pro-Israel,33710,6000,39710
S001170,N00028091,Carol Shea-Porter (D),2012,Transportation Unions,0,31000,31000
L000564,N00028133,Douglas L Lamborn (R),2012,Oil & Gas,4250,60000,64250
L000564,N00028133,Douglas L Lamborn (R),2012,Defense Aerospace,0,46500,46500
L000564,N00028133,Douglas L Lamborn (R),2012,Leadership PACs,0,44946,44946
L000564,N00028133,Douglas L Lamborn (R),2012,Defense Electronics,500,38500,39000
L000564,N00028133,Douglas L Lamborn (R),2012,Health Professionals,9398,25000,34398
L000564,N00028133,Douglas L Lamborn (R),2012,Mining,0,27499,27499
L000564,N00028133,Douglas L Lamborn (R),2012,Real Estate,19250,7500,26750
L000564,N00028133,Douglas L Lamborn (R),2012,Pro-Israel,13250,9500,22750
L000564,N00028133,Douglas L Lamborn (R),2012,Telecom Services,9351,7692,17043
L000564,N00028133,Douglas L Lamborn (R),2012,Crop Production & Basic Processing,0,17000,17000
H001042,N00028139,Mazie K Hirono (D),2012,Lawyers/Law Firms,501619,23000,524619
H001042,N00028139,Mazie K Hirono (D),2012,Women's Issues,310272,29500,339772
H001042,N00028139,Mazie K Hirono (D),2012,Retired,194557,0,194557
H001042,N00028139,Mazie K Hirono (D),2012,Leadership PACs,1000,185500,186500
H001042,N00028139,Mazie K Hirono (D),2012,Real Estate,125848,13500,139348
H001042,N00028139,Mazie K Hirono (D),2012,Lobbyists,112094,4750,116844
H001042,N00028139,Mazie K Hirono (D),2012,Transportation Unions,1400,109000,110400
H001042,N00028139,Mazie K Hirono (D),2012,Public Sector Unions,300,107000,107300
H001042,N00028139,Mazie K Hirono (D),2012,Sea Transport,46885,46000,92885
H001042,N00028139,Mazie K Hirono (D),2012,Construction Services,70849,14000,84849
M001165,N00028152,Kevin McCarthy (R),2012,Securities & Investment,159500,133650,293150
M001165,N00028152,Kevin McCarthy (R),2012,Oil & Gas,109200,146500,255700
M001165,N00028152,Kevin McCarthy (R),2012,Health Professionals,56200,191678,247878
M001165,N00028152,Kevin McCarthy (R),2012,Insurance,41727,179750,221477
M001165,N00028152,Kevin McCarthy (R),2012,Pharmaceuticals/Health Products,27650,165750,193400
M001165,N00028152,Kevin McCarthy (R),2012,Real Estate,118000,70500,188500
M001165,N00028152,Kevin McCarthy (R),2012,Crop Production & Basic Processing,88050,47000,135050
M001165,N00028152,Kevin McCarthy (R),2012,Electric Utilities,5300,113000,118300
M001165,N00028152,Kevin McCarthy (R),2012,Health Services/HMOs,25400,85000,110400
M001165,N00028152,Kevin McCarthy (R),2012,Electronics Mfg & Equip,49750,60050,109800
E000290,N00028249,Donna Edwards (D),2012,Public Sector Unions,0,51250,51250
E000290,N00028249,Donna Edwards (D),2012,Building Trade Unions,0,47900,47900
E000290,N00028249,Donna Edwards (D),2012,Industrial Unions,200,43499,43699
E000290,N00028249,Donna Edwards (D),2012,Transportation Unions,0,41000,41000
E000290,N00028249,Donna Edwards (D),2012,Misc Unions,0,35500,35500
E000290,N00028249,Donna Edwards (D),2012,Lawyers/Law Firms,20900,12500,33400
E000290,N00028249,Donna Edwards (D),2012,Democratic/Liberal,11400,20483,31883
E000290,N00028249,Donna Edwards (D),2012,Non-Profit Institutions,31400,0,31400
E000290,N00028249,Donna Edwards (D),2012,Air Transport,0,27000,27000
E000290,N00028249,Donna Edwards (D),2012,Railroads,0,25500,25500
E000288,N00028257,Keith Ellison (D),2012,Health Professionals,163650,7550,171200
E000288,N00028257,Keith Ellison (D),2012,Lawyers/Law Firms,47135,26763,73898
E000288,N00028257,Keith Ellison (D),2012,Retired,58450,0,58450
E000288,N00028257,Keith Ellison (D),2012,Real Estate,33011,14000,47011
E000288,N00028257,Keith Ellison (D),2012,Industrial Unions,0,47000,47000
E000288,N00028257,Keith Ellison (D),2012,Public Sector Unions,0,44000,44000
E000288,N00028257,Keith Ellison (D),2012,Insurance,9751,30200,39951
E000288,N00028257,Keith Ellison (D),2012,Securities & Investment,33900,5000,38900
E000288,N00028257,Keith Ellison (D),2012,Misc Unions,250,38000,38250
E000288,N00028257,Keith Ellison (D),2012,Hospitals/Nursing Homes,32550,0,32550
G000556,N00028418,Alan Grayson (D),2012,Democratic/Liberal,100525,5890,106415
G000556,N00028418,Alan Grayson (D),2012,Retired,99010,0,99010
G000556,N00028418,Alan Grayson (D),2012,Public Sector Unions,0,63500,63500
G000556,N00028418,Alan Grayson (D),2012,Lawyers/Law Firms,33980,10000,43980
G000556,N00028418,Alan Grayson (D),2012,Building Trade Unions,0,33000,33000
G000556,N00028418,Alan Grayson (D),2012,Industrial Unions,0,32500,32500
G000556,N00028418,Alan Grayson (D),2012,Education,30529,0,30529
G000556,N00028418,Alan Grayson (D),2012,Transportation Unions,0,21500,21500
G000556,N00028418,Alan Grayson (D),2012,Misc Business,21200,0,21200
G000556,N00028418,Alan Grayson (D),2012,Electronics Mfg & Equip,20075,0,20075
R000582,N00028463,Phil Roe (R),2012,Health Professionals,99875,-5000,94875
R000582,N00028463,Phil Roe (R),2012,General Contractors,76500,0,76500
R000582,N00028463,Phil Roe (R),2012,Retired,51940,0,51940
R000582,N00028463,Phil Roe (R),2012,Hospitals/Nursing Homes,24750,0,24750
R000582,N00028463,Phil Roe (R),2012,Building Materials & Equipment,22250,0,22250
R000582,N00028463,Phil Roe (R),2012,Chemical & Related Manufacturing,21500,0,21500
R000582,N00028463,Phil Roe (R),2012,Food Processing & Sales,21200,0,21200
R000582,N00028463,Phil Roe (R),2012,Mining,20000,0,20000
R000582,N00028463,Phil Roe (R),2012,Securities & Investment,13150,5000,18150
R000582,N00028463,Phil Roe (R),2012,Misc Energy,16000,0,16000
C001076,N00028958,Jason Chaffetz (R),2012,Electronics Mfg & Equip,17750,39093,56843
C001076,N00028958,Jason Chaffetz (R),2012,Business Services,46680,2500,49180
C001076,N00028958,Jason Chaffetz (R),2012,Misc Manufacturing & Distributing,24900,19500,44400
C001076,N00028958,Jason Chaffetz (R),2012,Pharmaceuticals/Health Products,17250,23345,40595
C001076,N00028958,Jason Chaffetz (R),2012,Finance/Credit Companies,17900,19800,37700
C001076,N00028958,Jason Chaffetz (R),2012,Commercial Banks,10700,26000,36700
C001076,N00028958,Jason Chaffetz (R),2012,Lobbyists,30348,1500,31848
C001076,N00028958,Jason Chaffetz (R),2012,Oil & Gas,5000,25000,30000
C001076,N00028958,Jason Chaffetz (R),2012,Health Professionals,11900,16500,28400
C001076,N00028958,Jason Chaffetz (R),2012,Securities & Investment,14700,9500,24200
B001262,N00028986,Paul Broun Jr (R),2012,Health Professionals,49430,91000,140430
B001262,N00028986,Paul Broun Jr (R),2012,Retired,114363,0,114363
B001262,N00028986,Paul Broun Jr (R),2012,Republican/Conservative,63437,10000,73437
B001262,N00028986,Paul Broun Jr (R),2012,Real Estate,26012,7000,33012
B001262,N00028986,Paul Broun Jr (R),2012,Food & Beverage,12250,20000,32250
B001262,N00028986,Paul Broun Jr (R),2012,Leadership PACs,0,31000,31000
B001262,N00028986,Paul Broun Jr (R),2012,Insurance,6734,18000,24734
B001262,N00028986,Paul Broun Jr (R),2012,Lawyers/Law Firms,14649,8500,23149
B001262,N00028986,Paul Broun Jr (R),2012,Oil & Gas,12450,9500,21950
B001262,N00028986,Paul Broun Jr (R),2012,Misc Manufacturing & Distributing,11501,9000,20501
F000457,N00029016,Al Franken (D),2012,Lawyers/Law Firms,1509678,31646,1541324
F000457,N00029016,Al Franken (D),2012,Retired,1203940,0,1203940
F000457,N00029016,Al Franken (D),2012,TV/Movies/Music,999289,3000,1002289
F000457,N00029016,Al Franken (D),2012,Securities & Investment,675705,6000,681705
F000457,N00029016,Al Franken (D),2012,Printing & Publishing,402637,0,402637
F000457,N00029016,Al Franken (D),2012,Democratic/Liberal,357608,31950,389558
F000457,N00029016,Al Franken (D),2012,Education,388026,0,388026
F000457,N00029016,Al Franken (D),2012,Real Estate,378666,1010,379676
F000457,N00029016,Al Franken (D),2012,Business Services,371624,2000,373624
F000457,N00029016,Al Franken (D),2012,Health Professionals,307111,19000,326111
R000583,N00029018,Tom Rooney (R),2012,Crop Production & Basic Processing,48250,34500,82750
R000583,N00029018,Tom Rooney (R),2012,Defense Aerospace,0,54000,54000
R000583,N00029018,Tom Rooney (R),2012,Real Estate,28676,22000,50676
R000583,N00029018,Tom Rooney (R),2012,Retired,45501,0,45501
R000583,N00029018,Tom Rooney (R),2012,Food Processing & Sales,24450,19042,43492
R000583,N00029018,Tom Rooney (R),2012,Health Professionals,6000,28000,34000
R000583,N00029018,Tom Rooney (R),2012,Accountants,3500,28000,31500
R000583,N00029018,Tom Rooney (R),2012,Livestock,11250,18000,29250
R000583,N00029018,Tom Rooney (R),2012,Dairy,6500,20946,27446
R000583,N00029018,Tom Rooney (R),2012,Agricultural Services/Products,1750,24270,26020
T000465,N00029026,Niki Tsongas (D),2012,Lawyers/Law Firms,92150,15750,107900
T000465,N00029026,Niki Tsongas (D),2012,Real Estate,68375,4000,72375
T000465,N00029026,Niki Tsongas (D),2012,Retired,61675,0,61675
T000465,N00029026,Niki Tsongas (D),2012,Women's Issues,57049,100,57149
T000465,N00029026,Niki Tsongas (D),2012,Building Trade Unions,0,37000,37000
T000465,N00029026,Niki Tsongas (D),2012,Pharmaceuticals/Health Products,7000,26000,33000
T000465,N00029026,Niki Tsongas (D),2012,Lobbyists,28650,2000,30650
T000465,N00029026,Niki Tsongas (D),2012,Civil Servants/Public Officials,30550,0,30550
T000465,N00029026,Niki Tsongas (D),2012,Non-Profit Institutions,29250,0,29250
T000465,N00029026,Niki Tsongas (D),2012,Misc Manufacturing & Distributing,14250,14500,28750
H001047,N00029070,Jim Himes (D),2012,Securities & Investment,347929,195499,543428
H001047,N00029070,Jim Himes (D),2012,Lawyers/Law Firms,176750,27750,204500
H001047,N00029070,Jim Himes (D),2012,Insurance,9500,182500,192000
H001047,N00029070,Jim Himes (D),2012,Retired,181175,0,181175
H001047,N00029070,Jim Himes (D),2012,Commercial Banks,85950,80000,165950
H001047,N00029070,Jim Himes (D),2012,Real Estate,91016,56000,147016
H001047,N00029070,Jim Himes (D),2012,Misc Finance,63050,18000,81050
H001047,N00029070,Jim Himes (D),2012,Misc Manufacturing & Distributing,49700,27000,76700
H001047,N00029070,Jim Himes (D),2012,Business Services,67600,2500,70100
H001047,N00029070,Jim Himes (D),2012,Accountants,10800,47500,58300
J000290,N00029077,Lynn Jenkins (R),2012,Health Professionals,29050,106750,135800
J000290,N00029077,Lynn Jenkins (R),2012,Oil & Gas,73450,47000,120450
J000290,N00029077,Lynn Jenkins (R),2012,Insurance,19000,98028,117028
J000290,N00029077,Lynn Jenkins (R),2012,Real Estate,35750,39000,74750
J000290,N00029077,Lynn Jenkins (R),2012,Securities & Investment,27550,42000,69550
J000290,N00029077,Lynn Jenkins (R),2012,Accountants,6250,53750,60000
J000290,N00029077,Lynn Jenkins (R),2012,Finance/Credit Companies,33800,17500,51300
J000290,N00029077,Lynn Jenkins (R),2012,General Contractors,31450,19500,50950
J000290,N00029077,Lynn Jenkins (R),2012,Misc Manufacturing & Distributing,25500,25000,50500
J000290,N00029077,Lynn Jenkins (R),2012,Railroads,23250,25584,48834
P000598,N00029127,Jared Polis (D),2012,Securities & Investment,129950,5500,135450
P000598,N00029127,Jared Polis (D),2012,Retired,64050,0,64050
P000598,N00029127,Jared Polis (D),2012,Lawyers/Law Firms,46610,2000,48610
P000598,N00029127,Jared Polis (D),2012,Printing & Publishing,31250,0,31250
P000598,N00029127,Jared Polis (D),2012,Business Services,28450,0,28450
P000598,N00029127,Jared Polis (D),2012,Real Estate,26450,0,26450
P000598,N00029127,Jared Polis (D),2012,Misc Finance,23550,0,23550
P000598,N00029127,Jared Polis (D),2012,Lobbyists,20800,0,20800
P000598,N00029127,Jared Polis (D),2012,Non-Profit Institutions,20500,0,20500
P000598,N00029127,Jared Polis (D),2012,Misc Business,19500,0,19500
F000454,N00029139,Bill Foster (D),2012,Education,412376,0,412376
F000454,N00029139,Bill Foster (D),2012,Lawyers/Law Firms,232120,15500,247620
F000454,N00029139,Bill Foster (D),2012,Retired,190064,0,190064
F000454,N00029139,Bill Foster (D),2012,Civil Servants/Public Officials,123117,0,123117
F000454,N00029139,Bill Foster (D),2012,Securities & Investment,114110,2000,116110
F000454,N00029139,Bill Foster (D),2012,Pro-Israel,105219,3000,108219
F000454,N00029139,Bill Foster (D),2012,Leadership PACs,500,103500,104000
F000454,N00029139,Bill Foster (D),2012,Democratic/Liberal,88442,10000,98442
F000454,N00029139,Bill Foster (D),2012,Abortion Policy/Pro-Abortion Rights,64463,12500,76963
F000454,N00029139,Bill Foster (D),2012,Real Estate,68399,5000,73399
H001052,N00029147,Andy Harris (R),2012,Health Professionals,278085,130500,408585
H001052,N00029147,Andy Harris (R),2012,Retired,87481,0,87481
H001052,N00029147,Andy Harris (R),2012,Real Estate,46655,5000,51655
H001052,N00029147,Andy Harris (R),2012,Oil & Gas,6760,35000,41760
H001052,N00029147,Andy Harris (R),2012,Food & Beverage,29300,11000,40300
H001052,N00029147,Andy Harris (R),2012,Lawyers/Law Firms,36250,1000,37250
H001052,N00029147,Andy Harris (R),2012,Securities & Investment,27795,0,27795
H001052,N00029147,Andy Harris (R),2012,Air Transport,750,25499,26249
H001052,N00029147,Andy Harris (R),2012,Insurance,12250,12500,24750
H001052,N00029147,Andy Harris (R),2012,Education,24450,0,24450
P000596,N00029168,Pedro Pierluisi (D),2012,Lawyers/Law Firms,182551,37250,219801
P000596,N00029168,Pedro Pierluisi (D),2012,Misc Business,81050,0,81050
P000596,N00029168,Pedro Pierluisi (D),2012,Business Services,68610,0,68610
P000596,N00029168,Pedro Pierluisi (D),2012,Construction Services,67600,1000,68600
P000596,N00029168,Pedro Pierluisi (D),2012,Health Professionals,60049,5000,65049
P000596,N00029168,Pedro Pierluisi (D),2012,Real Estate,64300,0,64300
P000596,N00029168,Pedro Pierluisi (D),2012,General Contractors,46804,500,47304
P000596,N00029168,Pedro Pierluisi (D),2012,Insurance,43450,0,43450
P000596,N00029168,Pedro Pierluisi (D),2012,Retired,42400,0,42400
P000596,N00029168,Pedro Pierluisi (D),2012,Accountants,37700,0,37700
H001048,N00029258,Duncan D Hunter (R),2012,Defense Aerospace,6800,56000,62800
H001048,N00029258,Duncan D Hunter (R),2012,Defense Electronics,2150,52000,54150
H001048,N00029258,Duncan D Hunter (R),2012,Air Transport,0,37000,37000
H001048,N00029258,Duncan D Hunter (R),2012,Misc Manufacturing & Distributing,19050,16500,35550
H001048,N00029258,Duncan D Hunter (R),2012,Real Estate,15350,20000,35350
H001048,N00029258,Duncan D Hunter (R),2012,Construction Services,17715,17000,34715
H001048,N00029258,Duncan D Hunter (R),2012,Misc Defense,2800,31900,34700
H001048,N00029258,Duncan D Hunter (R),2012,Retired,34352,0,34352
H001048,N00029258,Duncan D Hunter (R),2012,Health Professionals,4250,30000,34250
H001048,N00029258,Duncan D Hunter (R),2012,Transportation Unions,0,28000,28000
K000368,N00029260,Ann Kirkpatrick (D),2012,Women's Issues,199355,21250,220605
K000368,N00029260,Ann Kirkpatrick (D),2012,Retired,181940,0,181940
K000368,N00029260,Ann Kirkpatrick (D),2012,Lawyers/Law Firms,129746,13500,143246
K000368,N00029260,Ann Kirkpatrick (D),2012,Leadership PACs,0,110500,110500
K000368,N00029260,Ann Kirkpatrick (D),2012,Public Sector Unions,200,71000,71200
K000368,N00029260,Ann Kirkpatrick (D),2012,Candidate Committees,0,56250,56250
K000368,N00029260,Ann Kirkpatrick (D),2012,Health Professionals,27450,22500,49950
K000368,N00029260,Ann Kirkpatrick (D),2012,Education,48994,0,48994
K000368,N00029260,Ann Kirkpatrick (D),2012,Building Trade Unions,0,43000,43000
K000368,N00029260,Ann Kirkpatrick (D),2012,Real Estate,31000,10000,41000
S001179,N00029273,Aaron Schock (R),2012,Health Professionals,129880,141150,271030
S001179,N00029273,Aaron Schock (R),2012,Securities & Investment,189549,37000,226549
S001179,N00029273,Aaron Schock (R),2012,Retired,172711,0,172711
S001179,N00029273,Aaron Schock (R),2012,Insurance,50465,99831,150296
S001179,N00029273,Aaron Schock (R),2012,Real Estate,70915,36000,106915
S001179,N00029273,Aaron Schock (R),2012,Lawyers/Law Firms,79115,18800,97915
S001179,N00029273,Aaron Schock (R),2012,Pharmaceuticals/Health Products,7750,69500,77250
S001179,N00029273,Aaron Schock (R),2012,Business Services,57800,9500,67300
S001179,N00029273,Aaron Schock (R),2012,Misc Manufacturing & Distributing,32915,34000,66915
S001179,N00029273,Aaron Schock (R),2012,Food & Beverage,28767,31000,59767
P000595,N00029277,Gary Peters (D),2012,Lawyers/Law Firms,135175,52000,187175
P000595,N00029277,Gary Peters (D),2012,Insurance,6000,119600,125600
P000595,N00029277,Gary Peters (D),2012,Securities & Investment,23550,100500,124050
P000595,N00029277,Gary Peters (D),2012,Real Estate,29800,59199,88999
P000595,N00029277,Gary Peters (D),2012,Health Professionals,59950,27700,87650
P000595,N00029277,Gary Peters (D),2012,Commercial Banks,1200,73000,74200
P000595,N00029277,Gary Peters (D),2012,Pro-Israel,52850,10500,63350
P000595,N00029277,Gary Peters (D),2012,Accountants,14650,47999,62649
P000595,N00029277,Gary Peters (D),2012,Building Trade Unions,250,61000,61250
P000595,N00029277,Gary Peters (D),2012,Industrial Unions,0,55000,55000
O000168,N00029285,Pete Olson (R),2012,Oil & Gas,69900,108500,178400
O000168,N00029285,Pete Olson (R),2012,Health Professionals,47813,59000,106813
O000168,N00029285,Pete Olson (R),2012,Real Estate,55650,17500,73150
O000168,N00029285,Pete Olson (R),2012,Chemical & Related Manufacturing,1250,63999,65249
O000168,N00029285,Pete Olson (R),2012,Electric Utilities,13500,42500,56000
O000168,N00029285,Pete Olson (R),2012,Lawyers/Law Firms,26898,27499,54397
O000168,N00029285,Pete Olson (R),2012,Pharmaceuticals/Health Products,11000,29000,40000
O000168,N00029285,Pete Olson (R),2012,Insurance,19475,19500,38975
O000168,N00029285,Pete Olson (R),2012,Lobbyists,32568,1500,34068
O000168,N00029285,Pete Olson (R),2012,Retired,33800,0,33800
M001176,N00029303,Jeff Merkley (D),2012,Lawyers/Law Firms,598783,55798,654581
M001176,N00029303,Jeff Merkley (D),2012,Retired,559487,0,559487
M001176,N00029303,Jeff Merkley (D),2012,Securities & Investment,399540,12750,412290
M001176,N00029303,Jeff Merkley (D),2012,Leadership PACs,0,279350,279350
M001176,N00029303,Jeff Merkley (D),2012,Real Estate,224850,32510,257360
M001176,N00029303,Jeff Merkley (D),2012,Education,203175,3000,206175
M001176,N00029303,Jeff Merkley (D),2012,Democratic/Liberal,159900,30084,189984
M001176,N00029303,Jeff Merkley (D),2012,Health Professionals,115411,60900,176311
M001176,N00029303,Jeff Merkley (D),2012,Pro-Israel,129330,16600,145930
M001176,N00029303,Jeff Merkley (D),2012,Electronics Mfg & Equip,115526,27500,143026
P000594,N00029391,Erik Paulsen (R),2012,Pharmaceuticals/Health Products,70850,155000,225850
P000594,N00029391,Erik Paulsen (R),2012,Retired,204909,0,204909
P000594,N00029391,Erik Paulsen (R),2012,Insurance,63102,134028,197130
P000594,N00029391,Erik Paulsen (R),2012,Health Professionals,65925,111000,176925
P000594,N00029391,Erik Paulsen (R),2012,Securities & Investment,122200,53500,175700
P000594,N00029391,Erik Paulsen (R),2012,Lawyers/Law Firms,69850,39938,109788
P000594,N00029391,Erik Paulsen (R),2012,Misc Manufacturing & Distributing,56900,38500,95400
P000594,N00029391,Erik Paulsen (R),2012,Real Estate,41650,49020,90670
P000594,N00029391,Erik Paulsen (R),2012,Retail Sales,32200,48500,80700
P000594,N00029391,Erik Paulsen (R),2012,Misc Finance,65400,12500,77900
L000580,N00029400,Michelle Lujan Grisham (D),2012,Lawyers/Law Firms,148751,13000,161751
L000580,N00029400,Michelle Lujan Grisham (D),2012,Health Professionals,18775,94000,112775
L000580,N00029400,Michelle Lujan Grisham (D),2012,Women's Issues,80139,10500,90639
L000580,N00029400,Michelle Lujan Grisham (D),2012,Retired,90080,0,90080
L000580,N00029400,Michelle Lujan Grisham (D),2012,Leadership PACs,0,62500,62500
L000580,N00029400,Michelle Lujan Grisham (D),2012,Public Sector Unions,900,54500,55400
L000580,N00029400,Michelle Lujan Grisham (D),2012,Industrial Unions,0,40000,40000
L000580,N00029400,Michelle Lujan Grisham (D),2012,Building Trade Unions,0,38500,38500
L000580,N00029400,Michelle Lujan Grisham (D),2012,Candidate Committees,0,34000,34000
L000580,N00029400,Michelle Lujan Grisham (D),2012,Civil Servants/Public Officials,30350,0,30350
R000584,N00029441,James E Risch (R),2012,Republican/Conservative,166706,13500,180206
R000584,N00029441,James E Risch (R),2012,Leadership PACs,2000,166936,168936
R000584,N00029441,James E Risch (R),2012,Retired,141150,0,141150
R000584,N00029441,James E Risch (R),2012,Mining,62530,35750,98280
R000584,N00029441,James E Risch (R),2012,Insurance,5950,87462,93412
R000584,N00029441,James E Risch (R),2012,Oil & Gas,27500,60500,88000
R000584,N00029441,James E Risch (R),2012,Real Estate,64649,21000,85649
R000584,N00029441,James E Risch (R),2012,Misc Manufacturing & Distributing,55500,26000,81500
R000584,N00029441,James E Risch (R),2012,Crop Production & Basic Processing,29600,48000,77600
R000584,N00029441,James E Risch (R),2012,Electric Utilities,5957,62249,68206
J000291,N00029444,Michael O Johanns (R),2012,Insurance,58650,196750,255400
J000291,N00029444,Michael O Johanns (R),2012,Leadership PACs,0,230930,230930
J000291,N00029444,Michael O Johanns (R),2012,Retired,223335,0,223335
J000291,N00029444,Michael O Johanns (R),2012,Lawyers/Law Firms,114099,55600,169699
J000291,N00029444,Michael O Johanns (R),2012,Telecom Services,113200,55999,169199
J000291,N00029444,Michael O Johanns (R),2012,Real Estate,120640,47500,168140
J000291,N00029444,Michael O Johanns (R),2012,Securities & Investment,123485,43000,166485
J000291,N00029444,Michael O Johanns (R),2012,Food Processing & Sales,71150,79998,151148
J000291,N00029444,Michael O Johanns (R),2012,Agricultural Services/Products,24500,116500,141000
J000291,N00029444,Michael O Johanns (R),2012,Health Professionals,60430,76250,136680
W000804,N00029459,Rob Wittman (R),2012,Defense Aerospace,200,64500,64700
W000804,N00029459,Rob Wittman (R),2012,Misc Defense,26650,37000,63650
W000804,N00029459,Rob Wittman (R),2012,Retired,54950,0,54950
W000804,N00029459,Rob Wittman (R),2012,Defense Electronics,250,43500,43750
W000804,N00029459,Rob Wittman (R),2012,Health Professionals,8000,32000,40000
W000804,N00029459,Rob Wittman (R),2012,Real Estate,25950,8000,33950
W000804,N00029459,Rob Wittman (R),2012,Electric Utilities,750,21000,21750
W000804,N00029459,Rob Wittman (R),2012,"Beer, Wine & Liquor",2750,15000,17750
W000804,N00029459,Rob Wittman (R),2012,Railroads,1000,16500,17500
W000804,N00029459,Rob Wittman (R),2012,Trucking,13000,4000,17000
C001072,N00029513,Andre Carson (D),2012,Lawyers/Law Firms,73506,11500,85006
C001072,N00029513,Andre Carson (D),2012,Health Professionals,58550,21500,80050
C001072,N00029513,Andre Carson (D),2012,Securities & Investment,20000,30500,50500
C001072,N00029513,Andre Carson (D),2012,Industrial Unions,0,46000,46000
C001072,N00029513,Andre Carson (D),2012,Building Trade Unions,750,44250,45000
C001072,N00029513,Andre Carson (D),2012,Real Estate,18000,23750,41750
C001072,N00029513,Andre Carson (D),2012,Accountants,8000,29000,37000
C001072,N00029513,Andre Carson (D),2012,Public Sector Unions,0,37000,37000
C001072,N00029513,Andre Carson (D),2012,Insurance,5558,29000,34558
C001072,N00029513,Andre Carson (D),2012,Construction Services,30700,2000,32700
L000570,N00029562,Ben R Lujan (D),2012,Casinos/Gambling,110750,4000,114750
L000570,N00029562,Ben R Lujan (D),2012,Lawyers/Law Firms,52950,15500,68450
L000570,N00029562,Ben R Lujan (D),2012,Building Trade Unions,0,47000,47000
L000570,N00029562,Ben R Lujan (D),2012,Public Sector Unions,0,44000,44000
L000570,N00029562,Ben R Lujan (D),2012,Lobbyists,42250,0,42250
L000570,N00029562,Ben R Lujan (D),2012,Health Professionals,6250,33500,39750
L000570,N00029562,Ben R Lujan (D),2012,Retired,36730,0,36730
L000570,N00029562,Ben R Lujan (D),2012,Industrial Unions,0,36500,36500
L000570,N00029562,Ben R Lujan (D),2012,Real Estate,14500,16325,30825
L000570,N00029562,Ben R Lujan (D),2012,Electronics Mfg & Equip,2000,24000,26000
S001187,N00029574,Steve Stivers (R),2012,Insurance,64250,175235,239485
S001187,N00029574,Steve Stivers (R),2012,Securities & Investment,55200,98500,153700
S001187,N00029574,Steve Stivers (R),2012,Commercial Banks,30550,115750,146300
S001187,N00029574,Steve Stivers (R),2012,Real Estate,72925,59800,132725
S001187,N00029574,Steve Stivers (R),2012,Health Professionals,18400,95000,113400
S001187,N00029574,Steve Stivers (R),2012,Lawyers/Law Firms,49547,56425,105972
S001187,N00029574,Steve Stivers (R),2012,Finance/Credit Companies,12750,76250,89000
S001187,N00029574,Steve Stivers (R),2012,Misc Finance,66225,19000,85225
S001187,N00029574,Steve Stivers (R),2012,Electric Utilities,36950,34750,71700
S001187,N00029574,Steve Stivers (R),2012,Lobbyists,67694,2500,70194
H001049,N00029617,Kay R Hagan (D),2012,Lawyers/Law Firms,763822,73326,837148
H001049,N00029617,Kay R Hagan (D),2012,Retired,703360,0,703360
H001049,N00029617,Kay R Hagan (D),2012,Women's Issues,598820,25661,624481
H001049,N00029617,Kay R Hagan (D),2012,Securities & Investment,319261,109000,428261
H001049,N00029617,Kay R Hagan (D),2012,Leadership PACs,1600,308000,309600
H001049,N00029617,Kay R Hagan (D),2012,Real Estate,267576,34050,301626
H001049,N00029617,Kay R Hagan (D),2012,Pharmaceuticals/Health Products,62950,199309,262259
H001049,N00029617,Kay R Hagan (D),2012,Education,227730,6000,233730
H001049,N00029617,Kay R Hagan (D),2012,Insurance,103548,120000,223548
H001049,N00029617,Kay R Hagan (D),2012,Democratic/Liberal,129797,82219,212016
H001045,N00029632,Gregg Harper (R),2012,Oil & Gas,51250,31000,82250
H001045,N00029632,Gregg Harper (R),2012,Health Professionals,22850,29999,52849
H001045,N00029632,Gregg Harper (R),2012,Electric Utilities,1000,43000,44000
H001045,N00029632,Gregg Harper (R),2012,Lawyers/Law Firms,26850,16000,42850
H001045,N00029632,Gregg Harper (R),2012,Leadership PACs,1000,32500,33500
H001045,N00029632,Gregg Harper (R),2012,General Contractors,28067,2000,30067
H001045,N00029632,Gregg Harper (R),2012,Real Estate,21950,8000,29950
H001045,N00029632,Gregg Harper (R),2012,Commercial Banks,10950,18700,29650
H001045,N00029632,Gregg Harper (R),2012,Telephone Utilities,8250,17500,25750
H001045,N00029632,Gregg Harper (R),2012,Lobbyists,25550,0,25550
S001175,N00029649,Jackie Speier (D),2012,Retired,72200,0,72200
S001175,N00029649,Jackie Speier (D),2012,Pharmaceuticals/Health Products,24625,41500,66125
S001175,N00029649,Jackie Speier (D),2012,Health Professionals,17150,38250,55400
S001175,N00029649,Jackie Speier (D),2012,Lawyers/Law Firms,35754,12500,48254
S001175,N00029649,Jackie Speier (D),2012,Retail Sales,550,43500,44050
S001175,N00029649,Jackie Speier (D),2012,Public Sector Unions,0,42500,42500
S001175,N00029649,Jackie Speier (D),2012,Insurance,2000,37000,39000
S001175,N00029649,Jackie Speier (D),2012,Securities & Investment,36300,2500,38800
S001175,N00029649,Jackie Speier (D),2012,Building Trade Unions,0,33500,33500
S001175,N00029649,Jackie Speier (D),2012,Real Estate,20450,8500,28950
P000599,N00029662,Bill Posey (R),2012,Health Professionals,68650,54000,122650
P000599,N00029662,Bill Posey (R),2012,Real Estate,43250,30300,73550
P000599,N00029662,Bill Posey (R),2012,Retired,72300,0,72300
P000599,N00029662,Bill Posey (R),2012,Misc Issues,55750,0,55750
P000599,N00029662,Bill Posey (R),2012,Insurance,2750,47000,49750
P000599,N00029662,Bill Posey (R),2012,Defense Electronics,16950,32000,48950
P000599,N00029662,Bill Posey (R),2012,Commercial Banks,7500,36000,43500
P000599,N00029662,Bill Posey (R),2012,Securities & Investment,11250,23000,34250
P000599,N00029662,Bill Posey (R),2012,Tobacco,20250,10500,30750
P000599,N00029662,Bill Posey (R),2012,Defense Aerospace,0,29000,29000
G000558,N00029675,Brett Guthrie (R),2012,Health Professionals,22150,177000,199150
G000558,N00029675,Brett Guthrie (R),2012,Pharmaceuticals/Health Products,500,111000,111500
G000558,N00029675,Brett Guthrie (R),2012,Insurance,14250,51500,65750
G000558,N00029675,Brett Guthrie (R),2012,Health Services/HMOs,8250,47000,55250
G000558,N00029675,Brett Guthrie (R),2012,Oil & Gas,3000,41000,44000
G000558,N00029675,Brett Guthrie (R),2012,"Beer, Wine & Liquor",7500,35000,42500
G000558,N00029675,Brett Guthrie (R),2012,Retired,39300,0,39300
G000558,N00029675,Brett Guthrie (R),2012,Telecom Services,250,39000,39250
G000558,N00029675,Brett Guthrie (R),2012,Telephone Utilities,2500,36000,38500
G000558,N00029675,Brett Guthrie (R),2012,Hospitals/Nursing Homes,5600,32500,38100
F000456,N00029679,John Fleming (R),2012,Health Professionals,151026,61000,212026
F000456,N00029679,John Fleming (R),2012,Oil & Gas,169800,41500,211300
F000456,N00029679,John Fleming (R),2012,Retired,63850,0,63850
F000456,N00029679,John Fleming (R),2012,General Contractors,49250,9000,58250
F000456,N00029679,John Fleming (R),2012,Hospitals/Nursing Homes,53125,1000,54125
F000456,N00029679,John Fleming (R),2012,Real Estate,49797,4010,53807
F000456,N00029679,John Fleming (R),2012,Lawyers/Law Firms,42550,6500,49050
F000456,N00029679,John Fleming (R),2012,Crop Production & Basic Processing,34250,12000,46250
F000456,N00029679,John Fleming (R),2012,Insurance,31730,7000,38730
F000456,N00029679,John Fleming (R),2012,Defense Aerospace,0,33000,33000
T000467,N00029736,Glenn Thompson (R),2012,Oil & Gas,31650,39500,71150
T000467,N00029736,Glenn Thompson (R),2012,Retired,62550,0,62550
T000467,N00029736,Glenn Thompson (R),2012,Hospitals/Nursing Homes,34750,25000,59750
T000467,N00029736,Glenn Thompson (R),2012,Health Professionals,32850,26000,58850
T000467,N00029736,Glenn Thompson (R),2012,Real Estate,43100,10000,53100
T000467,N00029736,Glenn Thompson (R),2012,Lawyers/Law Firms,29693,5500,35193
T000467,N00029736,Glenn Thompson (R),2012,Insurance,18400,10500,28900
T000467,N00029736,Glenn Thompson (R),2012,Mining,6500,22000,28500
T000467,N00029736,Glenn Thompson (R),2012,Misc Business,25233,3000,28233
T000467,N00029736,Glenn Thompson (R),2012,Electric Utilities,3000,23000,26000
L000571,N00029788,Cynthia Marie Lummis (R),2012,Oil & Gas,36050,76000,112050
L000571,N00029788,Cynthia Marie Lummis (R),2012,Mining,8650,42500,51150
L000571,N00029788,Cynthia Marie Lummis (R),2012,Retired,47430,0,47430
L000571,N00029788,Cynthia Marie Lummis (R),2012,Livestock,21700,6500,28200
L000571,N00029788,Cynthia Marie Lummis (R),2012,Crop Production & Basic Processing,7250,20500,27750
L000571,N00029788,Cynthia Marie Lummis (R),2012,Health Professionals,9650,18000,27650
L000571,N00029788,Cynthia Marie Lummis (R),2012,Leadership PACs,0,25500,25500
L000571,N00029788,Cynthia Marie Lummis (R),2012,Real Estate,12450,8000,20450
L000571,N00029788,Cynthia Marie Lummis (R),2012,Telephone Utilities,0,19750,19750
L000571,N00029788,Cynthia Marie Lummis (R),2012,Commercial Banks,5250,14000,19250
H001046,N00029835,Martin Heinrich (D),2012,Lawyers/Law Firms,534066,41175,575241
H001046,N00029835,Martin Heinrich (D),2012,Retired,466675,0,466675
H001046,N00029835,Martin Heinrich (D),2012,Environment,214603,28672,243275
H001046,N00029835,Martin Heinrich (D),2012,Lobbyists,228813,1474,230287
H001046,N00029835,Martin Heinrich (D),2012,Leadership PACs,0,217000,217000
H001046,N00029835,Martin Heinrich (D),2012,Health Professionals,96666,72500,169166
H001046,N00029835,Martin Heinrich (D),2012,Pro-Israel,134380,23993,158373
H001046,N00029835,Martin Heinrich (D),2012,Education,126443,500,126943
H001046,N00029835,Martin Heinrich (D),2012,Democratic/Liberal,84562,30935,115497
H001046,N00029835,Martin Heinrich (D),2012,Real Estate,92965,17260,110225
C001078,N00029891,Gerry Connolly (D),2012,Retired,113095,0,113095
C001078,N00029891,Gerry Connolly (D),2012,Electronics Mfg & Equip,37729,72500,110229
C001078,N00029891,Gerry Connolly (D),2012,Public Sector Unions,0,106000,106000
C001078,N00029891,Gerry Connolly (D),2012,Lobbyists,78466,2540,81006
C001078,N00029891,Gerry Connolly (D),2012,Real Estate,60437,19500,79937
C001078,N00029891,Gerry Connolly (D),2012,Lawyers/Law Firms,45037,24928,69965
C001078,N00029891,Gerry Connolly (D),2012,Leadership PACs,0,69500,69500
C001078,N00029891,Gerry Connolly (D),2012,Business Services,47458,20000,67458
C001078,N00029891,Gerry Connolly (D),2012,Defense Electronics,12750,39000,51750
C001078,N00029891,Gerry Connolly (D),2012,Misc Defense,4300,41500,45800
B001265,N00029901,Mark Begich (D),2012,Lawyers/Law Firms,641356,72845,714201
B001265,N00029901,Mark Begich (D),2012,Leadership PACs,0,298299,298299
B001265,N00029901,Mark Begich (D),2012,Securities & Investment,255662,7500,263162
B001265,N00029901,Mark Begich (D),2012,Retired,239408,0,239408
B001265,N00029901,Mark Begich (D),2012,Oil & Gas,131455,98500,229955
B001265,N00029901,Mark Begich (D),2012,Lobbyists,203021,6500,209521
B001265,N00029901,Mark Begich (D),2012,Real Estate,173874,20000,193874
B001265,N00029901,Mark Begich (D),2012,TV/Movies/Music,148176,15250,163426
B001265,N00029901,Mark Begich (D),2012,Health Professionals,117498,18000,135498
B001265,N00029901,Mark Begich (D),2012,Business Services,129401,1500,130901
G000573,N00029908,Joe Garcia (D),2012,Lawyers/Law Firms,130543,10000,140543
G000573,N00029908,Joe Garcia (D),2012,Business Services,45300,500,45800
G000573,N00029908,Joe Garcia (D),2012,Retired,45350,0,45350
G000573,N00029908,Joe Garcia (D),2012,Real Estate,38250,0,38250
G000573,N00029908,Joe Garcia (D),2012,Leadership PACs,0,35500,35500
G000573,N00029908,Joe Garcia (D),2012,Health Services/HMOs,30750,2500,33250
G000573,N00029908,Joe Garcia (D),2012,Public Sector Unions,0,33000,33000
G000573,N00029908,Joe Garcia (D),2012,Education,32800,0,32800
G000573,N00029908,Joe Garcia (D),2012,Democratic/Liberal,22250,8456,30706
G000573,N00029908,Joe Garcia (D),2012,Health Professionals,22000,4000,26000
L000569,N00030026,Blaine Luetkemeyer (R),2012,Commercial Banks,29950,63500,93450
L000569,N00030026,Blaine Luetkemeyer (R),2012,Insurance,8300,75935,84235
L000569,N00030026,Blaine Luetkemeyer (R),2012,Securities & Investment,13750,44500,58250
L000569,N00030026,Blaine Luetkemeyer (R),2012,Finance/Credit Companies,9600,44000,53600
L000569,N00030026,Blaine Luetkemeyer (R),2012,Agricultural Services/Products,13250,26500,39750
L000569,N00030026,Blaine Luetkemeyer (R),2012,Real Estate,10500,26000,36500
L000569,N00030026,Blaine Luetkemeyer (R),2012,Health Professionals,9250,21000,30250
L000569,N00030026,Blaine Luetkemeyer (R),2012,Crop Production & Basic Processing,6640,23000,29640
L000569,N00030026,Blaine Luetkemeyer (R),2012,Retired,28250,0,28250
L000569,N00030026,Blaine Luetkemeyer (R),2012,Misc Finance,14500,12000,26500
S001180,N00030071,Kurt Schrader (D),2012,Health Professionals,21050,78100,99150
S001180,N00030071,Kurt Schrader (D),2012,Leadership PACs,1500,92000,93500
S001180,N00030071,Kurt Schrader (D),2012,Agricultural Services/Products,25050,56250,81300
S001180,N00030071,Kurt Schrader (D),2012,Pharmaceuticals/Health Products,4500,58000,62500
S001180,N00030071,Kurt Schrader (D),2012,Retired,60469,0,60469
S001180,N00030071,Kurt Schrader (D),2012,Insurance,9411,51000,60411
S001180,N00030071,Kurt Schrader (D),2012,Lawyers/Law Firms,38910,20076,58986
S001180,N00030071,Kurt Schrader (D),2012,Forestry & Forest Products,20750,35500,56250
S001180,N00030071,Kurt Schrader (D),2012,Public Sector Unions,210,53500,53710
S001180,N00030071,Kurt Schrader (D),2012,Misc Manufacturing & Distributing,24550,23124,47674
R000588,N00030184,Cedric Richmond (D),2012,Lawyers/Law Firms,89950,31044,120994
R000588,N00030184,Cedric Richmond (D),2012,Transportation Unions,0,43171,43171
R000588,N00030184,Cedric Richmond (D),2012,Building Trade Unions,0,43000,43000
R000588,N00030184,Cedric Richmond (D),2012,Sea Transport,10511,32186,42697
R000588,N00030184,Cedric Richmond (D),2012,Lobbyists,35800,2000,37800
R000588,N00030184,Cedric Richmond (D),2012,Public Sector Unions,0,28500,28500
R000588,N00030184,Cedric Richmond (D),2012,Construction Services,12100,14000,26100
R000588,N00030184,Cedric Richmond (D),2012,Oil & Gas,1000,23750,24750
R000588,N00030184,Cedric Richmond (D),2012,Pharmaceuticals/Health Products,0,23500,23500
R000588,N00030184,Cedric Richmond (D),2012,Leadership PACs,0,23000,23000
T000468,N00030191,Dina Titus (D),2012,Lawyers/Law Firms,55550,18750,74300
T000468,N00030191,Dina Titus (D),2012,Retired,67875,0,67875
T000468,N00030191,Dina Titus (D),2012,Leadership PACs,0,63600,63600
T000468,N00030191,Dina Titus (D),2012,Building Trade Unions,0,63000,63000
T000468,N00030191,Dina Titus (D),2012,Public Sector Unions,0,50500,50500
T000468,N00030191,Dina Titus (D),2012,Health Professionals,40600,8500,49100
T000468,N00030191,Dina Titus (D),2012,Casinos/Gambling,20800,26250,47050
T000468,N00030191,Dina Titus (D),2012,Real Estate,27400,15000,42400
T000468,N00030191,Dina Titus (D),2012,Women's Issues,27850,3157,31007
T000468,N00030191,Dina Titus (D),2012,Misc Unions,400,28250,28650
T000469,N00030196,Paul Tonko (D),2012,Public Sector Unions,0,67000,67000
T000469,N00030196,Paul Tonko (D),2012,Building Trade Unions,250,54500,54750
T000469,N00030196,Paul Tonko (D),2012,Health Professionals,9350,39500,48850
T000469,N00030196,Paul Tonko (D),2012,Industrial Unions,0,46000,46000
T000469,N00030196,Paul Tonko (D),2012,Lawyers/Law Firms,21362,18750,40112
T000469,N00030196,Paul Tonko (D),2012,Lobbyists,27348,2477,29825
T000469,N00030196,Paul Tonko (D),2012,Transportation Unions,0,25000,25000
T000469,N00030196,Paul Tonko (D),2012,Crop Production & Basic Processing,1250,22500,23750
T000469,N00030196,Paul Tonko (D),2012,Misc Manufacturing & Distributing,5350,18000,23350
T000469,N00030196,Paul Tonko (D),2012,Real Estate,17250,6000,23250
H001051,N00030197,Richard Hanna (R),2012,Securities & Investment,84566,19000,103566
H001051,N00030197,Richard Hanna (R),2012,General Contractors,42419,29753,72172
H001051,N00030197,Richard Hanna (R),2012,Leadership PACs,0,58000,58000
H001051,N00030197,Richard Hanna (R),2012,Air Transport,0,49999,49999
H001051,N00030197,Richard Hanna (R),2012,Insurance,0,35500,35500
H001051,N00030197,Richard Hanna (R),2012,Republican/Conservative,3250,27500,30750
H001051,N00030197,Richard Hanna (R),2012,Real Estate,18133,9000,27133
H001051,N00030197,Richard Hanna (R),2012,Retired,26166,0,26166
H001051,N00030197,Richard Hanna (R),2012,Lawyers/Law Firms,19798,5500,25298
H001051,N00030197,Richard Hanna (R),2012,Health Professionals,11550,13500,25050
C001075,N00030245,Bill Cassidy (R),2012,Health Professionals,111902,169000,280902
C001075,N00030245,Bill Cassidy (R),2012,Oil & Gas,78600,67250,145850
C001075,N00030245,Bill Cassidy (R),2012,Health Services/HMOs,24000,60191,84191
C001075,N00030245,Bill Cassidy (R),2012,Pharmaceuticals/Health Products,8453,64750,73203
C001075,N00030245,Bill Cassidy (R),2012,General Contractors,53350,2000,55350
C001075,N00030245,Bill Cassidy (R),2012,Lobbyists,50965,500,51465
C001075,N00030245,Bill Cassidy (R),2012,Retired,50300,0,50300
C001075,N00030245,Bill Cassidy (R),2012,Hospitals/Nursing Homes,32145,18000,50145
C001075,N00030245,Bill Cassidy (R),2012,Insurance,23881,23750,47631
C001075,N00030245,Bill Cassidy (R),2012,Lawyers/Law Firms,29400,14784,44184
S001177,N00030418,Gregorio Sablan (D),2012,Candidate Committees,0,12000,12000
S001177,N00030418,Gregorio Sablan (D),2012,Leadership PACs,0,9250,9250
S001177,N00030418,Gregorio Sablan (D),2012,Misc Business,9000,0,9000
S001177,N00030418,Gregorio Sablan (D),2012,Human Rights,0,7000,7000
S001177,N00030418,Gregorio Sablan (D),2012,Lawyers/Law Firms,4500,1000,5500
S001177,N00030418,Gregorio Sablan (D),2012,Retired,2900,0,2900
S001177,N00030418,Gregorio Sablan (D),2012,Industrial Unions,0,2500,2500
S001177,N00030418,Gregorio Sablan (D),2012,Building Trade Unions,0,2500,2500
S001177,N00030418,Gregorio Sablan (D),2012,Commercial Banks,1400,0,1400
S001177,N00030418,Gregorio Sablan (D),2012,General Contractors,1100,0,1100
S001177,N00030418,Gregorio Sablan (D),2012,Misc Finance,1100,0,1100
F000455,N00030490,Marcia L Fudge (D),2012,Public Sector Unions,0,43500,43500
F000455,N00030490,Marcia L Fudge (D),2012,Building Trade Unions,0,42000,42000
F000455,N00030490,Marcia L Fudge (D),2012,Transportation Unions,0,34000,34000
F000455,N00030490,Marcia L Fudge (D),2012,Food Processing & Sales,250,27000,27250
F000455,N00030490,Marcia L Fudge (D),2012,Lawyers/Law Firms,7204,19525,26729
F000455,N00030490,Marcia L Fudge (D),2012,Food & Beverage,1750,23500,25250
F000455,N00030490,Marcia L Fudge (D),2012,Industrial Unions,0,24500,24500
F000455,N00030490,Marcia L Fudge (D),2012,Pharmaceuticals/Health Products,500,17500,18000
F000455,N00030490,Marcia L Fudge (D),2012,Real Estate,9425,8010,17435
F000455,N00030490,Marcia L Fudge (D),2012,Electric Utilities,1250,16025,17275
Q000023,N00030581,Mike Quigley (D),2012,Lawyers/Law Firms,49723,13999,63722
Q000023,N00030581,Mike Quigley (D),2012,Securities & Investment,44550,18500,63050
Q000023,N00030581,Mike Quigley (D),2012,Building Trade Unions,1000,29500,30500
Q000023,N00030581,Mike Quigley (D),2012,Business Services,21650,6000,27650
Q000023,N00030581,Mike Quigley (D),2012,Real Estate,16500,8000,24500
Q000023,N00030581,Mike Quigley (D),2012,Pro-Israel,22750,1600,24350
Q000023,N00030581,Mike Quigley (D),2012,Public Sector Unions,250,20000,20250
Q000023,N00030581,Mike Quigley (D),2012,Transportation Unions,0,19300,19300
Q000023,N00030581,Mike Quigley (D),2012,Accountants,1000,16935,17935
Q000023,N00030581,Mike Quigley (D),2012,Food & Beverage,9800,7500,17300
C001080,N00030600,Judy Chu (D),2012,Lawyers/Law Firms,48033,18500,66533
C001080,N00030600,Judy Chu (D),2012,Building Trade Unions,0,49500,49500
C001080,N00030600,Judy Chu (D),2012,Public Sector Unions,500,47000,47500
C001080,N00030600,Judy Chu (D),2012,Health Professionals,30551,11100,41651
C001080,N00030600,Judy Chu (D),2012,Real Estate,31600,8000,39600
C001080,N00030600,Judy Chu (D),2012,TV/Movies/Music,20550,18000,38550
C001080,N00030600,Judy Chu (D),2012,Industrial Unions,0,38500,38500
C001080,N00030600,Judy Chu (D),2012,Misc Unions,0,35500,35500
C001080,N00030600,Judy Chu (D),2012,Retired,34136,0,34136
C001080,N00030600,Judy Chu (D),2012,Human Rights,24616,7500,32116
W000816,N00030602,Roger Williams (R),2012,Oil & Gas,308808,33500,342308
W000816,N00030602,Roger Williams (R),2012,Retired,331726,0,331726
W000816,N00030602,Roger Williams (R),2012,Automotive,251050,32000,283050
W000816,N00030602,Roger Williams (R),2012,Real Estate,230226,11300,241526
W000816,N00030602,Roger Williams (R),2012,Lawyers/Law Firms,200200,2000,202200
W000816,N00030602,Roger Williams (R),2012,Securities & Investment,144950,7500,152450
W000816,N00030602,Roger Williams (R),2012,Misc Finance,117879,500,118379
W000816,N00030602,Roger Williams (R),2012,Health Professionals,98250,9500,107750
W000816,N00030602,Roger Williams (R),2012,Commercial Banks,85830,5000,90830
W000816,N00030602,Roger Williams (R),2012,Insurance,61374,5000,66374
B001267,N00030608,Michael F Bennet (D),2012,Lawyers/Law Firms,1269183,147401,1416584
B001267,N00030608,Michael F Bennet (D),2012,Securities & Investment,1310974,100000,1410974
B001267,N00030608,Michael F Bennet (D),2012,Retired,686270,0,686270
B001267,N00030608,Michael F Bennet (D),2012,Real Estate,495470,90500,585970
B001267,N00030608,Michael F Bennet (D),2012,Lobbyists,334412,17000,351412
B001267,N00030608,Michael F Bennet (D),2012,Leadership PACs,250,345262,345512
B001267,N00030608,Michael F Bennet (D),2012,Misc Finance,317907,14500,332407
B001267,N00030608,Michael F Bennet (D),2012,Education,303955,25100,329055
B001267,N00030608,Michael F Bennet (D),2012,Business Services,311051,14000,325051
B001267,N00030608,Michael F Bennet (D),2012,TV/Movies/Music,272166,28000,300166
R000595,N00030612,Marco Rubio (R),2012,Retired,2511515,0,2511515
R000595,N00030612,Marco Rubio (R),2012,Republican/Conservative,904993,70600,975593
R000595,N00030612,Marco Rubio (R),2012,Securities & Investment,934623,28500,963123
R000595,N00030612,Marco Rubio (R),2012,Real Estate,641344,33800,675144
R000595,N00030612,Marco Rubio (R),2012,Lawyers/Law Firms,402410,75893,478303
R000595,N00030612,Marco Rubio (R),2012,Health Professionals,413957,51500,465457
R000595,N00030612,Marco Rubio (R),2012,Misc Finance,413486,1000,414486
R000595,N00030612,Marco Rubio (R),2012,Insurance,269540,135500,405040
R000595,N00030612,Marco Rubio (R),2012,Leadership PACs,96494,251766,348260
R000595,N00030612,Marco Rubio (R),2012,General Contractors,265635,18500,284135
S001185,N00030622,Terri A Sewell (D),2012,Lawyers/Law Firms,105850,36750,142600
S001185,N00030622,Terri A Sewell (D),2012,Securities & Investment,22750,37500,60250
S001185,N00030622,Terri A Sewell (D),2012,Insurance,11250,37500,48750
S001185,N00030622,Terri A Sewell (D),2012,Commercial Banks,9500,38500,48000
S001185,N00030622,Terri A Sewell (D),2012,Crop Production & Basic Processing,2300,39000,41300
S001185,N00030622,Terri A Sewell (D),2012,Industrial Unions,0,39000,39000
S001185,N00030622,Terri A Sewell (D),2012,Electric Utilities,6250,31000,37250
S001185,N00030622,Terri A Sewell (D),2012,Building Trade Unions,0,27500,27500
S001185,N00030622,Terri A Sewell (D),2012,Agricultural Services/Products,1000,25000,26000
S001185,N00030622,Terri A Sewell (D),2012,Forestry & Forest Products,1000,24500,25500
L000586,N00030642,Alfred Lawson Jr (D),2012,Lawyers/Law Firms,53225,10000,63225
L000586,N00030642,Alfred Lawson Jr (D),2012,Leadership PACs,0,54500,54500
L000586,N00030642,Alfred Lawson Jr (D),2012,Public Sector Unions,2750,48000,50750
L000586,N00030642,Alfred Lawson Jr (D),2012,Candidate Committees,0,40500,40500
L000586,N00030642,Alfred Lawson Jr (D),2012,Education,28750,0,28750
L000586,N00030642,Alfred Lawson Jr (D),2012,Retired,26835,0,26835
L000586,N00030642,Alfred Lawson Jr (D),2012,Building Trade Unions,0,26000,26000
L000586,N00030642,Alfred Lawson Jr (D),2012,Industrial Unions,0,21000,21000
L000586,N00030642,Alfred Lawson Jr (D),2012,Business Services,17979,0,17979
L000586,N00030642,Alfred Lawson Jr (D),2012,Fisheries & Wildlife,17650,0,17650
R000593,N00030645,Dennis Ross (R),2012,Insurance,3250,49500,52750
R000593,N00030645,Dennis Ross (R),2012,Health Professionals,14802,32000,46802
R000593,N00030645,Dennis Ross (R),2012,Retail Sales,0,34000,34000
R000593,N00030645,Dennis Ross (R),2012,Leadership PACs,0,32500,32500
R000593,N00030645,Dennis Ross (R),2012,Food & Beverage,500,29000,29500
R000593,N00030645,Dennis Ross (R),2012,Lawyers/Law Firms,16801,12263,29064
R000593,N00030645,Dennis Ross (R),2012,Retired,27334,0,27334
R000593,N00030645,Dennis Ross (R),2012,Crop Production & Basic Processing,6101,20000,26101
R000593,N00030645,Dennis Ross (R),2012,TV/Movies/Music,10500,13000,23500
R000593,N00030645,Dennis Ross (R),2012,Accountants,3250,19000,22250
W000808,N00030650,Frederica Wilson (D),2012,Industrial Unions,0,57500,57500
W000808,N00030650,Frederica Wilson (D),2012,Public Sector Unions,0,44500,44500
W000808,N00030650,Frederica Wilson (D),2012,Lawyers/Law Firms,22750,14500,37250
W000808,N00030650,Frederica Wilson (D),2012,Building Trade Unions,0,35500,35500
W000808,N00030650,Frederica Wilson (D),2012,Transportation Unions,0,24000,24000
W000808,N00030650,Frederica Wilson (D),2012,Leadership PACs,0,24000,24000
W000808,N00030650,Frederica Wilson (D),2012,Retired,22870,0,22870
W000808,N00030650,Frederica Wilson (D),2012,Crop Production & Basic Processing,7500,13000,20500
W000808,N00030650,Frederica Wilson (D),2012,Pro-Israel,12000,4500,16500
W000808,N00030650,Frederica Wilson (D),2012,Lobbyists,11500,1000,12500
K000378,N00030667,Adam Kinzinger (R),2012,Leadership PACs,0,93500,93500
K000378,N00030667,Adam Kinzinger (R),2012,Securities & Investment,82650,7500,90150
K000378,N00030667,Adam Kinzinger (R),2012,Insurance,26250,56500,82750
K000378,N00030667,Adam Kinzinger (R),2012,Health Professionals,13550,65500,79050
K000378,N00030667,Adam Kinzinger (R),2012,Electric Utilities,21750,56000,77750
K000378,N00030667,Adam Kinzinger (R),2012,Pharmaceuticals/Health Products,11700,46500,58200
K000378,N00030667,Adam Kinzinger (R),2012,Lobbyists,56949,1000,57949
K000378,N00030667,Adam Kinzinger (R),2012,Chemical & Related Manufacturing,19250,36500,55750
K000378,N00030667,Adam Kinzinger (R),2012,Real Estate,27500,27000,54500
K000378,N00030667,Adam Kinzinger (R),2012,Oil & Gas,4812,48625,53437
Y000064,N00030670,Todd Young (R),2012,Retired,140240,0,140240
Y000064,N00030670,Todd Young (R),2012,Health Professionals,72100,20000,92100
Y000064,N00030670,Todd Young (R),2012,Real Estate,49750,12500,62250
Y000064,N00030670,Todd Young (R),2012,General Contractors,44985,11000,55985
Y000064,N00030670,Todd Young (R),2012,Lawyers/Law Firms,48800,4000,52800
Y000064,N00030670,Todd Young (R),2012,Leadership PACs,1500,49249,50749
Y000064,N00030670,Todd Young (R),2012,Building Materials & Equipment,44250,2500,46750
Y000064,N00030670,Todd Young (R),2012,Misc Finance,38750,0,38750
Y000064,N00030670,Todd Young (R),2012,Pharmaceuticals/Health Products,17084,20000,37084
Y000064,N00030670,Todd Young (R),2012,Defense Aerospace,0,36500,36500
H001058,N00030673,Bill Huizenga (R),2012,Real Estate,69175,51500,120675
H001058,N00030673,Bill Huizenga (R),2012,Insurance,7000,97165,104165
H001058,N00030673,Bill Huizenga (R),2012,Securities & Investment,21800,42500,64300
H001058,N00030673,Bill Huizenga (R),2012,Commercial Banks,4500,57500,62000
H001058,N00030673,Bill Huizenga (R),2012,Misc Manufacturing & Distributing,36200,14000,50200
H001058,N00030673,Bill Huizenga (R),2012,Leadership PACs,500,40879,41379
H001058,N00030673,Bill Huizenga (R),2012,Retail Sales,23500,10500,34000
H001058,N00030673,Bill Huizenga (R),2012,Accountants,2250,31411,33661
H001058,N00030673,Bill Huizenga (R),2012,Finance/Credit Companies,2500,28500,31000
H001058,N00030673,Bill Huizenga (R),2012,Electric Utilities,750,29000,29750
L000576,N00030676,Billy Long (R),2012,Misc Finance,48700,0,48700
L000576,N00030676,Billy Long (R),2012,Retired,45700,0,45700
L000576,N00030676,Billy Long (R),2012,Real Estate,30750,10490,41240
L000576,N00030676,Billy Long (R),2012,Leadership PACs,0,40500,40500
L000576,N00030676,Billy Long (R),2012,Health Professionals,15100,22000,37100
L000576,N00030676,Billy Long (R),2012,Trucking,25250,11000,36250
L000576,N00030676,Billy Long (R),2012,Commercial Banks,12150,23500,35650
L000576,N00030676,Billy Long (R),2012,Automotive,14000,21500,35500
L000576,N00030676,Billy Long (R),2012,Air Transport,0,31500,31500
L000576,N00030676,Billy Long (R),2012,Misc Manufacturing & Distributing,10750,18000,28750
D000617,N00030693,Suzan DelBene (D),2012,Electronics Mfg & Equip,171900,0,171900
D000617,N00030693,Suzan DelBene (D),2012,Retired,103775,0,103775
D000617,N00030693,Suzan DelBene (D),2012,Lawyers/Law Firms,56742,10000,66742
D000617,N00030693,Suzan DelBene (D),2012,Leadership PACs,0,57000,57000
D000617,N00030693,Suzan DelBene (D),2012,Women's Issues,46795,6250,53045
D000617,N00030693,Suzan DelBene (D),2012,Business Services,51550,0,51550
D000617,N00030693,Suzan DelBene (D),2012,Industrial Unions,0,50000,50000
D000617,N00030693,Suzan DelBene (D),2012,Building Trade Unions,0,44500,44500
D000617,N00030693,Suzan DelBene (D),2012,Public Sector Unions,500,43500,44000
D000617,N00030693,Suzan DelBene (D),2012,Abortion Policy/Pro-Abortion Rights,26800,15000,41800
B001287,N00030717,Ami Bera (D),2012,Retired,322147,0,322147
B001287,N00030717,Ami Bera (D),2012,Health Professionals,125300,153499,278799
B001287,N00030717,Ami Bera (D),2012,Lawyers/Law Firms,129870,10000,139870
B001287,N00030717,Ami Bera (D),2012,Education,113699,0,113699
B001287,N00030717,Ami Bera (D),2012,Leadership PACs,0,106500,106500
B001287,N00030717,Ami Bera (D),2012,Electronics Mfg & Equip,95800,1000,96800
B001287,N00030717,Ami Bera (D),2012,Democratic/Liberal,67465,19370,86835
B001287,N00030717,Ami Bera (D),2012,Public Sector Unions,250,78300,78550
B001287,N00030717,Ami Bera (D),2012,Building Trade Unions,500,62000,62500
B001287,N00030717,Ami Bera (D),2012,Abortion Policy/Pro-Abortion Rights,34901,21000,55901
C001083,N00030736,John Carney (D),2012,Lawyers/Law Firms,168750,17100,185850
C001083,N00030736,John Carney (D),2012,Securities & Investment,20200,110000,130200
C001083,N00030736,John Carney (D),2012,Insurance,5750,121500,127250
C001083,N00030736,John Carney (D),2012,Commercial Banks,8550,73000,81550
C001083,N00030736,John Carney (D),2012,Real Estate,28125,51500,79625
C001083,N00030736,John Carney (D),2012,Pharmaceuticals/Health Products,15400,54952,70352
C001083,N00030736,John Carney (D),2012,Finance/Credit Companies,6500,51000,57500
C001083,N00030736,John Carney (D),2012,Accountants,0,45500,45500
C001083,N00030736,John Carney (D),2012,Retired,43190,0,43190
C001083,N00030736,John Carney (D),2012,Lobbyists,37301,0,37301
P000602,N00030744,Mike Pompeo (R),2012,Oil & Gas,209800,87000,296800
P000602,N00030744,Mike Pompeo (R),2012,Health Professionals,37750,54500,92250
P000602,N00030744,Mike Pompeo (R),2012,Air Transport,28500,51499,79999
P000602,N00030744,Mike Pompeo (R),2012,Retired,60650,0,60650
P000602,N00030744,Mike Pompeo (R),2012,Commercial Banks,43480,14000,57480
P000602,N00030744,Mike Pompeo (R),2012,Insurance,16500,33500,50000
P000602,N00030744,Mike Pompeo (R),2012,Lawyers/Law Firms,37200,11600,48800
P000602,N00030744,Mike Pompeo (R),2012,Electric Utilities,6000,40500,46500
P000602,N00030744,Mike Pompeo (R),2012,Leadership PACs,0,45000,45000
P000602,N00030744,Mike Pompeo (R),2012,Hospitals/Nursing Homes,26750,16500,43250
D000615,N00030752,Jeff Duncan (R),2012,Oil & Gas,1900,40000,41900
D000615,N00030752,Jeff Duncan (R),2012,Health Professionals,3700,27000,30700
D000615,N00030752,Jeff Duncan (R),2012,Insurance,3500,26000,29500
D000615,N00030752,Jeff Duncan (R),2012,Real Estate,6700,17500,24200
D000615,N00030752,Jeff Duncan (R),2012,Electric Utilities,4150,19000,23150
D000615,N00030752,Jeff Duncan (R),2012,Lawyers/Law Firms,11700,9500,21200
D000615,N00030752,Jeff Duncan (R),2012,Misc Manufacturing & Distributing,5000,16000,21000
D000615,N00030752,Jeff Duncan (R),2012,Leadership PACs,0,21000,21000
D000615,N00030752,Jeff Duncan (R),2012,General Contractors,6450,14000,20450
D000615,N00030752,Jeff Duncan (R),2012,Retail Sales,500,18500,19000
R000591,N00030768,Martha Roby (R),2012,Leadership PACs,0,86890,86890
R000591,N00030768,Martha Roby (R),2012,Crop Production & Basic Processing,7550,47752,55302
R000591,N00030768,Martha Roby (R),2012,Real Estate,44300,10500,54800
R000591,N00030768,Martha Roby (R),2012,Retired,45500,0,45500
R000591,N00030768,Martha Roby (R),2012,Defense Aerospace,0,42500,42500
R000591,N00030768,Martha Roby (R),2012,Insurance,4050,32000,36050
R000591,N00030768,Martha Roby (R),2012,Health Professionals,13350,22500,35850
R000591,N00030768,Martha Roby (R),2012,General Contractors,20250,12000,32250
R000591,N00030768,Martha Roby (R),2012,Lawyers/Law Firms,15308,13000,28308
R000591,N00030768,Martha Roby (R),2012,Agricultural Services/Products,0,25500,25500
C001087,N00030770,Rick Crawford (R),2012,Crop Production & Basic Processing,68850,52000,120850
C001087,N00030770,Rick Crawford (R),2012,Leadership PACs,0,101500,101500
C001087,N00030770,Rick Crawford (R),2012,Health Professionals,47766,14000,61766
C001087,N00030770,Rick Crawford (R),2012,Securities & Investment,40600,20000,60600
C001087,N00030770,Rick Crawford (R),2012,Retired,43014,0,43014
C001087,N00030770,Rick Crawford (R),2012,Retail Sales,12500,20000,32500
C001087,N00030770,Rick Crawford (R),2012,Agricultural Services/Products,4250,27000,31250
C001087,N00030770,Rick Crawford (R),2012,Candidate Committees,0,31000,31000
C001087,N00030770,Rick Crawford (R),2012,Oil & Gas,14772,15000,29772
C001087,N00030770,Rick Crawford (R),2012,Commercial Banks,13111,16500,29611
G000565,N00030771,Paul Gosar (R),2012,Health Professionals,216781,82000,298781
G000565,N00030771,Paul Gosar (R),2012,Leadership PACs,0,65397,65397
G000565,N00030771,Paul Gosar (R),2012,Retired,35566,0,35566
G000565,N00030771,Paul Gosar (R),2012,Electric Utilities,6500,28000,34500
G000565,N00030771,Paul Gosar (R),2012,Lawyers/Law Firms,19800,6750,26550
G000565,N00030771,Paul Gosar (R),2012,Casinos/Gambling,23750,1000,24750
G000565,N00030771,Paul Gosar (R),2012,Business Services,24750,0,24750
G000565,N00030771,Paul Gosar (R),2012,Food Processing & Sales,13250,10000,23250
G000565,N00030771,Paul Gosar (R),2012,Crop Production & Basic Processing,16700,5000,21700
G000565,N00030771,Paul Gosar (R),2012,Food & Beverage,8000,13000,21000
G000562,N00030780,Cory Gardner (R),2012,Oil & Gas,71550,128000,199550
G000562,N00030780,Cory Gardner (R),2012,Retired,110901,0,110901
G000562,N00030780,Cory Gardner (R),2012,Real Estate,55356,30500,85856
G000562,N00030780,Cory Gardner (R),2012,Telecom Services,30480,41000,71480
G000562,N00030780,Cory Gardner (R),2012,Pharmaceuticals/Health Products,8000,62500,70500
G000562,N00030780,Cory Gardner (R),2012,Electric Utilities,2500,67000,69500
G000562,N00030780,Cory Gardner (R),2012,Health Professionals,4150,63500,67650
G000562,N00030780,Cory Gardner (R),2012,Lawyers/Law Firms,45139,18750,63889
G000562,N00030780,Cory Gardner (R),2012,Crop Production & Basic Processing,32450,21250,53700
G000562,N00030780,Cory Gardner (R),2012,Misc Manufacturing & Distributing,33900,19500,53400
G000560,N00030788,Tom Graves (R),2012,Health Professionals,40900,33500,74400
G000560,N00030788,Tom Graves (R),2012,Real Estate,32849,25500,58349
G000560,N00030788,Tom Graves (R),2012,Textiles,41408,6000,47408
G000560,N00030788,Tom Graves (R),2012,Retired,43710,0,43710
G000560,N00030788,Tom Graves (R),2012,Misc Manufacturing & Distributing,18500,19184,37684
G000560,N00030788,Tom Graves (R),2012,Oil & Gas,3750,30000,33750
G000560,N00030788,Tom Graves (R),2012,Lawyers/Law Firms,20333,10500,30833
G000560,N00030788,Tom Graves (R),2012,Leadership PACs,0,29122,29122
G000560,N00030788,Tom Graves (R),2012,Food & Beverage,5000,20250,25250
G000560,N00030788,Tom Graves (R),2012,"Beer, Wine & Liquor",11000,13000,24000
G000570,N00030801,Frank Guinta (R),2012,Leadership PACs,0,170017,170017
G000570,N00030801,Frank Guinta (R),2012,Insurance,47925,67500,115425
G000570,N00030801,Frank Guinta (R),2012,Real Estate,63308,25500,88808
G000570,N00030801,Frank Guinta (R),2012,Retired,80350,0,80350
G000570,N00030801,Frank Guinta (R),2012,Securities & Investment,54915,22000,76915
G000570,N00030801,Frank Guinta (R),2012,Candidate Committees,250,52500,52750
G000570,N00030801,Frank Guinta (R),2012,Food & Beverage,21100,29000,50100
G000570,N00030801,Frank Guinta (R),2012,Health Professionals,17100,30500,47600
G000570,N00030801,Frank Guinta (R),2012,Automotive,22192,21000,43192
G000570,N00030801,Frank Guinta (R),2012,Air Transport,3250,38134,41384
F000459,N00030815,Chuck Fleischmann (R),2012,Leadership PACs,0,104000,104000
F000459,N00030815,Chuck Fleischmann (R),2012,General Contractors,64050,17500,81550
F000459,N00030815,Chuck Fleischmann (R),2012,Real Estate,55250,13000,68250
F000459,N00030815,Chuck Fleischmann (R),2012,Lawyers/Law Firms,42850,15000,57850
F000459,N00030815,Chuck Fleischmann (R),2012,Insurance,32750,24000,56750
F000459,N00030815,Chuck Fleischmann (R),2012,Health Professionals,29600,25500,55100
F000459,N00030815,Chuck Fleischmann (R),2012,Retired,32100,0,32100
F000459,N00030815,Chuck Fleischmann (R),2012,Automotive,14000,15000,29000
F000459,N00030815,Chuck Fleischmann (R),2012,"Beer, Wine & Liquor",4300,22000,26300
F000459,N00030815,Chuck Fleischmann (R),2012,Business Services,15500,9000,24500
P000603,N00030836,Rand Paul (R),2012,Retired,515558,0,515558
P000603,N00030836,Rand Paul (R),2012,Health Professionals,309732,61000,370732
P000603,N00030836,Rand Paul (R),2012,Republican/Conservative,231890,42750,274640
P000603,N00030836,Rand Paul (R),2012,Securities & Investment,201697,5500,207197
P000603,N00030836,Rand Paul (R),2012,Leadership PACs,32085,156220,188305
P000603,N00030836,Rand Paul (R),2012,Mining,121110,22350,143460
P000603,N00030836,Rand Paul (R),2012,Lawyers/Law Firms,131654,8050,139704
P000603,N00030836,Rand Paul (R),2012,Misc Finance,125148,2000,127148
P000603,N00030836,Rand Paul (R),2012,Real Estate,112350,4000,116350
P000603,N00030836,Rand Paul (R),2012,Oil & Gas,81500,34750,116250
G000559,N00030856,John Garamendi (D),2012,Lawyers/Law Firms,79051,30250,109301
G000559,N00030856,John Garamendi (D),2012,Leadership PACs,0,103000,103000
G000559,N00030856,John Garamendi (D),2012,Real Estate,75215,6000,81215
G000559,N00030856,John Garamendi (D),2012,Public Sector Unions,0,75590,75590
G000559,N00030856,John Garamendi (D),2012,Building Trade Unions,0,75000,75000
G000559,N00030856,John Garamendi (D),2012,Retired,74150,0,74150
G000559,N00030856,John Garamendi (D),2012,"Beer, Wine & Liquor",51251,15500,66751
G000559,N00030856,John Garamendi (D),2012,Candidate Committees,0,56250,56250
G000559,N00030856,John Garamendi (D),2012,Insurance,32700,21000,53700
G000559,N00030856,John Garamendi (D),2012,Transportation Unions,0,50250,50250
K000382,N00030875,Ann Mclane Kuster (D),2012,Retired,338225,0,338225
K000382,N00030875,Ann Mclane Kuster (D),2012,Women's Issues,202989,30250,233239
K000382,N00030875,Ann Mclane Kuster (D),2012,Lawyers/Law Firms,132604,10000,142604
K000382,N00030875,Ann Mclane Kuster (D),2012,Democratic/Liberal,91143,27301,118444
K000382,N00030875,Ann Mclane Kuster (D),2012,Leadership PACs,250,96500,96750
K000382,N00030875,Ann Mclane Kuster (D),2012,Education,85800,0,85800
K000382,N00030875,Ann Mclane Kuster (D),2012,Public Sector Unions,0,78000,78000
K000382,N00030875,Ann Mclane Kuster (D),2012,Securities & Investment,66000,0,66000
K000382,N00030875,Ann Mclane Kuster (D),2012,Building Trade Unions,0,64500,64500
K000382,N00030875,Ann Mclane Kuster (D),2012,Pro-Israel,52060,5770,57830
G000566,N00030880,Trey Gowdy (R),2012,Health Professionals,15650,31000,46650
G000566,N00030880,Trey Gowdy (R),2012,Insurance,11350,22394,33744
G000566,N00030880,Trey Gowdy (R),2012,Leadership PACs,0,32272,32272
G000566,N00030880,Trey Gowdy (R),2012,Misc Manufacturing & Distributing,500,28000,28500
G000566,N00030880,Trey Gowdy (R),2012,Accountants,2250,23000,25250
G000566,N00030880,Trey Gowdy (R),2012,Lawyers/Law Firms,19100,2750,21850
G000566,N00030880,Trey Gowdy (R),2012,Lobbyists,21050,500,21550
G000566,N00030880,Trey Gowdy (R),2012,Real Estate,7750,13500,21250
G000566,N00030880,Trey Gowdy (R),2012,Textiles,10000,9000,19000
G000566,N00030880,Trey Gowdy (R),2012,Retired,18375,0,18375
S001188,N00030891,Marlin Stutzman (R),2012,Health Professionals,18700,37999,56699
S001188,N00030891,Marlin Stutzman (R),2012,Crop Production & Basic Processing,27925,19000,46925
S001188,N00030891,Marlin Stutzman (R),2012,Agricultural Services/Products,7400,34000,41400
S001188,N00030891,Marlin Stutzman (R),2012,Misc Manufacturing & Distributing,18808,22000,40808
S001188,N00030891,Marlin Stutzman (R),2012,Leadership PACs,0,36770,36770
S001188,N00030891,Marlin Stutzman (R),2012,Insurance,7800,24000,31800
S001188,N00030891,Marlin Stutzman (R),2012,Retired,30699,0,30699
S001188,N00030891,Marlin Stutzman (R),2012,Pharmaceuticals/Health Products,6150,24000,30150
S001188,N00030891,Marlin Stutzman (R),2012,Retail Sales,16500,7000,23500
S001188,N00030891,Marlin Stutzman (R),2012,Food Processing & Sales,15200,6500,21700
B001274,N00030910,Mo Brooks (R),2012,Defense Aerospace,14920,75500,90420
B001274,N00030910,Mo Brooks (R),2012,Misc Defense,37300,34500,71800
B001274,N00030910,Mo Brooks (R),2012,Lawyers/Law Firms,34060,19500,53560
B001274,N00030910,Mo Brooks (R),2012,Health Professionals,28000,25000,53000
B001274,N00030910,Mo Brooks (R),2012,Defense Electronics,2300,48500,50800
B001274,N00030910,Mo Brooks (R),2012,Leadership PACs,0,35898,35898
B001274,N00030910,Mo Brooks (R),2012,Electronics Mfg & Equip,19580,15950,35530
B001274,N00030910,Mo Brooks (R),2012,Retired,33700,0,33700
B001274,N00030910,Mo Brooks (R),2012,Misc Manufacturing & Distributing,3750,22500,26250
B001274,N00030910,Mo Brooks (R),2012,Real Estate,12600,9000,21600
R000585,N00030949,Tom Reed (R),2012,Real Estate,93333,51000,144333
R000585,N00030949,Tom Reed (R),2012,Securities & Investment,77666,58000,135666
R000585,N00030949,Tom Reed (R),2012,Oil & Gas,37121,80400,117521
R000585,N00030949,Tom Reed (R),2012,Insurance,4293,108212,112505
R000585,N00030949,Tom Reed (R),2012,Health Professionals,3800,84689,88489
R000585,N00030949,Tom Reed (R),2012,Lobbyists,75473,1129,76602
R000585,N00030949,Tom Reed (R),2012,Electronics Mfg & Equip,40500,31000,71500
R000585,N00030949,Tom Reed (R),2012,Lawyers/Law Firms,40120,27400,67520
R000585,N00030949,Tom Reed (R),2012,Air Transport,0,62133,62133
R000585,N00030949,Tom Reed (R),2012,"Beer, Wine & Liquor",18250,36250,54500
D000616,N00030957,Scott Desjarlais (R),2012,Leadership PACs,0,137000,137000
D000616,N00030957,Scott Desjarlais (R),2012,Health Professionals,81399,49884,131283
D000616,N00030957,Scott Desjarlais (R),2012,Retired,57460,0,57460
D000616,N00030957,Scott Desjarlais (R),2012,Real Estate,27800,14000,41800
D000616,N00030957,Scott Desjarlais (R),2012,Crop Production & Basic Processing,13500,23000,36500
D000616,N00030957,Scott Desjarlais (R),2012,Hospitals/Nursing Homes,15850,18500,34350
D000616,N00030957,Scott Desjarlais (R),2012,Insurance,13700,18500,32200
D000616,N00030957,Scott Desjarlais (R),2012,Lawyers/Law Firms,29550,2000,31550
D000616,N00030957,Scott Desjarlais (R),2012,Misc Manufacturing & Distributing,23672,7500,31172
D000616,N00030957,Scott Desjarlais (R),2012,Food & Beverage,5500,25500,31000
R000589,N00030962,Scott Rigell (R),2012,Retired,148658,0,148658
R000589,N00030962,Scott Rigell (R),2012,Real Estate,109350,9500,118850
R000589,N00030962,Scott Rigell (R),2012,Automotive,82965,31500,114465
R000589,N00030962,Scott Rigell (R),2012,Leadership PACs,1250,109500,110750
R000589,N00030962,Scott Rigell (R),2012,Health Professionals,35175,27500,62675
R000589,N00030962,Scott Rigell (R),2012,Defense Aerospace,900,48499,49399
R000589,N00030962,Scott Rigell (R),2012,Commercial Banks,24250,23500,47750
R000589,N00030962,Scott Rigell (R),2012,Special Trade Contractors,43750,0,43750
R000589,N00030962,Scott Rigell (R),2012,Misc Defense,19950,22000,41950
R000589,N00030962,Scott Rigell (R),2012,Oil & Gas,16500,19500,36000
D000614,N00030967,Sean P Duffy (R),2012,Leadership PACs,0,201831,201831
D000614,N00030967,Sean P Duffy (R),2012,Retired,131248,0,131248
D000614,N00030967,Sean P Duffy (R),2012,Insurance,12450,117062,129512
D000614,N00030967,Sean P Duffy (R),2012,Health Professionals,89410,24750,114160
D000614,N00030967,Sean P Duffy (R),2012,Securities & Investment,50400,59650,110050
D000614,N00030967,Sean P Duffy (R),2012,Commercial Banks,27783,59250,87033
D000614,N00030967,Sean P Duffy (R),2012,Real Estate,32850,52000,84850
D000614,N00030967,Sean P Duffy (R),2012,Misc Manufacturing & Distributing,58300,17884,76184
D000614,N00030967,Sean P Duffy (R),2012,Republican/Conservative,28140,29250,57390
D000614,N00030967,Sean P Duffy (R),2012,Forestry & Forest Products,38750,10500,49250
R000587,N00030968,Reid Ribble (R),2012,Leadership PACs,0,160582,160582
R000587,N00030968,Reid Ribble (R),2012,Health Professionals,75890,61100,136990
R000587,N00030968,Reid Ribble (R),2012,Retired,116900,0,116900
R000587,N00030968,Reid Ribble (R),2012,Dairy,35750,38602,74352
R000587,N00030968,Reid Ribble (R),2012,Food Processing & Sales,36100,37000,73100
R000587,N00030968,Reid Ribble (R),2012,Misc Manufacturing & Distributing,33600,38999,72599
R000587,N00030968,Reid Ribble (R),2012,Insurance,13824,54600,68424
R000587,N00030968,Reid Ribble (R),2012,Forestry & Forest Products,23550,37000,60550
R000587,N00030968,Reid Ribble (R),2012,Special Trade Contractors,34550,21000,55550
R000587,N00030968,Reid Ribble (R),2012,Commercial Banks,27360,26000,53360
A000368,N00030980,Kelly Ayotte (R),2012,Securities & Investment,670014,28000,698014
A000368,N00030980,Kelly Ayotte (R),2012,Retired,353704,0,353704
A000368,N00030980,Kelly Ayotte (R),2012,Lobbyists,276480,2000,278480
A000368,N00030980,Kelly Ayotte (R),2012,Insurance,115966,154000,269966
A000368,N00030980,Kelly Ayotte (R),2012,Leadership PACs,4149,250650,254799
A000368,N00030980,Kelly Ayotte (R),2012,Lawyers/Law Firms,199415,31500,230915
A000368,N00030980,Kelly Ayotte (R),2012,Real Estate,167778,29810,197588
A000368,N00030980,Kelly Ayotte (R),2012,Misc Finance,144359,25000,169359
A000368,N00030980,Kelly Ayotte (R),2012,Oil & Gas,75718,84650,160368
A000368,N00030980,Kelly Ayotte (R),2012,Health Professionals,59035,85000,144035
H001053,N00031005,Vicky Hartzler (R),2012,Leadership PACs,0,93879,93879
H001053,N00031005,Vicky Hartzler (R),2012,Crop Production & Basic Processing,36462,41240,77702
H001053,N00031005,Vicky Hartzler (R),2012,Retired,73950,0,73950
H001053,N00031005,Vicky Hartzler (R),2012,Agricultural Services/Products,24500,35500,60000
H001053,N00031005,Vicky Hartzler (R),2012,General Contractors,46600,5000,51600
H001053,N00031005,Vicky Hartzler (R),2012,Commercial Banks,34450,14500,48950
H001053,N00031005,Vicky Hartzler (R),2012,Real Estate,38800,7000,45800
H001053,N00031005,Vicky Hartzler (R),2012,Automotive,29650,15500,45150
H001053,N00031005,Vicky Hartzler (R),2012,Defense Aerospace,0,45134,45134
H001053,N00031005,Vicky Hartzler (R),2012,Health Professionals,31150,10500,41650
N000186,N00031006,Alan Nunnelee (R),2012,Health Professionals,94500,35000,129500
N000186,N00031006,Alan Nunnelee (R),2012,General Contractors,66500,3500,70000
N000186,N00031006,Alan Nunnelee (R),2012,Retired,61600,0,61600
N000186,N00031006,Alan Nunnelee (R),2012,Oil & Gas,33900,27000,60900
N000186,N00031006,Alan Nunnelee (R),2012,Commercial Banks,13150,32000,45150
N000186,N00031006,Alan Nunnelee (R),2012,Leadership PACs,2500,41000,43500
N000186,N00031006,Alan Nunnelee (R),2012,Crop Production & Basic Processing,6050,36000,42050
N000186,N00031006,Alan Nunnelee (R),2012,Real Estate,32800,8000,40800
N000186,N00031006,Alan Nunnelee (R),2012,Lobbyists,39050,1179,40229
N000186,N00031006,Alan Nunnelee (R),2012,Insurance,10500,20500,31000
O000169,N00031011,Bill Owens (D),2012,Leadership PACs,0,118250,118250
O000169,N00031011,Bill Owens (D),2012,Lawyers/Law Firms,86599,23762,110361
O000169,N00031011,Bill Owens (D),2012,Public Sector Unions,0,77500,77500
O000169,N00031011,Bill Owens (D),2012,Securities & Investment,46895,28000,74895
O000169,N00031011,Bill Owens (D),2012,Retired,74101,0,74101
O000169,N00031011,Bill Owens (D),2012,Real Estate,37604,28500,66104
O000169,N00031011,Bill Owens (D),2012,Health Professionals,17125,43000,60125
O000169,N00031011,Bill Owens (D),2012,Candidate Committees,0,59000,59000
O000169,N00031011,Bill Owens (D),2012,Building Trade Unions,700,52000,52700
O000169,N00031011,Bill Owens (D),2012,Commercial Banks,14250,34000,48250
D000613,N00031103,Robert Dold (R),2012,Securities & Investment,440999,100150,541149
D000613,N00031103,Robert Dold (R),2012,Lawyers/Law Firms,255350,22000,277350
D000613,N00031103,Robert Dold (R),2012,Retired,258775,0,258775
D000613,N00031103,Robert Dold (R),2012,Leadership PACs,0,238499,238499
D000613,N00031103,Robert Dold (R),2012,Insurance,43500,151206,194706
D000613,N00031103,Robert Dold (R),2012,Real Estate,119250,47500,166750
D000613,N00031103,Robert Dold (R),2012,Pro-Israel,135700,18000,153700
D000613,N00031103,Robert Dold (R),2012,Misc Finance,96850,22500,119350
D000613,N00031103,Robert Dold (R),2012,Commercial Banks,46250,62056,108306
D000613,N00031103,Robert Dold (R),2012,Misc Manufacturing & Distributing,68923,34384,103307
H001059,N00031104,Randy Hultgren (R),2012,Securities & Investment,124500,14000,138500
H001059,N00031104,Randy Hultgren (R),2012,Retired,58375,0,58375
H001059,N00031104,Randy Hultgren (R),2012,Health Professionals,29625,22000,51625
H001059,N00031104,Randy Hultgren (R),2012,Agricultural Services/Products,3500,44808,48308
H001059,N00031104,Randy Hultgren (R),2012,Air Transport,0,43500,43500
H001059,N00031104,Randy Hultgren (R),2012,Leadership PACs,0,42900,42900
H001059,N00031104,Randy Hultgren (R),2012,Lawyers/Law Firms,29250,10000,39250
H001059,N00031104,Randy Hultgren (R),2012,General Contractors,21750,14000,35750
H001059,N00031104,Randy Hultgren (R),2012,Insurance,5700,30000,35700
H001059,N00031104,Randy Hultgren (R),2012,Crop Production & Basic Processing,2150,33000,35150
R000586,N00031127,Jim Renacci (R),2012,Leadership PACs,0,265556,265556
R000586,N00031127,Jim Renacci (R),2012,Misc Manufacturing & Distributing,115925,48018,163943
R000586,N00031127,Jim Renacci (R),2012,Insurance,21350,133935,155285
R000586,N00031127,Jim Renacci (R),2012,Securities & Investment,64800,76150,140950
R000586,N00031127,Jim Renacci (R),2012,Real Estate,77587,59000,136587
R000586,N00031127,Jim Renacci (R),2012,Retired,121875,0,121875
R000586,N00031127,Jim Renacci (R),2012,Commercial Banks,3500,115700,119200
R000586,N00031127,Jim Renacci (R),2012,Mining,66817,20500,87317
R000586,N00031127,Jim Renacci (R),2012,Hospitals/Nursing Homes,33250,51750,85000
R000586,N00031127,Jim Renacci (R),2012,Oil & Gas,24000,56250,80250
G000563,N00031128,Bob Gibbs (R),2012,Leadership PACs,0,113382,113382
G000563,N00031128,Bob Gibbs (R),2012,Oil & Gas,44550,40500,85050
G000563,N00031128,Bob Gibbs (R),2012,Mining,55900,21500,77400
G000563,N00031128,Bob Gibbs (R),2012,Misc Manufacturing & Distributing,64250,12500,76750
G000563,N00031128,Bob Gibbs (R),2012,Electric Utilities,28850,33000,61850
G000563,N00031128,Bob Gibbs (R),2012,Agricultural Services/Products,2500,47200,49700
G000563,N00031128,Bob Gibbs (R),2012,Retired,34150,0,34150
G000563,N00031128,Bob Gibbs (R),2012,Air Transport,0,31500,31500
G000563,N00031128,Bob Gibbs (R),2012,Insurance,7250,24250,31500
G000563,N00031128,Bob Gibbs (R),2012,Lawyers/Law Firms,13400,17500,30900
L000575,N00031129,James Lankford (R),2012,Oil & Gas,88600,81500,170100
L000575,N00031129,James Lankford (R),2012,Retired,49400,0,49400
L000575,N00031129,James Lankford (R),2012,Commercial Banks,26400,15000,41400
L000575,N00031129,James Lankford (R),2012,General Contractors,30250,10500,40750
L000575,N00031129,James Lankford (R),2012,Republican/Conservative,39700,500,40200
L000575,N00031129,James Lankford (R),2012,Health Professionals,26200,12000,38200
L000575,N00031129,James Lankford (R),2012,Electric Utilities,20150,15000,35150
L000575,N00031129,James Lankford (R),2012,Insurance,6450,23750,30200
L000575,N00031129,James Lankford (R),2012,Leadership PACs,0,27892,27892
L000575,N00031129,James Lankford (R),2012,Real Estate,21750,5500,27250
M001181,N00031134,Patrick Meehan (R),2012,Lawyers/Law Firms,212947,54000,266947
M001181,N00031134,Patrick Meehan (R),2012,Leadership PACs,0,149550,149550
M001181,N00031134,Patrick Meehan (R),2012,Securities & Investment,102000,15250,117250
M001181,N00031134,Patrick Meehan (R),2012,Insurance,40782,60500,101282
M001181,N00031134,Patrick Meehan (R),2012,Pharmaceuticals/Health Products,18750,82500,101250
M001181,N00031134,Patrick Meehan (R),2012,Real Estate,60201,23000,83201
M001181,N00031134,Patrick Meehan (R),2012,Health Professionals,19700,54000,73700
M001181,N00031134,Patrick Meehan (R),2012,Republican/Conservative,24746,36000,60746
M001181,N00031134,Patrick Meehan (R),2012,Lobbyists,56325,2000,58325
M001181,N00031134,Patrick Meehan (R),2012,Air Transport,2500,54000,56500
F000458,N00031141,Steve Fincher (R),2012,Crop Production & Basic Processing,219950,63631,283581
F000458,N00031141,Steve Fincher (R),2012,Retired,110900,0,110900
F000458,N00031141,Steve Fincher (R),2012,Insurance,26250,84000,110250
F000458,N00031141,Steve Fincher (R),2012,Commercial Banks,35065,72000,107065
F000458,N00031141,Steve Fincher (R),2012,Real Estate,53000,42000,95000
F000458,N00031141,Steve Fincher (R),2012,Leadership PACs,0,76910,76910
F000458,N00031141,Steve Fincher (R),2012,General Contractors,59250,14000,73250
F000458,N00031141,Steve Fincher (R),2012,Securities & Investment,11200,45650,56850
F000458,N00031141,Steve Fincher (R),2012,Agricultural Services/Products,4650,51500,56150
F000458,N00031141,Steve Fincher (R),2012,Oil & Gas,32200,23000,55200
A000369,N00031177,Mark Amodei (R),2012,Leadership PACs,1000,103000,104000
A000369,N00031177,Mark Amodei (R),2012,Casinos/Gambling,54528,44101,98629
A000369,N00031177,Mark Amodei (R),2012,Health Professionals,21750,51500,73250
A000369,N00031177,Mark Amodei (R),2012,Lawyers/Law Firms,47060,19750,66810
A000369,N00031177,Mark Amodei (R),2012,Retired,50300,0,50300
A000369,N00031177,Mark Amodei (R),2012,General Contractors,22849,18500,41349
A000369,N00031177,Mark Amodei (R),2012,Lobbyists,34555,3000,37555
A000369,N00031177,Mark Amodei (R),2012,Real Estate,12500,23000,35500
A000369,N00031177,Mark Amodei (R),2012,Mining,2500,33000,35500
A000369,N00031177,Mark Amodei (R),2012,Oil & Gas,1500,33500,35000
S001186,N00031204,Steve Southerland (R),2012,Health Professionals,132267,47000,179267
S001186,N00031204,Steve Southerland (R),2012,Retired,97668,0,97668
S001186,N00031204,Steve Southerland (R),2012,Leadership PACs,0,90000,90000
S001186,N00031204,Steve Southerland (R),2012,Crop Production & Basic Processing,19700,42005,61705
S001186,N00031204,Steve Southerland (R),2012,General Contractors,30201,13923,44124
S001186,N00031204,Steve Southerland (R),2012,Food & Beverage,11874,31000,42874
S001186,N00031204,Steve Southerland (R),2012,Agricultural Services/Products,5700,35500,41200
S001186,N00031204,Steve Southerland (R),2012,Misc Business,37321,0,37321
S001186,N00031204,Steve Southerland (R),2012,Real Estate,27601,8000,35601
S001186,N00031204,Steve Southerland (R),2012,Air Transport,250,34500,34750
W000813,N00031226,Jackie Walorski (R),2012,Leadership PACs,0,159377,159377
W000813,N00031226,Jackie Walorski (R),2012,Retired,132975,0,132975
W000813,N00031226,Jackie Walorski (R),2012,Health Professionals,44500,46000,90500
W000813,N00031226,Jackie Walorski (R),2012,Misc Manufacturing & Distributing,69900,13250,83150
W000813,N00031226,Jackie Walorski (R),2012,Candidate Committees,0,42000,42000
W000813,N00031226,Jackie Walorski (R),2012,Oil & Gas,6000,35000,41000
W000813,N00031226,Jackie Walorski (R),2012,Misc Business,39900,1000,40900
W000813,N00031226,Jackie Walorski (R),2012,General Contractors,21700,14500,36200
W000813,N00031226,Jackie Walorski (R),2012,Republican/Conservative,11300,21500,32800
W000813,N00031226,Jackie Walorski (R),2012,Food Processing & Sales,26069,6000,32069
B001275,N00031227,Larry Bucshon (R),2012,Health Professionals,58750,151500,210250
B001275,N00031227,Larry Bucshon (R),2012,Leadership PACs,0,100750,100750
B001275,N00031227,Larry Bucshon (R),2012,Mining,29550,29250,58800
B001275,N00031227,Larry Bucshon (R),2012,Building Materials & Equipment,32850,13000,45850
B001275,N00031227,Larry Bucshon (R),2012,Insurance,15050,27500,42550
B001275,N00031227,Larry Bucshon (R),2012,General Contractors,21672,14500,36172
B001275,N00031227,Larry Bucshon (R),2012,Railroads,7650,23875,31525
B001275,N00031227,Larry Bucshon (R),2012,Pharmaceuticals/Health Products,9272,22150,31422
B001275,N00031227,Larry Bucshon (R),2012,Real Estate,25171,5000,30171
B001275,N00031227,Larry Bucshon (R),2012,Retired,27547,0,27547
B001282,N00031233,Andy Barr (R),2012,Mining,192332,43500,235832
B001282,N00031233,Andy Barr (R),2012,Retired,187615,0,187615
B001282,N00031233,Andy Barr (R),2012,Leadership PACs,0,133600,133600
B001282,N00031233,Andy Barr (R),2012,Health Professionals,55700,33000,88700
B001282,N00031233,Andy Barr (R),2012,Securities & Investment,82700,5000,87700
B001282,N00031233,Andy Barr (R),2012,Crop Production & Basic Processing,62450,0,62450
B001282,N00031233,Andy Barr (R),2012,Real Estate,56640,2500,59140
B001282,N00031233,Andy Barr (R),2012,Lawyers/Law Firms,50513,2500,53013
B001282,N00031233,Andy Barr (R),2012,Misc Manufacturing & Distributing,46800,1000,47800
B001282,N00031233,Andy Barr (R),2012,Insurance,32550,10500,43050
H001055,N00031244,Joe Heck (R),2012,Health Professionals,159667,170245,329912
H001055,N00031244,Joe Heck (R),2012,Casinos/Gambling,140750,46390,187140
H001055,N00031244,Joe Heck (R),2012,Leadership PACs,0,153879,153879
H001055,N00031244,Joe Heck (R),2012,Retired,105450,0,105450
H001055,N00031244,Joe Heck (R),2012,Real Estate,67000,23500,90500
H001055,N00031244,Joe Heck (R),2012,General Contractors,53040,16500,69540
H001055,N00031244,Joe Heck (R),2012,Oil & Gas,18600,42750,61350
H001055,N00031244,Joe Heck (R),2012,Insurance,8425,51500,59925
H001055,N00031244,Joe Heck (R),2012,Health Services/HMOs,13500,42500,56000
H001055,N00031244,Joe Heck (R),2012,Chemical & Related Manufacturing,47850,0,47850
R000598,N00031253,Keith J Rothfus (R),2012,Republican/Conservative,190871,62750,253621
R000598,N00031253,Keith J Rothfus (R),2012,Leadership PACs,0,172750,172750
R000598,N00031253,Keith J Rothfus (R),2012,Retired,162200,0,162200
R000598,N00031253,Keith J Rothfus (R),2012,Securities & Investment,70050,5000,75050
R000598,N00031253,Keith J Rothfus (R),2012,Health Professionals,58900,15000,73900
R000598,N00031253,Keith J Rothfus (R),2012,Misc Manufacturing & Distributing,71500,0,71500
R000598,N00031253,Keith J Rothfus (R),2012,Oil & Gas,29700,23000,52700
R000598,N00031253,Keith J Rothfus (R),2012,Lawyers/Law Firms,48000,500,48500
R000598,N00031253,Keith J Rothfus (R),2012,Candidate Committees,0,38875,38875
R000598,N00031253,Keith J Rothfus (R),2012,Insurance,24305,14000,38305
H001060,N00031265,Robert Hurt (R),2012,Retired,144250,0,144250
H001060,N00031265,Robert Hurt (R),2012,Securities & Investment,64250,78250,142500
H001060,N00031265,Robert Hurt (R),2012,Insurance,13000,91506,104506
H001060,N00031265,Robert Hurt (R),2012,Real Estate,36751,48500,85251
H001060,N00031265,Robert Hurt (R),2012,Commercial Banks,6500,77500,84000
H001060,N00031265,Robert Hurt (R),2012,Leadership PACs,0,83455,83455
H001060,N00031265,Robert Hurt (R),2012,Lawyers/Law Firms,43697,19200,62897
H001060,N00031265,Robert Hurt (R),2012,Finance/Credit Companies,12625,37500,50125
H001060,N00031265,Robert Hurt (R),2012,Accountants,4000,44000,48000
H001060,N00031265,Robert Hurt (R),2012,Electric Utilities,7750,34500,42250
G000567,N00031297,Tim Griffin (R),2012,Health Professionals,73282,24500,97782
G000567,N00031297,Tim Griffin (R),2012,Commercial Banks,56650,31000,87650
G000567,N00031297,Tim Griffin (R),2012,Oil & Gas,49100,37000,86100
G000567,N00031297,Tim Griffin (R),2012,Securities & Investment,71000,10000,81000
G000567,N00031297,Tim Griffin (R),2012,Retail Sales,50050,24500,74550
G000567,N00031297,Tim Griffin (R),2012,Retired,73650,0,73650
G000567,N00031297,Tim Griffin (R),2012,Leadership PACs,0,49176,49176
G000567,N00031297,Tim Griffin (R),2012,Lobbyists,39600,2500,42100
G000567,N00031297,Tim Griffin (R),2012,Lawyers/Law Firms,27550,13164,40714
G000567,N00031297,Tim Griffin (R),2012,Insurance,16550,16000,32550
D000610,N00031317,Ted Deutch (D),2012,Lawyers/Law Firms,96100,22328,118428
D000610,N00031317,Ted Deutch (D),2012,Securities & Investment,84150,1500,85650
D000610,N00031317,Ted Deutch (D),2012,Retired,82310,0,82310
D000610,N00031317,Ted Deutch (D),2012,Pro-Israel,66040,14250,80290
D000610,N00031317,Ted Deutch (D),2012,Real Estate,68265,11500,79765
D000610,N00031317,Ted Deutch (D),2012,Business Services,29100,5000,34100
D000610,N00031317,Ted Deutch (D),2012,Health Professionals,22000,11000,33000
D000610,N00031317,Ted Deutch (D),2012,Health Services/HMOs,18000,12000,30000
D000610,N00031317,Ted Deutch (D),2012,Misc Finance,27300,2000,29300
D000610,N00031317,Ted Deutch (D),2012,Public Sector Unions,0,27500,27500
L000573,N00031377,Raul Labrador (R),2012,Leadership PACs,0,52173,52173
L000573,N00031377,Raul Labrador (R),2012,Crop Production & Basic Processing,10350,37000,47350
L000573,N00031377,Raul Labrador (R),2012,Retired,39360,0,39360
L000573,N00031377,Raul Labrador (R),2012,Real Estate,29650,2000,31650
L000573,N00031377,Raul Labrador (R),2012,Lawyers/Law Firms,18654,11500,30154
L000573,N00031377,Raul Labrador (R),2012,Electronics Mfg & Equip,12750,15000,27750
L000573,N00031377,Raul Labrador (R),2012,Livestock,22400,2000,24400
L000573,N00031377,Raul Labrador (R),2012,Lobbyists,24000,250,24250
L000573,N00031377,Raul Labrador (R),2012,Forestry & Forest Products,8750,14000,22750
L000573,N00031377,Raul Labrador (R),2012,Insurance,3000,16000,19000
G000569,N00031401,Michael Grimm (R),2012,Securities & Investment,124582,98150,222732
G000569,N00031401,Michael Grimm (R),2012,Leadership PACs,250,156785,157035
G000569,N00031401,Michael Grimm (R),2012,Real Estate,55033,62000,117033
G000569,N00031401,Michael Grimm (R),2012,Insurance,8750,103006,111756
G000569,N00031401,Michael Grimm (R),2012,Transportation Unions,0,106500,106500
G000569,N00031401,Michael Grimm (R),2012,Lawyers/Law Firms,74658,8500,83158
G000569,N00031401,Michael Grimm (R),2012,Commercial Banks,22800,53000,75800
G000569,N00031401,Michael Grimm (R),2012,Building Trade Unions,0,64000,64000
G000569,N00031401,Michael Grimm (R),2012,Accountants,9700,47499,57199
G000569,N00031401,Michael Grimm (R),2012,Health Professionals,27801,22500,50301
M001182,N00031412,Mick Mulvaney (R),2012,Retired,50940,0,50940
M001182,N00031412,Mick Mulvaney (R),2012,Health Professionals,22150,22000,44150
M001182,N00031412,Mick Mulvaney (R),2012,Misc Manufacturing & Distributing,14125,26999,41124
M001182,N00031412,Mick Mulvaney (R),2012,Leadership PACs,0,35500,35500
M001182,N00031412,Mick Mulvaney (R),2012,Insurance,5500,24500,30000
M001182,N00031412,Mick Mulvaney (R),2012,Real Estate,17000,10760,27760
M001182,N00031412,Mick Mulvaney (R),2012,Building Materials & Equipment,21250,6000,27250
M001182,N00031412,Mick Mulvaney (R),2012,Electric Utilities,550,25500,26050
M001182,N00031412,Mick Mulvaney (R),2012,Misc Finance,23232,0,23232
M001182,N00031412,Mick Mulvaney (R),2012,Lawyers/Law Firms,12250,5500,17750
Y000063,N00031502,Kevin Yoder (R),2012,Securities & Investment,79411,24500,103911
Y000063,N00031502,Kevin Yoder (R),2012,Real Estate,55626,19500,75126
Y000063,N00031502,Kevin Yoder (R),2012,Health Professionals,30000,45000,75000
Y000063,N00031502,Kevin Yoder (R),2012,Finance/Credit Companies,56900,13800,70700
Y000063,N00031502,Kevin Yoder (R),2012,Oil & Gas,52450,18000,70450
Y000063,N00031502,Kevin Yoder (R),2012,Insurance,41000,27750,68750
Y000063,N00031502,Kevin Yoder (R),2012,Lawyers/Law Firms,50081,18500,68581
Y000063,N00031502,Kevin Yoder (R),2012,Misc Finance,47850,1500,49350
Y000063,N00031502,Kevin Yoder (R),2012,Leadership PACs,0,45000,45000
Y000063,N00031502,Kevin Yoder (R),2012,Commercial Banks,21115,22999,44114
E000291,N00031513,Renee Ellmers (R),2012,Health Professionals,18650,63750,82400
E000291,N00031513,Renee Ellmers (R),2012,Leadership PACs,0,70380,70380
E000291,N00031513,Renee Ellmers (R),2012,Crop Production & Basic Processing,20450,35500,55950
E000291,N00031513,Renee Ellmers (R),2012,Real Estate,22950,18000,40950
E000291,N00031513,Renee Ellmers (R),2012,Agricultural Services/Products,500,38000,38500
E000291,N00031513,Renee Ellmers (R),2012,Retired,37850,0,37850
E000291,N00031513,Renee Ellmers (R),2012,Insurance,6700,23000,29700
E000291,N00031513,Renee Ellmers (R),2012,Tobacco,1750,27500,29250
E000291,N00031513,Renee Ellmers (R),2012,Retail Sales,4250,22500,26750
E000291,N00031513,Renee Ellmers (R),2012,Misc Manufacturing & Distributing,10673,14999,25672
B001273,N00031539,Diane Black (R),2012,Health Professionals,48245,105344,153589
B001273,N00031539,Diane Black (R),2012,Insurance,35750,104528,140278
B001273,N00031539,Diane Black (R),2012,Hospitals/Nursing Homes,34150,98650,132800
B001273,N00031539,Diane Black (R),2012,Leadership PACs,0,96498,96498
B001273,N00031539,Diane Black (R),2012,Health Services/HMOs,26950,59650,86600
B001273,N00031539,Diane Black (R),2012,Pharmaceuticals/Health Products,3000,82591,85591
B001273,N00031539,Diane Black (R),2012,Oil & Gas,9405,52500,61905
B001273,N00031539,Diane Black (R),2012,Real Estate,18250,42000,60250
B001273,N00031539,Diane Black (R),2012,Lawyers/Law Firms,20950,29361,50311
B001273,N00031539,Diane Black (R),2012,Commercial Banks,12900,35500,48400
F000461,N00031545,Bill Flores (R),2012,Oil & Gas,121506,81000,202506
F000461,N00031545,Bill Flores (R),2012,Retired,125983,0,125983
F000461,N00031545,Bill Flores (R),2012,Health Professionals,32196,32500,64696
F000461,N00031545,Bill Flores (R),2012,Accountants,1250,42000,43250
F000461,N00031545,Bill Flores (R),2012,Misc Manufacturing & Distributing,24250,17134,41384
F000461,N00031545,Bill Flores (R),2012,Lawyers/Law Firms,26797,12000,38797
F000461,N00031545,Bill Flores (R),2012,Leadership PACs,0,37051,37051
F000461,N00031545,Bill Flores (R),2012,Real Estate,21400,11500,32900
F000461,N00031545,Bill Flores (R),2012,Commercial Banks,14000,18500,32500
F000461,N00031545,Bill Flores (R),2012,Crop Production & Basic Processing,4250,25350,29600
H001064,N00031557,Dennis Heck (D),2012,Retired,134037,0,134037
H001064,N00031557,Dennis Heck (D),2012,Lawyers/Law Firms,77795,12000,89795
H001064,N00031557,Dennis Heck (D),2012,Leadership PACs,0,87000,87000
H001064,N00031557,Dennis Heck (D),2012,Health Professionals,19882,54000,73882
H001064,N00031557,Dennis Heck (D),2012,Public Sector Unions,0,71500,71500
H001064,N00031557,Dennis Heck (D),2012,Lobbyists,69124,1500,70624
H001064,N00031557,Dennis Heck (D),2012,Building Trade Unions,250,68000,68250
H001064,N00031557,Dennis Heck (D),2012,Transportation Unions,3400,54000,57400
H001064,N00031557,Dennis Heck (D),2012,Business Services,50150,1000,51150
H001064,N00031557,Dennis Heck (D),2012,Democratic/Liberal,37300,10000,47300
H001056,N00031559,Jaime Herrera Beutler (R),2012,Retired,140888,0,140888
H001056,N00031559,Jaime Herrera Beutler (R),2012,Real Estate,60745,20000,80745
H001056,N00031559,Jaime Herrera Beutler (R),2012,Food & Beverage,50153,18500,68653
H001056,N00031559,Jaime Herrera Beutler (R),2012,Securities & Investment,44770,11000,55770
H001056,N00031559,Jaime Herrera Beutler (R),2012,Leadership PACs,0,53759,53759
H001056,N00031559,Jaime Herrera Beutler (R),2012,Forestry & Forest Products,30854,18500,49354
H001056,N00031559,Jaime Herrera Beutler (R),2012,Air Transport,4900,42500,47400
H001056,N00031559,Jaime Herrera Beutler (R),2012,General Contractors,31800,11000,42800
H001056,N00031559,Jaime Herrera Beutler (R),2012,Republican/Conservative,22535,16000,38535
H001056,N00031559,Jaime Herrera Beutler (R),2012,Health Professionals,15150,22500,37650
D000612,N00031593,Jeff Denham (R),2012,Crop Production & Basic Processing,248783,55000,303783
D000612,N00031593,Jeff Denham (R),2012,Leadership PACs,0,207906,207906
D000612,N00031593,Jeff Denham (R),2012,Casinos/Gambling,116590,7000,123590
D000612,N00031593,Jeff Denham (R),2012,Real Estate,79999,21500,101499
D000612,N00031593,Jeff Denham (R),2012,Oil & Gas,13900,77000,90900
D000612,N00031593,Jeff Denham (R),2012,Agricultural Services/Products,41750,44500,86250
D000612,N00031593,Jeff Denham (R),2012,Livestock,82782,0,82782
D000612,N00031593,Jeff Denham (R),2012,Dairy,53166,26250,79416
D000612,N00031593,Jeff Denham (R),2012,Candidate Committees,750,71454,72204
D000612,N00031593,Jeff Denham (R),2012,Health Professionals,29100,39384,68484
K000376,N00031647,Mike Kelly (R),2012,Leadership PACs,0,50500,50500
K000376,N00031647,Mike Kelly (R),2012,Misc Manufacturing & Distributing,7950,35883,43833
K000376,N00031647,Mike Kelly (R),2012,Oil & Gas,1500,40500,42000
K000376,N00031647,Mike Kelly (R),2012,Retired,41821,0,41821
K000376,N00031647,Mike Kelly (R),2012,Automotive,19900,20500,40400
K000376,N00031647,Mike Kelly (R),2012,Insurance,9150,29000,38150
K000376,N00031647,Mike Kelly (R),2012,Mining,12850,20000,32850
K000376,N00031647,Mike Kelly (R),2012,Republican/Conservative,17050,11869,28919
K000376,N00031647,Mike Kelly (R),2012,Lawyers/Law Firms,14350,9000,23350
K000376,N00031647,Mike Kelly (R),2012,Health Professionals,14233,9000,23233
F000460,N00031672,Blake Farenthold (R),2012,Oil & Gas,42252,57500,99752
F000460,N00031672,Blake Farenthold (R),2012,Leadership PACs,0,77435,77435
F000460,N00031672,Blake Farenthold (R),2012,Health Professionals,35316,16500,51816
F000460,N00031672,Blake Farenthold (R),2012,General Contractors,44083,7500,51583
F000460,N00031672,Blake Farenthold (R),2012,Retired,49458,0,49458
F000460,N00031672,Blake Farenthold (R),2012,Air Transport,250,45133,45383
F000460,N00031672,Blake Farenthold (R),2012,Misc Finance,40725,0,40725
F000460,N00031672,Blake Farenthold (R),2012,Real Estate,23100,15000,38100
F000460,N00031672,Blake Farenthold (R),2012,Crop Production & Basic Processing,7350,28100,35450
F000460,N00031672,Blake Farenthold (R),2012,Lawyers/Law Firms,29375,1000,30375
M001180,N00031681,David McKinley (R),2012,Mining,236478,70500,306978
M001180,N00031681,David McKinley (R),2012,Health Professionals,43340,90500,133840
M001180,N00031681,David McKinley (R),2012,Oil & Gas,43300,55000,98300
M001180,N00031681,David McKinley (R),2012,Electric Utilities,21400,73000,94400
M001180,N00031681,David McKinley (R),2012,Lawyers/Law Firms,81050,8485,89535
M001180,N00031681,David McKinley (R),2012,Special Trade Contractors,43300,16500,59800
M001180,N00031681,David McKinley (R),2012,Hospitals/Nursing Homes,26925,26000,52925
M001180,N00031681,David McKinley (R),2012,Building Trade Unions,0,52500,52500
M001180,N00031681,David McKinley (R),2012,Leadership PACs,0,50000,50000
M001180,N00031681,David McKinley (R),2012,Misc Manufacturing & Distributing,43700,3500,47200
B001277,N00031685,Richard Blumenthal (D),2012,Lawyers/Law Firms,611176,43500,654676
B001277,N00031685,Richard Blumenthal (D),2012,Securities & Investment,578397,19100,597497
B001277,N00031685,Richard Blumenthal (D),2012,Retired,517541,0,517541
B001277,N00031685,Richard Blumenthal (D),2012,Real Estate,453155,20000,473155
B001277,N00031685,Richard Blumenthal (D),2012,Health Professionals,127539,110750,238289
B001277,N00031685,Richard Blumenthal (D),2012,Leadership PACs,0,208400,208400
B001277,N00031685,Richard Blumenthal (D),2012,Education,156250,0,156250
B001277,N00031685,Richard Blumenthal (D),2012,Misc Finance,128300,0,128300
B001277,N00031685,Richard Blumenthal (D),2012,Lobbyists,110000,11000,121000
B001277,N00031685,Richard Blumenthal (D),2012,Business Services,99900,3250,103150
H001061,N00031688,John Hoeven (R),2012,Oil & Gas,176139,124998,301137
H001061,N00031688,John Hoeven (R),2012,Retired,230310,0,230310
H001061,N00031688,John Hoeven (R),2012,Insurance,49800,110050,159850
H001061,N00031688,John Hoeven (R),2012,Mining,89831,63975,153806
H001061,N00031688,John Hoeven (R),2012,Leadership PACs,1000,141900,142900
H001061,N00031688,John Hoeven (R),2012,Securities & Investment,115300,15000,130300
H001061,N00031688,John Hoeven (R),2012,Real Estate,94560,30500,125060
H001061,N00031688,John Hoeven (R),2012,Misc Manufacturing & Distributing,98000,26000,124000
H001061,N00031688,John Hoeven (R),2012,Health Professionals,49650,73000,122650
H001061,N00031688,John Hoeven (R),2012,Commercial Banks,63360,37500,100860
L000577,N00031696,Mike Lee (R),2012,Business Services,117255,1500,118755
L000577,N00031696,Mike Lee (R),2012,Lawyers/Law Firms,89052,22350,111402
L000577,N00031696,Mike Lee (R),2012,Mining,63995,18250,82245
L000577,N00031696,Mike Lee (R),2012,Electronics Mfg & Equip,56600,19500,76100
L000577,N00031696,Mike Lee (R),2012,Retired,74364,0,74364
L000577,N00031696,Mike Lee (R),2012,Lobbyists,58730,2000,60730
L000577,N00031696,Mike Lee (R),2012,Real Estate,40147,17510,57657
L000577,N00031696,Mike Lee (R),2012,Leadership PACs,0,55289,55289
L000577,N00031696,Mike Lee (R),2012,Oil & Gas,12100,41500,53600
L000577,N00031696,Mike Lee (R),2012,Securities & Investment,41466,11500,52966
R000592,N00031741,Todd Rokita (R),2012,Lawyers/Law Firms,65050,7500,72550
R000592,N00031741,Todd Rokita (R),2012,Health Professionals,37939,26500,64439
R000592,N00031741,Todd Rokita (R),2012,Automotive,20300,30000,50300
R000592,N00031741,Todd Rokita (R),2012,Real Estate,39264,10500,49764
R000592,N00031741,Todd Rokita (R),2012,Insurance,20015,22500,42515
R000592,N00031741,Todd Rokita (R),2012,General Contractors,26750,11000,37750
R000592,N00031741,Todd Rokita (R),2012,Health Services/HMOs,8600,28500,37100
R000592,N00031741,Todd Rokita (R),2012,Pharmaceuticals/Health Products,9000,25500,34500
R000592,N00031741,Todd Rokita (R),2012,Retired,33932,0,33932
R000592,N00031741,Todd Rokita (R),2012,Misc Manufacturing & Distributing,13000,20884,33884
M001179,N00031777,Tom Marino (R),2012,Health Professionals,15060,26500,41560
M001179,N00031777,Tom Marino (R),2012,Retail Sales,22800,11500,34300
M001179,N00031777,Tom Marino (R),2012,Misc Manufacturing & Distributing,26173,5700,31873
M001179,N00031777,Tom Marino (R),2012,Real Estate,19450,10000,29450
M001179,N00031777,Tom Marino (R),2012,Lawyers/Law Firms,22597,6750,29347
M001179,N00031777,Tom Marino (R),2012,Retired,29050,0,29050
M001179,N00031777,Tom Marino (R),2012,Electric Utilities,0,27000,27000
M001179,N00031777,Tom Marino (R),2012,TV/Movies/Music,3800,23000,26800
M001179,N00031777,Tom Marino (R),2012,Leadership PACs,0,25895,25895
M001179,N00031777,Tom Marino (R),2012,Automotive,17500,5000,22500
S001184,N00031782,Tim Scott (R),2012,Insurance,46350,96000,142350
S001184,N00031782,Tim Scott (R),2012,Real Estate,100275,29325,129600
S001184,N00031782,Tim Scott (R),2012,Retired,126394,0,126394
S001184,N00031782,Tim Scott (R),2012,Health Professionals,41950,44500,86450
S001184,N00031782,Tim Scott (R),2012,Misc Business,44950,2000,46950
S001184,N00031782,Tim Scott (R),2012,Lawyers/Law Firms,34580,11750,46330
S001184,N00031782,Tim Scott (R),2012,Misc Manufacturing & Distributing,12750,25500,38250
S001184,N00031782,Tim Scott (R),2012,Leadership PACs,0,37379,37379
S001184,N00031782,Tim Scott (R),2012,Securities & Investment,16849,17000,33849
S001184,N00031782,Tim Scott (R),2012,Accountants,11400,21500,32900
C001088,N00031820,Chris Coons (D),2012,Lawyers/Law Firms,724929,87400,812329
C001088,N00031820,Chris Coons (D),2012,Leadership PACs,0,287900,287900
C001088,N00031820,Chris Coons (D),2012,Lobbyists,243029,9080,252109
C001088,N00031820,Chris Coons (D),2012,Securities & Investment,153650,44500,198150
C001088,N00031820,Chris Coons (D),2012,Retired,161365,0,161365
C001088,N00031820,Chris Coons (D),2012,Real Estate,116450,21000,137450
C001088,N00031820,Chris Coons (D),2012,Pharmaceuticals/Health Products,27400,104000,131400
C001088,N00031820,Chris Coons (D),2012,Health Professionals,80350,41500,121850
C001088,N00031820,Chris Coons (D),2012,Insurance,23275,92500,115775
C001088,N00031820,Chris Coons (D),2012,Chemical & Related Manufacturing,44650,43500,88150
W000809,N00031857,Steve Womack (R),2012,Retail Sales,33450,43000,76450
W000809,N00031857,Steve Womack (R),2012,Securities & Investment,45300,8500,53800
W000809,N00031857,Steve Womack (R),2012,Commercial Banks,19463,28500,47963
W000809,N00031857,Steve Womack (R),2012,Food Processing & Sales,26000,17234,43234
W000809,N00031857,Steve Womack (R),2012,Real Estate,32836,9000,41836
W000809,N00031857,Steve Womack (R),2012,Retired,29725,0,29725
W000809,N00031857,Steve Womack (R),2012,Leadership PACs,0,29000,29000
W000809,N00031857,Steve Womack (R),2012,Health Professionals,12700,15500,28200
W000809,N00031857,Steve Womack (R),2012,Poultry & Eggs,16500,10000,26500
W000809,N00031857,Steve Womack (R),2012,Oil & Gas,5750,20000,25750
B001270,N00031877,Karen Bass (D),2012,Health Professionals,8550,42500,51050
B001270,N00031877,Karen Bass (D),2012,Public Sector Unions,0,42000,42000
B001270,N00031877,Karen Bass (D),2012,Lawyers/Law Firms,23850,15488,39338
B001270,N00031877,Karen Bass (D),2012,Industrial Unions,0,35000,35000
B001270,N00031877,Karen Bass (D),2012,Building Trade Unions,0,34500,34500
B001270,N00031877,Karen Bass (D),2012,TV/Movies/Music,16250,13748,29998
B001270,N00031877,Karen Bass (D),2012,Misc Unions,0,23500,23500
B001270,N00031877,Karen Bass (D),2012,Transportation Unions,0,20000,20000
B001270,N00031877,Karen Bass (D),2012,Health Services/HMOs,10750,7000,17750
B001270,N00031877,Karen Bass (D),2012,Lobbyists,17552,0,17552
K000375,N00031933,Bill Keating (D),2012,Lawyers/Law Firms,79732,24500,104232
K000375,N00031933,Bill Keating (D),2012,Building Trade Unions,0,56000,56000
K000375,N00031933,Bill Keating (D),2012,Public Sector Unions,0,53500,53500
K000375,N00031933,Bill Keating (D),2012,Transportation Unions,0,42000,42000
K000375,N00031933,Bill Keating (D),2012,Industrial Unions,0,41000,41000
K000375,N00031933,Bill Keating (D),2012,Real Estate,31753,8000,39753
K000375,N00031933,Bill Keating (D),2012,Retired,36773,0,36773
K000375,N00031933,Bill Keating (D),2012,Leadership PACs,0,35500,35500
K000375,N00031933,Bill Keating (D),2012,Pharmaceuticals/Health Products,3750,29500,33250
K000375,N00031933,Bill Keating (D),2012,Lobbyists,29096,3000,32096
B001271,N00031934,Dan Benishek (R),2012,Leadership PACs,0,273953,273953
B001271,N00031934,Dan Benishek (R),2012,Health Professionals,76575,154000,230575
B001271,N00031934,Dan Benishek (R),2012,Oil & Gas,36800,69000,105800
B001271,N00031934,Dan Benishek (R),2012,Retired,80901,0,80901
B001271,N00031934,Dan Benishek (R),2012,Candidate Committees,0,74626,74626
B001271,N00031934,Dan Benishek (R),2012,Real Estate,34000,23000,57000
B001271,N00031934,Dan Benishek (R),2012,Casinos/Gambling,51000,4000,55000
B001271,N00031934,Dan Benishek (R),2012,Republican/Conservative,20251,31900,52151
B001271,N00031934,Dan Benishek (R),2012,Electric Utilities,6150,42000,48150
B001271,N00031934,Dan Benishek (R),2012,Misc Manufacturing & Distributing,31450,16634,48084
A000367,N00031938,Justin Amash (R),2012,Misc Manufacturing & Distributing,87800,4000,91800
A000367,N00031938,Justin Amash (R),2012,Retired,74000,0,74000
A000367,N00031938,Justin Amash (R),2012,Health Professionals,61900,10000,71900
A000367,N00031938,Justin Amash (R),2012,Retail Sales,56750,1000,57750
A000367,N00031938,Justin Amash (R),2012,Securities & Investment,42500,3000,45500
A000367,N00031938,Justin Amash (R),2012,Lawyers/Law Firms,37025,3000,40025
A000367,N00031938,Justin Amash (R),2012,Leadership PACs,0,35000,35000
A000367,N00031938,Justin Amash (R),2012,Misc Finance,33300,0,33300
A000367,N00031938,Justin Amash (R),2012,Food Processing & Sales,31250,0,31250
A000367,N00031938,Justin Amash (R),2012,Automotive,23750,5000,28750
P000601,N00031958,Steven Palazzo (R),2012,Defense Aerospace,2500,50000,52500
P000601,N00031958,Steven Palazzo (R),2012,Accountants,12750,39499,52249
P000601,N00031958,Steven Palazzo (R),2012,Health Professionals,39850,11000,50850
P000601,N00031958,Steven Palazzo (R),2012,Oil & Gas,12500,28000,40500
P000601,N00031958,Steven Palazzo (R),2012,General Contractors,33600,4500,38100
P000601,N00031958,Steven Palazzo (R),2012,Real Estate,29750,8000,37750
P000601,N00031958,Steven Palazzo (R),2012,Leadership PACs,0,31500,31500
P000601,N00031958,Steven Palazzo (R),2012,Misc Defense,7500,19500,27000
P000601,N00031958,Steven Palazzo (R),2012,Defense Electronics,0,27000,27000
P000601,N00031958,Steven Palazzo (R),2012,Insurance,10000,16500,26500
R000594,N00031988,Jon Runyan (R),2012,Leadership PACs,0,153750,153750
R000594,N00031988,Jon Runyan (R),2012,Health Professionals,45300,91500,136800
R000594,N00031988,Jon Runyan (R),2012,Insurance,53950,29250,83200
R000594,N00031988,Jon Runyan (R),2012,Defense Aerospace,300,63498,63798
R000594,N00031988,Jon Runyan (R),2012,Lawyers/Law Firms,46610,9000,55610
R000594,N00031988,Jon Runyan (R),2012,Building Trade Unions,0,53030,53030
R000594,N00031988,Jon Runyan (R),2012,Real Estate,35372,16500,51872
R000594,N00031988,Jon Runyan (R),2012,Transportation Unions,0,49500,49500
R000594,N00031988,Jon Runyan (R),2012,Candidate Committees,0,45850,45850
R000594,N00031988,Jon Runyan (R),2012,Securities & Investment,32050,11500,43550
G000564,N00031998,Chris Gibson (R),2012,Leadership PACs,0,212500,212500
G000564,N00031998,Chris Gibson (R),2012,Securities & Investment,102333,27000,129333
G000564,N00031998,Chris Gibson (R),2012,General Contractors,59500,20000,79500
G000564,N00031998,Chris Gibson (R),2012,Retired,74469,0,74469
G000564,N00031998,Chris Gibson (R),2012,Real Estate,41333,25000,66333
G000564,N00031998,Chris Gibson (R),2012,Lawyers/Law Firms,51733,9500,61233
G000564,N00031998,Chris Gibson (R),2012,Candidate Committees,0,61050,61050
G000564,N00031998,Chris Gibson (R),2012,Crop Production & Basic Processing,31075,26750,57825
G000564,N00031998,Chris Gibson (R),2012,Defense Aerospace,0,50998,50998
G000564,N00031998,Chris Gibson (R),2012,Building Trade Unions,0,49500,49500
C001084,N00032019,David Cicilline (D),2012,Lawyers/Law Firms,175050,21000,196050
C001084,N00032019,David Cicilline (D),2012,Retired,133245,0,133245
C001084,N00032019,David Cicilline (D),2012,Real Estate,90262,12000,102262
C001084,N00032019,David Cicilline (D),2012,Leadership PACs,1000,100050,101050
C001084,N00032019,David Cicilline (D),2012,Securities & Investment,63200,9500,72700
C001084,N00032019,David Cicilline (D),2012,Human Rights,44500,26996,71496
C001084,N00032019,David Cicilline (D),2012,Lobbyists,71148,181,71329
C001084,N00032019,David Cicilline (D),2012,TV/Movies/Music,50350,6000,56350
C001084,N00032019,David Cicilline (D),2012,Public Sector Unions,350,55500,55850
C001084,N00032019,David Cicilline (D),2012,Candidate Committees,0,54900,54900
N000184,N00032022,Kristi Noem (R),2012,Retired,219570,0,219570
N000184,N00032022,Kristi Noem (R),2012,Crop Production & Basic Processing,77360,41000,118360
N000184,N00032022,Kristi Noem (R),2012,Health Professionals,59150,40500,99650
N000184,N00032022,Kristi Noem (R),2012,Insurance,7700,91000,98700
N000184,N00032022,Kristi Noem (R),2012,Oil & Gas,51001,44500,95501
N000184,N00032022,Kristi Noem (R),2012,Real Estate,56700,33010,89710
N000184,N00032022,Kristi Noem (R),2012,Lawyers/Law Firms,64800,15336,80136
N000184,N00032022,Kristi Noem (R),2012,Commercial Banks,54433,22000,76433
N000184,N00032022,Kristi Noem (R),2012,Leadership PACs,0,71000,71000
N000184,N00032022,Kristi Noem (R),2012,Securities & Investment,32750,31500,64250
G000568,N00032029,Morgan Griffith (R),2012,Mining,94638,53500,148138
G000568,N00032029,Morgan Griffith (R),2012,Retired,66900,0,66900
G000568,N00032029,Morgan Griffith (R),2012,Oil & Gas,8550,51000,59550
G000568,N00032029,Morgan Griffith (R),2012,Health Professionals,22158,34000,56158
G000568,N00032029,Morgan Griffith (R),2012,Electric Utilities,3500,51750,55250
G000568,N00032029,Morgan Griffith (R),2012,Misc Manufacturing & Distributing,34650,18469,53119
G000568,N00032029,Morgan Griffith (R),2012,Lawyers/Law Firms,23650,16000,39650
G000568,N00032029,Morgan Griffith (R),2012,Leadership PACs,0,34075,34075
G000568,N00032029,Morgan Griffith (R),2012,Chemical & Related Manufacturing,6950,25000,31950
G000568,N00032029,Morgan Griffith (R),2012,Telecom Services,1000,25000,26000
J000292,N00032088,Bill Johnson (R),2012,Leadership PACs,0,193682,193682
J000292,N00032088,Bill Johnson (R),2012,Mining,79250,50500,129750
J000292,N00032088,Bill Johnson (R),2012,Misc Manufacturing & Distributing,70508,36999,107507
J000292,N00032088,Bill Johnson (R),2012,Oil & Gas,22200,78000,100200
J000292,N00032088,Bill Johnson (R),2012,Health Professionals,27000,53500,80500
J000292,N00032088,Bill Johnson (R),2012,Electric Utilities,10400,46500,56900
J000292,N00032088,Bill Johnson (R),2012,Retired,51325,0,51325
J000292,N00032088,Bill Johnson (R),2012,Insurance,13750,30500,44250
J000292,N00032088,Bill Johnson (R),2012,Candidate Committees,0,39500,39500
J000292,N00032088,Bill Johnson (R),2012,Special Trade Contractors,30862,2500,33362
W000810,N00032416,Rob Woodall (R),2012,Health Professionals,23100,17500,40600
W000810,N00032416,Rob Woodall (R),2012,Leadership PACs,0,23500,23500
W000810,N00032416,Rob Woodall (R),2012,Lawyers/Law Firms,7250,10750,18000
W000810,N00032416,Rob Woodall (R),2012,Electric Utilities,2500,15500,18000
W000810,N00032416,Rob Woodall (R),2012,Automotive,6083,11500,17583
W000810,N00032416,Rob Woodall (R),2012,Real Estate,2850,14500,17350
W000810,N00032416,Rob Woodall (R),2012,Insurance,800,15500,16300
W000810,N00032416,Rob Woodall (R),2012,Oil & Gas,0,16000,16000
W000810,N00032416,Rob Woodall (R),2012,Food & Beverage,2000,12250,14250
W000810,N00032416,Rob Woodall (R),2012,General Contractors,11100,2000,13100
N000185,N00032441,Richard Nugent (R),2012,Leadership PACs,0,39000,39000
N000185,N00032441,Richard Nugent (R),2012,Health Professionals,11300,16000,27300
N000185,N00032441,Richard Nugent (R),2012,Food & Beverage,0,26500,26500
N000185,N00032441,Richard Nugent (R),2012,Real Estate,8000,17510,25510
N000185,N00032441,Richard Nugent (R),2012,Misc Manufacturing & Distributing,7114,16500,23614
N000185,N00032441,Richard Nugent (R),2012,Oil & Gas,10000,12500,22500
N000185,N00032441,Richard Nugent (R),2012,Pro-Israel,12500,9600,22100
N000185,N00032441,Richard Nugent (R),2012,Health Services/HMOs,3500,18500,22000
N000185,N00032441,Richard Nugent (R),2012,"Beer, Wine & Liquor",8666,13000,21666
N000185,N00032441,Richard Nugent (R),2012,Electric Utilities,0,19000,19000
S001189,N00032457,Austin Scott (R),2012,Health Professionals,63250,33000,96250
S001189,N00032457,Austin Scott (R),2012,Crop Production & Basic Processing,47887,39500,87387
S001189,N00032457,Austin Scott (R),2012,Defense Aerospace,250,46898,47148
S001189,N00032457,Austin Scott (R),2012,Real Estate,31390,15500,46890
S001189,N00032457,Austin Scott (R),2012,Retired,45200,0,45200
S001189,N00032457,Austin Scott (R),2012,Insurance,4500,39500,44000
S001189,N00032457,Austin Scott (R),2012,Agricultural Services/Products,8750,28000,36750
S001189,N00032457,Austin Scott (R),2012,Retail Sales,5500,20000,25500
S001189,N00032457,Austin Scott (R),2012,Food Processing & Sales,1000,23000,24000
S001189,N00032457,Austin Scott (R),2012,Lawyers/Law Firms,16500,7000,23500
J000293,N00032546,Ron Johnson (R),2012,Retired,639521,0,639521
J000293,N00032546,Ron Johnson (R),2012,Securities & Investment,249835,14000,263835
J000293,N00032546,Ron Johnson (R),2012,Misc Manufacturing & Distributing,218234,36500,254734
J000293,N00032546,Ron Johnson (R),2012,Health Professionals,213126,33325,246451
J000293,N00032546,Ron Johnson (R),2012,Real Estate,142930,32900,175830
J000293,N00032546,Ron Johnson (R),2012,Leadership PACs,0,172396,172396
J000293,N00032546,Ron Johnson (R),2012,Insurance,80550,85150,165700
J000293,N00032546,Ron Johnson (R),2012,Republican/Conservative,141133,12724,153857
J000293,N00032546,Ron Johnson (R),2012,Misc Finance,97721,12500,110221
J000293,N00032546,Ron Johnson (R),2012,Lawyers/Law Firms,96575,10000,106575
M001183,N00032838,Joe Manchin (D),2012,Mining,532700,149998,682698
M001183,N00032838,Joe Manchin (D),2012,Lawyers/Law Firms,600953,81400,682353
M001183,N00032838,Joe Manchin (D),2012,Electric Utilities,217450,170750,388200
M001183,N00032838,Joe Manchin (D),2012,Leadership PACs,1000,365000,366000
M001183,N00032838,Joe Manchin (D),2012,Health Professionals,191650,99998,291648
M001183,N00032838,Joe Manchin (D),2012,Retired,275750,0,275750
M001183,N00032838,Joe Manchin (D),2012,Pharmaceuticals/Health Products,135400,137750,273150
M001183,N00032838,Joe Manchin (D),2012,Oil & Gas,154150,109500,263650
M001183,N00032838,Joe Manchin (D),2012,Real Estate,188750,41000,229750
M001183,N00032838,Joe Manchin (D),2012,Lobbyists,196469,6220,202689
H001068,N00033030,Jared Huffman (D),2012,Retired,143173,0,143173
H001068,N00033030,Jared Huffman (D),2012,Lawyers/Law Firms,107251,17000,124251
H001068,N00033030,Jared Huffman (D),2012,Health Professionals,19725,57500,77225
H001068,N00033030,Jared Huffman (D),2012,Building Trade Unions,250,61537,61787
H001068,N00033030,Jared Huffman (D),2012,Real Estate,44561,10000,54561
H001068,N00033030,Jared Huffman (D),2012,Public Sector Unions,0,53000,53000
H001068,N00033030,Jared Huffman (D),2012,"Beer, Wine & Liquor",33232,13900,47132
H001068,N00033030,Jared Huffman (D),2012,Environment,27550,12200,39750
H001068,N00033030,Jared Huffman (D),2012,Misc Finance,25498,0,25498
H001068,N00033030,Jared Huffman (D),2012,Transportation Unions,0,25000,25000
D000618,N00033054,Steven Daines (R),2012,Retired,159584,0,159584
D000618,N00033054,Steven Daines (R),2012,Oil & Gas,70020,44500,114520
D000618,N00033054,Steven Daines (R),2012,Livestock,65400,10000,75400
D000618,N00033054,Steven Daines (R),2012,Leadership PACs,0,68500,68500
D000618,N00033054,Steven Daines (R),2012,General Contractors,47650,12500,60150
D000618,N00033054,Steven Daines (R),2012,Real Estate,48462,10000,58462
D000618,N00033054,Steven Daines (R),2012,Commercial Banks,29500,14500,44000
D000618,N00033054,Steven Daines (R),2012,Republican/Conservative,19950,24000,43950
D000618,N00033054,Steven Daines (R),2012,Automotive,22950,12000,34950
D000618,N00033054,Steven Daines (R),2012,Health Professionals,21185,12750,33935
C001098,N00033085,Ted Cruz (R),2012,Republican/Conservative,1334632,102081,1436713
C001098,N00033085,Ted Cruz (R),2012,Lawyers/Law Firms,760575,54250,814825
C001098,N00033085,Ted Cruz (R),2012,Oil & Gas,598782,184000,782782
C001098,N00033085,Ted Cruz (R),2012,Securities & Investment,590117,24500,614617
C001098,N00033085,Ted Cruz (R),2012,Retired,614264,0,614264
C001098,N00033085,Ted Cruz (R),2012,Real Estate,398920,22500,421420
C001098,N00033085,Ted Cruz (R),2012,Misc Finance,352789,3500,356289
C001098,N00033085,Ted Cruz (R),2012,Health Professionals,261779,38000,299779
C001098,N00033085,Ted Cruz (R),2012,Misc Business,248124,10000,258124
C001098,N00033085,Ted Cruz (R),2012,Misc Manufacturing & Distributing,194150,37000,231150
M001191,N00033091,Patrick E Murphy (D),2012,Retired,371830,0,371830
M001191,N00033091,Patrick E Murphy (D),2012,Lawyers/Law Firms,233528,11000,244528
M001191,N00033091,Patrick E Murphy (D),2012,Real Estate,197448,5000,202448
M001191,N00033091,Patrick E Murphy (D),2012,General Contractors,139100,0,139100
M001191,N00033091,Patrick E Murphy (D),2012,Securities & Investment,108100,0,108100
M001191,N00033091,Patrick E Murphy (D),2012,Misc Finance,89500,0,89500
M001191,N00033091,Patrick E Murphy (D),2012,Leadership PACs,0,82600,82600
M001191,N00033091,Patrick E Murphy (D),2012,Democratic/Liberal,67750,11262,79012
M001191,N00033091,Patrick E Murphy (D),2012,Public Sector Unions,250,75500,75750
M001191,N00033091,Patrick E Murphy (D),2012,Special Trade Contractors,62250,2500,64750
S001190,N00033101,Brad Schneider (D),2012,Lawyers/Law Firms,232661,17500,250161
S001190,N00033101,Brad Schneider (D),2012,Securities & Investment,179133,2500,181633
S001190,N00033101,Brad Schneider (D),2012,Retired,178879,0,178879
S001190,N00033101,Brad Schneider (D),2012,Pro-Israel,160584,2700,163284
S001190,N00033101,Brad Schneider (D),2012,Real Estate,110999,0,110999
S001190,N00033101,Brad Schneider (D),2012,Leadership PACs,1500,99500,101000
S001190,N00033101,Brad Schneider (D),2012,Democratic/Liberal,69596,20350,89946
S001190,N00033101,Brad Schneider (D),2012,Public Sector Unions,750,64000,64750
S001190,N00033101,Brad Schneider (D),2012,Business Services,59500,0,59500
S001190,N00033101,Brad Schneider (D),2012,Candidate Committees,0,48750,48750
W000812,N00033106,Ann L Wagner (R),2012,Automotive,238150,20000,258150
W000812,N00033106,Ann L Wagner (R),2012,Retired,173425,0,173425
W000812,N00033106,Ann L Wagner (R),2012,Lawyers/Law Firms,115600,14500,130100
W000812,N00033106,Ann L Wagner (R),2012,Securities & Investment,122700,7000,129700
W000812,N00033106,Ann L Wagner (R),2012,Misc Manufacturing & Distributing,89750,25500,115250
W000812,N00033106,Ann L Wagner (R),2012,Health Professionals,41150,69500,110650
W000812,N00033106,Ann L Wagner (R),2012,Mining,67000,24500,91500
W000812,N00033106,Ann L Wagner (R),2012,Real Estate,74000,11000,85000
W000812,N00033106,Ann L Wagner (R),2012,Business Services,78100,2000,80100
W000812,N00033106,Ann L Wagner (R),2012,Leadership PACs,0,76500,76500
K000384,N00033177,Tim Kaine (D),2012,Lawyers/Law Firms,1929485,80886,2010371
K000384,N00033177,Tim Kaine (D),2012,Retired,1788035,0,1788035
K000384,N00033177,Tim Kaine (D),2012,Securities & Investment,722566,0,722566
K000384,N00033177,Tim Kaine (D),2012,Real Estate,514144,5000,519144
K000384,N00033177,Tim Kaine (D),2012,Education,502915,0,502915
K000384,N00033177,Tim Kaine (D),2012,Business Services,484674,3000,487674
K000384,N00033177,Tim Kaine (D),2012,Women's Issues,371887,3193,375080
K000384,N00033177,Tim Kaine (D),2012,Lobbyists,356795,7175,363970
K000384,N00033177,Tim Kaine (D),2012,Leadership PACs,0,322500,322500
K000384,N00033177,Tim Kaine (D),2012,Civil Servants/Public Officials,297216,0,297216
E000293,N00033217,Elizabeth Esty (D),2012,Lawyers/Law Firms,270736,12886,283622
E000293,N00033217,Elizabeth Esty (D),2012,Retired,191585,0,191585
E000293,N00033217,Elizabeth Esty (D),2012,Women's Issues,143059,20500,163559
E000293,N00033217,Elizabeth Esty (D),2012,Securities & Investment,143150,500,143650
E000293,N00033217,Elizabeth Esty (D),2012,Education,140652,0,140652
E000293,N00033217,Elizabeth Esty (D),2012,Business Services,100832,0,100832
E000293,N00033217,Elizabeth Esty (D),2012,Real Estate,81683,0,81683
E000293,N00033217,Elizabeth Esty (D),2012,Leadership PACs,250,71000,71250
E000293,N00033217,Elizabeth Esty (D),2012,Public Sector Unions,0,64500,64500
E000293,N00033217,Elizabeth Esty (D),2012,Health Professionals,34154,28500,62654
Y000065,N00033220,Ted Yoho (R),2012,Retired,56812,0,56812
Y000065,N00033220,Ted Yoho (R),2012,Leadership PACs,0,42000,42000
Y000065,N00033220,Ted Yoho (R),2012,Agricultural Services/Products,18985,20500,39485
Y000065,N00033220,Ted Yoho (R),2012,Misc Business,33766,0,33766
Y000065,N00033220,Ted Yoho (R),2012,Crop Production & Basic Processing,24750,6000,30750
Y000065,N00033220,Ted Yoho (R),2012,Health Professionals,18000,8500,26500
Y000065,N00033220,Ted Yoho (R),2012,General Contractors,15000,5000,20000
Y000065,N00033220,Ted Yoho (R),2012,Real Estate,13050,6000,19050
Y000065,N00033220,Ted Yoho (R),2012,Livestock,10250,7500,17750
Y000065,N00033220,Ted Yoho (R),2012,Special Trade Contractors,14725,3000,17725
L000579,N00033274,Alan Lowenthal (D),2012,Public Sector Unions,1000,75000,76000
L000579,N00033274,Alan Lowenthal (D),2012,Retired,67350,0,67350
L000579,N00033274,Alan Lowenthal (D),2012,Lawyers/Law Firms,47650,12250,59900
L000579,N00033274,Alan Lowenthal (D),2012,Leadership PACs,0,59250,59250
L000579,N00033274,Alan Lowenthal (D),2012,Candidate Committees,0,55750,55750
L000579,N00033274,Alan Lowenthal (D),2012,Building Trade Unions,0,48000,48000
L000579,N00033274,Alan Lowenthal (D),2012,Transportation Unions,0,40000,40000
L000579,N00033274,Alan Lowenthal (D),2012,Industrial Unions,0,38000,38000
L000579,N00033274,Alan Lowenthal (D),2012,Democratic/Liberal,29099,8852,37951
L000579,N00033274,Alan Lowenthal (D),2012,Health Professionals,12950,20000,32950
G000571,N00033281,Tulsi Gabbard (D),2012,Retired,82164,0,82164
G000571,N00033281,Tulsi Gabbard (D),2012,Construction Services,56401,1000,57401
G000571,N00033281,Tulsi Gabbard (D),2012,Women's Issues,42911,9000,51911
G000571,N00033281,Tulsi Gabbard (D),2012,Lawyers/Law Firms,43528,7500,51028
G000571,N00033281,Tulsi Gabbard (D),2012,Leadership PACs,250,49000,49250
G000571,N00033281,Tulsi Gabbard (D),2012,Real Estate,42304,5000,47304
G000571,N00033281,Tulsi Gabbard (D),2012,Health Professionals,26251,20500,46751
G000571,N00033281,Tulsi Gabbard (D),2012,Civil Servants/Public Officials,43925,0,43925
G000571,N00033281,Tulsi Gabbard (D),2012,General Contractors,43450,0,43450
G000571,N00033281,Tulsi Gabbard (D),2012,Public Sector Unions,0,41500,41500
W000815,N00033310,Brad Wenstrup (R),2012,Health Professionals,82498,43000,125498
W000815,N00033310,Brad Wenstrup (R),2012,Insurance,35500,8300,43800
W000815,N00033310,Brad Wenstrup (R),2012,Retired,39650,0,39650
W000815,N00033310,Brad Wenstrup (R),2012,Real Estate,27850,11000,38850
W000815,N00033310,Brad Wenstrup (R),2012,Leadership PACs,0,38749,38749
W000815,N00033310,Brad Wenstrup (R),2012,Misc Manufacturing & Distributing,26255,9000,35255
W000815,N00033310,Brad Wenstrup (R),2012,Lawyers/Law Firms,29650,4000,33650
W000815,N00033310,Brad Wenstrup (R),2012,Automotive,12800,15000,27800
W000815,N00033310,Brad Wenstrup (R),2012,Oil & Gas,0,19000,19000
W000815,N00033310,Brad Wenstrup (R),2012,Securities & Investment,15750,3000,18750
C001091,N00033316,Joaquin Castro (D),2012,Lawyers/Law Firms,132688,21999,154687
C001091,N00033316,Joaquin Castro (D),2012,Real Estate,58666,22500,81166
C001091,N00033316,Joaquin Castro (D),2012,Oil & Gas,29550,36500,66050
C001091,N00033316,Joaquin Castro (D),2012,Health Professionals,35949,22000,57949
C001091,N00033316,Joaquin Castro (D),2012,Building Trade Unions,0,43500,43500
C001091,N00033316,Joaquin Castro (D),2012,Construction Services,28113,9500,37613
C001091,N00033316,Joaquin Castro (D),2012,Public Sector Unions,0,35500,35500
C001091,N00033316,Joaquin Castro (D),2012,Industrial Unions,0,35000,35000
C001091,N00033316,Joaquin Castro (D),2012,Business Services,27950,5500,33450
C001091,N00033316,Joaquin Castro (D),2012,Retired,31200,0,31200
C001095,N00033363,Tom Cotton (R),2012,Republican/Conservative,265783,28750,294533
C001095,N00033363,Tom Cotton (R),2012,Securities & Investment,129900,6000,135900
C001095,N00033363,Tom Cotton (R),2012,Lawyers/Law Firms,117110,12740,129850
C001095,N00033363,Tom Cotton (R),2012,Health Professionals,50992,66750,117742
C001095,N00033363,Tom Cotton (R),2012,Oil & Gas,64775,37500,102275
C001095,N00033363,Tom Cotton (R),2012,Retired,82850,0,82850
C001095,N00033363,Tom Cotton (R),2012,Commercial Banks,47250,23500,70750
C001095,N00033363,Tom Cotton (R),2012,Leadership PACs,0,65750,65750
C001095,N00033363,Tom Cotton (R),2012,General Contractors,49375,11000,60375
C001095,N00033363,Tom Cotton (R),2012,Business Services,46700,0,46700
V000129,N00033367,David Valadao (R),2012,Crop Production & Basic Processing,174676,29109,203785
V000129,N00033367,David Valadao (R),2012,Dairy,125949,27000,152949
V000129,N00033367,David Valadao (R),2012,Leadership PACs,0,144250,144250
V000129,N00033367,David Valadao (R),2012,Oil & Gas,5250,54000,59250
V000129,N00033367,David Valadao (R),2012,Health Professionals,11400,35000,46400
V000129,N00033367,David Valadao (R),2012,Real Estate,10250,27000,37250
V000129,N00033367,David Valadao (R),2012,Candidate Committees,0,37000,37000
V000129,N00033367,David Valadao (R),2012,Agricultural Services/Products,10250,24500,34750
V000129,N00033367,David Valadao (R),2012,Livestock,31400,3000,34400
V000129,N00033367,David Valadao (R),2012,Insurance,5000,18500,23500
C001097,N00033373,Tony Cardenas (D),2012,Real Estate,37550,14500,52050
C001097,N00033373,Tony Cardenas (D),2012,Public Sector Unions,0,41500,41500
C001097,N00033373,Tony Cardenas (D),2012,Lawyers/Law Firms,34500,5477,39977
C001097,N00033373,Tony Cardenas (D),2012,Building Trade Unions,0,37000,37000
C001097,N00033373,Tony Cardenas (D),2012,Health Professionals,6500,28500,35000
C001097,N00033373,Tony Cardenas (D),2012,Lobbyists,29840,0,29840
C001097,N00033373,Tony Cardenas (D),2012,Casinos/Gambling,28000,0,28000
C001097,N00033373,Tony Cardenas (D),2012,Leadership PACs,0,23000,23000
C001097,N00033373,Tony Cardenas (D),2012,Pharmaceuticals/Health Products,0,19500,19500
C001097,N00033373,Tony Cardenas (D),2012,TV/Movies/Music,14000,4000,18000
B001286,N00033390,Cheri Bustos (D),2012,Women's Issues,171025,16500,187525
B001286,N00033390,Cheri Bustos (D),2012,Lawyers/Law Firms,155317,11250,166567
B001286,N00033390,Cheri Bustos (D),2012,Leadership PACs,1750,112750,114500
B001286,N00033390,Cheri Bustos (D),2012,Retired,91046,0,91046
B001286,N00033390,Cheri Bustos (D),2012,Public Sector Unions,1300,74500,75800
B001286,N00033390,Cheri Bustos (D),2012,Pro-Israel,67728,5000,72728
B001286,N00033390,Cheri Bustos (D),2012,Building Trade Unions,250,64000,64250
B001286,N00033390,Cheri Bustos (D),2012,Candidate Committees,0,55500,55500
B001286,N00033390,Cheri Bustos (D),2012,Industrial Unions,2700,49000,51700
B001286,N00033390,Cheri Bustos (D),2012,Education,38050,0,38050
K000380,N00033395,Dan Kildee (D),2012,Health Professionals,51382,6000,57382
K000380,N00033395,Dan Kildee (D),2012,Casinos/Gambling,45000,3500,48500
K000380,N00033395,Dan Kildee (D),2012,Public Sector Unions,0,43500,43500
K000380,N00033395,Dan Kildee (D),2012,Building Trade Unions,0,41000,41000
K000380,N00033395,Dan Kildee (D),2012,Industrial Unions,250,40100,40350
K000380,N00033395,Dan Kildee (D),2012,Leadership PACs,0,33500,33500
K000380,N00033395,Dan Kildee (D),2012,Lawyers/Law Firms,12200,13000,25200
K000380,N00033395,Dan Kildee (D),2012,Lobbyists,22300,500,22800
K000380,N00033395,Dan Kildee (D),2012,Crop Production & Basic Processing,0,19500,19500
K000380,N00033395,Dan Kildee (D),2012,Real Estate,10700,7500,18200
H001065,N00033399,George Holding (R),2012,Retired,126240,0,126240
H001065,N00033399,George Holding (R),2012,Lawyers/Law Firms,113518,10750,124268
H001065,N00033399,George Holding (R),2012,Health Professionals,40664,27000,67664
H001065,N00033399,George Holding (R),2012,Real Estate,56180,5000,61180
H001065,N00033399,George Holding (R),2012,Commercial Banks,41845,13000,54845
H001065,N00033399,George Holding (R),2012,Leadership PACs,0,42250,42250
H001065,N00033399,George Holding (R),2012,Misc Business,33859,0,33859
H001065,N00033399,George Holding (R),2012,Crop Production & Basic Processing,32200,1000,33200
H001065,N00033399,George Holding (R),2012,Food & Beverage,15750,9500,25250
H001065,N00033399,George Holding (R),2012,Business Services,22850,0,22850
M001190,N00033410,Markwayne Mullin (R),2012,Leadership PACs,0,107250,107250
M001190,N00033410,Markwayne Mullin (R),2012,Oil & Gas,52000,45500,97500
M001190,N00033410,Markwayne Mullin (R),2012,Commercial Banks,57350,15000,72350
M001190,N00033410,Markwayne Mullin (R),2012,Special Trade Contractors,61476,3000,64476
M001190,N00033410,Markwayne Mullin (R),2012,Retired,54908,0,54908
M001190,N00033410,Markwayne Mullin (R),2012,General Contractors,36700,11000,47700
M001190,N00033410,Markwayne Mullin (R),2012,Insurance,24400,7500,31900
M001190,N00033410,Markwayne Mullin (R),2012,Real Estate,31261,0,31261
M001190,N00033410,Markwayne Mullin (R),2012,Livestock,26500,2000,28500
M001190,N00033410,Markwayne Mullin (R),2012,Health Professionals,26800,0,26800
F000463,N00033443,Deb Fischer (R),2012,Retired,321767,0,321767
F000463,N00033443,Deb Fischer (R),2012,Leadership PACs,200,234750,234950
F000463,N00033443,Deb Fischer (R),2012,Republican/Conservative,148771,45500,194271
F000463,N00033443,Deb Fischer (R),2012,Commercial Banks,76500,69500,146000
F000463,N00033443,Deb Fischer (R),2012,Crop Production & Basic Processing,120660,19500,140160
F000463,N00033443,Deb Fischer (R),2012,Health Professionals,102299,33500,135799
F000463,N00033443,Deb Fischer (R),2012,Securities & Investment,121742,6500,128242
F000463,N00033443,Deb Fischer (R),2012,Insurance,72500,55000,127500
F000463,N00033443,Deb Fischer (R),2012,Oil & Gas,63034,49000,112034
F000463,N00033443,Deb Fischer (R),2012,Real Estate,94663,14500,109163
D000627,N00033449,Val Demings (D),2012,Women's Issues,163674,25420,189094
D000627,N00033449,Val Demings (D),2012,Lawyers/Law Firms,84879,10000,94879
D000627,N00033449,Val Demings (D),2012,Leadership PACs,0,94000,94000
D000627,N00033449,Val Demings (D),2012,Retired,78493,0,78493
D000627,N00033449,Val Demings (D),2012,Public Sector Unions,0,74750,74750
D000627,N00033449,Val Demings (D),2012,Democratic/Liberal,48506,14600,63106
D000627,N00033449,Val Demings (D),2012,Industrial Unions,0,48500,48500
D000627,N00033449,Val Demings (D),2012,Candidate Committees,0,46500,46500
D000627,N00033449,Val Demings (D),2012,Civil Servants/Public Officials,37655,0,37655
D000627,N00033449,Val Demings (D),2012,Building Trade Unions,0,37000,37000
B001278,N00033474,Suzanne Bonamici (D),2012,Lawyers/Law Firms,282580,24164,306744
B001278,N00033474,Suzanne Bonamici (D),2012,Retired,117325,0,117325
B001278,N00033474,Suzanne Bonamici (D),2012,Leadership PACs,0,105000,105000
B001278,N00033474,Suzanne Bonamici (D),2012,Public Sector Unions,0,102500,102500
B001278,N00033474,Suzanne Bonamici (D),2012,Women's Issues,79600,13000,92600
B001278,N00033474,Suzanne Bonamici (D),2012,Health Professionals,22850,36500,59350
B001278,N00033474,Suzanne Bonamici (D),2012,Candidate Committees,0,48500,48500
B001278,N00033474,Suzanne Bonamici (D),2012,Building Trade Unions,0,47500,47500
B001278,N00033474,Suzanne Bonamici (D),2012,Transportation Unions,500,43000,43500
B001278,N00033474,Suzanne Bonamici (D),2012,Education,42092,0,42092
W000817,N00033492,Elizabeth Warren (D),2012,Retired,3291086,0,3291086
W000817,N00033492,Elizabeth Warren (D),2012,Lawyers/Law Firms,2185072,24000,2209072
W000817,N00033492,Elizabeth Warren (D),2012,Women's Issues,1577911,20472,1598383
W000817,N00033492,Elizabeth Warren (D),2012,Education,1364383,0,1364383
W000817,N00033492,Elizabeth Warren (D),2012,Democratic/Liberal,902592,351533,1254125
W000817,N00033492,Elizabeth Warren (D),2012,Securities & Investment,622525,2500,625025
W000817,N00033492,Elizabeth Warren (D),2012,TV/Movies/Music,497231,0,497231
W000817,N00033492,Elizabeth Warren (D),2012,Business Services,478774,2500,481274
W000817,N00033492,Elizabeth Warren (D),2012,Health Professionals,447306,2500,449806
W000817,N00033492,Elizabeth Warren (D),2012,Printing & Publishing,377931,0,377931
B001284,N00033495,Susan Brooks (R),2012,Lawyers/Law Firms,148950,5000,153950
B001284,N00033495,Susan Brooks (R),2012,Retired,67100,0,67100
B001284,N00033495,Susan Brooks (R),2012,Real Estate,52500,8500,61000
B001284,N00033495,Susan Brooks (R),2012,Pharmaceuticals/Health Products,42803,12000,54803
B001284,N00033495,Susan Brooks (R),2012,Health Professionals,31550,14500,46050
B001284,N00033495,Susan Brooks (R),2012,Leadership PACs,0,41000,41000
B001284,N00033495,Susan Brooks (R),2012,Securities & Investment,36250,1000,37250
B001284,N00033495,Susan Brooks (R),2012,Insurance,20000,4500,24500
B001284,N00033495,Susan Brooks (R),2012,Construction Services,23750,0,23750
B001284,N00033495,Susan Brooks (R),2012,Accountants,13350,10000,23350
S001193,N00033508,Eric Swalwell (D),2012,Real Estate,62550,3500,66050
S001193,N00033508,Eric Swalwell (D),2012,Lawyers/Law Firms,45850,11000,56850
S001193,N00033508,Eric Swalwell (D),2012,Retired,34610,0,34610
S001193,N00033508,Eric Swalwell (D),2012,Pro-Israel,18650,15000,33650
S001193,N00033508,Eric Swalwell (D),2012,Pharmaceuticals/Health Products,3250,21000,24250
S001193,N00033508,Eric Swalwell (D),2012,"Beer, Wine & Liquor",22840,0,22840
S001193,N00033508,Eric Swalwell (D),2012,Automotive,10250,5000,15250
S001193,N00033508,Eric Swalwell (D),2012,Home Builders,13850,0,13850
S001193,N00033508,Eric Swalwell (D),2012,Civil Servants/Public Officials,13600,0,13600
S001193,N00033508,Eric Swalwell (D),2012,Business Services,11960,0,11960
N000187,N00033509,Gloria McLeod (D),2012,Health Professionals,18920,16500,35420
N000187,N00033509,Gloria McLeod (D),2012,Lobbyists,16100,0,16100
N000187,N00033509,Gloria McLeod (D),2012,Business Services,16000,0,16000
N000187,N00033509,Gloria McLeod (D),2012,Retired,12425,0,12425
N000187,N00033509,Gloria McLeod (D),2012,Industrial Unions,0,10000,10000
N000187,N00033509,Gloria McLeod (D),2012,Real Estate,7000,2000,9000
N000187,N00033509,Gloria McLeod (D),2012,Civil Servants/Public Officials,8300,0,8300
N000187,N00033509,Gloria McLeod (D),2012,Retail Sales,7700,0,7700
N000187,N00033509,Gloria McLeod (D),2012,Casinos/Gambling,7500,0,7500
N000187,N00033509,Gloria McLeod (D),2012,Women's Issues,950,6500,7450
R000599,N00033510,Raul Ruiz (D),2012,Health Professionals,153933,38000,191933
R000599,N00033510,Raul Ruiz (D),2012,Retired,164502,0,164502
R000599,N00033510,Raul Ruiz (D),2012,Democratic/Liberal,53889,43418,97307
R000599,N00033510,Raul Ruiz (D),2012,Leadership PACs,0,91000,91000
R000599,N00033510,Raul Ruiz (D),2012,Lawyers/Law Firms,71900,10000,81900
R000599,N00033510,Raul Ruiz (D),2012,Industrial Unions,250,53000,53250
R000599,N00033510,Raul Ruiz (D),2012,Public Sector Unions,0,53000,53000
R000599,N00033510,Raul Ruiz (D),2012,Candidate Committees,0,53000,53000
R000599,N00033510,Raul Ruiz (D),2012,Hospitals/Nursing Homes,29770,20000,49770
R000599,N00033510,Raul Ruiz (D),2012,Building Trade Unions,0,48500,48500
C001093,N00033518,Doug Collins (R),2012,Lawyers/Law Firms,49480,8500,57980
C001093,N00033518,Doug Collins (R),2012,Leadership PACs,0,50500,50500
C001093,N00033518,Doug Collins (R),2012,Health Professionals,25850,17000,42850
C001093,N00033518,Doug Collins (R),2012,Retired,34000,0,34000
C001093,N00033518,Doug Collins (R),2012,Automotive,5500,20500,26000
C001093,N00033518,Doug Collins (R),2012,Real Estate,5750,16000,21750
C001093,N00033518,Doug Collins (R),2012,Oil & Gas,5500,14500,20000
C001093,N00033518,Doug Collins (R),2012,Misc Finance,17500,1000,18500
C001093,N00033518,Doug Collins (R),2012,General Contractors,10250,7000,17250
C001093,N00033518,Doug Collins (R),2012,Misc Manufacturing & Distributing,16000,1000,17000
R000603,N00033527,David Rouzer (R),2012,Crop Production & Basic Processing,217906,8500,226406
R000603,N00033527,David Rouzer (R),2012,Leadership PACs,0,135500,135500
R000603,N00033527,David Rouzer (R),2012,Retired,89405,0,89405
R000603,N00033527,David Rouzer (R),2012,Candidate Committees,0,55050,55050
R000603,N00033527,David Rouzer (R),2012,Health Professionals,35050,19500,54550
R000603,N00033527,David Rouzer (R),2012,Lawyers/Law Firms,38300,16135,54435
R000603,N00033527,David Rouzer (R),2012,Lobbyists,34334,0,34334
R000603,N00033527,David Rouzer (R),2012,Real Estate,33733,0,33733
R000603,N00033527,David Rouzer (R),2012,Agricultural Services/Products,12100,21500,33600
R000603,N00033527,David Rouzer (R),2012,Oil & Gas,10900,17500,28400
B001283,N00033532,James Bridenstine (R),2012,Health Professionals,97415,18000,115415
B001283,N00033532,James Bridenstine (R),2012,Oil & Gas,26000,49000,75000
B001283,N00033532,James Bridenstine (R),2012,Retired,68050,0,68050
B001283,N00033532,James Bridenstine (R),2012,Leadership PACs,0,46000,46000
B001283,N00033532,James Bridenstine (R),2012,Lawyers/Law Firms,20800,0,20800
B001283,N00033532,James Bridenstine (R),2012,Republican/Conservative,12750,1000,13750
B001283,N00033532,James Bridenstine (R),2012,Automotive,5250,7000,12250
B001283,N00033532,James Bridenstine (R),2012,Misc Manufacturing & Distributing,9250,2000,11250
B001283,N00033532,James Bridenstine (R),2012,Real Estate,11250,0,11250
B001283,N00033532,James Bridenstine (R),2012,Commercial Banks,2500,8500,11000
B001283,N00033532,James Bridenstine (R),2012,Insurance,2500,8500,11000
W000814,N00033539,Randy Weber (R),2012,Leadership PACs,0,132500,132500
W000814,N00033539,Randy Weber (R),2012,Oil & Gas,13100,49500,62600
W000814,N00033539,Randy Weber (R),2012,Misc Manufacturing & Distributing,50000,1000,51000
W000814,N00033539,Randy Weber (R),2012,Lawyers/Law Firms,47133,1500,48633
W000814,N00033539,Randy Weber (R),2012,Candidate Committees,0,40250,40250
W000814,N00033539,Randy Weber (R),2012,Retired,39100,0,39100
W000814,N00033539,Randy Weber (R),2012,Special Trade Contractors,29450,9042,38492
W000814,N00033539,Randy Weber (R),2012,Real Estate,19661,7000,26661
W000814,N00033539,Randy Weber (R),2012,Chemical & Related Manufacturing,1900,23500,25400
W000814,N00033539,Randy Weber (R),2012,Republican/Conservative,5750,13750,19500
O000170,N00033540,Beto O'Rourke (D),2012,Real Estate,61205,5000,66205
O000170,N00033540,Beto O'Rourke (D),2012,Retired,25900,0,25900
O000170,N00033540,Beto O'Rourke (D),2012,Lawyers/Law Firms,24737,500,25237
O000170,N00033540,Beto O'Rourke (D),2012,Health Professionals,15050,5000,20050
O000170,N00033540,Beto O'Rourke (D),2012,Misc Finance,16250,0,16250
O000170,N00033540,Beto O'Rourke (D),2012,Building Trade Unions,0,16000,16000
O000170,N00033540,Beto O'Rourke (D),2012,Business Services,12850,0,12850
O000170,N00033540,Beto O'Rourke (D),2012,Automotive,12000,0,12000
O000170,N00033540,Beto O'Rourke (D),2012,Commercial Banks,9950,2000,11950
O000170,N00033540,Beto O'Rourke (D),2012,Telephone Utilities,9900,1000,10900
G000572,N00033541,Pete Gallego (D),2012,Lawyers/Law Firms,260844,18000,278844
G000572,N00033541,Pete Gallego (D),2012,Public Sector Unions,0,73000,73000
G000572,N00033541,Pete Gallego (D),2012,Leadership PACs,0,60500,60500
G000572,N00033541,Pete Gallego (D),2012,Candidate Committees,0,57000,57000
G000572,N00033541,Pete Gallego (D),2012,"Beer, Wine & Liquor",56500,0,56500
G000572,N00033541,Pete Gallego (D),2012,Real Estate,49150,0,49150
G000572,N00033541,Pete Gallego (D),2012,Misc Finance,48950,0,48950
G000572,N00033541,Pete Gallego (D),2012,Industrial Unions,250,38500,38750
G000572,N00033541,Pete Gallego (D),2012,Misc Business,37550,0,37550
G000572,N00033541,Pete Gallego (D),2012,Building Trade Unions,0,37500,37500
P000607,N00033549,Mark Pocan (D),2012,Building Trade Unions,0,79000,79000
P000607,N00033549,Mark Pocan (D),2012,Public Sector Unions,1450,67500,68950
P000607,N00033549,Mark Pocan (D),2012,Health Professionals,5450,51000,56450
P000607,N00033549,Mark Pocan (D),2012,Retired,47400,0,47400
P000607,N00033549,Mark Pocan (D),2012,Lawyers/Law Firms,30850,11000,41850
P000607,N00033549,Mark Pocan (D),2012,Industrial Unions,500,38000,38500
P000607,N00033549,Mark Pocan (D),2012,Real Estate,21750,12500,34250
P000607,N00033549,Mark Pocan (D),2012,Human Rights,12500,19865,32365
P000607,N00033549,Mark Pocan (D),2012,Lobbyists,24588,1500,26088
P000607,N00033549,Mark Pocan (D),2012,Education,24000,1000,25000
P000608,N00033591,Scott Peters (D),2012,Lawyers/Law Firms,164650,11000,175650
P000608,N00033591,Scott Peters (D),2012,Retired,168325,0,168325
P000608,N00033591,Scott Peters (D),2012,Real Estate,71600,0,71600
P000608,N00033591,Scott Peters (D),2012,Leadership PACs,0,58675,58675
P000608,N00033591,Scott Peters (D),2012,Misc Finance,58450,0,58450
P000608,N00033591,Scott Peters (D),2012,Education,57100,0,57100
P000608,N00033591,Scott Peters (D),2012,Public Sector Unions,250,48000,48250
P000608,N00033591,Scott Peters (D),2012,Health Professionals,39644,500,40144
P000608,N00033591,Scott Peters (D),2012,Building Trade Unions,0,39000,39000
P000608,N00033591,Scott Peters (D),2012,Securities & Investment,38370,0,38370
B001280,N00033625,Kerry Bentivolio (R),2012,Leadership PACs,0,83500,83500
B001280,N00033625,Kerry Bentivolio (R),2012,Republican/Conservative,1750,25300,27050
B001280,N00033625,Kerry Bentivolio (R),2012,Candidate Committees,0,23500,23500
B001280,N00033625,Kerry Bentivolio (R),2012,Automotive,7750,9500,17250
B001280,N00033625,Kerry Bentivolio (R),2012,Retired,14750,0,14750
B001280,N00033625,Kerry Bentivolio (R),2012,Real Estate,9750,4500,14250
B001280,N00033625,Kerry Bentivolio (R),2012,Lawyers/Law Firms,10500,3000,13500
B001280,N00033625,Kerry Bentivolio (R),2012,Oil & Gas,0,13500,13500
B001280,N00033625,Kerry Bentivolio (R),2012,Credit Unions,0,10000,10000
B001280,N00033625,Kerry Bentivolio (R),2012,Gun Rights,5000,1024,6024
H001067,N00033630,Richard Hudson (R),2012,Leadership PACs,0,263282,263282
H001067,N00033630,Richard Hudson (R),2012,Lobbyists,76050,0,76050
H001067,N00033630,Richard Hudson (R),2012,Candidate Committees,0,75685,75685
H001067,N00033630,Richard Hudson (R),2012,Health Professionals,5750,50000,55750
H001067,N00033630,Richard Hudson (R),2012,Lawyers/Law Firms,49300,4000,53300
H001067,N00033630,Richard Hudson (R),2012,Accountants,4000,46500,50500
H001067,N00033630,Richard Hudson (R),2012,Oil & Gas,3200,46500,49700
H001067,N00033630,Richard Hudson (R),2012,Insurance,11900,30000,41900
H001067,N00033630,Richard Hudson (R),2012,Crop Production & Basic Processing,29175,8500,37675
H001067,N00033630,Richard Hudson (R),2012,Civil Servants/Public Officials,34000,0,34000
M001187,N00033631,Mark R Meadows (R),2012,Retired,178450,0,178450
M001187,N00033631,Mark R Meadows (R),2012,Leadership PACs,0,99500,99500
M001187,N00033631,Mark R Meadows (R),2012,Real Estate,31000,12000,43000
M001187,N00033631,Mark R Meadows (R),2012,Candidate Committees,0,27500,27500
M001187,N00033631,Mark R Meadows (R),2012,Republican/Conservative,2150,24500,26650
M001187,N00033631,Mark R Meadows (R),2012,Health Professionals,13650,10500,24150
M001187,N00033631,Mark R Meadows (R),2012,Oil & Gas,7000,14000,21000
M001187,N00033631,Mark R Meadows (R),2012,Lawyers/Law Firms,20000,0,20000
M001187,N00033631,Mark R Meadows (R),2012,General Contractors,10200,3500,13700
M001187,N00033631,Mark R Meadows (R),2012,Misc Finance,10800,1000,11800
H001066,N00033638,Steven Horsford (D),2012,Lawyers/Law Firms,97094,23230,120324
H001066,N00033638,Steven Horsford (D),2012,Leadership PACs,1000,107134,108134
H001066,N00033638,Steven Horsford (D),2012,Casinos/Gambling,61217,25000,86217
H001066,N00033638,Steven Horsford (D),2012,Health Professionals,66306,19000,85306
H001066,N00033638,Steven Horsford (D),2012,Public Sector Unions,0,81000,81000
H001066,N00033638,Steven Horsford (D),2012,Building Trade Unions,0,72500,72500
H001066,N00033638,Steven Horsford (D),2012,Candidate Committees,0,58952,58952
H001066,N00033638,Steven Horsford (D),2012,Industrial Unions,0,48500,48500
H001066,N00033638,Steven Horsford (D),2012,Retired,48316,0,48316
H001066,N00033638,Steven Horsford (D),2012,Business Services,41750,0,41750
J000294,N00033640,Hakeem Jeffries (D),2012,Lawyers/Law Firms,216775,17000,233775
J000294,N00033640,Hakeem Jeffries (D),2012,Securities & Investment,104200,3000,107200
J000294,N00033640,Hakeem Jeffries (D),2012,Real Estate,80838,5000,85838
J000294,N00033640,Hakeem Jeffries (D),2012,Pro-Israel,58400,20300,78700
J000294,N00033640,Hakeem Jeffries (D),2012,Retired,47218,0,47218
J000294,N00033640,Hakeem Jeffries (D),2012,Business Services,31245,0,31245
J000294,N00033640,Hakeem Jeffries (D),2012,Misc Business,30300,0,30300
J000294,N00033640,Hakeem Jeffries (D),2012,Building Trade Unions,450,29350,29800
J000294,N00033640,Hakeem Jeffries (D),2012,TV/Movies/Music,24150,3500,27650
J000294,N00033640,Hakeem Jeffries (D),2012,Misc Finance,23110,0,23110
H001069,N00033782,Heidi Heitkamp (D),2012,Lawyers/Law Firms,561950,39911,601861
H001069,N00033782,Heidi Heitkamp (D),2012,Leadership PACs,0,323918,323918
H001069,N00033782,Heidi Heitkamp (D),2012,Women's Issues,165994,8500,174494
H001069,N00033782,Heidi Heitkamp (D),2012,Retired,150316,0,150316
H001069,N00033782,Heidi Heitkamp (D),2012,Lobbyists,131885,3500,135385
H001069,N00033782,Heidi Heitkamp (D),2012,Securities & Investment,118349,16000,134349
H001069,N00033782,Heidi Heitkamp (D),2012,Crop Production & Basic Processing,82800,17500,100300
H001069,N00033782,Heidi Heitkamp (D),2012,TV/Movies/Music,92667,1000,93667
H001069,N00033782,Heidi Heitkamp (D),2012,Education,84962,0,84962
H001069,N00033782,Heidi Heitkamp (D),2012,Public Sector Unions,800,83000,83800
R000597,N00033832,Tom Rice (R),2012,Retired,146715,0,146715
R000597,N00033832,Tom Rice (R),2012,Real Estate,97421,5000,102421
R000597,N00033832,Tom Rice (R),2012,Health Professionals,60900,30500,91400
R000597,N00033832,Tom Rice (R),2012,General Contractors,67038,8500,75538
R000597,N00033832,Tom Rice (R),2012,Lawyers/Law Firms,56969,7500,64469
R000597,N00033832,Tom Rice (R),2012,Hospitals/Nursing Homes,26700,24500,51200
R000597,N00033832,Tom Rice (R),2012,Leadership PACs,0,48500,48500
R000597,N00033832,Tom Rice (R),2012,Business Services,27400,1500,28900
R000597,N00033832,Tom Rice (R),2012,Accountants,8450,17000,25450
R000597,N00033832,Tom Rice (R),2012,Commercial Banks,17650,7000,24650
V000131,N00033839,Marc Veasey (D),2012,Lawyers/Law Firms,158950,12000,170950
V000131,N00033839,Marc Veasey (D),2012,Public Sector Unions,250,74000,74250
V000131,N00033839,Marc Veasey (D),2012,Oil & Gas,44850,17000,61850
V000131,N00033839,Marc Veasey (D),2012,Industrial Unions,0,60000,60000
V000131,N00033839,Marc Veasey (D),2012,Real Estate,24500,20000,44500
V000131,N00033839,Marc Veasey (D),2012,Retired,40550,0,40550
V000131,N00033839,Marc Veasey (D),2012,Transportation Unions,0,39500,39500
V000131,N00033839,Marc Veasey (D),2012,Building Trade Unions,0,38000,38000
V000131,N00033839,Marc Veasey (D),2012,Health Professionals,6950,20000,26950
V000131,N00033839,Marc Veasey (D),2012,Automotive,7500,16000,23500
L000584,N00033842,Mia Love (R),2012,Leadership PACs,0,207400,207400
L000584,N00033842,Mia Love (R),2012,Retired,148626,0,148626
L000584,N00033842,Mia Love (R),2012,Republican/Conservative,72925,37200,110125
L000584,N00033842,Mia Love (R),2012,Candidate Committees,0,64750,64750
L000584,N00033842,Mia Love (R),2012,Real Estate,57060,6000,63060
L000584,N00033842,Mia Love (R),2012,Securities & Investment,44450,0,44450
L000584,N00033842,Mia Love (R),2012,Business Services,34950,250,35200
L000584,N00033842,Mia Love (R),2012,Lawyers/Law Firms,32650,0,32650
L000584,N00033842,Mia Love (R),2012,Misc Finance,30150,0,30150
L000584,N00033842,Mia Love (R),2012,Electronics Mfg & Equip,28393,0,28393
D000620,N00033897,John K Delaney (D),2012,Securities & Investment,270000,0,270000
D000620,N00033897,John K Delaney (D),2012,Lawyers/Law Firms,198039,13000,211039
D000620,N00033897,John K Delaney (D),2012,Real Estate,136499,4500,140999
D000620,N00033897,John K Delaney (D),2012,Finance/Credit Companies,108450,0,108450
D000620,N00033897,John K Delaney (D),2012,Misc Finance,84750,0,84750
D000620,N00033897,John K Delaney (D),2012,Business Services,66250,5000,71250
D000620,N00033897,John K Delaney (D),2012,Leadership PACs,0,65000,65000
D000620,N00033897,John K Delaney (D),2012,Public Sector Unions,0,55500,55500
D000620,N00033897,John K Delaney (D),2012,Retired,53840,0,53840
D000620,N00033897,John K Delaney (D),2012,Commercial Banks,35400,12000,47400
B001281,N00033904,Joyce Beatty (D),2012,Lawyers/Law Firms,22200,22750,44950
B001281,N00033904,Joyce Beatty (D),2012,Commercial Banks,1900,37500,39400
B001281,N00033904,Joyce Beatty (D),2012,Public Sector Unions,1000,36000,37000
B001281,N00033904,Joyce Beatty (D),2012,Insurance,18750,17000,35750
B001281,N00033904,Joyce Beatty (D),2012,Retail Sales,7500,25750,33250
B001281,N00033904,Joyce Beatty (D),2012,Electric Utilities,10250,17000,27250
B001281,N00033904,Joyce Beatty (D),2012,Education,27100,0,27100
B001281,N00033904,Joyce Beatty (D),2012,Leadership PACs,0,26208,26208
B001281,N00033904,Joyce Beatty (D),2012,Industrial Unions,0,26000,26000
B001281,N00033904,Joyce Beatty (D),2012,Retired,24100,0,24100
S001192,N00033932,Chris Stewart (R),2012,Leadership PACs,0,55500,55500
S001192,N00033932,Chris Stewart (R),2012,Oil & Gas,10000,32000,42000
S001192,N00033932,Chris Stewart (R),2012,Retired,25600,0,25600
S001192,N00033932,Chris Stewart (R),2012,Commercial Banks,3750,19000,22750
S001192,N00033932,Chris Stewart (R),2012,Insurance,5500,10500,16000
S001192,N00033932,Chris Stewart (R),2012,Pharmaceuticals/Health Products,2250,11000,13250
S001192,N00033932,Chris Stewart (R),2012,Health Professionals,3000,10000,13000
S001192,N00033932,Chris Stewart (R),2012,Misc Business,12250,0,12250
S001192,N00033932,Chris Stewart (R),2012,Candidate Committees,0,10500,10500
S001192,N00033932,Chris Stewart (R),2012,Electric Utilities,0,10500,10500
B001279,N00033981,Ron Barber (D),2012,Retired,292573,0,292573
B001279,N00033981,Ron Barber (D),2012,Leadership PACs,0,162500,162500
B001279,N00033981,Ron Barber (D),2012,Public Sector Unions,1250,129500,130750
B001279,N00033981,Ron Barber (D),2012,Lawyers/Law Firms,66750,24000,90750
B001279,N00033981,Ron Barber (D),2012,Democratic/Liberal,60402,28000,88402
B001279,N00033981,Ron Barber (D),2012,Health Professionals,22100,65000,87100
B001279,N00033981,Ron Barber (D),2012,Building Trade Unions,0,83500,83500
B001279,N00033981,Ron Barber (D),2012,Candidate Committees,0,71496,71496
B001279,N00033981,Ron Barber (D),2012,Education,62865,0,62865
B001279,N00033981,Ron Barber (D),2012,Real Estate,34500,24000,58500
M001197,N00033982,Martha McSally (R),2012,Retired,181333,0,181333
M001197,N00033982,Martha McSally (R),2012,Leadership PACs,0,149750,149750
M001197,N00033982,Martha McSally (R),2012,Real Estate,72594,0,72594
M001197,N00033982,Martha McSally (R),2012,Candidate Committees,0,53000,53000
M001197,N00033982,Martha McSally (R),2012,Automotive,45333,7500,52833
M001197,N00033982,Martha McSally (R),2012,Securities & Investment,35333,0,35333
M001197,N00033982,Martha McSally (R),2012,Republican/Conservative,19500,13280,32780
M001197,N00033982,Martha McSally (R),2012,Health Professionals,25440,2500,27940
M001197,N00033982,Martha McSally (R),2012,Misc Business,26083,0,26083
M001197,N00033982,Martha McSally (R),2012,Home Builders,21000,2500,23500
S001191,N00033983,Kyrsten Sinema (D),2012,Lawyers/Law Firms,176636,6000,182636
S001191,N00033983,Kyrsten Sinema (D),2012,Retired,166469,0,166469
S001191,N00033983,Kyrsten Sinema (D),2012,Women's Issues,116090,23000,139090
S001191,N00033983,Kyrsten Sinema (D),2012,Human Rights,40074,26866,66940
S001191,N00033983,Kyrsten Sinema (D),2012,Democratic/Liberal,50292,16250,66542
S001191,N00033983,Kyrsten Sinema (D),2012,Real Estate,44500,12000,56500
S001191,N00033983,Kyrsten Sinema (D),2012,Public Sector Unions,200,52750,52950
S001191,N00033983,Kyrsten Sinema (D),2012,Education,52476,0,52476
S001191,N00033983,Kyrsten Sinema (D),2012,Leadership PACs,0,52000,52000
S001191,N00033983,Kyrsten Sinema (D),2012,Health Professionals,34060,12500,46560
L000578,N00033987,Doug LaMalfa (R),2012,Crop Production & Basic Processing,102590,11500,114090
L000578,N00033987,Doug LaMalfa (R),2012,Leadership PACs,0,79656,79656
L000578,N00033987,Doug LaMalfa (R),2012,Health Professionals,6300,21000,27300
L000578,N00033987,Doug LaMalfa (R),2012,Real Estate,6250,20000,26250
L000578,N00033987,Doug LaMalfa (R),2012,Automotive,3000,19500,22500
L000578,N00033987,Doug LaMalfa (R),2012,Agricultural Services/Products,4500,15000,19500
L000578,N00033987,Doug LaMalfa (R),2012,Oil & Gas,500,18000,18500
L000578,N00033987,Doug LaMalfa (R),2012,Casinos/Gambling,18500,0,18500
L000578,N00033987,Doug LaMalfa (R),2012,Finance/Credit Companies,0,17000,17000
L000578,N00033987,Doug LaMalfa (R),2012,Insurance,1075,15500,16575
R000596,N00034017,Trey Radel (R),2012,Retired,155298,0,155298
R000596,N00034017,Trey Radel (R),2012,Real Estate,32263,7500,39763
R000596,N00034017,Trey Radel (R),2012,Leadership PACs,0,39500,39500
R000596,N00034017,Trey Radel (R),2012,Lawyers/Law Firms,36223,1000,37223
R000596,N00034017,Trey Radel (R),2012,Health Professionals,18000,15500,33500
R000596,N00034017,Trey Radel (R),2012,Crop Production & Basic Processing,14000,7500,21500
R000596,N00034017,Trey Radel (R),2012,General Contractors,14000,5000,19000
R000596,N00034017,Trey Radel (R),2012,Republican/Conservative,8750,10000,18750
R000596,N00034017,Trey Radel (R),2012,Misc Manufacturing & Distributing,18500,0,18500
R000596,N00034017,Trey Radel (R),2012,Oil & Gas,500,18000,18500
M001184,N00034041,Thomas Massie (R),2012,Republican/Conservative,137057,4400,141457
M001184,N00034041,Thomas Massie (R),2012,Leadership PACs,0,80500,80500
M001184,N00034041,Thomas Massie (R),2012,Retired,54715,0,54715
M001184,N00034041,Thomas Massie (R),2012,Oil & Gas,6451,22000,28451
M001184,N00034041,Thomas Massie (R),2012,Mining,0,27000,27000
M001184,N00034041,Thomas Massie (R),2012,Lawyers/Law Firms,24350,1000,25350
M001184,N00034041,Thomas Massie (R),2012,Pharmaceuticals/Health Products,3201,21500,24701
M001184,N00034041,Thomas Massie (R),2012,Health Professionals,11751,12000,23751
M001184,N00034041,Thomas Massie (R),2012,Air Transport,12000,5000,17000
M001184,N00034041,Thomas Massie (R),2012,"Beer, Wine & Liquor",8000,8000,16000
K000379,N00034044,Joe Kennedy III (D),2012,Lawyers/Law Firms,437594,35000,472594
K000379,N00034044,Joe Kennedy III (D),2012,Securities & Investment,413300,4500,417800
K000379,N00034044,Joe Kennedy III (D),2012,Real Estate,237930,10000,247930
K000379,N00034044,Joe Kennedy III (D),2012,Business Services,182650,0,182650
K000379,N00034044,Joe Kennedy III (D),2012,Retired,145000,0,145000
K000379,N00034044,Joe Kennedy III (D),2012,Lobbyists,131514,2357,133871
K000379,N00034044,Joe Kennedy III (D),2012,TV/Movies/Music,102600,0,102600
K000379,N00034044,Joe Kennedy III (D),2012,Education,97400,0,97400
K000379,N00034044,Joe Kennedy III (D),2012,Misc Finance,95900,0,95900
K000379,N00034044,Joe Kennedy III (D),2012,Misc Business,81880,2500,84380
P000605,N00034120,Scott Perry (R),2012,Leadership PACs,0,56500,56500
P000605,N00034120,Scott Perry (R),2012,Retired,32071,0,32071
P000605,N00034120,Scott Perry (R),2012,Oil & Gas,4000,16000,20000
P000605,N00034120,Scott Perry (R),2012,General Contractors,12500,6000,18500
P000605,N00034120,Scott Perry (R),2012,Health Professionals,4500,13000,17500
P000605,N00034120,Scott Perry (R),2012,Real Estate,12219,5000,17219
P000605,N00034120,Scott Perry (R),2012,Misc Business,13550,0,13550
P000605,N00034120,Scott Perry (R),2012,Securities & Investment,7750,5500,13250
P000605,N00034120,Scott Perry (R),2012,Republican/Conservative,1000,12000,13000
P000605,N00034120,Scott Perry (R),2012,Lobbyists,12997,0,12997
C001090,N00034128,Matt Cartwright (D),2012,Lawyers/Law Firms,360875,11500,372375
C001090,N00034128,Matt Cartwright (D),2012,Public Sector Unions,0,50000,50000
C001090,N00034128,Matt Cartwright (D),2012,Industrial Unions,0,27500,27500
C001090,N00034128,Matt Cartwright (D),2012,Transportation Unions,0,27500,27500
C001090,N00034128,Matt Cartwright (D),2012,Building Trade Unions,0,27500,27500
C001090,N00034128,Matt Cartwright (D),2012,Retired,21650,0,21650
C001090,N00034128,Matt Cartwright (D),2012,Misc Business,17500,0,17500
C001090,N00034128,Matt Cartwright (D),2012,Health Professionals,7750,7100,14850
C001090,N00034128,Matt Cartwright (D),2012,Misc Unions,0,12500,12500
C001090,N00034128,Matt Cartwright (D),2012,Education,10500,0,10500
C001094,N00034224,Paul Cook (R),2012,Casinos/Gambling,45316,0,45316
C001094,N00034224,Paul Cook (R),2012,Health Professionals,5350,23000,28350
C001094,N00034224,Paul Cook (R),2012,Leadership PACs,0,27500,27500
C001094,N00034224,Paul Cook (R),2012,Public Sector Unions,0,27500,27500
C001094,N00034224,Paul Cook (R),2012,Real Estate,21367,5000,26367
C001094,N00034224,Paul Cook (R),2012,Retired,22350,0,22350
C001094,N00034224,Paul Cook (R),2012,Accountants,21450,0,21450
C001094,N00034224,Paul Cook (R),2012,Home Builders,11500,3500,15000
C001094,N00034224,Paul Cook (R),2012,Electric Utilities,250,14000,14250
C001094,N00034224,Paul Cook (R),2012,Hospitals/Nursing Homes,9750,3000,12750
C001094,N00034224,Paul Cook (R),2012,General Contractors,11750,1000,12750
B001285,N00034254,Julia Brownley (D),2012,Retired,209945,0,209945
B001285,N00034254,Julia Brownley (D),2012,Women's Issues,184055,24250,208305
B001285,N00034254,Julia Brownley (D),2012,Lawyers/Law Firms,107815,11000,118815
B001285,N00034254,Julia Brownley (D),2012,Leadership PACs,0,89001,89001
B001285,N00034254,Julia Brownley (D),2012,Public Sector Unions,0,70000,70000
B001285,N00034254,Julia Brownley (D),2012,Democratic/Liberal,42460,23400,65860
B001285,N00034254,Julia Brownley (D),2012,Candidate Committees,0,62500,62500
B001285,N00034254,Julia Brownley (D),2012,Education,42655,0,42655
B001285,N00034254,Julia Brownley (D),2012,Building Trade Unions,0,39500,39500
B001285,N00034254,Julia Brownley (D),2012,Environment,23475,12883,36358
M001185,N00034277,Sean Maloney (D),2012,Lawyers/Law Firms,244616,14000,258616
M001185,N00034277,Sean Maloney (D),2012,Securities & Investment,146512,500,147012
M001185,N00034277,Sean Maloney (D),2012,Real Estate,104683,5000,109683
M001185,N00034277,Sean Maloney (D),2012,Retired,101811,0,101811
M001185,N00034277,Sean Maloney (D),2012,Business Services,87297,0,87297
M001185,N00034277,Sean Maloney (D),2012,Leadership PACs,0,66500,66500
M001185,N00034277,Sean Maloney (D),2012,Human Rights,46325,17244,63569
M001185,N00034277,Sean Maloney (D),2012,Public Sector Unions,750,56000,56750
M001185,N00034277,Sean Maloney (D),2012,TV/Movies/Music,52344,0,52344
M001185,N00034277,Sean Maloney (D),2012,Misc Manufacturing & Distributing,49100,1000,50100
V000132,N00034349,Filemon Vela (D),2012,Lawyers/Law Firms,91358,15000,106358
V000132,N00034349,Filemon Vela (D),2012,Construction Services,43656,3500,47156
V000132,N00034349,Filemon Vela (D),2012,Leadership PACs,0,21000,21000
V000132,N00034349,Filemon Vela (D),2012,Real Estate,12000,5000,17000
V000132,N00034349,Filemon Vela (D),2012,Hospitals/Nursing Homes,5250,11000,16250
V000132,N00034349,Filemon Vela (D),2012,Health Professionals,15156,0,15156
V000132,N00034349,Filemon Vela (D),2012,Building Trade Unions,0,15000,15000
V000132,N00034349,Filemon Vela (D),2012,Public Sector Unions,0,13500,13500
V000132,N00034349,Filemon Vela (D),2012,Misc Business,13000,0,13000
V000132,N00034349,Filemon Vela (D),2012,Candidate Committees,0,12000,12000
P000606,N00034416,Robert Pittenger (R),2012,Retired,120650,0,120650
P000606,N00034416,Robert Pittenger (R),2012,Real Estate,46950,7500,54450
P000606,N00034416,Robert Pittenger (R),2012,Health Professionals,28400,19000,47400
P000606,N00034416,Robert Pittenger (R),2012,Leadership PACs,0,35000,35000
P000606,N00034416,Robert Pittenger (R),2012,Insurance,22725,8500,31225
P000606,N00034416,Robert Pittenger (R),2012,Securities & Investment,30750,0,30750
P000606,N00034416,Robert Pittenger (R),2012,Oil & Gas,3750,22750,26500
P000606,N00034416,Robert Pittenger (R),2012,Food & Beverage,19768,5500,25268
P000606,N00034416,Robert Pittenger (R),2012,Automotive,15500,7500,23000
P000606,N00034416,Robert Pittenger (R),2012,Lawyers/Law Firms,19700,2500,22200
K000381,N00034453,Derek Kilmer (D),2012,Retired,86219,0,86219
K000381,N00034453,Derek Kilmer (D),2012,Lawyers/Law Firms,66574,17500,84074
K000381,N00034453,Derek Kilmer (D),2012,Building Trade Unions,0,70000,70000
K000381,N00034453,Derek Kilmer (D),2012,Public Sector Unions,6250,63000,69250
K000381,N00034453,Derek Kilmer (D),2012,Health Professionals,19800,44250,64050
K000381,N00034453,Derek Kilmer (D),2012,Business Services,53795,6000,59795
K000381,N00034453,Derek Kilmer (D),2012,Leadership PACs,0,51500,51500
K000381,N00034453,Derek Kilmer (D),2012,Transportation Unions,1000,47000,48000
K000381,N00034453,Derek Kilmer (D),2012,Electronics Mfg & Equip,40155,7000,47155
K000381,N00034453,Derek Kilmer (D),2012,Lobbyists,44458,500,44958
M001188,N00034547,Grace Meng (D),2012,Real Estate,67474,9000,76474
M001188,N00034547,Grace Meng (D),2012,Health Professionals,69338,3000,72338
M001188,N00034547,Grace Meng (D),2012,Lawyers/Law Firms,60150,9250,69400
M001188,N00034547,Grace Meng (D),2012,Retired,59100,0,59100
M001188,N00034547,Grace Meng (D),2012,Public Sector Unions,0,42000,42000
M001188,N00034547,Grace Meng (D),2012,Leadership PACs,0,34000,34000
M001188,N00034547,Grace Meng (D),2012,Food & Beverage,24550,0,24550
M001188,N00034547,Grace Meng (D),2012,Hospitals/Nursing Homes,19106,3500,22606
M001188,N00034547,Grace Meng (D),2012,Securities & Investment,21566,1000,22566
M001188,N00034547,Grace Meng (D),2012,Business Services,22145,0,22145
K000383,N00034580,Angus King (I),2012,Retired,307186,0,307186
K000383,N00034580,Angus King (I),2012,Lawyers/Law Firms,262598,22000,284598
K000383,N00034580,Angus King (I),2012,Securities & Investment,125894,9000,134894
K000383,N00034580,Angus King (I),2012,Health Professionals,46000,47000,93000
K000383,N00034580,Angus King (I),2012,Real Estate,77200,5000,82200
K000383,N00034580,Angus King (I),2012,Education,55823,0,55823
K000383,N00034580,Angus King (I),2012,Insurance,26000,22500,48500
K000383,N00034580,Angus King (I),2012,Business Services,48054,0,48054
K000383,N00034580,Angus King (I),2012,Misc Finance,47050,0,47050
K000383,N00034580,Angus King (I),2012,Pro-Israel,29500,17000,46500
P000604,N00034639,Donald M Payne Jr (D),2012,Lawyers/Law Firms,25300,18750,44050
P000604,N00034639,Donald M Payne Jr (D),2012,Leadership PACs,0,42500,42500
P000604,N00034639,Donald M Payne Jr (D),2012,Transportation Unions,0,30000,30000
P000604,N00034639,Donald M Payne Jr (D),2012,Building Trade Unions,500,28500,29000
P000604,N00034639,Donald M Payne Jr (D),2012,Industrial Unions,0,27500,27500
P000604,N00034639,Donald M Payne Jr (D),2012,Real Estate,22500,5000,27500
P000604,N00034639,Donald M Payne Jr (D),2012,Candidate Committees,0,23000,23000
P000604,N00034639,Donald M Payne Jr (D),2012,Pharmaceuticals/Health Products,6450,10000,16450
P000604,N00034639,Donald M Payne Jr (D),2012,Public Sector Unions,0,15000,15000
P000604,N00034639,Donald M Payne Jr (D),2012,Retired,14854,0,14854
D000621,N00034746,Ron DeSantis (R),2012,Retired,147658,0,147658
D000621,N00034746,Ron DeSantis (R),2012,Real Estate,68755,8500,77255
D000621,N00034746,Ron DeSantis (R),2012,Republican/Conservative,37261,33750,71011
D000621,N00034746,Ron DeSantis (R),2012,Lawyers/Law Firms,52000,3500,55500
D000621,N00034746,Ron DeSantis (R),2012,Health Professionals,35400,13000,48400
D000621,N00034746,Ron DeSantis (R),2012,Securities & Investment,45000,0,45000
D000621,N00034746,Ron DeSantis (R),2012,Leadership PACs,0,36628,36628
D000621,N00034746,Ron DeSantis (R),2012,Insurance,20800,12500,33300
D000621,N00034746,Ron DeSantis (R),2012,Misc Finance,31280,1500,32780
D000621,N00034746,Ron DeSantis (R),2012,Oil & Gas,11250,18500,29750
D000619,N00034784,Rodney Davis (R),2012,Leadership PACs,0,148750,148750
D000619,N00034784,Rodney Davis (R),2012,Health Professionals,35316,44500,79816
D000619,N00034784,Rodney Davis (R),2012,Food & Beverage,55275,20000,75275
D000619,N00034784,Rodney Davis (R),2012,Candidate Committees,0,47000,47000
D000619,N00034784,Rodney Davis (R),2012,Agricultural Services/Products,27733,16443,44176
D000619,N00034784,Rodney Davis (R),2012,Insurance,18700,25000,43700
D000619,N00034784,Rodney Davis (R),2012,Retired,37697,0,37697
D000619,N00034784,Rodney Davis (R),2012,Real Estate,27950,8000,35950
D000619,N00034784,Rodney Davis (R),2012,Oil & Gas,1750,31000,32750
D000619,N00034784,Rodney Davis (R),2012,Commercial Banks,21250,9000,30250
E000292,N00034884,William Enyart (D),2012,Lawyers/Law Firms,133332,6500,139832
E000292,N00034884,William Enyart (D),2012,Leadership PACs,0,98500,98500
E000292,N00034884,William Enyart (D),2012,Public Sector Unions,0,50000,50000
E000292,N00034884,William Enyart (D),2012,Building Trade Unions,1500,48500,50000
E000292,N00034884,William Enyart (D),2012,Candidate Committees,0,42000,42000
E000292,N00034884,William Enyart (D),2012,Industrial Unions,0,33000,33000
E000292,N00034884,William Enyart (D),2012,Retired,27705,0,27705
E000292,N00034884,William Enyart (D),2012,Transportation Unions,300,26500,26800
E000292,N00034884,William Enyart (D),2012,Civil Servants/Public Officials,24100,0,24100
E000292,N00034884,William Enyart (D),2012,Education,15428,0,15428
J000295,N00035007,David P Joyce (R),2012,Leadership PACs,0,76000,76000
J000295,N00035007,David P Joyce (R),2012,Misc Manufacturing & Distributing,57850,5000,62850
J000295,N00035007,David P Joyce (R),2012,Mining,29314,9000,38314
J000295,N00035007,David P Joyce (R),2012,Retired,37350,0,37350
J000295,N00035007,David P Joyce (R),2012,Real Estate,31200,6100,37300
J000295,N00035007,David P Joyce (R),2012,Lawyers/Law Firms,28900,5500,34400
J000295,N00035007,David P Joyce (R),2012,Building Trade Unions,0,33000,33000
J000295,N00035007,David P Joyce (R),2012,Special Trade Contractors,25450,5000,30450
J000295,N00035007,David P Joyce (R),2012,General Contractors,16250,3500,19750
J000295,N00035007,David P Joyce (R),2012,Health Professionals,8750,9500,18250
M000087,N00000078,Carolyn B Maloney (D),2014,Securities & Investment,57300,101500,158800
M000087,N00000078,Carolyn B Maloney (D),2014,Real Estate,99050,45000,144050
M000087,N00000078,Carolyn B Maloney (D),2014,Insurance,7250,82500,89750
M000087,N00000078,Carolyn B Maloney (D),2014,Lawyers/Law Firms,51050,29200,80250
M000087,N00000078,Carolyn B Maloney (D),2014,Commercial Banks,10250,52000,62250
M000087,N00000078,Carolyn B Maloney (D),2014,Accountants,0,53000,53000
M000087,N00000078,Carolyn B Maloney (D),2014,Misc Finance,34950,15500,50450
M000087,N00000078,Carolyn B Maloney (D),2014,Retired,45200,0,45200
M000087,N00000078,Carolyn B Maloney (D),2014,Public Sector Unions,500,41250,41750
M000087,N00000078,Carolyn B Maloney (D),2014,Building Trade Unions,0,39500,39500
C000380,N00000133,Donna Christian-Christensen (D),2014,Health Professionals,3800,26000,29800
C000380,N00000133,Donna Christian-Christensen (D),2014,Pharmaceuticals/Health Products,500,27848,28348
C000380,N00000133,Donna Christian-Christensen (D),2014,Lawyers/Law Firms,18500,9250,27750
C000380,N00000133,Donna Christian-Christensen (D),2014,Telecom Services,0,13000,13000
C000380,N00000133,Donna Christian-Christensen (D),2014,Leadership PACs,0,10500,10500
C000380,N00000133,Donna Christian-Christensen (D),2014,Telephone Utilities,0,10000,10000
C000380,N00000133,Donna Christian-Christensen (D),2014,Business Services,8850,0,8850
C000380,N00000133,Donna Christian-Christensen (D),2014,Health Services/HMOs,2000,5500,7500
C000380,N00000133,Donna Christian-Christensen (D),2014,Candidate Committees,0,7000,7000
C000380,N00000133,Donna Christian-Christensen (D),2014,Electronics Mfg & Equip,5100,1500,6600
N000015,N00000153,Richard E Neal (D),2014,Insurance,78525,227500,306025
N000015,N00000153,Richard E Neal (D),2014,Securities & Investment,23400,144000,167400
N000015,N00000153,Richard E Neal (D),2014,Pharmaceuticals/Health Products,0,101949,101949
N000015,N00000153,Richard E Neal (D),2014,Health Professionals,1800,89500,91300
N000015,N00000153,Richard E Neal (D),2014,Lawyers/Law Firms,25550,44363,69913
N000015,N00000153,Richard E Neal (D),2014,Accountants,14000,47000,61000
N000015,N00000153,Richard E Neal (D),2014,Railroads,9975,49500,59475
N000015,N00000153,Richard E Neal (D),2014,Commercial Banks,3550,51000,54550
N000015,N00000153,Richard E Neal (D),2014,Electric Utilities,500,54000,54500
N000015,N00000153,Richard E Neal (D),2014,Real Estate,3250,48490,51740
M000312,N00000179,James P McGovern (D),2014,Lawyers/Law Firms,32800,18050,50850
M000312,N00000179,James P McGovern (D),2014,Railroads,3750,43500,47250
M000312,N00000179,James P McGovern (D),2014,Lobbyists,33200,1000,34200
M000312,N00000179,James P McGovern (D),2014,Health Professionals,3750,27500,31250
M000312,N00000179,James P McGovern (D),2014,Public Sector Unions,0,26500,26500
M000312,N00000179,James P McGovern (D),2014,Insurance,1250,24250,25500
M000312,N00000179,James P McGovern (D),2014,Business Services,23090,0,23090
M000312,N00000179,James P McGovern (D),2014,Hospitals/Nursing Homes,11450,10000,21450
M000312,N00000179,James P McGovern (D),2014,Misc Unions,0,20250,20250
M000312,N00000179,James P McGovern (D),2014,Retired,18104,0,18104
T000266,N00000226,John F Tierney (D),2014,Lawyers/Law Firms,140371,17000,157371
T000266,N00000226,John F Tierney (D),2014,Leadership PACs,0,151800,151800
T000266,N00000226,John F Tierney (D),2014,Retired,84430,0,84430
T000266,N00000226,John F Tierney (D),2014,Candidate Committees,0,67500,67500
T000266,N00000226,John F Tierney (D),2014,Public Sector Unions,0,51500,51500
T000266,N00000226,John F Tierney (D),2014,Industrial Unions,0,42000,42000
T000266,N00000226,John F Tierney (D),2014,Real Estate,36450,5000,41450
T000266,N00000226,John F Tierney (D),2014,Health Professionals,11100,29000,40100
T000266,N00000226,John F Tierney (D),2014,Building Trade Unions,0,38500,38500
T000266,N00000226,John F Tierney (D),2014,Education,34525,0,34525
K000148,N00000245,John Kerry (D),2014,Lawyers/Law Firms,172909,33150,206059
K000148,N00000245,John Kerry (D),2014,Securities & Investment,88250,12000,100250
K000148,N00000245,John Kerry (D),2014,Lobbyists,97043,3000,100043
K000148,N00000245,John Kerry (D),2014,Pharmaceuticals/Health Products,28400,52500,80900
K000148,N00000245,John Kerry (D),2014,Real Estate,63150,2010,65160
K000148,N00000245,John Kerry (D),2014,Business Services,53825,2500,56325
K000148,N00000245,John Kerry (D),2014,Hospitals/Nursing Homes,48200,3500,51700
K000148,N00000245,John Kerry (D),2014,Telecom Services,19800,31500,51300
K000148,N00000245,John Kerry (D),2014,Electronics Mfg & Equip,20975,21588,42563
K000148,N00000245,John Kerry (D),2014,Health Professionals,23800,17000,40800
C001037,N00000267,Michael E Capuano (D),2014,Insurance,2250,132000,134250
C001037,N00000267,Michael E Capuano (D),2014,Real Estate,42500,67000,109500
C001037,N00000267,Michael E Capuano (D),2014,Transportation Unions,0,60500,60500
C001037,N00000267,Michael E Capuano (D),2014,Securities & Investment,10600,45000,55600
C001037,N00000267,Michael E Capuano (D),2014,Lawyers/Law Firms,42500,10000,52500
C001037,N00000267,Michael E Capuano (D),2014,Public Sector Unions,0,35500,35500
C001037,N00000267,Michael E Capuano (D),2014,Oil & Gas,28250,2500,30750
C001037,N00000267,Michael E Capuano (D),2014,Construction Services,6250,23500,29750
C001037,N00000267,Michael E Capuano (D),2014,Hospitals/Nursing Homes,18450,7500,25950
C001037,N00000267,Michael E Capuano (D),2014,Building Trade Unions,0,20000,20000
M000133,N00000270,Ed Markey (D),2014,Lawyers/Law Firms,1232848,140263,1373111
M000133,N00000270,Ed Markey (D),2014,Securities & Investment,707726,52500,760226
M000133,N00000270,Ed Markey (D),2014,Real Estate,561100,35000,596100
M000133,N00000270,Ed Markey (D),2014,Retired,388753,0,388753
M000133,N00000270,Ed Markey (D),2014,Lobbyists,367620,7800,375420
M000133,N00000270,Ed Markey (D),2014,Environment,333532,34949,368481
M000133,N00000270,Ed Markey (D),2014,Telecom Services,147150,219100,366250
M000133,N00000270,Ed Markey (D),2014,TV/Movies/Music,321450,39000,360450
M000133,N00000270,Ed Markey (D),2014,Leadership PACs,0,337800,337800
M000133,N00000270,Ed Markey (D),2014,Business Services,277050,7600,284650
R000122,N00000362,Jack Reed (D),2014,Lawyers/Law Firms,340576,91770,432346
R000122,N00000362,Jack Reed (D),2014,Securities & Investment,170350,156500,326850
R000122,N00000362,Jack Reed (D),2014,Leadership PACs,0,261500,261500
R000122,N00000362,Jack Reed (D),2014,Insurance,55900,140000,195900
R000122,N00000362,Jack Reed (D),2014,Lobbyists,176746,12050,188796
R000122,N00000362,Jack Reed (D),2014,Real Estate,100618,74500,175118
R000122,N00000362,Jack Reed (D),2014,Retired,133754,0,133754
R000122,N00000362,Jack Reed (D),2014,Health Professionals,23500,109000,132500
R000122,N00000362,Jack Reed (D),2014,Defense Electronics,23750,66500,90250
R000122,N00000362,Jack Reed (D),2014,Retail Sales,24013,65500,89513
C001035,N00000491,Susan Collins (R),2014,Retired,414200,0,414200
C001035,N00000491,Susan Collins (R),2014,Lawyers/Law Firms,243506,130750,374256
C001035,N00000491,Susan Collins (R),2014,Securities & Investment,305150,62600,367750
C001035,N00000491,Susan Collins (R),2014,Leadership PACs,0,327000,327000
C001035,N00000491,Susan Collins (R),2014,Lobbyists,306760,9500,316260
C001035,N00000491,Susan Collins (R),2014,Health Professionals,58150,230300,288450
C001035,N00000491,Susan Collins (R),2014,Insurance,36500,198500,235000
C001035,N00000491,Susan Collins (R),2014,Real Estate,121250,53000,174250
C001035,N00000491,Susan Collins (R),2014,Misc Manufacturing & Distributing,57150,64500,121650
C001035,N00000491,Susan Collins (R),2014,Business Services,94200,24000,118200
S000033,N00000528,Bernie Sanders (I),2014,Retired,560312,0,560312
S000033,N00000528,Bernie Sanders (I),2014,Democratic/Liberal,252560,11070,263630
S000033,N00000528,Bernie Sanders (I),2014,Public Sector Unions,600,119500,120100
S000033,N00000528,Bernie Sanders (I),2014,Lawyers/Law Firms,103924,13000,116924
S000033,N00000528,Bernie Sanders (I),2014,Health Professionals,44872,50000,94872
S000033,N00000528,Bernie Sanders (I),2014,Leadership PACs,0,71500,71500
S000033,N00000528,Bernie Sanders (I),2014,Education,59855,0,59855
S000033,N00000528,Bernie Sanders (I),2014,Misc Unions,3750,50000,53750
S000033,N00000528,Bernie Sanders (I),2014,Environment,49890,3257,53147
S000033,N00000528,Bernie Sanders (I),2014,TV/Movies/Music,44150,0,44150
L000557,N00000575,John B Larson (D),2014,Insurance,57650,204499,262149
L000557,N00000575,John B Larson (D),2014,Securities & Investment,24850,83000,107850
L000557,N00000575,John B Larson (D),2014,Real Estate,39950,55000,94950
L000557,N00000575,John B Larson (D),2014,Health Professionals,11450,79500,90950
L000557,N00000575,John B Larson (D),2014,Lawyers/Law Firms,41200,21000,62200
L000557,N00000575,John B Larson (D),2014,Health Services/HMOs,10400,44500,54900
L000557,N00000575,John B Larson (D),2014,Building Trade Unions,0,53500,53500
L000557,N00000575,John B Larson (D),2014,Defense Aerospace,16050,33500,49550
L000557,N00000575,John B Larson (D),2014,Public Sector Unions,0,47000,47000
L000557,N00000575,John B Larson (D),2014,Pharmaceuticals/Health Products,6200,40000,46200
D000216,N00000615,Rosa L DeLauro (D),2014,Democratic/Liberal,189905,0,189905
D000216,N00000615,Rosa L DeLauro (D),2014,Health Professionals,10621,93499,104120
D000216,N00000615,Rosa L DeLauro (D),2014,Public Sector Unions,0,73500,73500
D000216,N00000615,Rosa L DeLauro (D),2014,Lawyers/Law Firms,38429,26500,64929
D000216,N00000615,Rosa L DeLauro (D),2014,Building Trade Unions,0,56000,56000
D000216,N00000615,Rosa L DeLauro (D),2014,Human Rights,36800,13600,50400
D000216,N00000615,Rosa L DeLauro (D),2014,Industrial Unions,0,44500,44500
D000216,N00000615,Rosa L DeLauro (D),2014,Lobbyists,43248,1128,44376
D000216,N00000615,Rosa L DeLauro (D),2014,Transportation Unions,0,33500,33500
D000216,N00000615,Rosa L DeLauro (D),2014,Misc Unions,0,33500,33500
L000123,N00000659,Frank Lautenberg (D),2014,Lobbyists,42357,8500,50857
L000123,N00000659,Frank Lautenberg (D),2014,Pharmaceuticals/Health Products,0,44500,44500
L000123,N00000659,Frank Lautenberg (D),2014,Railroads,0,34000,34000
L000123,N00000659,Frank Lautenberg (D),2014,Air Transport,3012,22500,25512
L000123,N00000659,Frank Lautenberg (D),2014,Lawyers/Law Firms,-650,25500,24850
L000123,N00000659,Frank Lautenberg (D),2014,Building Trade Unions,500,22500,23000
L000123,N00000659,Frank Lautenberg (D),2014,Transportation Unions,0,21000,21000
L000123,N00000659,Frank Lautenberg (D),2014,Sea Transport,2500,11500,14000
L000123,N00000659,Frank Lautenberg (D),2014,Telecom Services,0,12000,12000
L000123,N00000659,Frank Lautenberg (D),2014,TV/Movies/Music,1000,8000,9000
F000372,N00000684,Rodney Frelinghuysen (R),2014,Defense Aerospace,101381,54500,155881
F000372,N00000684,Rodney Frelinghuysen (R),2014,Retired,88850,0,88850
F000372,N00000684,Rodney Frelinghuysen (R),2014,Defense Electronics,1000,70500,71500
F000372,N00000684,Rodney Frelinghuysen (R),2014,Lobbyists,63030,5125,68155
F000372,N00000684,Rodney Frelinghuysen (R),2014,Securities & Investment,51500,10000,61500
F000372,N00000684,Rodney Frelinghuysen (R),2014,Electric Utilities,2850,48979,51829
F000372,N00000684,Rodney Frelinghuysen (R),2014,Pharmaceuticals/Health Products,500,50500,51000
F000372,N00000684,Rodney Frelinghuysen (R),2014,Misc Defense,18500,26500,45000
F000372,N00000684,Rodney Frelinghuysen (R),2014,Real Estate,22250,20000,42250
F000372,N00000684,Rodney Frelinghuysen (R),2014,Lawyers/Law Firms,14250,27000,41250
M000639,N00000699,Robert Menendez (D),2014,Lawyers/Law Firms,1570251,199426,1769677
M000639,N00000699,Robert Menendez (D),2014,Real Estate,956517,107265,1063782
M000639,N00000699,Robert Menendez (D),2014,Securities & Investment,603751,137800,741551
M000639,N00000699,Robert Menendez (D),2014,Health Professionals,535860,139500,675360
M000639,N00000699,Robert Menendez (D),2014,Lobbyists,609262,28360,637622
M000639,N00000699,Robert Menendez (D),2014,Retired,557070,0,557070
M000639,N00000699,Robert Menendez (D),2014,Pharmaceuticals/Health Products,182788,226750,409538
M000639,N00000699,Robert Menendez (D),2014,Insurance,229400,155600,385000
M000639,N00000699,Robert Menendez (D),2014,Leadership PACs,0,383244,383244
M000639,N00000699,Robert Menendez (D),2014,Construction Services,291725,56100,347825
G000548,N00000743,Scott Garrett (R),2014,Securities & Investment,250400,230600,481000
G000548,N00000743,Scott Garrett (R),2014,Insurance,32030,180500,212530
G000548,N00000743,Scott Garrett (R),2014,Commercial Banks,18200,118500,136700
G000548,N00000743,Scott Garrett (R),2014,Real Estate,43600,79000,122600
G000548,N00000743,Scott Garrett (R),2014,Retired,73300,0,73300
G000548,N00000743,Scott Garrett (R),2014,Finance/Credit Companies,5000,61500,66500
G000548,N00000743,Scott Garrett (R),2014,Misc Finance,37450,21100,58550
G000548,N00000743,Scott Garrett (R),2014,Lawyers/Law Firms,41290,16250,57540
G000548,N00000743,Scott Garrett (R),2014,Accountants,6500,49999,56499
G000548,N00000743,Scott Garrett (R),2014,Oil & Gas,16900,20500,37400
P000096,N00000751,Bill Pascrell Jr (D),2014,Health Professionals,19050,151150,170200
P000096,N00000751,Bill Pascrell Jr (D),2014,Lawyers/Law Firms,132585,31479,164064
P000096,N00000751,Bill Pascrell Jr (D),2014,Insurance,8850,87500,96350
P000096,N00000751,Bill Pascrell Jr (D),2014,Real Estate,45500,32000,77500
P000096,N00000751,Bill Pascrell Jr (D),2014,Pharmaceuticals/Health Products,4842,69000,73842
P000096,N00000751,Bill Pascrell Jr (D),2014,Building Trade Unions,0,60000,60000
P000096,N00000751,Bill Pascrell Jr (D),2014,Public Sector Unions,0,55900,55900
P000096,N00000751,Bill Pascrell Jr (D),2014,Transportation Unions,0,47500,47500
P000096,N00000751,Bill Pascrell Jr (D),2014,Securities & Investment,15400,30000,45400
P000096,N00000751,Bill Pascrell Jr (D),2014,Health Services/HMOs,18450,26000,44450
P000034,N00000781,Frank Pallone Jr (D),2014,Health Professionals,56850,341000,397850
P000034,N00000781,Frank Pallone Jr (D),2014,Pharmaceuticals/Health Products,13822,158250,172072
P000034,N00000781,Frank Pallone Jr (D),2014,Lawyers/Law Firms,89200,51500,140700
P000034,N00000781,Frank Pallone Jr (D),2014,Lobbyists,101000,5000,106000
P000034,N00000781,Frank Pallone Jr (D),2014,Real Estate,52150,29000,81150
P000034,N00000781,Frank Pallone Jr (D),2014,Casinos/Gambling,58450,10000,68450
P000034,N00000781,Frank Pallone Jr (D),2014,Building Trade Unions,0,66000,66000
P000034,N00000781,Frank Pallone Jr (D),2014,Food Processing & Sales,55200,7000,62200
P000034,N00000781,Frank Pallone Jr (D),2014,Hospitals/Nursing Homes,27450,34500,61950
P000034,N00000781,Frank Pallone Jr (D),2014,Health Services/HMOs,13100,43000,56100
A000210,N00000826,Robert E Andrews (D),2014,Lawyers/Law Firms,29835,38000,67835
A000210,N00000826,Robert E Andrews (D),2014,Education,38900,26499,65399
A000210,N00000826,Robert E Andrews (D),2014,Lobbyists,32681,5500,38181
A000210,N00000826,Robert E Andrews (D),2014,Building Trade Unions,0,32000,32000
A000210,N00000826,Robert E Andrews (D),2014,Insurance,7550,22500,30050
A000210,N00000826,Robert E Andrews (D),2014,Health Professionals,10625,17000,27625
A000210,N00000826,Robert E Andrews (D),2014,Food Processing & Sales,16600,11000,27600
A000210,N00000826,Robert E Andrews (D),2014,Defense Aerospace,2600,22500,25100
A000210,N00000826,Robert E Andrews (D),2014,Public Sector Unions,0,24500,24500
A000210,N00000826,Robert E Andrews (D),2014,Pro-Israel,10400,5000,15400
L000554,N00000851,Frank A LoBiondo (R),2014,Leadership PACs,0,175000,175000
L000554,N00000851,Frank A LoBiondo (R),2014,Air Transport,28100,133230,161330
L000554,N00000851,Frank A LoBiondo (R),2014,Transportation Unions,0,152300,152300
L000554,N00000851,Frank A LoBiondo (R),2014,Public Sector Unions,0,71250,71250
L000554,N00000851,Frank A LoBiondo (R),2014,Building Trade Unions,0,67350,67350
L000554,N00000851,Frank A LoBiondo (R),2014,Health Professionals,24066,40000,64066
L000554,N00000851,Frank A LoBiondo (R),2014,Lawyers/Law Firms,36850,24150,61000
L000554,N00000851,Frank A LoBiondo (R),2014,Real Estate,39700,18600,58300
L000554,N00000851,Frank A LoBiondo (R),2014,Insurance,15450,33000,48450
L000554,N00000851,Frank A LoBiondo (R),2014,Defense Aerospace,250,48000,48250
H001032,N00000860,Rush Holt (D),2014,Retired,312602,0,312602
H001032,N00000860,Rush Holt (D),2014,Education,113925,0,113925
H001032,N00000860,Rush Holt (D),2014,Securities & Investment,51050,44000,95050
H001032,N00000860,Rush Holt (D),2014,Lawyers/Law Firms,55249,8500,63749
H001032,N00000860,Rush Holt (D),2014,Insurance,7500,33500,41000
H001032,N00000860,Rush Holt (D),2014,Pharmaceuticals/Health Products,17000,23500,40500
H001032,N00000860,Rush Holt (D),2014,Business Services,36150,2000,38150
H001032,N00000860,Rush Holt (D),2014,Democratic/Liberal,32350,2500,34850
H001032,N00000860,Rush Holt (D),2014,Non-Profit Institutions,28100,6500,34600
H001032,N00000860,Rush Holt (D),2014,Environment,25550,500,26050
L000567,N00000898,Leonard Lance (R),2014,Pharmaceuticals/Health Products,18050,117450,135500
L000567,N00000898,Leonard Lance (R),2014,Health Professionals,13025,81000,94025
L000567,N00000898,Leonard Lance (R),2014,Lawyers/Law Firms,35400,6000,41400
L000567,N00000898,Leonard Lance (R),2014,Retired,38160,0,38160
L000567,N00000898,Leonard Lance (R),2014,Insurance,8250,29000,37250
L000567,N00000898,Leonard Lance (R),2014,Leadership PACs,0,35000,35000
L000567,N00000898,Leonard Lance (R),2014,Telecom Services,0,33500,33500
L000567,N00000898,Leonard Lance (R),2014,Lobbyists,31400,1000,32400
L000567,N00000898,Leonard Lance (R),2014,Electric Utilities,2000,29498,31498
L000567,N00000898,Leonard Lance (R),2014,Building Trade Unions,0,28500,28500
L000567,N00000898,Leonard Lance (R),2014,Oil & Gas,1000,27500,28500
N000002,N00000939,Jerrold Nadler (D),2014,Lawyers/Law Firms,99494,28350,127844
N000002,N00000939,Jerrold Nadler (D),2014,TV/Movies/Music,37850,52000,89850
N000002,N00000939,Jerrold Nadler (D),2014,Real Estate,80983,6500,87483
N000002,N00000939,Jerrold Nadler (D),2014,Transportation Unions,0,64600,64600
N000002,N00000939,Jerrold Nadler (D),2014,Securities & Investment,59250,3000,62250
N000002,N00000939,Jerrold Nadler (D),2014,Construction Services,29100,30900,60000
N000002,N00000939,Jerrold Nadler (D),2014,Railroads,1250,37000,38250
N000002,N00000939,Jerrold Nadler (D),2014,Public Sector Unions,0,33970,33970
N000002,N00000939,Jerrold Nadler (D),2014,Retired,30400,0,30400
N000002,N00000939,Jerrold Nadler (D),2014,Internet,8350,20100,28450
R000053,N00000964,Charles B Rangel (D),2014,Lawyers/Law Firms,77750,23750,101500
R000053,N00000964,Charles B Rangel (D),2014,Real Estate,73800,22000,95800
R000053,N00000964,Charles B Rangel (D),2014,Leadership PACs,1000,81600,82600
R000053,N00000964,Charles B Rangel (D),2014,Securities & Investment,56650,9000,65650
R000053,N00000964,Charles B Rangel (D),2014,Lobbyists,55049,0,55049
R000053,N00000964,Charles B Rangel (D),2014,Retired,54826,0,54826
R000053,N00000964,Charles B Rangel (D),2014,Hospitals/Nursing Homes,44200,3000,47200
R000053,N00000964,Charles B Rangel (D),2014,Public Sector Unions,1000,45000,46000
R000053,N00000964,Charles B Rangel (D),2014,Misc Finance,31550,8500,40050
R000053,N00000964,Charles B Rangel (D),2014,Insurance,5100,30100,35200
E000179,N00001003,Eliot L Engel (D),2014,Pro-Israel,92200,46700,138900
E000179,N00001003,Eliot L Engel (D),2014,Health Professionals,43582,60500,104082
E000179,N00001003,Eliot L Engel (D),2014,Real Estate,78245,8000,86245
E000179,N00001003,Eliot L Engel (D),2014,Lawyers/Law Firms,43800,19500,63300
E000179,N00001003,Eliot L Engel (D),2014,Pharmaceuticals/Health Products,16300,36500,52800
E000179,N00001003,Eliot L Engel (D),2014,Retired,47300,0,47300
E000179,N00001003,Eliot L Engel (D),2014,Education,41750,1000,42750
E000179,N00001003,Eliot L Engel (D),2014,Securities & Investment,38600,3500,42100
E000179,N00001003,Eliot L Engel (D),2014,Building Trade Unions,0,38000,38000
E000179,N00001003,Eliot L Engel (D),2014,Defense Aerospace,0,33000,33000
L000480,N00001024,Nita M Lowey (D),2014,Securities & Investment,205450,7500,212950
L000480,N00001024,Nita M Lowey (D),2014,Retired,179900,0,179900
L000480,N00001024,Nita M Lowey (D),2014,Real Estate,156200,10000,166200
L000480,N00001024,Nita M Lowey (D),2014,Lawyers/Law Firms,121825,22500,144325
L000480,N00001024,Nita M Lowey (D),2014,Pro-Israel,84500,21246,105746
L000480,N00001024,Nita M Lowey (D),2014,Health Professionals,38300,41500,79800
L000480,N00001024,Nita M Lowey (D),2014,Non-Profit Institutions,62500,2500,65000
L000480,N00001024,Nita M Lowey (D),2014,Public Sector Unions,0,58500,58500
L000480,N00001024,Nita M Lowey (D),2014,Business Services,46800,2000,48800
L000480,N00001024,Nita M Lowey (D),2014,Lobbyists,47100,1000,48100
S000148,N00001093,Charles E Schumer (D),2014,Securities & Investment,3819405,269800,4089205
S000148,N00001093,Charles E Schumer (D),2014,Lawyers/Law Firms,2354333,321664,2675997
S000148,N00001093,Charles E Schumer (D),2014,Real Estate,1557189,111500,1668689
S000148,N00001093,Charles E Schumer (D),2014,Lobbyists,711043,11420,722463
S000148,N00001093,Charles E Schumer (D),2014,Misc Finance,684900,36100,721000
S000148,N00001093,Charles E Schumer (D),2014,Insurance,371550,294900,666450
S000148,N00001093,Charles E Schumer (D),2014,Business Services,527815,45300,573115
S000148,N00001093,Charles E Schumer (D),2014,Retired,513750,0,513750
S000148,N00001093,Charles E Schumer (D),2014,Hospitals/Nursing Homes,346400,142700,489100
S000148,N00001093,Charles E Schumer (D),2014,Health Professionals,184750,275350,460100
V000081,N00001102,Nydia M Velazquez (D),2014,Lawyers/Law Firms,66450,5000,71450
V000081,N00001102,Nydia M Velazquez (D),2014,Securities & Investment,9200,31500,40700
V000081,N00001102,Nydia M Velazquez (D),2014,Misc Issues,36750,0,36750
V000081,N00001102,Nydia M Velazquez (D),2014,Real Estate,16950,19000,35950
V000081,N00001102,Nydia M Velazquez (D),2014,Accountants,2000,25500,27500
V000081,N00001102,Nydia M Velazquez (D),2014,Special Trade Contractors,15000,12500,27500
V000081,N00001102,Nydia M Velazquez (D),2014,Leadership PACs,0,23000,23000
V000081,N00001102,Nydia M Velazquez (D),2014,Public Sector Unions,0,23000,23000
V000081,N00001102,Nydia M Velazquez (D),2014,Commercial Banks,5500,16500,22000
V000081,N00001102,Nydia M Velazquez (D),2014,Health Professionals,12000,10000,22000
C001038,N00001127,Joseph Crowley (D),2014,Real Estate,232360,71175,303535
C001038,N00001127,Joseph Crowley (D),2014,Securities & Investment,133848,167500,301348
C001038,N00001127,Joseph Crowley (D),2014,Insurance,35650,255100,290750
C001038,N00001127,Joseph Crowley (D),2014,Lawyers/Law Firms,165299,55750,221049
C001038,N00001127,Joseph Crowley (D),2014,Commercial Banks,51050,85500,136550
C001038,N00001127,Joseph Crowley (D),2014,Pharmaceuticals/Health Products,13200,103500,116700
C001038,N00001127,Joseph Crowley (D),2014,Health Professionals,14350,67500,81850
C001038,N00001127,Joseph Crowley (D),2014,Hospitals/Nursing Homes,33650,41000,74650
C001038,N00001127,Joseph Crowley (D),2014,Misc Finance,32950,30500,63450
C001038,N00001127,Joseph Crowley (D),2014,Lobbyists,55968,2550,58518
M000309,N00001148,Carolyn McCarthy (D),2014,Insurance,0,45000,45000
M000309,N00001148,Carolyn McCarthy (D),2014,Securities & Investment,7600,31000,38600
M000309,N00001148,Carolyn McCarthy (D),2014,Retired,25705,0,25705
M000309,N00001148,Carolyn McCarthy (D),2014,Education,17750,1000,18750
M000309,N00001148,Carolyn McCarthy (D),2014,Health Professionals,800,13000,13800
M000309,N00001148,Carolyn McCarthy (D),2014,Leadership PACs,0,13500,13500
M000309,N00001148,Carolyn McCarthy (D),2014,Lawyers/Law Firms,2925,10000,12925
M000309,N00001148,Carolyn McCarthy (D),2014,Public Sector Unions,0,8000,8000
M000309,N00001148,Carolyn McCarthy (D),2014,Building Trade Unions,0,7500,7500
M000309,N00001148,Carolyn McCarthy (D),2014,Hospitals/Nursing Homes,1250,5000,6250
M000309,N00001148,Carolyn McCarthy (D),2014,Real Estate,750,5500,6250
M001137,N00001171,Gregory W Meeks (D),2014,Securities & Investment,25309,101000,126309
M001137,N00001171,Gregory W Meeks (D),2014,Insurance,0,119300,119300
M001137,N00001171,Gregory W Meeks (D),2014,Finance/Credit Companies,17250,66000,83250
M001137,N00001171,Gregory W Meeks (D),2014,Real Estate,9600,58049,67649
M001137,N00001171,Gregory W Meeks (D),2014,Commercial Banks,1725,58000,59725
M001137,N00001171,Gregory W Meeks (D),2014,Lawyers/Law Firms,19000,22912,41912
M001137,N00001171,Gregory W Meeks (D),2014,Accountants,0,35500,35500
M001137,N00001171,Gregory W Meeks (D),2014,Misc Services,8650,23500,32150
M001137,N00001171,Gregory W Meeks (D),2014,Air Transport,0,29500,29500
M001137,N00001171,Gregory W Meeks (D),2014,Lobbyists,25117,3500,28617
K000210,N00001193,Pete King (R),2014,Real Estate,104450,13000,117450
K000210,N00001193,Pete King (R),2014,Securities & Investment,60010,47000,107010
K000210,N00001193,Pete King (R),2014,Lawyers/Law Firms,45800,12700,58500
K000210,N00001193,Pete King (R),2014,Building Trade Unions,0,57500,57500
K000210,N00001193,Pete King (R),2014,Retired,56655,0,56655
K000210,N00001193,Pete King (R),2014,Insurance,19250,32000,51250
K000210,N00001193,Pete King (R),2014,Transportation Unions,0,39500,39500
K000210,N00001193,Pete King (R),2014,Lobbyists,37950,1000,38950
K000210,N00001193,Pete King (R),2014,Hospitals/Nursing Homes,27950,8000,35950
K000210,N00001193,Pete King (R),2014,Defense Aerospace,0,31000,31000
C001092,N00001285,Chris Collins (R),2014,Food & Beverage,42487,11500,53987
C001092,N00001285,Chris Collins (R),2014,Health Professionals,13000,30500,43500
C001092,N00001285,Chris Collins (R),2014,Misc Manufacturing & Distributing,24000,16999,40999
C001092,N00001285,Chris Collins (R),2014,Oil & Gas,31200,7000,38200
C001092,N00001285,Chris Collins (R),2014,Leadership PACs,0,31500,31500
C001092,N00001285,Chris Collins (R),2014,Lawyers/Law Firms,22750,5500,28250
C001092,N00001285,Chris Collins (R),2014,Automotive,12050,15500,27550
C001092,N00001285,Chris Collins (R),2014,Republican/Conservative,0,27500,27500
C001092,N00001285,Chris Collins (R),2014,Retired,27050,0,27050
C001092,N00001285,Chris Collins (R),2014,Real Estate,18950,7000,25950
S000480,N00001311,Louise M Slaughter (D),2014,Public Sector Unions,0,71000,71000
S000480,N00001311,Louise M Slaughter (D),2014,Health Professionals,3200,51000,54200
S000480,N00001311,Louise M Slaughter (D),2014,Industrial Unions,0,54000,54000
S000480,N00001311,Louise M Slaughter (D),2014,Transportation Unions,0,51500,51500
S000480,N00001311,Louise M Slaughter (D),2014,Defense Electronics,28500,19500,48000
S000480,N00001311,Louise M Slaughter (D),2014,Building Trade Unions,0,48000,48000
S000480,N00001311,Louise M Slaughter (D),2014,Real Estate,34500,8000,42500
S000480,N00001311,Louise M Slaughter (D),2014,Lawyers/Law Firms,19046,20500,39546
S000480,N00001311,Louise M Slaughter (D),2014,Defense Aerospace,200,31000,31200
S000480,N00001311,Louise M Slaughter (D),2014,"Beer, Wine & Liquor",7000,21500,28500
D000482,N00001373,Mike Doyle (D),2014,Electric Utilities,0,88500,88500
D000482,N00001373,Mike Doyle (D),2014,Telecom Services,1000,65000,66000
D000482,N00001373,Mike Doyle (D),2014,Building Trade Unions,0,59000,59000
D000482,N00001373,Mike Doyle (D),2014,Industrial Unions,0,54500,54500
D000482,N00001373,Mike Doyle (D),2014,Lawyers/Law Firms,21350,32000,53350
D000482,N00001373,Mike Doyle (D),2014,Real Estate,14750,18000,32750
D000482,N00001373,Mike Doyle (D),2014,Health Professionals,7750,24000,31750
D000482,N00001373,Mike Doyle (D),2014,Transportation Unions,0,31500,31500
D000482,N00001373,Mike Doyle (D),2014,Telephone Utilities,0,31000,31000
D000482,N00001373,Mike Doyle (D),2014,Public Sector Unions,0,29000,29000
D000482,N00001373,Mike Doyle (D),2014,Oil & Gas,2500,26500,29000
T000461,N00001489,Pat Toomey (R),2014,Securities & Investment,1615668,220338,1836006
T000461,N00001489,Pat Toomey (R),2014,Republican/Conservative,1406884,89567,1496451
T000461,N00001489,Pat Toomey (R),2014,Retired,1473479,0,1473479
T000461,N00001489,Pat Toomey (R),2014,Lawyers/Law Firms,794128,164726,958854
T000461,N00001489,Pat Toomey (R),2014,Real Estate,735750,57100,792850
T000461,N00001489,Pat Toomey (R),2014,Business Services,670250,18000,688250
T000461,N00001489,Pat Toomey (R),2014,Insurance,344420,323400,667820
T000461,N00001489,Pat Toomey (R),2014,Leadership PACs,59873,428013,487886
T000461,N00001489,Pat Toomey (R),2014,Oil & Gas,299566,177650,477216
T000461,N00001489,Pat Toomey (R),2014,Health Professionals,361590,95500,457090
S001162,N00001579,Allyson Schwartz (D),2014,Lawyers/Law Firms,40589,20964,61553
S001162,N00001579,Allyson Schwartz (D),2014,Pharmaceuticals/Health Products,3500,51799,55299
S001162,N00001579,Allyson Schwartz (D),2014,Health Professionals,750,35000,35750
S001162,N00001579,Allyson Schwartz (D),2014,Building Trade Unions,0,30000,30000
S001162,N00001579,Allyson Schwartz (D),2014,Securities & Investment,16150,13500,29650
S001162,N00001579,Allyson Schwartz (D),2014,Insurance,500,26000,26500
S001162,N00001579,Allyson Schwartz (D),2014,Retired,26250,0,26250
S001162,N00001579,Allyson Schwartz (D),2014,Hospitals/Nursing Homes,9250,9000,18250
S001162,N00001579,Allyson Schwartz (D),2014,Industrial Unions,0,15000,15000
S001162,N00001579,Allyson Schwartz (D),2014,Real Estate,7600,6000,13600
B001227,N00001619,Robert A Brady (D),2014,Lawyers/Law Firms,59500,15600,75100
B001227,N00001619,Robert A Brady (D),2014,Building Trade Unions,0,74600,74600
B001227,N00001619,Robert A Brady (D),2014,Industrial Unions,0,50000,50000
B001227,N00001619,Robert A Brady (D),2014,Transportation Unions,0,37000,37000
B001227,N00001619,Robert A Brady (D),2014,Public Sector Unions,0,29000,29000
B001227,N00001619,Robert A Brady (D),2014,General Contractors,25700,0,25700
B001227,N00001619,Robert A Brady (D),2014,Real Estate,20300,5400,25700
B001227,N00001619,Robert A Brady (D),2014,Business Services,21100,0,21100
B001227,N00001619,Robert A Brady (D),2014,Telecom Services,5000,15000,20000
B001227,N00001619,Robert A Brady (D),2014,Oil & Gas,13025,5000,18025
P000373,N00001633,Joe Pitts (R),2014,Health Professionals,11150,282000,293150
P000373,N00001633,Joe Pitts (R),2014,Pharmaceuticals/Health Products,5500,181500,187000
P000373,N00001633,Joe Pitts (R),2014,Health Services/HMOs,0,76600,76600
P000373,N00001633,Joe Pitts (R),2014,Oil & Gas,0,57000,57000
P000373,N00001633,Joe Pitts (R),2014,Electric Utilities,250,47000,47250
P000373,N00001633,Joe Pitts (R),2014,Insurance,4800,37500,42300
P000373,N00001633,Joe Pitts (R),2014,Hospitals/Nursing Homes,1000,39000,40000
P000373,N00001633,Joe Pitts (R),2014,Food Processing & Sales,3600,33000,36600
P000373,N00001633,Joe Pitts (R),2014,Lawyers/Law Firms,16525,15000,31525
P000373,N00001633,Joe Pitts (R),2014,Telecom Services,0,26000,26000
R000361,N00001685,Jay Rockefeller (D),2014,Air Transport,11000,67500,78500
R000361,N00001685,Jay Rockefeller (D),2014,Lawyers/Law Firms,49700,24000,73700
R000361,N00001685,Jay Rockefeller (D),2014,Sea Transport,24849,41500,66349
R000361,N00001685,Jay Rockefeller (D),2014,Telecom Services,9000,55000,64000
R000361,N00001685,Jay Rockefeller (D),2014,Lobbyists,51825,-1500,50325
R000361,N00001685,Jay Rockefeller (D),2014,Electronics Mfg & Equip,8000,28500,36500
R000361,N00001685,Jay Rockefeller (D),2014,TV/Movies/Music,11500,24000,35500
R000361,N00001685,Jay Rockefeller (D),2014,Railroads,11925,21311,33236
R000361,N00001685,Jay Rockefeller (D),2014,Transportation Unions,0,28875,28875
R000361,N00001685,Jay Rockefeller (D),2014,Telephone Utilities,0,25000,25000
L000261,N00001691,Carl Levin (D),2014,Building Trade Unions,0,7500,7500
L000261,N00001691,Carl Levin (D),2014,Health Professionals,0,7500,7500
L000261,N00001691,Carl Levin (D),2014,General Contractors,0,5000,5000
L000261,N00001691,Carl Levin (D),2014,Steel Production,0,3000,3000
L000261,N00001691,Carl Levin (D),2014,Pro-Israel,0,1200,1200
L000261,N00001691,Carl Levin (D),2014,Electric Utilities,0,1000,1000
L000261,N00001691,Carl Levin (D),2014,Misc Issues,1000,0,1000
L000261,N00001691,Carl Levin (D),2014,Chemical & Related Manufacturing,0,1000,1000
L000261,N00001691,Carl Levin (D),2014,Telephone Utilities,0,1000,1000
L000261,N00001691,Carl Levin (D),2014,Pharmaceuticals/Health Products,0,1000,1000
L000261,N00001691,Carl Levin (D),2014,Crop Production & Basic Processing,0,1000,1000
L000261,N00001691,Carl Levin (D),2014,Misc Manufacturing & Distributing,0,1000,1000
L000261,N00001691,Carl Levin (D),2014,Insurance,0,1000,1000
N000147,N00001692,Eleanor Holmes Norton (D),2014,Real Estate,57300,20000,77300
N000147,N00001692,Eleanor Holmes Norton (D),2014,Transportation Unions,0,49500,49500
N000147,N00001692,Eleanor Holmes Norton (D),2014,Building Trade Unions,0,47500,47500
N000147,N00001692,Eleanor Holmes Norton (D),2014,Public Sector Unions,0,36500,36500
N000147,N00001692,Eleanor Holmes Norton (D),2014,Lawyers/Law Firms,13500,9500,23000
N000147,N00001692,Eleanor Holmes Norton (D),2014,Misc Unions,0,14750,14750
N000147,N00001692,Eleanor Holmes Norton (D),2014,Industrial Unions,0,13000,13000
N000147,N00001692,Eleanor Holmes Norton (D),2014,General Contractors,5300,7000,12300
N000147,N00001692,Eleanor Holmes Norton (D),2014,Air Transport,0,12000,12000
N000147,N00001692,Eleanor Holmes Norton (D),2014,Construction Services,1000,9500,10500
F000043,N00001746,Chaka Fattah (D),2014,Lawyers/Law Firms,32200,32053,64253
F000043,N00001746,Chaka Fattah (D),2014,Public Sector Unions,0,39500,39500
F000043,N00001746,Chaka Fattah (D),2014,Building Trade Unions,0,35000,35000
F000043,N00001746,Chaka Fattah (D),2014,Defense Aerospace,0,33000,33000
F000043,N00001746,Chaka Fattah (D),2014,Telecom Services,9500,15000,24500
F000043,N00001746,Chaka Fattah (D),2014,Transportation Unions,0,23000,23000
F000043,N00001746,Chaka Fattah (D),2014,Industrial Unions,0,21000,21000
F000043,N00001746,Chaka Fattah (D),2014,Real Estate,10000,10000,20000
F000043,N00001746,Chaka Fattah (D),2014,Pharmaceuticals/Health Products,500,17500,18000
F000043,N00001746,Chaka Fattah (D),2014,Lobbyists,12500,0,12500
G000386,N00001758,Chuck Grassley (R),2014,Insurance,104402,235900,340302
G000386,N00001758,Chuck Grassley (R),2014,Lobbyists,299635,21606,321241
G000386,N00001758,Chuck Grassley (R),2014,Leadership PACs,0,315300,315300
G000386,N00001758,Chuck Grassley (R),2014,Health Professionals,80710,221210,301920
G000386,N00001758,Chuck Grassley (R),2014,Securities & Investment,124300,108250,232550
G000386,N00001758,Chuck Grassley (R),2014,Agricultural Services/Products,67750,153000,220750
G000386,N00001758,Chuck Grassley (R),2014,Retired,199957,0,199957
G000386,N00001758,Chuck Grassley (R),2014,Lawyers/Law Firms,81150,117373,198523
G000386,N00001758,Chuck Grassley (R),2014,Health Services/HMOs,49050,128100,177150
G000386,N00001758,Chuck Grassley (R),2014,Pharmaceuticals/Health Products,51000,123400,174400
D000355,N00001783,John D Dingell (D),2014,Electric Utilities,0,38100,38100
D000355,N00001783,John D Dingell (D),2014,Pharmaceuticals/Health Products,0,32500,32500
D000355,N00001783,John D Dingell (D),2014,Health Professionals,0,24350,24350
D000355,N00001783,John D Dingell (D),2014,Lawyers/Law Firms,6475,17070,23545
D000355,N00001783,John D Dingell (D),2014,Building Trade Unions,0,22100,22100
D000355,N00001783,John D Dingell (D),2014,Transportation Unions,0,21000,21000
D000355,N00001783,John D Dingell (D),2014,Telephone Utilities,1300,15500,16800
D000355,N00001783,John D Dingell (D),2014,TV/Movies/Music,0,15500,15500
D000355,N00001783,John D Dingell (D),2014,Telecom Services,0,15000,15000
D000355,N00001783,John D Dingell (D),2014,Industrial Unions,300,13600,13900
S000583,N00001811,Lamar Smith (R),2014,Oil & Gas,30050,64500,94550
S000583,N00001811,Lamar Smith (R),2014,Retired,76000,0,76000
S000583,N00001811,Lamar Smith (R),2014,TV/Movies/Music,20450,44000,64450
S000583,N00001811,Lamar Smith (R),2014,General Contractors,45400,14000,59400
S000583,N00001811,Lamar Smith (R),2014,Lawyers/Law Firms,33300,24000,57300
S000583,N00001811,Lamar Smith (R),2014,Automotive,27450,27500,54950
S000583,N00001811,Lamar Smith (R),2014,Real Estate,37700,14500,52200
S000583,N00001811,Lamar Smith (R),2014,Health Professionals,35500,16000,51500
S000583,N00001811,Lamar Smith (R),2014,Accountants,500,46000,46500
S000583,N00001811,Lamar Smith (R),2014,Electronics Mfg & Equip,3350,41140,44490
S000248,N00001813,Jose E Serrano (D),2014,Public Sector Unions,0,53000,53000
S000248,N00001813,Jose E Serrano (D),2014,Leadership PACs,0,17000,17000
S000248,N00001813,Jose E Serrano (D),2014,Real Estate,1000,10000,11000
S000248,N00001813,Jose E Serrano (D),2014,Transportation Unions,0,11000,11000
S000248,N00001813,Jose E Serrano (D),2014,Building Trade Unions,0,10500,10500
S000248,N00001813,Jose E Serrano (D),2014,Accountants,0,10000,10000
S000248,N00001813,Jose E Serrano (D),2014,Candidate Committees,0,9500,9500
S000248,N00001813,Jose E Serrano (D),2014,Crop Production & Basic Processing,0,8500,8500
S000248,N00001813,Jose E Serrano (D),2014,Defense Aerospace,0,6000,6000
S000248,N00001813,Jose E Serrano (D),2014,Lawyers/Law Firms,250,5750,6000
S000248,N00001813,Jose E Serrano (D),2014,"Beer, Wine & Liquor",0,6000,6000
H000874,N00001821,Steny H Hoyer (D),2014,Electric Utilities,22250,195750,218000
H000874,N00001821,Steny H Hoyer (D),2014,Insurance,33800,170000,203800
H000874,N00001821,Steny H Hoyer (D),2014,Health Professionals,23720,179000,202720
H000874,N00001821,Steny H Hoyer (D),2014,Securities & Investment,63290,134500,197790
H000874,N00001821,Steny H Hoyer (D),2014,Lawyers/Law Firms,129150,54500,183650
H000874,N00001821,Steny H Hoyer (D),2014,Real Estate,108660,72000,180660
H000874,N00001821,Steny H Hoyer (D),2014,Pharmaceuticals/Health Products,19950,126500,146450
H000874,N00001821,Steny H Hoyer (D),2014,Public Sector Unions,0,138000,138000
H000874,N00001821,Steny H Hoyer (D),2014,Pro-Israel,99450,26000,125450
H000874,N00001821,Steny H Hoyer (D),2014,Commercial Banks,1750,82500,84250
W000215,N00001861,Henry Waxman (D),2014,Health Professionals,3500,95000,98500
W000215,N00001861,Henry Waxman (D),2014,TV/Movies/Music,60350,24000,84350
W000215,N00001861,Henry Waxman (D),2014,Lawyers/Law Firms,18500,22372,40872
W000215,N00001861,Henry Waxman (D),2014,Telecom Services,1000,33250,34250
W000215,N00001861,Henry Waxman (D),2014,Real Estate,26450,3000,29450
W000215,N00001861,Henry Waxman (D),2014,Public Sector Unions,0,28500,28500
W000215,N00001861,Henry Waxman (D),2014,Pharmaceuticals/Health Products,3700,23000,26700
W000215,N00001861,Henry Waxman (D),2014,Lobbyists,22900,3000,25900
W000215,N00001861,Henry Waxman (D),2014,Hospitals/Nursing Homes,11450,14000,25450
W000215,N00001861,Henry Waxman (D),2014,Environment,12200,10749,22949
M000702,N00001945,Barbara A Mikulski (D),2014,Lawyers/Law Firms,218741,88150,306891
M000702,N00001945,Barbara A Mikulski (D),2014,Pharmaceuticals/Health Products,8150,268685,276835
M000702,N00001945,Barbara A Mikulski (D),2014,Lobbyists,220304,20312,240616
M000702,N00001945,Barbara A Mikulski (D),2014,Health Professionals,44734,189650,234384
M000702,N00001945,Barbara A Mikulski (D),2014,Real Estate,165550,28500,194050
M000702,N00001945,Barbara A Mikulski (D),2014,Pro-Israel,134675,38500,173175
M000702,N00001945,Barbara A Mikulski (D),2014,Defense Electronics,83900,77500,161400
M000702,N00001945,Barbara A Mikulski (D),2014,Retired,152215,0,152215
M000702,N00001945,Barbara A Mikulski (D),2014,Leadership PACs,0,131250,131250
M000702,N00001945,Barbara A Mikulski (D),2014,Securities & Investment,92315,38500,130815
C000141,N00001955,Ben Cardin (D),2014,Lawyers/Law Firms,380676,125650,506326
C000141,N00001955,Ben Cardin (D),2014,Securities & Investment,266233,143500,409733
C000141,N00001955,Ben Cardin (D),2014,Real Estate,344620,61500,406120
C000141,N00001955,Ben Cardin (D),2014,Health Professionals,138310,247047,385357
C000141,N00001955,Ben Cardin (D),2014,Insurance,77850,218000,295850
C000141,N00001955,Ben Cardin (D),2014,Lobbyists,243393,9366,252759
C000141,N00001955,Ben Cardin (D),2014,Retired,250760,0,250760
C000141,N00001955,Ben Cardin (D),2014,Pro-Israel,183413,60280,243693
C000141,N00001955,Ben Cardin (D),2014,Health Services/HMOs,74550,150359,224909
C000141,N00001955,Ben Cardin (D),2014,Leadership PACs,0,192000,192000
C000984,N00001971,Elijah E Cummings (D),2014,Public Sector Unions,0,103000,103000
C000984,N00001971,Elijah E Cummings (D),2014,Transportation Unions,0,80500,80500
C000984,N00001971,Elijah E Cummings (D),2014,Sea Transport,9700,39500,49200
C000984,N00001971,Elijah E Cummings (D),2014,Oil & Gas,37050,2000,39050
C000984,N00001971,Elijah E Cummings (D),2014,Building Trade Unions,400,34000,34400
C000984,N00001971,Elijah E Cummings (D),2014,Health Professionals,14300,18000,32300
C000984,N00001971,Elijah E Cummings (D),2014,Air Transport,0,32000,32000
C000984,N00001971,Elijah E Cummings (D),2014,Industrial Unions,0,31000,31000
C000984,N00001971,Elijah E Cummings (D),2014,Railroads,0,29500,29500
C000984,N00001971,Elijah E Cummings (D),2014,Lawyers/Law Firms,16000,12500,28500
W000672,N00002073,Frank Wolf (R),2014,Public Sector Unions,0,20500,20500
W000672,N00002073,Frank Wolf (R),2014,Retired,16500,0,16500
W000672,N00002073,Frank Wolf (R),2014,Defense Aerospace,0,16000,16000
W000672,N00002073,Frank Wolf (R),2014,Air Transport,0,15000,15000
W000672,N00002073,Frank Wolf (R),2014,Lawyers/Law Firms,5750,8750,14500
W000672,N00002073,Frank Wolf (R),2014,Lobbyists,6000,0,6000
W000672,N00002073,Frank Wolf (R),2014,Defense Electronics,0,6000,6000
W000672,N00002073,Frank Wolf (R),2014,Construction Services,0,6000,6000
W000672,N00002073,Frank Wolf (R),2014,Transportation Unions,0,5000,5000
W000672,N00002073,Frank Wolf (R),2014,Telephone Utilities,0,5000,5000
W000672,N00002073,Frank Wolf (R),2014,Accountants,0,5000,5000
M000933,N00002083,Jim Moran (D),2014,Defense Aerospace,40900,26500,67400
M000933,N00002083,Jim Moran (D),2014,Lobbyists,51410,3500,54910
M000933,N00002083,Jim Moran (D),2014,Electronics Mfg & Equip,19200,23090,42290
M000933,N00002083,Jim Moran (D),2014,Misc Defense,14900,26000,40900
M000933,N00002083,Jim Moran (D),2014,Public Sector Unions,200,38000,38200
M000933,N00002083,Jim Moran (D),2014,Lawyers/Law Firms,13200,21500,34700
M000933,N00002083,Jim Moran (D),2014,Defense Electronics,3250,26000,29250
M000933,N00002083,Jim Moran (D),2014,Real Estate,20750,5000,25750
M000933,N00002083,Jim Moran (D),2014,Retired,23500,0,23500
M000933,N00002083,Jim Moran (D),2014,Transportation Unions,0,21000,21000
S000185,N00002147,Bobby Scott (D),2014,Public Sector Unions,250,50000,50250
S000185,N00002147,Bobby Scott (D),2014,Lawyers/Law Firms,14750,24500,39250
S000185,N00002147,Bobby Scott (D),2014,Building Trade Unions,0,32000,32000
S000185,N00002147,Bobby Scott (D),2014,Securities & Investment,2000,24000,26000
S000185,N00002147,Bobby Scott (D),2014,Industrial Unions,0,24500,24500
S000185,N00002147,Bobby Scott (D),2014,Education,8750,11500,20250
S000185,N00002147,Bobby Scott (D),2014,Telecom Services,0,20000,20000
S000185,N00002147,Bobby Scott (D),2014,Transportation Unions,0,18500,18500
S000185,N00002147,Bobby Scott (D),2014,Electric Utilities,3750,14500,18250
S000185,N00002147,Bobby Scott (D),2014,Insurance,0,16000,16000
R000011,N00002198,Nick Rahall (D),2014,Leadership PACs,500,207150,207650
R000011,N00002198,Nick Rahall (D),2014,Transportation Unions,250,161500,161750
R000011,N00002198,Nick Rahall (D),2014,Lawyers/Law Firms,97350,52500,149850
R000011,N00002198,Nick Rahall (D),2014,Air Transport,0,125000,125000
R000011,N00002198,Nick Rahall (D),2014,Candidate Committees,0,98571,98571
R000011,N00002198,Nick Rahall (D),2014,Railroads,36869,54500,91369
R000011,N00002198,Nick Rahall (D),2014,Building Trade Unions,1000,80000,81000
R000011,N00002198,Nick Rahall (D),2014,Lobbyists,63550,17088,80638
R000011,N00002198,Nick Rahall (D),2014,Building Materials & Equipment,25100,55000,80100
R000011,N00002198,Nick Rahall (D),2014,Public Sector Unions,0,80000,80000
B001135,N00002221,Richard Burr (R),2014,Retired,553156,0,553156
B001135,N00002221,Richard Burr (R),2014,Health Professionals,276839,201200,478039
B001135,N00002221,Richard Burr (R),2014,Pharmaceuticals/Health Products,100550,329720,430270
B001135,N00002221,Richard Burr (R),2014,Insurance,175751,235500,411251
B001135,N00002221,Richard Burr (R),2014,Lawyers/Law Firms,276751,120250,397001
B001135,N00002221,Richard Burr (R),2014,Securities & Investment,248152,120900,369052
B001135,N00002221,Richard Burr (R),2014,Leadership PACs,0,321241,321241
B001135,N00002221,Richard Burr (R),2014,Lobbyists,299093,16000,315093
B001135,N00002221,Richard Burr (R),2014,Real Estate,226429,46500,272929
B001135,N00002221,Richard Burr (R),2014,Electric Utilities,129831,139999,269830
C000556,N00002247,Howard Coble (R),2014,Air Transport,0,6500,6500
C000556,N00002247,Howard Coble (R),2014,Automotive,0,5000,5000
C000556,N00002247,Howard Coble (R),2014,TV/Movies/Music,0,4500,4500
C000556,N00002247,Howard Coble (R),2014,Crop Production & Basic Processing,500,3500,4000
C000556,N00002247,Howard Coble (R),2014,Retired,3600,0,3600
C000556,N00002247,Howard Coble (R),2014,Agricultural Services/Products,0,3500,3500
C000556,N00002247,Howard Coble (R),2014,Sea Transport,0,3000,3000
C000556,N00002247,Howard Coble (R),2014,Electric Utilities,0,3000,3000
C000556,N00002247,Howard Coble (R),2014,Telecom Services,0,3000,3000
C000556,N00002247,Howard Coble (R),2014,Real Estate,1000,2000,3000
C000556,N00002247,Howard Coble (R),2014,Health Professionals,0,3000,3000
C000556,N00002247,Howard Coble (R),2014,Pharmaceuticals/Health Products,0,3000,3000
C000556,N00002247,Howard Coble (R),2014,Trucking,0,3000,3000
P000523,N00002260,David Price (D),2014,Retired,54472,0,54472
P000523,N00002260,David Price (D),2014,Education,46250,0,46250
P000523,N00002260,David Price (D),2014,Pharmaceuticals/Health Products,2000,42500,44500
P000523,N00002260,David Price (D),2014,Defense Electronics,0,42000,42000
P000523,N00002260,David Price (D),2014,Public Sector Unions,0,40000,40000
P000523,N00002260,David Price (D),2014,Lawyers/Law Firms,22372,16000,38372
P000523,N00002260,David Price (D),2014,Transportation Unions,0,33000,33000
P000523,N00002260,David Price (D),2014,Health Professionals,8101,22500,30601
P000523,N00002260,David Price (D),2014,Industrial Unions,0,30500,30500
P000523,N00002260,David Price (D),2014,Defense Aerospace,0,28000,28000
J000255,N00002299,Walter B Jones Jr (R),2014,Health Professionals,23900,34750,58650
J000255,N00002299,Walter B Jones Jr (R),2014,Retired,51050,0,51050
J000255,N00002299,Walter B Jones Jr (R),2014,Crop Production & Basic Processing,8450,23750,32200
J000255,N00002299,Walter B Jones Jr (R),2014,Defense Aerospace,0,29000,29000
J000255,N00002299,Walter B Jones Jr (R),2014,Real Estate,22375,6000,28375
J000255,N00002299,Walter B Jones Jr (R),2014,Lawyers/Law Firms,13300,15000,28300
J000255,N00002299,Walter B Jones Jr (R),2014,Democratic/Liberal,21415,0,21415
J000255,N00002299,Walter B Jones Jr (R),2014,Transportation Unions,0,20000,20000
J000255,N00002299,Walter B Jones Jr (R),2014,Misc Manufacturing & Distributing,13000,1000,14000
J000255,N00002299,Walter B Jones Jr (R),2014,Pro-Israel,8000,5000,13000
J000255,N00002299,Walter B Jones Jr (R),2014,Electric Utilities,0,13000,13000
W000207,N00002328,Melvin L Watt (D),2014,Insurance,0,3000,3000
W000207,N00002328,Melvin L Watt (D),2014,Securities & Investment,0,2000,2000
W000207,N00002328,Melvin L Watt (D),2014,Tobacco,0,1000,1000
M000485,N00002356,Mike McIntyre (D),2014,Leadership PACs,1000,36500,37500
M000485,N00002356,Mike McIntyre (D),2014,Lawyers/Law Firms,10400,20428,30828
M000485,N00002356,Mike McIntyre (D),2014,Defense Aerospace,0,27998,27998
M000485,N00002356,Mike McIntyre (D),2014,Public Sector Unions,0,27000,27000
M000485,N00002356,Mike McIntyre (D),2014,Agricultural Services/Products,0,23500,23500
M000485,N00002356,Mike McIntyre (D),2014,Crop Production & Basic Processing,5152,16500,21652
M000485,N00002356,Mike McIntyre (D),2014,Health Professionals,5750,14500,20250
M000485,N00002356,Mike McIntyre (D),2014,Food & Beverage,6500,11500,18000
M000485,N00002356,Mike McIntyre (D),2014,Commercial Banks,250,17000,17250
M000485,N00002356,Mike McIntyre (D),2014,Transportation Unions,0,17000,17000
C000537,N00002408,James E Clyburn (D),2014,Insurance,20250,108500,128750
C000537,N00002408,James E Clyburn (D),2014,Electric Utilities,4250,124000,128250
C000537,N00002408,James E Clyburn (D),2014,Lawyers/Law Firms,60443,57600,118043
C000537,N00002408,James E Clyburn (D),2014,Pharmaceuticals/Health Products,0,106110,106110
C000537,N00002408,James E Clyburn (D),2014,Health Professionals,8250,83500,91750
C000537,N00002408,James E Clyburn (D),2014,Public Sector Unions,0,84500,84500
C000537,N00002408,James E Clyburn (D),2014,Transportation Unions,0,81500,81500
C000537,N00002408,James E Clyburn (D),2014,Securities & Investment,9200,63500,72700
C000537,N00002408,James E Clyburn (D),2014,Commercial Banks,1000,69000,70000
C000537,N00002408,James E Clyburn (D),2014,Hospitals/Nursing Homes,14100,48600,62700
S000051,N00002424,Mark Sanford (R),2014,Real Estate,156660,6000,162660
S000051,N00002424,Mark Sanford (R),2014,Retired,132950,0,132950
S000051,N00002424,Mark Sanford (R),2014,Securities & Investment,123950,0,123950
S000051,N00002424,Mark Sanford (R),2014,Misc Finance,101400,0,101400
S000051,N00002424,Mark Sanford (R),2014,Misc Manufacturing & Distributing,61450,10000,71450
S000051,N00002424,Mark Sanford (R),2014,Lawyers/Law Firms,41350,2000,43350
S000051,N00002424,Mark Sanford (R),2014,Health Professionals,39150,2500,41650
S000051,N00002424,Mark Sanford (R),2014,Forestry & Forest Products,37950,3000,40950
S000051,N00002424,Mark Sanford (R),2014,General Contractors,37450,3500,40950
S000051,N00002424,Mark Sanford (R),2014,Business Services,37730,0,37730
L000287,N00002577,John Lewis (D),2014,Insurance,3500,55500,59000
L000287,N00002577,John Lewis (D),2014,Industrial Unions,0,40000,40000
L000287,N00002577,John Lewis (D),2014,Health Professionals,2000,32750,34750
L000287,N00002577,John Lewis (D),2014,Lawyers/Law Firms,11050,22500,33550
L000287,N00002577,John Lewis (D),2014,Public Sector Unions,0,31500,31500
L000287,N00002577,John Lewis (D),2014,Transportation Unions,0,26500,26500
L000287,N00002577,John Lewis (D),2014,Real Estate,5650,20000,25650
L000287,N00002577,John Lewis (D),2014,Retail Sales,3500,20500,24000
L000287,N00002577,John Lewis (D),2014,Pro-Israel,22000,300,22300
L000287,N00002577,John Lewis (D),2014,Misc Unions,500,21500,22000
I000055,N00002593,Johnny Isakson (R),2014,Real Estate,641812,123500,765312
I000055,N00002593,Johnny Isakson (R),2014,Retired,436647,0,436647
I000055,N00002593,Johnny Isakson (R),2014,Lawyers/Law Firms,271102,101916,373018
I000055,N00002593,Johnny Isakson (R),2014,Insurance,117200,200000,317200
I000055,N00002593,Johnny Isakson (R),2014,Health Professionals,128316,161500,289816
I000055,N00002593,Johnny Isakson (R),2014,Leadership PACs,0,268104,268104
I000055,N00002593,Johnny Isakson (R),2014,Securities & Investment,132100,117000,249100
I000055,N00002593,Johnny Isakson (R),2014,Lobbyists,221941,12000,233941
I000055,N00002593,Johnny Isakson (R),2014,Pharmaceuticals/Health Products,35600,176500,212100
I000055,N00002593,Johnny Isakson (R),2014,Food & Beverage,94100,91870,185970
K000220,N00002656,Jack Kingston (R),2014,Retired,439654,0,439654
K000220,N00002656,Jack Kingston (R),2014,Lawyers/Law Firms,308209,59089,367298
K000220,N00002656,Jack Kingston (R),2014,Health Professionals,246429,78000,324429
K000220,N00002656,Jack Kingston (R),2014,Crop Production & Basic Processing,237190,69000,306190
K000220,N00002656,Jack Kingston (R),2014,Real Estate,272399,14500,286899
K000220,N00002656,Jack Kingston (R),2014,Insurance,208658,64500,273158
K000220,N00002656,Jack Kingston (R),2014,Lobbyists,173408,2500,175908
K000220,N00002656,Jack Kingston (R),2014,Leadership PACs,0,154500,154500
K000220,N00002656,Jack Kingston (R),2014,Agricultural Services/Products,42950,76250,119200
K000220,N00002656,Jack Kingston (R),2014,Misc Manufacturing & Distributing,69156,31500,100656
B000490,N00002674,Sanford Bishop (D),2014,Lawyers/Law Firms,31600,32444,64044
B000490,N00002674,Sanford Bishop (D),2014,Crop Production & Basic Processing,2750,60500,63250
B000490,N00002674,Sanford Bishop (D),2014,Industrial Unions,0,44000,44000
B000490,N00002674,Sanford Bishop (D),2014,Building Trade Unions,0,39500,39500
B000490,N00002674,Sanford Bishop (D),2014,Food & Beverage,14500,20500,35000
B000490,N00002674,Sanford Bishop (D),2014,Public Sector Unions,0,35000,35000
B000490,N00002674,Sanford Bishop (D),2014,Defense Aerospace,0,34000,34000
B000490,N00002674,Sanford Bishop (D),2014,Forestry & Forest Products,6500,25000,31500
B000490,N00002674,Sanford Bishop (D),2014,Health Professionals,8000,23500,31500
B000490,N00002674,Sanford Bishop (D),2014,Food Processing & Sales,2250,27988,30238
C000286,N00002685,Saxby Chambliss (R),2014,Crop Production & Basic Processing,63650,61341,124991
C000286,N00002685,Saxby Chambliss (R),2014,Retired,114875,0,114875
C000286,N00002685,Saxby Chambliss (R),2014,Insurance,39250,57000,96250
C000286,N00002685,Saxby Chambliss (R),2014,Lawyers/Law Firms,60700,29500,90200
C000286,N00002685,Saxby Chambliss (R),2014,Agricultural Services/Products,28050,47770,75820
C000286,N00002685,Saxby Chambliss (R),2014,Securities & Investment,44810,28500,73310
C000286,N00002685,Saxby Chambliss (R),2014,Lobbyists,66043,2500,68543
C000286,N00002685,Saxby Chambliss (R),2014,Real Estate,43970,10000,53970
C000286,N00002685,Saxby Chambliss (R),2014,Mining,43003,5000,48003
C000286,N00002685,Saxby Chambliss (R),2014,Health Services/HMOs,26500,19500,46000
B000911,N00002713,Corrine Brown (D),2014,Transportation Unions,0,56000,56000
B000911,N00002713,Corrine Brown (D),2014,Railroads,2500,53000,55500
B000911,N00002713,Corrine Brown (D),2014,Lawyers/Law Firms,33450,19600,53050
B000911,N00002713,Corrine Brown (D),2014,Real Estate,14800,6000,20800
B000911,N00002713,Corrine Brown (D),2014,Building Materials & Equipment,15200,4000,19200
B000911,N00002713,Corrine Brown (D),2014,Sea Transport,6700,12000,18700
B000911,N00002713,Corrine Brown (D),2014,Hospitals/Nursing Homes,12500,5000,17500
B000911,N00002713,Corrine Brown (D),2014,Air Transport,0,17500,17500
B000911,N00002713,Corrine Brown (D),2014,Building Trade Unions,0,15000,15000
B000911,N00002713,Corrine Brown (D),2014,Lobbyists,11200,0,11200
M000689,N00002793,John L Mica (R),2014,Air Transport,21650,75000,96650
M000689,N00002793,John L Mica (R),2014,Railroads,5250,47500,52750
M000689,N00002793,John L Mica (R),2014,Health Professionals,20100,16000,36100
M000689,N00002793,John L Mica (R),2014,Oil & Gas,0,33500,33500
M000689,N00002793,John L Mica (R),2014,Real Estate,19550,11500,31050
M000689,N00002793,John L Mica (R),2014,Lawyers/Law Firms,17600,12750,30350
M000689,N00002793,John L Mica (R),2014,Construction Services,5450,24500,29950
M000689,N00002793,John L Mica (R),2014,"Beer, Wine & Liquor",6000,22500,28500
M000689,N00002793,John L Mica (R),2014,Insurance,13950,11500,25450
M000689,N00002793,John L Mica (R),2014,Defense Electronics,0,21000,21000
R000435,N00002858,Ileana Ros-Lehtinen (R),2014,Pro-Israel,67700,27100,94800
R000435,N00002858,Ileana Ros-Lehtinen (R),2014,Real Estate,60150,8000,68150
R000435,N00002858,Ileana Ros-Lehtinen (R),2014,Building Trade Unions,0,41000,41000
R000435,N00002858,Ileana Ros-Lehtinen (R),2014,Transportation Unions,0,40500,40500
R000435,N00002858,Ileana Ros-Lehtinen (R),2014,Health Professionals,20450,19500,39950
R000435,N00002858,Ileana Ros-Lehtinen (R),2014,Retired,35800,0,35800
R000435,N00002858,Ileana Ros-Lehtinen (R),2014,Lobbyists,29950,1220,31170
R000435,N00002858,Ileana Ros-Lehtinen (R),2014,Human Rights,4400,25000,29400
R000435,N00002858,Ileana Ros-Lehtinen (R),2014,Misc Manufacturing & Distributing,21900,7000,28900
R000435,N00002858,Ileana Ros-Lehtinen (R),2014,TV/Movies/Music,11100,16500,27600
H000324,N00002884,Alcee L Hastings (D),2014,Education,33700,30500,64200
H000324,N00002884,Alcee L Hastings (D),2014,Lawyers/Law Firms,39960,14500,54460
H000324,N00002884,Alcee L Hastings (D),2014,Crop Production & Basic Processing,12050,31000,43050
H000324,N00002884,Alcee L Hastings (D),2014,Leadership PACs,0,39755,39755
H000324,N00002884,Alcee L Hastings (D),2014,Finance/Credit Companies,14000,22000,36000
H000324,N00002884,Alcee L Hastings (D),2014,Lobbyists,28400,500,28900
H000324,N00002884,Alcee L Hastings (D),2014,Transportation Unions,0,27500,27500
H000324,N00002884,Alcee L Hastings (D),2014,Industrial Unions,0,27500,27500
H000324,N00002884,Alcee L Hastings (D),2014,Telephone Utilities,0,21000,21000
H000324,N00002884,Alcee L Hastings (D),2014,Real Estate,11500,8000,19500
F000462,N00002893,Lois J Frankel (D),2014,Lawyers/Law Firms,91473,20500,111973
F000462,N00002893,Lois J Frankel (D),2014,Retired,93250,0,93250
F000462,N00002893,Lois J Frankel (D),2014,Real Estate,53550,8000,61550
F000462,N00002893,Lois J Frankel (D),2014,Building Trade Unions,0,60000,60000
F000462,N00002893,Lois J Frankel (D),2014,Securities & Investment,59850,0,59850
F000462,N00002893,Lois J Frankel (D),2014,Business Services,40000,11000,51000
F000462,N00002893,Lois J Frankel (D),2014,Transportation Unions,0,47500,47500
F000462,N00002893,Lois J Frankel (D),2014,Public Sector Unions,2000,34500,36500
F000462,N00002893,Lois J Frankel (D),2014,Crop Production & Basic Processing,17700,14000,31700
F000462,N00002893,Lois J Frankel (D),2014,Industrial Unions,0,30500,30500
A000055,N00003028,Robert B Aderholt (R),2014,Crop Production & Basic Processing,0,57500,57500
A000055,N00003028,Robert B Aderholt (R),2014,Agricultural Services/Products,2500,50500,53000
A000055,N00003028,Robert B Aderholt (R),2014,Defense Aerospace,6398,45000,51398
A000055,N00003028,Robert B Aderholt (R),2014,Commercial Banks,6000,38000,44000
A000055,N00003028,Robert B Aderholt (R),2014,Lawyers/Law Firms,13948,28000,41948
A000055,N00003028,Robert B Aderholt (R),2014,Misc Defense,28747,12000,40747
A000055,N00003028,Robert B Aderholt (R),2014,Defense Electronics,1000,39000,40000
A000055,N00003028,Robert B Aderholt (R),2014,Food Processing & Sales,1498,38000,39498
A000055,N00003028,Robert B Aderholt (R),2014,Lobbyists,36417,2119,38536
A000055,N00003028,Robert B Aderholt (R),2014,Pharmaceuticals/Health Products,0,34000,34000
S001141,N00003062,Jeff Sessions (R),2014,Leadership PACs,0,101500,101500
S001141,N00003062,Jeff Sessions (R),2014,Defense Aerospace,2000,95500,97500
S001141,N00003062,Jeff Sessions (R),2014,Oil & Gas,2250,87000,89250
S001141,N00003062,Jeff Sessions (R),2014,Lawyers/Law Firms,24205,52198,76403
S001141,N00003062,Jeff Sessions (R),2014,Real Estate,40400,24000,64400
S001141,N00003062,Jeff Sessions (R),2014,Electric Utilities,0,58250,58250
S001141,N00003062,Jeff Sessions (R),2014,Misc Defense,25400,30600,56000
S001141,N00003062,Jeff Sessions (R),2014,Health Professionals,11450,42000,53450
S001141,N00003062,Jeff Sessions (R),2014,Insurance,8150,39500,47650
S001141,N00003062,Jeff Sessions (R),2014,Pharmaceuticals/Health Products,3100,43500,46600
B001243,N00003105,Marsha Blackburn (R),2014,Health Professionals,26000,205150,231150
B001243,N00003105,Marsha Blackburn (R),2014,Pharmaceuticals/Health Products,7750,155100,162850
B001243,N00003105,Marsha Blackburn (R),2014,Oil & Gas,22100,79500,101600
B001243,N00003105,Marsha Blackburn (R),2014,Automotive,27950,43000,70950
B001243,N00003105,Marsha Blackburn (R),2014,Health Services/HMOs,11500,50500,62000
B001243,N00003105,Marsha Blackburn (R),2014,Insurance,11750,49500,61250
B001243,N00003105,Marsha Blackburn (R),2014,Hospitals/Nursing Homes,16450,42000,58450
B001243,N00003105,Marsha Blackburn (R),2014,Lawyers/Law Firms,21250,35791,57041
B001243,N00003105,Marsha Blackburn (R),2014,TV/Movies/Music,24250,28600,52850
B001243,N00003105,Marsha Blackburn (R),2014,Telecom Services,0,49500,49500
C000754,N00003132,Jim Cooper (D),2014,Lawyers/Law Firms,64100,14500,78600
C000754,N00003132,Jim Cooper (D),2014,Real Estate,35100,5000,40100
C000754,N00003132,Jim Cooper (D),2014,Defense Aerospace,0,40000,40000
C000754,N00003132,Jim Cooper (D),2014,Securities & Investment,33900,6000,39900
C000754,N00003132,Jim Cooper (D),2014,Retired,32350,0,32350
C000754,N00003132,Jim Cooper (D),2014,Insurance,8700,22000,30700
C000754,N00003132,Jim Cooper (D),2014,Accountants,5250,24500,29750
C000754,N00003132,Jim Cooper (D),2014,Education,20200,5000,25200
C000754,N00003132,Jim Cooper (D),2014,"Beer, Wine & Liquor",14400,8500,22900
C000754,N00003132,Jim Cooper (D),2014,Building Trade Unions,0,20000,20000
D000533,N00003209,John J Duncan Jr (R),2014,Railroads,0,45000,45000
D000533,N00003209,John J Duncan Jr (R),2014,Air Transport,0,43000,43000
D000533,N00003209,John J Duncan Jr (R),2014,Lawyers/Law Firms,14150,14500,28650
D000533,N00003209,John J Duncan Jr (R),2014,Construction Services,0,25500,25500
D000533,N00003209,John J Duncan Jr (R),2014,Transportation Unions,0,25000,25000
D000533,N00003209,John J Duncan Jr (R),2014,Building Materials & Equipment,2500,21500,24000
D000533,N00003209,John J Duncan Jr (R),2014,Trucking,3000,21000,24000
D000533,N00003209,John J Duncan Jr (R),2014,Misc Transport,1500,20000,21500
D000533,N00003209,John J Duncan Jr (R),2014,Pharmaceuticals/Health Products,20800,0,20800
D000533,N00003209,John J Duncan Jr (R),2014,General Contractors,8500,11500,20000
C001068,N00003225,Steve Cohen (D),2014,Transportation Unions,0,50000,50000
C001068,N00003225,Steve Cohen (D),2014,Industrial Unions,0,42000,42000
C001068,N00003225,Steve Cohen (D),2014,Real Estate,30050,6000,36050
C001068,N00003225,Steve Cohen (D),2014,Lawyers/Law Firms,12050,23500,35550
C001068,N00003225,Steve Cohen (D),2014,Railroads,0,29000,29000
C001068,N00003225,Steve Cohen (D),2014,Public Sector Unions,0,27500,27500
C001068,N00003225,Steve Cohen (D),2014,Telecom Services,0,26000,26000
C001068,N00003225,Steve Cohen (D),2014,Retired,24650,0,24650
C001068,N00003225,Steve Cohen (D),2014,Health Professionals,11250,13000,24250
C001068,N00003225,Steve Cohen (D),2014,Misc Unions,0,21000,21000
C001068,N00003225,Steve Cohen (D),2014,Automotive,2000,19000,21000
W000437,N00003280,Roger Wicker (R),2014,Lawyers/Law Firms,134090,113150,247240
W000437,N00003280,Roger Wicker (R),2014,Oil & Gas,118916,123000,241916
W000437,N00003280,Roger Wicker (R),2014,Leadership PACs,0,229500,229500
W000437,N00003280,Roger Wicker (R),2014,Lobbyists,216989,10000,226989
W000437,N00003280,Roger Wicker (R),2014,Securities & Investment,133625,78071,211696
W000437,N00003280,Roger Wicker (R),2014,Insurance,61500,136750,198250
W000437,N00003280,Roger Wicker (R),2014,Health Professionals,82850,79000,161850
W000437,N00003280,Roger Wicker (R),2014,Real Estate,83950,50500,134450
W000437,N00003280,Roger Wicker (R),2014,Telecom Services,33800,85000,118800
W000437,N00003280,Roger Wicker (R),2014,Commercial Banks,20791,79570,100361
T000193,N00003288,Bennie G Thompson (D),2014,Lawyers/Law Firms,25858,39961,65819
T000193,N00003288,Bennie G Thompson (D),2014,Transportation Unions,0,60000,60000
T000193,N00003288,Bennie G Thompson (D),2014,Industrial Unions,0,52500,52500
T000193,N00003288,Bennie G Thompson (D),2014,Electric Utilities,0,47500,47500
T000193,N00003288,Bennie G Thompson (D),2014,Public Sector Unions,0,46000,46000
T000193,N00003288,Bennie G Thompson (D),2014,Railroads,0,45000,45000
T000193,N00003288,Bennie G Thompson (D),2014,Defense Aerospace,0,34500,34500
T000193,N00003288,Bennie G Thompson (D),2014,Pharmaceuticals/Health Products,0,34500,34500
T000193,N00003288,Bennie G Thompson (D),2014,Telecom Services,8250,24000,32250
T000193,N00003288,Bennie G Thompson (D),2014,Building Trade Unions,0,31500,31500
C000567,N00003328,Thad Cochran (R),2014,Crop Production & Basic Processing,263925,239350,503275
C000567,N00003328,Thad Cochran (R),2014,Leadership PACs,0,463300,463300
C000567,N00003328,Thad Cochran (R),2014,Lawyers/Law Firms,151700,138500,290200
C000567,N00003328,Thad Cochran (R),2014,Agricultural Services/Products,21000,210500,231500
C000567,N00003328,Thad Cochran (R),2014,Lobbyists,220775,6001,226776
C000567,N00003328,Thad Cochran (R),2014,Oil & Gas,85505,141000,226505
C000567,N00003328,Thad Cochran (R),2014,Defense Aerospace,65800,151500,217300
C000567,N00003328,Thad Cochran (R),2014,Retired,182254,0,182254
C000567,N00003328,Thad Cochran (R),2014,Health Professionals,52509,107150,159659
C000567,N00003328,Thad Cochran (R),2014,Insurance,33200,121300,154500
M000355,N00003389,Mitch McConnell (R),2014,Securities & Investment,2157107,270600,2427707
M000355,N00003389,Mitch McConnell (R),2014,Retired,1447510,0,1447510
M000355,N00003389,Mitch McConnell (R),2014,Oil & Gas,728710,380599,1109309
M000355,N00003389,Mitch McConnell (R),2014,Lawyers/Law Firms,761864,304650,1066514
M000355,N00003389,Mitch McConnell (R),2014,Health Professionals,734995,289500,1024495
M000355,N00003389,Mitch McConnell (R),2014,Insurance,647100,366500,1013600
M000355,N00003389,Mitch McConnell (R),2014,Real Estate,876975,109100,986075
M000355,N00003389,Mitch McConnell (R),2014,Lobbyists,715166,31144,746310
M000355,N00003389,Mitch McConnell (R),2014,Misc Finance,616155,54000,670155
M000355,N00003389,Mitch McConnell (R),2014,Commercial Banks,413689,214350,628039
W000413,N00003467,Ed Whitfield (R),2014,Electric Utilities,11200,204750,215950
W000413,N00003467,Ed Whitfield (R),2014,Health Professionals,52650,158500,211150
W000413,N00003467,Ed Whitfield (R),2014,Oil & Gas,0,135000,135000
W000413,N00003467,Ed Whitfield (R),2014,Pharmaceuticals/Health Products,2000,96000,98000
W000413,N00003467,Ed Whitfield (R),2014,Lawyers/Law Firms,11950,51651,63601
W000413,N00003467,Ed Whitfield (R),2014,Misc Energy,4000,59500,63500
W000413,N00003467,Ed Whitfield (R),2014,Chemical & Related Manufacturing,0,56000,56000
W000413,N00003467,Ed Whitfield (R),2014,Lobbyists,47450,3500,50950
W000413,N00003467,Ed Whitfield (R),2014,Crop Production & Basic Processing,18800,32000,50800
W000413,N00003467,Ed Whitfield (R),2014,Railroads,3000,42500,45500
R000395,N00003473,Hal Rogers (R),2014,Air Transport,7500,65800,73300
R000395,N00003473,Hal Rogers (R),2014,Defense Aerospace,3500,57500,61000
R000395,N00003473,Hal Rogers (R),2014,Health Professionals,14900,44500,59400
R000395,N00003473,Hal Rogers (R),2014,Mining,7600,51000,58600
R000395,N00003473,Hal Rogers (R),2014,Defense Electronics,500,55500,56000
R000395,N00003473,Hal Rogers (R),2014,Lobbyists,50993,5000,55993
R000395,N00003473,Hal Rogers (R),2014,Misc Defense,14200,32500,46700
R000395,N00003473,Hal Rogers (R),2014,Lawyers/Law Firms,14900,31750,46650
R000395,N00003473,Hal Rogers (R),2014,Crop Production & Basic Processing,4200,37500,41700
R000395,N00003473,Hal Rogers (R),2014,Railroads,2000,38000,40000
K000009,N00003522,Marcy Kaptur (D),2014,Building Trade Unions,250,80000,80250
K000009,N00003522,Marcy Kaptur (D),2014,Electric Utilities,5000,56300,61300
K000009,N00003522,Marcy Kaptur (D),2014,Transportation Unions,0,56100,56100
K000009,N00003522,Marcy Kaptur (D),2014,Industrial Unions,0,51000,51000
K000009,N00003522,Marcy Kaptur (D),2014,Public Sector Unions,0,45000,45000
K000009,N00003522,Marcy Kaptur (D),2014,Lawyers/Law Firms,17150,23250,40400
K000009,N00003522,Marcy Kaptur (D),2014,Defense Aerospace,0,36500,36500
K000009,N00003522,Marcy Kaptur (D),2014,Real Estate,20600,10500,31100
K000009,N00003522,Marcy Kaptur (D),2014,Misc Manufacturing & Distributing,2750,26200,28950
K000009,N00003522,Marcy Kaptur (D),2014,Crop Production & Basic Processing,1000,24500,25500
B000944,N00003535,Sherrod Brown (D),2014,Lawyers/Law Firms,1791671,203123,1994794
B000944,N00003535,Sherrod Brown (D),2014,Retired,1264236,0,1264236
B000944,N00003535,Sherrod Brown (D),2014,Health Professionals,404777,259300,664077
B000944,N00003535,Sherrod Brown (D),2014,Education,607989,4000,611989
B000944,N00003535,Sherrod Brown (D),2014,Real Estate,510862,67000,577862
B000944,N00003535,Sherrod Brown (D),2014,Lobbyists,461581,21350,482931
B000944,N00003535,Sherrod Brown (D),2014,Women's Issues,402684,1500,404184
B000944,N00003535,Sherrod Brown (D),2014,Insurance,164608,228649,393257
B000944,N00003535,Sherrod Brown (D),2014,Hospitals/Nursing Homes,337188,46250,383438
B000944,N00003535,Sherrod Brown (D),2014,Leadership PACs,200,379000,379200
B000589,N00003675,John Boehner (R),2014,Securities & Investment,1102510,156000,1258510
B000589,N00003675,John Boehner (R),2014,Retired,1189700,0,1189700
B000589,N00003675,John Boehner (R),2014,Real Estate,669516,47500,717016
B000589,N00003675,John Boehner (R),2014,Oil & Gas,503339,174500,677839
B000589,N00003675,John Boehner (R),2014,Mining,511048,41150,552198
B000589,N00003675,John Boehner (R),2014,Insurance,302635,201500,504135
B000589,N00003675,John Boehner (R),2014,Lawyers/Law Firms,408256,43400,451656
B000589,N00003675,John Boehner (R),2014,Misc Manufacturing & Distributing,362807,55500,418307
B000589,N00003675,John Boehner (R),2014,Lobbyists,392126,5000,397126
B000589,N00003675,John Boehner (R),2014,Health Professionals,202245,190250,392495
P000449,N00003682,Rob Portman (R),2014,Securities & Investment,1541935,168000,1709935
P000449,N00003682,Rob Portman (R),2014,Retired,1401492,0,1401492
P000449,N00003682,Rob Portman (R),2014,Insurance,646747,487300,1134047
P000449,N00003682,Rob Portman (R),2014,Lawyers/Law Firms,882377,165798,1048175
P000449,N00003682,Rob Portman (R),2014,Misc Manufacturing & Distributing,657035,179200,836235
P000449,N00003682,Rob Portman (R),2014,Real Estate,707801,59900,767701
P000449,N00003682,Rob Portman (R),2014,Lobbyists,703823,14950,718773
P000449,N00003682,Rob Portman (R),2014,Misc Finance,477322,64500,541822
P000449,N00003682,Rob Portman (R),2014,Commercial Banks,370525,150399,520924
P000449,N00003682,Rob Portman (R),2014,Oil & Gas,293544,167500,461044
C000266,N00003689,Steve Chabot (R),2014,Misc Manufacturing & Distributing,38400,16185,54585
C000266,N00003689,Steve Chabot (R),2014,Retired,47500,0,47500
C000266,N00003689,Steve Chabot (R),2014,Insurance,28950,8100,37050
C000266,N00003689,Steve Chabot (R),2014,Health Professionals,28500,8000,36500
C000266,N00003689,Steve Chabot (R),2014,Lawyers/Law Firms,24200,12221,36421
C000266,N00003689,Steve Chabot (R),2014,Real Estate,26300,7000,33300
C000266,N00003689,Steve Chabot (R),2014,Recreation/Live Entertainment,18800,11000,29800
C000266,N00003689,Steve Chabot (R),2014,Automotive,9000,16500,25500
C000266,N00003689,Steve Chabot (R),2014,Securities & Investment,8450,16000,24450
C000266,N00003689,Steve Chabot (R),2014,Food Processing & Sales,19200,4000,23200
V000108,N00003813,Pete Visclosky (D),2014,Building Trade Unions,1792,73000,74792
V000108,N00003813,Pete Visclosky (D),2014,Defense Electronics,8500,61000,69500
V000108,N00003813,Pete Visclosky (D),2014,Defense Aerospace,10700,49500,60200
V000108,N00003813,Pete Visclosky (D),2014,Electric Utilities,500,51250,51750
V000108,N00003813,Pete Visclosky (D),2014,Lobbyists,29550,16344,45894
V000108,N00003813,Pete Visclosky (D),2014,Health Professionals,25000,16000,41000
V000108,N00003813,Pete Visclosky (D),2014,Lawyers/Law Firms,18950,15750,34700
V000108,N00003813,Pete Visclosky (D),2014,Transportation Unions,0,33000,33000
V000108,N00003813,Pete Visclosky (D),2014,Industrial Unions,0,33000,33000
V000108,N00003813,Pete Visclosky (D),2014,Misc Manufacturing & Distributing,3000,29000,32000
C000542,N00003845,Dan Coats (R),2014,Securities & Investment,309481,11000,320481
C000542,N00003845,Dan Coats (R),2014,Leadership PACs,0,283854,283854
C000542,N00003845,Dan Coats (R),2014,Lawyers/Law Firms,185254,64350,249604
C000542,N00003845,Dan Coats (R),2014,Retired,195896,0,195896
C000542,N00003845,Dan Coats (R),2014,Real Estate,154199,25000,179199
C000542,N00003845,Dan Coats (R),2014,Oil & Gas,63283,114750,178033
C000542,N00003845,Dan Coats (R),2014,Insurance,36500,137900,174400
C000542,N00003845,Dan Coats (R),2014,Lobbyists,146933,16000,162933
C000542,N00003845,Dan Coats (R),2014,Pharmaceuticals/Health Products,28450,106899,135349
C000542,N00003845,Dan Coats (R),2014,Health Professionals,37300,81500,118800
L000263,N00003950,Sander Levin (D),2014,Health Professionals,7500,138650,146150
L000263,N00003950,Sander Levin (D),2014,Insurance,250,132500,132750
L000263,N00003950,Sander Levin (D),2014,Lawyers/Law Firms,23500,49500,73000
L000263,N00003950,Sander Levin (D),2014,Public Sector Unions,250,60500,60750
L000263,N00003950,Sander Levin (D),2014,Electric Utilities,0,50000,50000
L000263,N00003950,Sander Levin (D),2014,Building Trade Unions,0,47500,47500
L000263,N00003950,Sander Levin (D),2014,Securities & Investment,2750,42500,45250
L000263,N00003950,Sander Levin (D),2014,Real Estate,20350,22490,42840
L000263,N00003950,Sander Levin (D),2014,Industrial Unions,0,42000,42000
L000263,N00003950,Sander Levin (D),2014,Defense Aerospace,0,42000,42000
C000714,N00004029,John Conyers Jr (D),2014,Telecom Services,16000,53000,69000
C000714,N00004029,John Conyers Jr (D),2014,Lawyers/Law Firms,21650,46392,68042
C000714,N00004029,John Conyers Jr (D),2014,TV/Movies/Music,13750,49000,62750
C000714,N00004029,John Conyers Jr (D),2014,Public Sector Unions,0,47000,47000
C000714,N00004029,John Conyers Jr (D),2014,Retail Sales,500,37000,37500
C000714,N00004029,John Conyers Jr (D),2014,Building Trade Unions,0,36500,36500
C000714,N00004029,John Conyers Jr (D),2014,Industrial Unions,0,33500,33500
C000714,N00004029,John Conyers Jr (D),2014,Misc Unions,0,30000,30000
C000714,N00004029,John Conyers Jr (D),2014,Telephone Utilities,0,27000,27000
C000714,N00004029,John Conyers Jr (D),2014,Leadership PACs,0,25000,25000
S000770,N00004118,Debbie Stabenow (D),2014,Lawyers/Law Firms,493546,153035,646581
S000770,N00004118,Debbie Stabenow (D),2014,Securities & Investment,436120,169250,605370
S000770,N00004118,Debbie Stabenow (D),2014,Health Professionals,228833,289710,518543
S000770,N00004118,Debbie Stabenow (D),2014,Retired,447039,0,447039
S000770,N00004118,Debbie Stabenow (D),2014,Crop Production & Basic Processing,112861,244565,357426
S000770,N00004118,Debbie Stabenow (D),2014,Insurance,143300,192545,335845
S000770,N00004118,Debbie Stabenow (D),2014,Women's Issues,316555,12000,328555
S000770,N00004118,Debbie Stabenow (D),2014,Lobbyists,307767,14893,322660
S000770,N00004118,Debbie Stabenow (D),2014,Hospitals/Nursing Homes,210647,79000,289647
S000770,N00004118,Debbie Stabenow (D),2014,Leadership PACs,0,287500,287500
U000031,N00004133,Fred Upton (R),2014,Health Professionals,42751,292000,334751
U000031,N00004133,Fred Upton (R),2014,Pharmaceuticals/Health Products,33700,272500,306200
U000031,N00004133,Fred Upton (R),2014,Oil & Gas,33150,202500,235650
U000031,N00004133,Fred Upton (R),2014,Electric Utilities,9550,225500,235050
U000031,N00004133,Fred Upton (R),2014,Leadership PACs,0,214600,214600
U000031,N00004133,Fred Upton (R),2014,Lawyers/Law Firms,53300,95250,148550
U000031,N00004133,Fred Upton (R),2014,Telecom Services,36550,101000,137550
U000031,N00004133,Fred Upton (R),2014,Lobbyists,117086,14500,131586
U000031,N00004133,Fred Upton (R),2014,Retired,129640,0,129640
U000031,N00004133,Fred Upton (R),2014,TV/Movies/Music,61200,58448,119648
H000206,N00004207,Tom Harkin (D),2014,Health Professionals,35050,126000,161050
H000206,N00004207,Tom Harkin (D),2014,Pharmaceuticals/Health Products,29200,129884,159084
H000206,N00004207,Tom Harkin (D),2014,Lobbyists,143734,3207,146941
H000206,N00004207,Tom Harkin (D),2014,Hospitals/Nursing Homes,76200,34500,110700
H000206,N00004207,Tom Harkin (D),2014,Lawyers/Law Firms,47750,53000,100750
H000206,N00004207,Tom Harkin (D),2014,Retired,84528,0,84528
H000206,N00004207,Tom Harkin (D),2014,Health Services/HMOs,34700,31000,65700
H000206,N00004207,Tom Harkin (D),2014,Education,55143,4000,59143
H000206,N00004207,Tom Harkin (D),2014,Insurance,20050,39000,59050
H000206,N00004207,Tom Harkin (D),2014,Securities & Investment,46300,11000,57300
L000111,N00004227,Tom Latham (R),2014,Leadership PACs,0,88999,88999
L000111,N00004227,Tom Latham (R),2014,Crop Production & Basic Processing,29350,28500,57850
L000111,N00004227,Tom Latham (R),2014,Insurance,10600,32000,42600
L000111,N00004227,Tom Latham (R),2014,Agricultural Services/Products,9850,27000,36850
L000111,N00004227,Tom Latham (R),2014,Pharmaceuticals/Health Products,250,35500,35750
L000111,N00004227,Tom Latham (R),2014,Transportation Unions,0,33500,33500
L000111,N00004227,Tom Latham (R),2014,Health Professionals,4300,27500,31800
L000111,N00004227,Tom Latham (R),2014,Air Transport,1500,29500,31000
L000111,N00004227,Tom Latham (R),2014,Electric Utilities,2877,28000,30877
L000111,N00004227,Tom Latham (R),2014,Railroads,0,30000,30000
S000244,N00004291,F James Sensenbrenner Jr (R),2014,Telecom Services,0,28500,28500
S000244,N00004291,F James Sensenbrenner Jr (R),2014,Retired,27998,0,27998
S000244,N00004291,F James Sensenbrenner Jr (R),2014,Lawyers/Law Firms,9051,17000,26051
S000244,N00004291,F James Sensenbrenner Jr (R),2014,Telephone Utilities,0,23500,23500
S000244,N00004291,F James Sensenbrenner Jr (R),2014,TV/Movies/Music,3250,15000,18250
S000244,N00004291,F James Sensenbrenner Jr (R),2014,Misc Manufacturing & Distributing,5744,12000,17744
S000244,N00004291,F James Sensenbrenner Jr (R),2014,Insurance,4000,13000,17000
S000244,N00004291,F James Sensenbrenner Jr (R),2014,Lobbyists,13279,500,13779
S000244,N00004291,F James Sensenbrenner Jr (R),2014,Internet,0,12000,12000
S000244,N00004291,F James Sensenbrenner Jr (R),2014,Commercial Banks,3000,8000,11000
R000570,N00004357,Paul Ryan (R),2014,Retired,920683,0,920683
R000570,N00004357,Paul Ryan (R),2014,Securities & Investment,459428,134100,593528
R000570,N00004357,Paul Ryan (R),2014,Insurance,191678,275000,466678
R000570,N00004357,Paul Ryan (R),2014,Oil & Gas,203049,98500,301549
R000570,N00004357,Paul Ryan (R),2014,Health Professionals,65980,174000,239980
R000570,N00004357,Paul Ryan (R),2014,Real Estate,164050,65000,229050
R000570,N00004357,Paul Ryan (R),2014,Misc Manufacturing & Distributing,129000,88600,217600
R000570,N00004357,Paul Ryan (R),2014,Pharmaceuticals/Health Products,51967,154000,205967
R000570,N00004357,Paul Ryan (R),2014,Lawyers/Law Firms,137699,62500,200199
R000570,N00004357,Paul Ryan (R),2014,Hospitals/Nursing Homes,81206,118500,199706
B001230,N00004367,Tammy Baldwin (D),2014,Women's Issues,882131,36972,919103
B001230,N00004367,Tammy Baldwin (D),2014,Retired,838964,0,838964
B001230,N00004367,Tammy Baldwin (D),2014,Lawyers/Law Firms,621807,27350,649157
B001230,N00004367,Tammy Baldwin (D),2014,Democratic/Liberal,388844,173765,562609
B001230,N00004367,Tammy Baldwin (D),2014,Education,328025,2500,330525
B001230,N00004367,Tammy Baldwin (D),2014,Leadership PACs,8750,300680,309430
B001230,N00004367,Tammy Baldwin (D),2014,Health Professionals,171254,56250,227504
B001230,N00004367,Tammy Baldwin (D),2014,Human Rights,187468,29993,217461
B001230,N00004367,Tammy Baldwin (D),2014,Business Services,192140,2000,194140
B001230,N00004367,Tammy Baldwin (D),2014,Pro-Israel,152265,24715,176980
K000188,N00004403,Ron Kind (D),2014,Insurance,44694,246750,291444
K000188,N00004403,Ron Kind (D),2014,Pharmaceuticals/Health Products,5250,183150,188400
K000188,N00004403,Ron Kind (D),2014,Health Professionals,9100,163150,172250
K000188,N00004403,Ron Kind (D),2014,Securities & Investment,7250,86500,93750
K000188,N00004403,Ron Kind (D),2014,Lawyers/Law Firms,38780,53550,92330
K000188,N00004403,Ron Kind (D),2014,Misc Manufacturing & Distributing,5950,58000,63950
K000188,N00004403,Ron Kind (D),2014,Electric Utilities,5240,56750,61990
K000188,N00004403,Ron Kind (D),2014,Lobbyists,56625,5250,61875
K000188,N00004403,Ron Kind (D),2014,Retail Sales,500,58000,58500
K000188,N00004403,Ron Kind (D),2014,Hospitals/Nursing Homes,21925,31000,52925
P000265,N00004426,Tom Petri (R),2014,Air Transport,0,34500,34500
P000265,N00004426,Tom Petri (R),2014,Building Materials & Equipment,2000,20500,22500
P000265,N00004426,Tom Petri (R),2014,Building Trade Unions,0,21500,21500
P000265,N00004426,Tom Petri (R),2014,Trucking,1500,18000,19500
P000265,N00004426,Tom Petri (R),2014,Construction Services,0,19000,19000
P000265,N00004426,Tom Petri (R),2014,Railroads,0,18000,18000
P000265,N00004426,Tom Petri (R),2014,Lobbyists,15875,1000,16875
P000265,N00004426,Tom Petri (R),2014,Lawyers/Law Firms,2627,11000,13627
P000265,N00004426,Tom Petri (R),2014,Transportation Unions,0,11500,11500
P000265,N00004426,Tom Petri (R),2014,Republican/Conservative,1000,10000,11000
K000363,N00004436,John Kline (R),2014,Education,219400,68099,287499
K000363,N00004436,John Kline (R),2014,Insurance,43400,98000,141400
K000363,N00004436,John Kline (R),2014,Securities & Investment,24923,99500,124423
K000363,N00004436,John Kline (R),2014,Leadership PACs,0,98000,98000
K000363,N00004436,John Kline (R),2014,Retired,95003,0,95003
K000363,N00004436,John Kline (R),2014,Lawyers/Law Firms,55025,32019,87044
K000363,N00004436,John Kline (R),2014,Mining,62750,19750,82500
K000363,N00004436,John Kline (R),2014,Retail Sales,6050,56500,62550
K000363,N00004436,John Kline (R),2014,Automotive,41300,21000,62300
K000363,N00004436,John Kline (R),2014,Misc Manufacturing & Distributing,50100,7000,57100
P000258,N00004558,Collin C Peterson (D),2014,Crop Production & Basic Processing,113150,169750,282900
P000258,N00004558,Collin C Peterson (D),2014,Agricultural Services/Products,3250,135000,138250
P000258,N00004558,Collin C Peterson (D),2014,Leadership PACs,0,105300,105300
P000258,N00004558,Collin C Peterson (D),2014,Dairy,24250,52500,76750
P000258,N00004558,Collin C Peterson (D),2014,Public Sector Unions,0,49500,49500
P000258,N00004558,Collin C Peterson (D),2014,Building Trade Unions,0,46500,46500
P000258,N00004558,Collin C Peterson (D),2014,Securities & Investment,6000,39500,45500
P000258,N00004558,Collin C Peterson (D),2014,Forestry & Forest Products,500,42500,43000
P000258,N00004558,Collin C Peterson (D),2014,Food Processing & Sales,1000,41618,42618
P000258,N00004558,Collin C Peterson (D),2014,Transportation Unions,0,38500,38500
T000250,N00004572,John Thune (R),2014,Retired,839375,0,839375
T000250,N00004572,John Thune (R),2014,Insurance,134350,260000,394350
T000250,N00004572,John Thune (R),2014,Securities & Investment,280002,110000,390002
T000250,N00004572,John Thune (R),2014,Lobbyists,327758,17398,345156
T000250,N00004572,John Thune (R),2014,Leadership PACs,0,304942,304942
T000250,N00004572,John Thune (R),2014,Real Estate,246047,51510,297557
T000250,N00004572,John Thune (R),2014,Lawyers/Law Firms,161296,107922,269218
T000250,N00004572,John Thune (R),2014,Republican/Conservative,196678,19977,216655
T000250,N00004572,John Thune (R),2014,Commercial Banks,113055,101476,214531
T000250,N00004572,John Thune (R),2014,Health Professionals,138835,69500,208335
C001096,N00004614,Kevin Cramer (R),2014,Oil & Gas,154850,87600,242450
C001096,N00004614,Kevin Cramer (R),2014,Crop Production & Basic Processing,78100,47250,125350
C001096,N00004614,Kevin Cramer (R),2014,Agricultural Services/Products,9050,46100,55150
C001096,N00004614,Kevin Cramer (R),2014,Retired,54820,0,54820
C001096,N00004614,Kevin Cramer (R),2014,Leadership PACs,2000,42100,44100
C001096,N00004614,Kevin Cramer (R),2014,Insurance,7550,32000,39550
C001096,N00004614,Kevin Cramer (R),2014,Real Estate,31400,8000,39400
C001096,N00004614,Kevin Cramer (R),2014,Commercial Banks,25050,13500,38550
C001096,N00004614,Kevin Cramer (R),2014,Mining,900,23500,24400
C001096,N00004614,Kevin Cramer (R),2014,Defense Aerospace,0,21000,21000
B000243,N00004643,Max Baucus (D),2014,Lobbyists,322627,8000,330627
B000243,N00004643,Max Baucus (D),2014,Insurance,145400,178500,323900
B000243,N00004643,Max Baucus (D),2014,Securities & Investment,204069,90000,294069
B000243,N00004643,Max Baucus (D),2014,Health Services/HMOs,114218,125450,239668
B000243,N00004643,Max Baucus (D),2014,Lawyers/Law Firms,114299,109049,223348
B000243,N00004643,Max Baucus (D),2014,Health Professionals,29412,188850,218262
B000243,N00004643,Max Baucus (D),2014,Hospitals/Nursing Homes,74548,116500,191048
B000243,N00004643,Max Baucus (D),2014,Real Estate,150779,28650,179429
B000243,N00004643,Max Baucus (D),2014,Pharmaceuticals/Health Products,35800,139268,175068
B000243,N00004643,Max Baucus (D),2014,Electric Utilities,9250,122750,132000
R000580,N00004719,Peter Roskam (R),2014,Securities & Investment,152100,113000,265100
R000580,N00004719,Peter Roskam (R),2014,Insurance,38550,216000,254550
R000580,N00004719,Peter Roskam (R),2014,Health Professionals,45300,145000,190300
R000580,N00004719,Peter Roskam (R),2014,Pharmaceuticals/Health Products,23050,143500,166550
R000580,N00004719,Peter Roskam (R),2014,Misc Manufacturing & Distributing,47400,66555,113955
R000580,N00004719,Peter Roskam (R),2014,Retired,113152,0,113152
R000580,N00004719,Peter Roskam (R),2014,Real Estate,47801,60500,108301
R000580,N00004719,Peter Roskam (R),2014,Food & Beverage,42450,58000,100450
R000580,N00004719,Peter Roskam (R),2014,Lawyers/Law Firms,52550,39650,92200
R000580,N00004719,Peter Roskam (R),2014,Oil & Gas,24250,64500,88750
S001145,N00004724,Jan Schakowsky (D),2014,Lawyers/Law Firms,128825,21000,149825
S001145,N00004724,Jan Schakowsky (D),2014,Health Professionals,15350,94000,109350
S001145,N00004724,Jan Schakowsky (D),2014,Retired,74950,0,74950
S001145,N00004724,Jan Schakowsky (D),2014,Women's Issues,71225,150,71375
S001145,N00004724,Jan Schakowsky (D),2014,Pro-Israel,65500,4950,70450
S001145,N00004724,Jan Schakowsky (D),2014,Industrial Unions,0,47600,47600
S001145,N00004724,Jan Schakowsky (D),2014,Business Services,43200,2500,45700
S001145,N00004724,Jan Schakowsky (D),2014,Public Sector Unions,550,34500,35050
S001145,N00004724,Jan Schakowsky (D),2014,Real Estate,20750,8000,28750
S001145,N00004724,Jan Schakowsky (D),2014,Misc Unions,0,26250,26250
G000535,N00004874,Luis V Gutierrez (D),2014,Building Trade Unions,0,22500,22500
G000535,N00004874,Luis V Gutierrez (D),2014,Accountants,0,19440,19440
G000535,N00004874,Luis V Gutierrez (D),2014,Misc Unions,0,17500,17500
G000535,N00004874,Luis V Gutierrez (D),2014,Public Sector Unions,0,13500,13500
G000535,N00004874,Luis V Gutierrez (D),2014,Hospitals/Nursing Homes,0,12500,12500
G000535,N00004874,Luis V Gutierrez (D),2014,Insurance,0,11000,11000
G000535,N00004874,Luis V Gutierrez (D),2014,Telephone Utilities,0,10500,10500
G000535,N00004874,Luis V Gutierrez (D),2014,Real Estate,2000,8000,10000
G000535,N00004874,Luis V Gutierrez (D),2014,Candidate Committees,0,10000,10000
G000535,N00004874,Luis V Gutierrez (D),2014,Securities & Investment,0,9000,9000
D000096,N00004884,Danny K Davis (D),2014,Insurance,250,49500,49750
D000096,N00004884,Danny K Davis (D),2014,Public Sector Unions,0,43500,43500
D000096,N00004884,Danny K Davis (D),2014,Pharmaceuticals/Health Products,0,39500,39500
D000096,N00004884,Danny K Davis (D),2014,Securities & Investment,0,24000,24000
D000096,N00004884,Danny K Davis (D),2014,Building Trade Unions,0,23500,23500
D000096,N00004884,Danny K Davis (D),2014,"Beer, Wine & Liquor",1000,21500,22500
D000096,N00004884,Danny K Davis (D),2014,Health Professionals,0,21500,21500
D000096,N00004884,Danny K Davis (D),2014,Electric Utilities,0,19000,19000
D000096,N00004884,Danny K Davis (D),2014,Lawyers/Law Firms,4000,14000,18000
D000096,N00004884,Danny K Davis (D),2014,Real Estate,300,15000,15300
R000515,N00004887,Bobby L Rush (D),2014,Electric Utilities,1000,41500,42500
R000515,N00004887,Bobby L Rush (D),2014,Telecom Services,500,34000,34500
R000515,N00004887,Bobby L Rush (D),2014,Building Trade Unions,0,23500,23500
R000515,N00004887,Bobby L Rush (D),2014,Health Professionals,0,22000,22000
R000515,N00004887,Bobby L Rush (D),2014,Public Sector Unions,0,21000,21000
R000515,N00004887,Bobby L Rush (D),2014,Telephone Utilities,0,20500,20500
R000515,N00004887,Bobby L Rush (D),2014,Railroads,0,20000,20000
R000515,N00004887,Bobby L Rush (D),2014,Industrial Unions,0,20000,20000
R000515,N00004887,Bobby L Rush (D),2014,Lawyers/Law Firms,2250,11000,13250
R000515,N00004887,Bobby L Rush (D),2014,Misc Energy,0,11000,11000
S000364,N00004961,John M Shimkus (R),2014,Health Professionals,2450,189500,191950
S000364,N00004961,John M Shimkus (R),2014,Pharmaceuticals/Health Products,3100,162100,165200
S000364,N00004961,John M Shimkus (R),2014,Electric Utilities,500,145500,146000
S000364,N00004961,John M Shimkus (R),2014,Oil & Gas,3000,109000,112000
S000364,N00004961,John M Shimkus (R),2014,Chemical & Related Manufacturing,2000,82499,84499
S000364,N00004961,John M Shimkus (R),2014,Insurance,1750,75500,77250
S000364,N00004961,John M Shimkus (R),2014,Lobbyists,60500,5500,66000
S000364,N00004961,John M Shimkus (R),2014,Crop Production & Basic Processing,14055,47000,61055
S000364,N00004961,John M Shimkus (R),2014,Misc Energy,9200,50500,59700
S000364,N00004961,John M Shimkus (R),2014,Telecom Services,0,56500,56500
D000563,N00004981,Dick Durbin (D),2014,Lawyers/Law Firms,1255172,112920,1368092
D000563,N00004981,Dick Durbin (D),2014,Securities & Investment,344800,41000,385800
D000563,N00004981,Dick Durbin (D),2014,Retired,321306,0,321306
D000563,N00004981,Dick Durbin (D),2014,Real Estate,245117,42500,287617
D000563,N00004981,Dick Durbin (D),2014,Lobbyists,252031,14500,266531
D000563,N00004981,Dick Durbin (D),2014,Health Professionals,107011,145700,252711
D000563,N00004981,Dick Durbin (D),2014,Defense Aerospace,191050,54999,246049
D000563,N00004981,Dick Durbin (D),2014,Insurance,93459,123000,216459
D000563,N00004981,Dick Durbin (D),2014,Pro-Israel,182040,25650,207690
D000563,N00004981,Dick Durbin (D),2014,Leadership PACs,0,183600,183600
B000575,N00005195,Roy Blunt (R),2014,Securities & Investment,902805,133200,1036005
B000575,N00005195,Roy Blunt (R),2014,Retired,692499,0,692499
B000575,N00005195,Roy Blunt (R),2014,Leadership PACs,0,643269,643269
B000575,N00005195,Roy Blunt (R),2014,Lawyers/Law Firms,400744,173488,574232
B000575,N00005195,Roy Blunt (R),2014,Real Estate,523535,47400,570935
B000575,N00005195,Roy Blunt (R),2014,Health Professionals,318330,200500,518830
B000575,N00005195,Roy Blunt (R),2014,Lobbyists,473380,10550,483930
B000575,N00005195,Roy Blunt (R),2014,Insurance,228634,239900,468534
B000575,N00005195,Roy Blunt (R),2014,Misc Manufacturing & Distributing,353450,91900,445350
B000575,N00005195,Roy Blunt (R),2014,Oil & Gas,246385,170750,417135
M000934,N00005282,Jerry Moran (R),2014,Crop Production & Basic Processing,189108,174470,363578
M000934,N00005282,Jerry Moran (R),2014,Health Professionals,124250,128647,252897
M000934,N00005282,Jerry Moran (R),2014,Leadership PACs,0,249500,249500
M000934,N00005282,Jerry Moran (R),2014,Agricultural Services/Products,58250,166199,224449
M000934,N00005282,Jerry Moran (R),2014,Securities & Investment,107600,99100,206700
M000934,N00005282,Jerry Moran (R),2014,Commercial Banks,135590,71000,206590
M000934,N00005282,Jerry Moran (R),2014,Retired,206107,0,206107
M000934,N00005282,Jerry Moran (R),2014,Lawyers/Law Firms,139256,57750,197006
M000934,N00005282,Jerry Moran (R),2014,Oil & Gas,137827,58500,196327
M000934,N00005282,Jerry Moran (R),2014,Insurance,68366,127800,196166
R000307,N00005285,Pat Roberts (R),2014,Leadership PACs,15600,467976,483576
R000307,N00005285,Pat Roberts (R),2014,Securities & Investment,227625,162250,389875
R000307,N00005285,Pat Roberts (R),2014,Oil & Gas,186500,198950,385450
R000307,N00005285,Pat Roberts (R),2014,Health Professionals,67468,240250,307718
R000307,N00005285,Pat Roberts (R),2014,Pharmaceuticals/Health Products,65900,230499,296399
R000307,N00005285,Pat Roberts (R),2014,Agricultural Services/Products,33550,253614,287164
R000307,N00005285,Pat Roberts (R),2014,Retired,275886,0,275886
R000307,N00005285,Pat Roberts (R),2014,Insurance,63500,208450,271950
R000307,N00005285,Pat Roberts (R),2014,Lawyers/Law Firms,125560,131537,257097
R000307,N00005285,Pat Roberts (R),2014,Lobbyists,238231,5000,243231
A000373,N00005293,Brad Ashford (D),2014,Leadership PACs,1500,86336,87836
A000373,N00005293,Brad Ashford (D),2014,Lawyers/Law Firms,67485,16500,83985
A000373,N00005293,Brad Ashford (D),2014,Retired,75355,0,75355
A000373,N00005293,Brad Ashford (D),2014,Candidate Committees,0,36097,36097
A000373,N00005293,Brad Ashford (D),2014,Public Sector Unions,250,35000,35250
A000373,N00005293,Brad Ashford (D),2014,Building Trade Unions,0,29500,29500
A000373,N00005293,Brad Ashford (D),2014,Health Professionals,24050,2500,26550
A000373,N00005293,Brad Ashford (D),2014,Real Estate,25850,0,25850
A000373,N00005293,Brad Ashford (D),2014,Transportation Unions,0,25000,25000
A000373,N00005293,Brad Ashford (D),2014,Education,24954,0,24954
T000459,N00005321,Lee Terry (R),2014,Leadership PACs,0,329500,329500
T000459,N00005321,Lee Terry (R),2014,Lawyers/Law Firms,83050,61250,144300
T000459,N00005321,Lee Terry (R),2014,Health Professionals,39846,88500,128346
T000459,N00005321,Lee Terry (R),2014,Electric Utilities,4777,108350,113127
T000459,N00005321,Lee Terry (R),2014,Telecom Services,15932,91500,107432
T000459,N00005321,Lee Terry (R),2014,Insurance,16050,82000,98050
T000459,N00005321,Lee Terry (R),2014,Oil & Gas,7575,88000,95575
T000459,N00005321,Lee Terry (R),2014,Pharmaceuticals/Health Products,6200,87000,93200
T000459,N00005321,Lee Terry (R),2014,Retired,91822,0,91822
T000459,N00005321,Lee Terry (R),2014,Candidate Committees,0,89407,89407
L000550,N00005395,Mary L Landrieu (D),2014,Lawyers/Law Firms,1574571,280432,1855003
L000550,N00005395,Mary L Landrieu (D),2014,Oil & Gas,565017,426366,991383
L000550,N00005395,Mary L Landrieu (D),2014,Retired,828245,0,828245
L000550,N00005395,Mary L Landrieu (D),2014,Leadership PACs,400,779800,780200
L000550,N00005395,Mary L Landrieu (D),2014,Lobbyists,534734,39043,573777
L000550,N00005395,Mary L Landrieu (D),2014,Electric Utilities,228249,310000,538249
L000550,N00005395,Mary L Landrieu (D),2014,Real Estate,455208,60500,515708
L000550,N00005395,Mary L Landrieu (D),2014,Securities & Investment,432224,78833,511057
L000550,N00005395,Mary L Landrieu (D),2014,Pro-Israel,241446,75579,317025
L000550,N00005395,Mary L Landrieu (D),2014,Business Services,248891,29098,277989
L000491,N00005559,Frank D Lucas (R),2014,Crop Production & Basic Processing,87799,134500,222299
L000491,N00005559,Frank D Lucas (R),2014,Agricultural Services/Products,5800,135000,140800
L000491,N00005559,Frank D Lucas (R),2014,Securities & Investment,2750,108000,110750
L000491,N00005559,Frank D Lucas (R),2014,Oil & Gas,29450,70500,99950
L000491,N00005559,Frank D Lucas (R),2014,Commercial Banks,28781,66100,94881
L000491,N00005559,Frank D Lucas (R),2014,Insurance,18998,51300,70298
L000491,N00005559,Frank D Lucas (R),2014,Dairy,1500,39250,40750
L000491,N00005559,Frank D Lucas (R),2014,Retail Sales,17000,20000,37000
L000491,N00005559,Frank D Lucas (R),2014,Lobbyists,34132,1000,35132
L000491,N00005559,Frank D Lucas (R),2014,Real Estate,6350,27500,33850
I000024,N00005582,James M Inhofe (R),2014,Oil & Gas,225650,247650,473300
I000024,N00005582,James M Inhofe (R),2014,Retired,253725,0,253725
I000024,N00005582,James M Inhofe (R),2014,Leadership PACs,3000,215927,218927
I000024,N00005582,James M Inhofe (R),2014,Electric Utilities,5250,143500,148750
I000024,N00005582,James M Inhofe (R),2014,Lobbyists,124881,10500,135381
I000024,N00005582,James M Inhofe (R),2014,Defense Aerospace,15750,110000,125750
I000024,N00005582,James M Inhofe (R),2014,Lawyers/Law Firms,62725,60625,123350
I000024,N00005582,James M Inhofe (R),2014,Real Estate,77885,26500,104385
I000024,N00005582,James M Inhofe (R),2014,Mining,48775,54000,102775
I000024,N00005582,James M Inhofe (R),2014,Commercial Banks,65607,27000,92607
C000560,N00005601,Tom Coburn (R),2014,Health Professionals,85072,113000,198072
C000560,N00005601,Tom Coburn (R),2014,Oil & Gas,67800,103000,170800
C000560,N00005601,Tom Coburn (R),2014,Leadership PACs,200,123708,123908
C000560,N00005601,Tom Coburn (R),2014,Insurance,8150,98500,106650
C000560,N00005601,Tom Coburn (R),2014,Pharmaceuticals/Health Products,3601,101000,104601
C000560,N00005601,Tom Coburn (R),2014,Securities & Investment,62750,29000,91750
C000560,N00005601,Tom Coburn (R),2014,Retired,91300,0,91300
C000560,N00005601,Tom Coburn (R),2014,Republican/Conservative,80150,2693,82843
C000560,N00005601,Tom Coburn (R),2014,Lobbyists,70350,9303,79653
C000560,N00005601,Tom Coburn (R),2014,Lawyers/Law Firms,40800,37910,78710
H000067,N00005645,Ralph Hall (R),2014,Leadership PACs,0,115217,115217
H000067,N00005645,Ralph Hall (R),2014,Candidate Committees,0,57500,57500
H000067,N00005645,Ralph Hall (R),2014,Lawyers/Law Firms,36150,14750,50900
H000067,N00005645,Ralph Hall (R),2014,Health Professionals,15850,33000,48850
H000067,N00005645,Ralph Hall (R),2014,Oil & Gas,7100,39000,46100
H000067,N00005645,Ralph Hall (R),2014,Retired,38550,0,38550
H000067,N00005645,Ralph Hall (R),2014,Defense Aerospace,0,35500,35500
H000067,N00005645,Ralph Hall (R),2014,Lobbyists,23228,2441,25669
H000067,N00005645,Ralph Hall (R),2014,Electric Utilities,3850,21000,24850
H000067,N00005645,Ralph Hall (R),2014,Commercial Banks,11750,10500,22250
B000213,N00005656,Joe Barton (R),2014,Oil & Gas,39400,95000,134400
B000213,N00005656,Joe Barton (R),2014,Electric Utilities,6000,95500,101500
B000213,N00005656,Joe Barton (R),2014,Health Professionals,25400,31500,56900
B000213,N00005656,Joe Barton (R),2014,Misc Manufacturing & Distributing,36250,7500,43750
B000213,N00005656,Joe Barton (R),2014,Telecom Services,3000,31000,34000
B000213,N00005656,Joe Barton (R),2014,Retail Sales,2500,29000,31500
B000213,N00005656,Joe Barton (R),2014,Automotive,3000,27500,30500
B000213,N00005656,Joe Barton (R),2014,Lawyers/Law Firms,7325,23125,30450
B000213,N00005656,Joe Barton (R),2014,Insurance,1000,27500,28500
B000213,N00005656,Joe Barton (R),2014,Misc Finance,25150,0,25150
S000250,N00005681,Pete Sessions (R),2014,Health Professionals,73700,143500,217200
S000250,N00005681,Pete Sessions (R),2014,Securities & Investment,103600,47000,150600
S000250,N00005681,Pete Sessions (R),2014,Oil & Gas,64650,70000,134650
S000250,N00005681,Pete Sessions (R),2014,Insurance,22400,104500,126900
S000250,N00005681,Pete Sessions (R),2014,Lawyers/Law Firms,77225,30600,107825
S000250,N00005681,Pete Sessions (R),2014,Real Estate,66650,33000,99650
S000250,N00005681,Pete Sessions (R),2014,Commercial Banks,6750,92500,99250
S000250,N00005681,Pete Sessions (R),2014,Misc Finance,61400,22000,83400
S000250,N00005681,Pete Sessions (R),2014,Finance/Credit Companies,35630,37000,72630
S000250,N00005681,Pete Sessions (R),2014,Automotive,32150,39500,71650
B001291,N00005736,Brian Babin (R),2014,Health Professionals,103826,79500,183326
B001291,N00005736,Brian Babin (R),2014,Leadership PACs,0,78076,78076
B001291,N00005736,Brian Babin (R),2014,Commercial Banks,39450,6750,46200
B001291,N00005736,Brian Babin (R),2014,Retired,43150,0,43150
B001291,N00005736,Brian Babin (R),2014,Oil & Gas,13050,25500,38550
B001291,N00005736,Brian Babin (R),2014,Real Estate,21550,11000,32550
B001291,N00005736,Brian Babin (R),2014,Food & Beverage,24600,2500,27100
B001291,N00005736,Brian Babin (R),2014,Lawyers/Law Firms,21800,3552,25352
B001291,N00005736,Brian Babin (R),2014,General Contractors,18000,5000,23000
B001291,N00005736,Brian Babin (R),2014,Construction Services,7615,15000,22615
J000032,N00005818,Sheila Jackson Lee (D),2014,Health Professionals,51450,3500,54950
J000032,N00005818,Sheila Jackson Lee (D),2014,Industrial Unions,0,26000,26000
J000032,N00005818,Sheila Jackson Lee (D),2014,Building Trade Unions,0,25000,25000
J000032,N00005818,Sheila Jackson Lee (D),2014,Misc Business,24200,0,24200
J000032,N00005818,Sheila Jackson Lee (D),2014,Education,23600,0,23600
J000032,N00005818,Sheila Jackson Lee (D),2014,Transportation Unions,0,19500,19500
J000032,N00005818,Sheila Jackson Lee (D),2014,Lawyers/Law Firms,15150,2500,17650
J000032,N00005818,Sheila Jackson Lee (D),2014,Real Estate,9700,7000,16700
J000032,N00005818,Sheila Jackson Lee (D),2014,Hospitals/Nursing Homes,5350,10000,15350
J000032,N00005818,Sheila Jackson Lee (D),2014,Securities & Investment,10000,5000,15000
J000032,N00005818,Sheila Jackson Lee (D),2014,Public Sector Unions,0,15000,15000
G000410,N00005870,Gene Green (D),2014,Health Professionals,14600,118500,133100
G000410,N00005870,Gene Green (D),2014,Oil & Gas,250,102100,102350
G000410,N00005870,Gene Green (D),2014,Pharmaceuticals/Health Products,5000,67044,72044
G000410,N00005870,Gene Green (D),2014,Chemical & Related Manufacturing,2800,53000,55800
G000410,N00005870,Gene Green (D),2014,Building Trade Unions,0,48500,48500
G000410,N00005870,Gene Green (D),2014,Electric Utilities,200,41750,41950
G000410,N00005870,Gene Green (D),2014,Lawyers/Law Firms,20750,21000,41750
G000410,N00005870,Gene Green (D),2014,Transportation Unions,0,40500,40500
G000410,N00005870,Gene Green (D),2014,Industrial Unions,0,38000,38000
G000410,N00005870,Gene Green (D),2014,Telecom Services,750,31500,32250
B000755,N00005883,Kevin Brady (R),2014,Oil & Gas,144150,166100,310250
B000755,N00005883,Kevin Brady (R),2014,Health Professionals,54567,210500,265067
B000755,N00005883,Kevin Brady (R),2014,Health Services/HMOs,37378,121700,159078
B000755,N00005883,Kevin Brady (R),2014,Insurance,10200,135000,145200
B000755,N00005883,Kevin Brady (R),2014,Real Estate,70374,59500,129874
B000755,N00005883,Kevin Brady (R),2014,Pharmaceuticals/Health Products,23200,103132,126332
B000755,N00005883,Kevin Brady (R),2014,Hospitals/Nursing Homes,43100,68100,111200
B000755,N00005883,Kevin Brady (R),2014,Lawyers/Law Firms,28050,56900,84950
B000755,N00005883,Kevin Brady (R),2014,Securities & Investment,30232,49500,79732
B000755,N00005883,Kevin Brady (R),2014,Misc Issues,74875,500,75375
S000937,N00005918,Steve Stockman (R),2014,Lawyers/Law Firms,14250,6000,20250
S000937,N00005918,Steve Stockman (R),2014,Oil & Gas,6350,13000,19350
S000937,N00005918,Steve Stockman (R),2014,General Contractors,16250,3000,19250
S000937,N00005918,Steve Stockman (R),2014,Misc Business,14400,0,14400
S000937,N00005918,Steve Stockman (R),2014,Construction Services,12650,0,12650
S000937,N00005918,Steve Stockman (R),2014,Real Estate,9000,2000,11000
S000937,N00005918,Steve Stockman (R),2014,Republican/Conservative,1500,8025,9525
S000937,N00005918,Steve Stockman (R),2014,Gun Rights,1000,8380,9380
S000937,N00005918,Steve Stockman (R),2014,Automotive,1750,6500,8250
S000937,N00005918,Steve Stockman (R),2014,Health Professionals,4500,3000,7500
H000636,N00006008,Ruben Hinojosa (D),2014,Health Professionals,61700,13000,74700
H000636,N00006008,Ruben Hinojosa (D),2014,Insurance,300,33500,33800
H000636,N00006008,Ruben Hinojosa (D),2014,Public Sector Unions,0,30500,30500
H000636,N00006008,Ruben Hinojosa (D),2014,Securities & Investment,13000,12500,25500
H000636,N00006008,Ruben Hinojosa (D),2014,Building Trade Unions,0,25000,25000
H000636,N00006008,Ruben Hinojosa (D),2014,"Beer, Wine & Liquor",10200,13000,23200
H000636,N00006008,Ruben Hinojosa (D),2014,Real Estate,500,21000,21500
H000636,N00006008,Ruben Hinojosa (D),2014,Crop Production & Basic Processing,0,20500,20500
H000636,N00006008,Ruben Hinojosa (D),2014,Telephone Utilities,0,19000,19000
H000636,N00006008,Ruben Hinojosa (D),2014,Lawyers/Law Firms,8350,7500,15850
D000399,N00006023,Lloyd Doggett (D),2014,Lawyers/Law Firms,142850,35500,178350
D000399,N00006023,Lloyd Doggett (D),2014,Retired,101550,0,101550
D000399,N00006023,Lloyd Doggett (D),2014,Health Professionals,12850,53000,65850
D000399,N00006023,Lloyd Doggett (D),2014,Building Trade Unions,0,56000,56000
D000399,N00006023,Lloyd Doggett (D),2014,Real Estate,18350,22500,40850
D000399,N00006023,Lloyd Doggett (D),2014,Industrial Unions,0,39000,39000
D000399,N00006023,Lloyd Doggett (D),2014,Public Sector Unions,0,32000,32000
D000399,N00006023,Lloyd Doggett (D),2014,Transportation Unions,0,31000,31000
D000399,N00006023,Lloyd Doggett (D),2014,Securities & Investment,17650,2500,20150
D000399,N00006023,Lloyd Doggett (D),2014,Education,18050,0,18050
T000238,N00006052,Mac Thornberry (R),2014,Defense Aerospace,87100,109500,196600
T000238,N00006052,Mac Thornberry (R),2014,Retired,102025,0,102025
T000238,N00006052,Mac Thornberry (R),2014,Livestock,65750,17650,83400
T000238,N00006052,Mac Thornberry (R),2014,Oil & Gas,65500,13000,78500
T000238,N00006052,Mac Thornberry (R),2014,Defense Electronics,1500,76500,78000
T000238,N00006052,Mac Thornberry (R),2014,Lobbyists,62035,6500,68535
T000238,N00006052,Mac Thornberry (R),2014,Misc Defense,750,59500,60250
T000238,N00006052,Mac Thornberry (R),2014,Crop Production & Basic Processing,20800,32500,53300
T000238,N00006052,Mac Thornberry (R),2014,Health Professionals,27550,17500,45050
T000238,N00006052,Mac Thornberry (R),2014,Commercial Banks,32650,8500,41150
D000197,N00006134,Diana DeGette (D),2014,Pharmaceuticals/Health Products,1500,111449,112949
D000197,N00006134,Diana DeGette (D),2014,Health Professionals,4250,101500,105750
D000197,N00006134,Diana DeGette (D),2014,Democratic/Liberal,84450,0,84450
D000197,N00006134,Diana DeGette (D),2014,Lawyers/Law Firms,30646,27500,58146
D000197,N00006134,Diana DeGette (D),2014,Telecom Services,0,46000,46000
D000197,N00006134,Diana DeGette (D),2014,Retired,40150,0,40150
D000197,N00006134,Diana DeGette (D),2014,Telephone Utilities,500,30500,31000
D000197,N00006134,Diana DeGette (D),2014,Building Trade Unions,0,27500,27500
D000197,N00006134,Diana DeGette (D),2014,Public Sector Unions,0,25750,25750
D000197,N00006134,Diana DeGette (D),2014,TV/Movies/Music,5750,18000,23750
B001261,N00006236,John A Barrasso (R),2014,Health Professionals,322643,228750,551393
B001261,N00006236,John A Barrasso (R),2014,Oil & Gas,180266,228900,409166
B001261,N00006236,John A Barrasso (R),2014,Pharmaceuticals/Health Products,63250,191000,254250
B001261,N00006236,John A Barrasso (R),2014,Securities & Investment,180600,72071,252671
B001261,N00006236,John A Barrasso (R),2014,Mining,160706,78000,238706
B001261,N00006236,John A Barrasso (R),2014,Electric Utilities,13750,220000,233750
B001261,N00006236,John A Barrasso (R),2014,Lobbyists,223758,6500,230258
B001261,N00006236,John A Barrasso (R),2014,Leadership PACs,0,220336,220336
B001261,N00006236,John A Barrasso (R),2014,Insurance,41000,125375,166375
B001261,N00006236,John A Barrasso (R),2014,Retired,102399,0,102399
E000285,N00006249,Mike Enzi (R),2014,Leadership PACs,0,300572,300572
E000285,N00006249,Mike Enzi (R),2014,Pharmaceuticals/Health Products,29350,244750,274100
E000285,N00006249,Mike Enzi (R),2014,Health Professionals,30950,206000,236950
E000285,N00006249,Mike Enzi (R),2014,Oil & Gas,43450,154833,198283
E000285,N00006249,Mike Enzi (R),2014,Securities & Investment,93200,101394,194594
E000285,N00006249,Mike Enzi (R),2014,Insurance,28500,150500,179000
E000285,N00006249,Mike Enzi (R),2014,Retail Sales,3850,107000,110850
E000285,N00006249,Mike Enzi (R),2014,Real Estate,34550,60000,94550
E000285,N00006249,Mike Enzi (R),2014,Health Services/HMOs,32200,59500,91700
E000285,N00006249,Mike Enzi (R),2014,Lobbyists,90642,500,91142
S001148,N00006263,Mike Simpson (R),2014,Leadership PACs,0,181384,181384
S001148,N00006263,Mike Simpson (R),2014,Electric Utilities,28044,135000,163044
S001148,N00006263,Mike Simpson (R),2014,Health Professionals,52100,91500,143600
S001148,N00006263,Mike Simpson (R),2014,Crop Production & Basic Processing,43050,69500,112550
S001148,N00006263,Mike Simpson (R),2014,Real Estate,63100,44490,107590
S001148,N00006263,Mike Simpson (R),2014,Lobbyists,100096,3000,103096
S001148,N00006263,Mike Simpson (R),2014,Oil & Gas,13500,76000,89500
S001148,N00006263,Mike Simpson (R),2014,Lawyers/Law Firms,29900,42350,72250
S001148,N00006263,Mike Simpson (R),2014,Casinos/Gambling,64800,1000,65800
S001148,N00006263,Mike Simpson (R),2014,Forestry & Forest Products,16442,42000,58442
C000880,N00006267,Mike Crapo (R),2014,Securities & Investment,185765,274750,460515
C000880,N00006267,Mike Crapo (R),2014,Insurance,56200,342500,398700
C000880,N00006267,Mike Crapo (R),2014,Leadership PACs,0,320984,320984
C000880,N00006267,Mike Crapo (R),2014,Lobbyists,189650,8500,198150
C000880,N00006267,Mike Crapo (R),2014,Finance/Credit Companies,43600,117700,161300
C000880,N00006267,Mike Crapo (R),2014,Real Estate,61525,98010,159535
C000880,N00006267,Mike Crapo (R),2014,Pharmaceuticals/Health Products,23200,134371,157571
C000880,N00006267,Mike Crapo (R),2014,Commercial Banks,28750,119500,148250
C000880,N00006267,Mike Crapo (R),2014,Health Services/HMOs,65550,73350,138900
C000880,N00006267,Mike Crapo (R),2014,Health Professionals,17894,104500,122394
P000099,N00006397,Ed Pastor (D),2014,Transportation Unions,0,35000,35000
P000099,N00006397,Ed Pastor (D),2014,Defense Aerospace,0,21500,21500
P000099,N00006397,Ed Pastor (D),2014,Electric Utilities,0,21500,21500
P000099,N00006397,Ed Pastor (D),2014,Air Transport,0,16000,16000
P000099,N00006397,Ed Pastor (D),2014,Lobbyists,15750,0,15750
P000099,N00006397,Ed Pastor (D),2014,Railroads,0,13000,13000
P000099,N00006397,Ed Pastor (D),2014,Public Sector Unions,0,13000,13000
P000099,N00006397,Ed Pastor (D),2014,Lawyers/Law Firms,3750,8250,12000
P000099,N00006397,Ed Pastor (D),2014,Casinos/Gambling,11700,0,11700
P000099,N00006397,Ed Pastor (D),2014,Construction Services,5000,6500,11500
F000448,N00006423,Trent Franks (R),2014,Defense Aerospace,750,35600,36350
F000448,N00006423,Trent Franks (R),2014,Telecom Services,2750,22600,25350
F000448,N00006423,Trent Franks (R),2014,Real Estate,16650,4000,20650
F000448,N00006423,Trent Franks (R),2014,Pro-Israel,11450,7100,18550
F000448,N00006423,Trent Franks (R),2014,Health Professionals,3000,15500,18500
F000448,N00006423,Trent Franks (R),2014,Defense Electronics,0,16000,16000
F000448,N00006423,Trent Franks (R),2014,Republican/Conservative,6750,8000,14750
F000448,N00006423,Trent Franks (R),2014,Retired,13850,0,13850
F000448,N00006423,Trent Franks (R),2014,Lawyers/Law Firms,10750,2500,13250
F000448,N00006423,Trent Franks (R),2014,Retail Sales,7850,5000,12850
M000303,N00006424,John McCain (R),2014,Retired,1127910,0,1127910
M000303,N00006424,John McCain (R),2014,Securities & Investment,542175,19000,561175
M000303,N00006424,John McCain (R),2014,Real Estate,393195,37600,430795
M000303,N00006424,John McCain (R),2014,Lawyers/Law Firms,293180,92501,385681
M000303,N00006424,John McCain (R),2014,Business Services,227719,15000,242719
M000303,N00006424,John McCain (R),2014,Leadership PACs,250,229200,229450
M000303,N00006424,John McCain (R),2014,Health Professionals,145229,75500,220729
M000303,N00006424,John McCain (R),2014,Misc Finance,192875,12500,205375
M000303,N00006424,John McCain (R),2014,Lobbyists,183576,5733,189309
M000303,N00006424,John McCain (R),2014,Electric Utilities,73400,111000,184400
S000018,N00006446,Matt Salmon (R),2014,Health Services/HMOs,31200,19500,50700
S000018,N00006446,Matt Salmon (R),2014,Real Estate,39500,4000,43500
S000018,N00006446,Matt Salmon (R),2014,Lawyers/Law Firms,23400,19250,42650
S000018,N00006446,Matt Salmon (R),2014,Retired,35450,0,35450
S000018,N00006446,Matt Salmon (R),2014,Health Professionals,4550,27000,31550
S000018,N00006446,Matt Salmon (R),2014,Lobbyists,21661,6000,27661
S000018,N00006446,Matt Salmon (R),2014,Education,7600,20000,27600
S000018,N00006446,Matt Salmon (R),2014,Pro-Israel,19450,6000,25450
S000018,N00006446,Matt Salmon (R),2014,Defense Aerospace,9050,15000,24050
S000018,N00006446,Matt Salmon (R),2014,Republican/Conservative,13500,10500,24000
S001183,N00006460,David Schweikert (R),2014,Retired,79950,0,79950
S001183,N00006460,David Schweikert (R),2014,Real Estate,65900,8000,73900
S001183,N00006460,David Schweikert (R),2014,Insurance,11300,23300,34600
S001183,N00006460,David Schweikert (R),2014,Lawyers/Law Firms,21834,12500,34334
S001183,N00006460,David Schweikert (R),2014,Health Professionals,11100,18500,29600
S001183,N00006460,David Schweikert (R),2014,Misc Manufacturing & Distributing,16000,12000,28000
S001183,N00006460,David Schweikert (R),2014,Casinos/Gambling,23500,0,23500
S001183,N00006460,David Schweikert (R),2014,Health Services/HMOs,14350,9000,23350
S001183,N00006460,David Schweikert (R),2014,Misc Finance,22500,0,22500
S001183,N00006460,David Schweikert (R),2014,Republican/Conservative,17300,4000,21300
U000039,N00006561,Tom Udall (D),2014,Lawyers/Law Firms,586956,86147,673103
U000039,N00006561,Tom Udall (D),2014,Retired,455219,0,455219
U000039,N00006561,Tom Udall (D),2014,Leadership PACs,0,299100,299100
U000039,N00006561,Tom Udall (D),2014,Securities & Investment,242622,31100,273722
U000039,N00006561,Tom Udall (D),2014,Real Estate,181805,25000,206805
U000039,N00006561,Tom Udall (D),2014,Oil & Gas,112263,93000,205263
U000039,N00006561,Tom Udall (D),2014,Lobbyists,186551,9300,195851
U000039,N00006561,Tom Udall (D),2014,Health Professionals,113640,58000,171640
U000039,N00006561,Tom Udall (D),2014,Environment,150351,20543,170894
U000039,N00006561,Tom Udall (D),2014,Casinos/Gambling,160718,1000,161718
R000486,N00006671,Lucille Roybal-Allard (D),2014,Building Trade Unions,0,41600,41600
R000486,N00006671,Lucille Roybal-Allard (D),2014,Public Sector Unions,0,38000,38000
R000486,N00006671,Lucille Roybal-Allard (D),2014,Transportation Unions,0,31500,31500
R000486,N00006671,Lucille Roybal-Allard (D),2014,Real Estate,22050,7000,29050
R000486,N00006671,Lucille Roybal-Allard (D),2014,Health Professionals,2050,23500,25550
R000486,N00006671,Lucille Roybal-Allard (D),2014,Industrial Unions,0,22000,22000
R000486,N00006671,Lucille Roybal-Allard (D),2014,Lobbyists,21736,0,21736
R000486,N00006671,Lucille Roybal-Allard (D),2014,Pharmaceuticals/Health Products,0,17500,17500
R000486,N00006671,Lucille Roybal-Allard (D),2014,Crop Production & Basic Processing,1000,15000,16000
R000486,N00006671,Lucille Roybal-Allard (D),2014,Misc Unions,0,15000,15000
R000486,N00006671,Lucille Roybal-Allard (D),2014,Lawyers/Law Firms,4000,11000,15000
W000187,N00006690,Maxine Waters (D),2014,Insurance,500,113500,114000
W000187,N00006690,Maxine Waters (D),2014,Securities & Investment,27600,76000,103600
W000187,N00006690,Maxine Waters (D),2014,Real Estate,15750,74490,90240
W000187,N00006690,Maxine Waters (D),2014,Commercial Banks,19350,27800,47150
W000187,N00006690,Maxine Waters (D),2014,Lawyers/Law Firms,21400,21000,42400
W000187,N00006690,Maxine Waters (D),2014,Misc Issues,41000,250,41250
W000187,N00006690,Maxine Waters (D),2014,Accountants,800,27330,28130
W000187,N00006690,Maxine Waters (D),2014,Industrial Unions,0,24000,24000
W000187,N00006690,Maxine Waters (D),2014,Credit Unions,0,21500,21500
W000187,N00006690,Maxine Waters (D),2014,Public Sector Unions,0,20750,20750
B000711,N00006692,Barbara Boxer (D),2014,Lawyers/Law Firms,1550441,110072,1660513
B000711,N00006692,Barbara Boxer (D),2014,Retired,1284320,0,1284320
B000711,N00006692,Barbara Boxer (D),2014,Women's Issues,1048926,23895,1072821
B000711,N00006692,Barbara Boxer (D),2014,TV/Movies/Music,652627,49300,701927
B000711,N00006692,Barbara Boxer (D),2014,Real Estate,442405,19681,462086
B000711,N00006692,Barbara Boxer (D),2014,Securities & Investment,407074,21300,428374
B000711,N00006692,Barbara Boxer (D),2014,Education,409914,1000,410914
B000711,N00006692,Barbara Boxer (D),2014,Health Professionals,336935,62650,399585
B000711,N00006692,Barbara Boxer (D),2014,Business Services,372550,6000,378550
B000711,N00006692,Barbara Boxer (D),2014,Electronics Mfg & Equip,267671,64883,332554
T000472,N00006701,Mark A Takano (D),2014,Lawyers/Law Firms,97343,11250,108593
T000472,N00006701,Mark A Takano (D),2014,Retired,89234,0,89234
T000472,N00006701,Mark A Takano (D),2014,Real Estate,49475,9500,58975
T000472,N00006701,Mark A Takano (D),2014,Public Sector Unions,1500,56500,58000
T000472,N00006701,Mark A Takano (D),2014,Building Trade Unions,0,56000,56000
T000472,N00006701,Mark A Takano (D),2014,Health Professionals,37975,15500,53475
T000472,N00006701,Mark A Takano (D),2014,Business Services,35000,0,35000
T000472,N00006701,Mark A Takano (D),2014,Industrial Unions,250,33000,33250
T000472,N00006701,Mark A Takano (D),2014,Human Rights,12225,19500,31725
T000472,N00006701,Mark A Takano (D),2014,Democratic/Liberal,30175,704,30879
N000179,N00006789,Grace Napolitano (D),2014,Transportation Unions,0,45500,45500
N000179,N00006789,Grace Napolitano (D),2014,Air Transport,0,29000,29000
N000179,N00006789,Grace Napolitano (D),2014,Building Trade Unions,0,27500,27500
N000179,N00006789,Grace Napolitano (D),2014,Lobbyists,19500,1500,21000
N000179,N00006789,Grace Napolitano (D),2014,Lawyers/Law Firms,4500,9250,13750
N000179,N00006789,Grace Napolitano (D),2014,Public Sector Unions,0,12500,12500
N000179,N00006789,Grace Napolitano (D),2014,Real Estate,3800,8000,11800
N000179,N00006789,Grace Napolitano (D),2014,Casinos/Gambling,10700,0,10700
N000179,N00006789,Grace Napolitano (D),2014,Crop Production & Basic Processing,0,10500,10500
N000179,N00006789,Grace Napolitano (D),2014,Sea Transport,0,10000,10000
N000179,N00006789,Grace Napolitano (D),2014,Railroads,0,10000,10000
H001063,N00006806,Janice Hahn (D),2014,Transportation Unions,0,92000,92000
H001063,N00006806,Janice Hahn (D),2014,Air Transport,0,49000,49000
H001063,N00006806,Janice Hahn (D),2014,Building Trade Unions,0,38500,38500
H001063,N00006806,Janice Hahn (D),2014,Lawyers/Law Firms,13500,21000,34500
H001063,N00006806,Janice Hahn (D),2014,Public Sector Unions,0,33000,33000
H001063,N00006806,Janice Hahn (D),2014,Sea Transport,8500,22500,31000
H001063,N00006806,Janice Hahn (D),2014,Railroads,0,29500,29500
H001063,N00006806,Janice Hahn (D),2014,Misc Unions,0,25750,25750
H001063,N00006806,Janice Hahn (D),2014,Lobbyists,23814,447,24261
H001063,N00006806,Janice Hahn (D),2014,Real Estate,9900,10000,19900
M001177,N00006863,Tom McClintock (R),2014,Retired,167875,0,167875
M001177,N00006863,Tom McClintock (R),2014,Republican/Conservative,70657,13600,84257
M001177,N00006863,Tom McClintock (R),2014,Real Estate,58024,2000,60024
M001177,N00006863,Tom McClintock (R),2014,Oil & Gas,14000,37000,51000
M001177,N00006863,Tom McClintock (R),2014,Crop Production & Basic Processing,26450,0,26450
M001177,N00006863,Tom McClintock (R),2014,Casinos/Gambling,25000,0,25000
M001177,N00006863,Tom McClintock (R),2014,Electronics Mfg & Equip,24250,0,24250
M001177,N00006863,Tom McClintock (R),2014,Insurance,14200,10000,24200
M001177,N00006863,Tom McClintock (R),2014,Securities & Investment,22450,0,22450
M001177,N00006863,Tom McClintock (R),2014,Printing & Publishing,22100,0,22100
M000508,N00006882,Buck Mckeon (R),2014,Defense Aerospace,24800,52000,76800
M000508,N00006882,Buck Mckeon (R),2014,Misc Defense,24400,28500,52900
M000508,N00006882,Buck Mckeon (R),2014,Defense Electronics,1300,28500,29800
M000508,N00006882,Buck Mckeon (R),2014,Air Transport,13700,5500,19200
M000508,N00006882,Buck Mckeon (R),2014,Lobbyists,15896,2000,17896
M000508,N00006882,Buck Mckeon (R),2014,Transportation Unions,0,15000,15000
M000508,N00006882,Buck Mckeon (R),2014,Food Processing & Sales,14700,0,14700
M000508,N00006882,Buck Mckeon (R),2014,General Contractors,0,13500,13500
M000508,N00006882,Buck Mckeon (R),2014,Health Professionals,1000,12350,13350
M000508,N00006882,Buck Mckeon (R),2014,Securities & Investment,2000,10500,12500
S000344,N00006897,Brad Sherman (D),2014,Real Estate,69250,46000,115250
S000344,N00006897,Brad Sherman (D),2014,Securities & Investment,30100,33500,63600
S000344,N00006897,Brad Sherman (D),2014,Accountants,17550,46000,63550
S000344,N00006897,Brad Sherman (D),2014,Lawyers/Law Firms,36925,24750,61675
S000344,N00006897,Brad Sherman (D),2014,Pro-Israel,44950,16000,60950
S000344,N00006897,Brad Sherman (D),2014,Building Trade Unions,0,56000,56000
S000344,N00006897,Brad Sherman (D),2014,TV/Movies/Music,45500,2000,47500
S000344,N00006897,Brad Sherman (D),2014,Insurance,0,46800,46800
S000344,N00006897,Brad Sherman (D),2014,Retired,42100,0,42100
S000344,N00006897,Brad Sherman (D),2014,Transportation Unions,0,40500,40500
M001139,N00006954,Gary Miller (R),2014,Misc Issues,101250,2300,103550
M001139,N00006954,Gary Miller (R),2014,Real Estate,54148,35000,89148
M001139,N00006954,Gary Miller (R),2014,Leadership PACs,0,73500,73500
M001139,N00006954,Gary Miller (R),2014,Insurance,10192,58400,68592
M001139,N00006954,Gary Miller (R),2014,Commercial Banks,2166,29500,31666
M001139,N00006954,Gary Miller (R),2014,Securities & Investment,3000,28500,31500
M001139,N00006954,Gary Miller (R),2014,Accountants,166,19801,19967
M001139,N00006954,Gary Miller (R),2014,Railroads,0,17500,17500
M001139,N00006954,Gary Miller (R),2014,Lawyers/Law Firms,10933,4500,15433
M001139,N00006954,Gary Miller (R),2014,Transportation Unions,0,14500,14500
I000056,N00007017,Darrell Issa (R),2014,Retired,244646,0,244646
I000056,N00007017,Darrell Issa (R),2014,Republican/Conservative,164387,7750,172137
I000056,N00007017,Darrell Issa (R),2014,Securities & Investment,81850,14000,95850
I000056,N00007017,Darrell Issa (R),2014,Lawyers/Law Firms,59775,32250,92025
I000056,N00007017,Darrell Issa (R),2014,Real Estate,76325,15500,91825
I000056,N00007017,Darrell Issa (R),2014,Health Professionals,61098,25000,86098
I000056,N00007017,Darrell Issa (R),2014,Oil & Gas,18600,61000,79600
I000056,N00007017,Darrell Issa (R),2014,Insurance,7500,45500,53000
I000056,N00007017,Darrell Issa (R),2014,Electronics Mfg & Equip,9400,41860,51260
I000056,N00007017,Darrell Issa (R),2014,Telecom Services,18400,25500,43900
V000130,N00007021,Juan Vargas (D),2014,Insurance,1000,89700,90700
V000130,N00007021,Juan Vargas (D),2014,Securities & Investment,9200,32250,41450
V000130,N00007021,Juan Vargas (D),2014,Health Services/HMOs,10650,28000,38650
V000130,N00007021,Juan Vargas (D),2014,Real Estate,20900,12000,32900
V000130,N00007021,Juan Vargas (D),2014,Health Professionals,4300,27000,31300
V000130,N00007021,Juan Vargas (D),2014,Building Trade Unions,0,31000,31000
V000130,N00007021,Juan Vargas (D),2014,Commercial Banks,0,28500,28500
V000130,N00007021,Juan Vargas (D),2014,Public Sector Unions,0,28500,28500
V000130,N00007021,Juan Vargas (D),2014,Defense Aerospace,500,25500,26000
V000130,N00007021,Juan Vargas (D),2014,Retail Sales,23400,1000,24400
C000059,N00007099,Ken Calvert (R),2014,Casinos/Gambling,87450,0,87450
C000059,N00007099,Ken Calvert (R),2014,Lobbyists,59508,11988,71496
C000059,N00007099,Ken Calvert (R),2014,Defense Electronics,4500,46500,51000
C000059,N00007099,Ken Calvert (R),2014,Crop Production & Basic Processing,18200,25100,43300
C000059,N00007099,Ken Calvert (R),2014,Defense Aerospace,500,42000,42500
C000059,N00007099,Ken Calvert (R),2014,Electric Utilities,0,41500,41500
C000059,N00007099,Ken Calvert (R),2014,Building Materials & Equipment,23650,11500,35150
C000059,N00007099,Ken Calvert (R),2014,Real Estate,14550,20500,35050
C000059,N00007099,Ken Calvert (R),2014,Oil & Gas,1000,34000,35000
C000059,N00007099,Ken Calvert (R),2014,Construction Services,9375,24500,33875
R000409,N00007151,Dana Rohrabacher (R),2014,Retired,85300,0,85300
R000409,N00007151,Dana Rohrabacher (R),2014,Real Estate,65950,4000,69950
R000409,N00007151,Dana Rohrabacher (R),2014,Lawyers/Law Firms,38750,1500,40250
R000409,N00007151,Dana Rohrabacher (R),2014,Securities & Investment,35682,0,35682
R000409,N00007151,Dana Rohrabacher (R),2014,Health Professionals,12700,12500,25200
R000409,N00007151,Dana Rohrabacher (R),2014,Misc Manufacturing & Distributing,24100,0,24100
R000409,N00007151,Dana Rohrabacher (R),2014,Air Transport,11600,10000,21600
R000409,N00007151,Dana Rohrabacher (R),2014,Pharmaceuticals/Health Products,20450,1000,21450
R000409,N00007151,Dana Rohrabacher (R),2014,Insurance,17800,1000,18800
R000409,N00007151,Dana Rohrabacher (R),2014,Misc Business,18450,0,18450
C001036,N00007232,Lois Capps (D),2014,Health Professionals,43134,194100,237234
C001036,N00007232,Lois Capps (D),2014,Retired,204764,0,204764
C001036,N00007232,Lois Capps (D),2014,Leadership PACs,0,168300,168300
C001036,N00007232,Lois Capps (D),2014,Lawyers/Law Firms,56600,27750,84350
C001036,N00007232,Lois Capps (D),2014,Candidate Committees,0,79250,79250
C001036,N00007232,Lois Capps (D),2014,Women's Issues,72690,6250,78940
C001036,N00007232,Lois Capps (D),2014,Public Sector Unions,500,66120,66620
C001036,N00007232,Lois Capps (D),2014,Democratic/Liberal,51225,13850,65075
C001036,N00007232,Lois Capps (D),2014,Pharmaceuticals/Health Products,2250,51800,54050
C001036,N00007232,Lois Capps (D),2014,TV/Movies/Music,38900,13000,51900
N000181,N00007248,Devin Nunes (R),2014,Crop Production & Basic Processing,161198,70200,231398
N000181,N00007248,Devin Nunes (R),2014,Insurance,11500,143500,155000
N000181,N00007248,Devin Nunes (R),2014,Health Professionals,13550,93600,107150
N000181,N00007248,Devin Nunes (R),2014,Pharmaceuticals/Health Products,2000,103000,105000
N000181,N00007248,Devin Nunes (R),2014,Securities & Investment,16000,61500,77500
N000181,N00007248,Devin Nunes (R),2014,Dairy,56998,15500,72498
N000181,N00007248,Devin Nunes (R),2014,Oil & Gas,0,68750,68750
N000181,N00007248,Devin Nunes (R),2014,Casinos/Gambling,61100,6000,67100
N000181,N00007248,Devin Nunes (R),2014,Electric Utilities,9250,56499,65749
N000181,N00007248,Devin Nunes (R),2014,Real Estate,12100,50200,62300
F000030,N00007312,Sam Farr (D),2014,Crop Production & Basic Processing,42290,65100,107390
F000030,N00007312,Sam Farr (D),2014,Health Professionals,10250,41500,51750
F000030,N00007312,Sam Farr (D),2014,Retired,43451,0,43451
F000030,N00007312,Sam Farr (D),2014,Lodging/Tourism,1750,33500,35250
F000030,N00007312,Sam Farr (D),2014,Agricultural Services/Products,6444,25500,31944
F000030,N00007312,Sam Farr (D),2014,Public Sector Unions,0,30000,30000
F000030,N00007312,Sam Farr (D),2014,"Beer, Wine & Liquor",13476,9042,22518
F000030,N00007312,Sam Farr (D),2014,Building Trade Unions,0,22500,22500
F000030,N00007312,Sam Farr (D),2014,Lawyers/Law Firms,5250,15000,20250
F000030,N00007312,Sam Farr (D),2014,Environment,11800,8350,20150
E000215,N00007335,Anna Eshoo (D),2014,Pharmaceuticals/Health Products,35200,166409,201609
E000215,N00007335,Anna Eshoo (D),2014,Telecom Services,5000,99600,104600
E000215,N00007335,Anna Eshoo (D),2014,Electronics Mfg & Equip,43300,59733,103033
E000215,N00007335,Anna Eshoo (D),2014,Securities & Investment,82550,11000,93550
E000215,N00007335,Anna Eshoo (D),2014,Health Professionals,27000,66500,93500
E000215,N00007335,Anna Eshoo (D),2014,Retired,81800,0,81800
E000215,N00007335,Anna Eshoo (D),2014,Internet,36950,36000,72950
E000215,N00007335,Anna Eshoo (D),2014,Lawyers/Law Firms,33782,29000,62782
E000215,N00007335,Anna Eshoo (D),2014,Telephone Utilities,0,51000,51000
E000215,N00007335,Anna Eshoo (D),2014,Lobbyists,41343,6000,47343
P000197,N00007360,Nancy Pelosi (D),2014,Health Professionals,19050,174000,193050
P000197,N00007360,Nancy Pelosi (D),2014,Real Estate,67650,47500,115150
P000197,N00007360,Nancy Pelosi (D),2014,Public Sector Unions,250,106000,106250
P000197,N00007360,Nancy Pelosi (D),2014,Securities & Investment,60550,44500,105050
P000197,N00007360,Nancy Pelosi (D),2014,Lawyers/Law Firms,57700,39500,97200
P000197,N00007360,Nancy Pelosi (D),2014,Retired,87871,0,87871
P000197,N00007360,Nancy Pelosi (D),2014,Women's Issues,64000,7500,71500
P000197,N00007360,Nancy Pelosi (D),2014,Insurance,5100,64200,69300
P000197,N00007360,Nancy Pelosi (D),2014,Non-Profit Institutions,57950,7500,65450
P000197,N00007360,Nancy Pelosi (D),2014,TV/Movies/Music,37845,22000,59845
F000062,N00007364,Dianne Feinstein (D),2014,Lawyers/Law Firms,436829,142500,579329
F000062,N00007364,Dianne Feinstein (D),2014,Retired,450058,0,450058
F000062,N00007364,Dianne Feinstein (D),2014,Crop Production & Basic Processing,262633,116499,379132
F000062,N00007364,Dianne Feinstein (D),2014,Securities & Investment,343057,26850,369907
F000062,N00007364,Dianne Feinstein (D),2014,Real Estate,325471,35000,360471
F000062,N00007364,Dianne Feinstein (D),2014,Lobbyists,315472,15874,331346
F000062,N00007364,Dianne Feinstein (D),2014,Electric Utilities,202800,91750,294550
F000062,N00007364,Dianne Feinstein (D),2014,TV/Movies/Music,197465,73400,270865
F000062,N00007364,Dianne Feinstein (D),2014,Women's Issues,201449,11000,212449
F000062,N00007364,Dianne Feinstein (D),2014,Electronics Mfg & Equip,87250,109789,197039
M000725,N00007390,George Miller (D),2014,Building Trade Unions,0,41100,41100
M000725,N00007390,George Miller (D),2014,Public Sector Unions,0,31500,31500
M000725,N00007390,George Miller (D),2014,Industrial Unions,375,27000,27375
M000725,N00007390,George Miller (D),2014,Lawyers/Law Firms,19675,5622,25297
M000725,N00007390,George Miller (D),2014,Securities & Investment,16050,4000,20050
M000725,N00007390,George Miller (D),2014,Retired,18575,0,18575
M000725,N00007390,George Miller (D),2014,Transportation Unions,0,14000,14000
M000725,N00007390,George Miller (D),2014,Misc Unions,0,11500,11500
M000725,N00007390,George Miller (D),2014,Insurance,2000,9000,11000
M000725,N00007390,George Miller (D),2014,Lobbyists,9500,0,9500
T000460,N00007419,Mike Thompson (D),2014,"Beer, Wine & Liquor",179981,33870,213851
T000460,N00007419,Mike Thompson (D),2014,Health Professionals,10705,180000,190705
T000460,N00007419,Mike Thompson (D),2014,Insurance,4500,133250,137750
T000460,N00007419,Mike Thompson (D),2014,Securities & Investment,10699,64500,75199
T000460,N00007419,Mike Thompson (D),2014,Pharmaceuticals/Health Products,0,73650,73650
T000460,N00007419,Mike Thompson (D),2014,Retail Sales,5450,57500,62950
T000460,N00007419,Mike Thompson (D),2014,Electric Utilities,500,53249,53749
T000460,N00007419,Mike Thompson (D),2014,Accountants,1000,46000,47000
T000460,N00007419,Mike Thompson (D),2014,Lawyers/Law Firms,20500,26000,46500
T000460,N00007419,Mike Thompson (D),2014,Crop Production & Basic Processing,6600,37250,43850
L000397,N00007479,Zoe Lofgren (D),2014,Electronics Mfg & Equip,49950,70250,120200
L000397,N00007479,Zoe Lofgren (D),2014,Internet,57650,39600,97250
L000397,N00007479,Zoe Lofgren (D),2014,Lawyers/Law Firms,79450,17100,96550
L000397,N00007479,Zoe Lofgren (D),2014,Retired,81905,0,81905
L000397,N00007479,Zoe Lofgren (D),2014,Securities & Investment,59400,10000,69400
L000397,N00007479,Zoe Lofgren (D),2014,Accountants,8350,35000,43350
L000397,N00007479,Zoe Lofgren (D),2014,Real Estate,24350,9000,33350
L000397,N00007479,Zoe Lofgren (D),2014,Telecom Services,3450,29500,32950
L000397,N00007479,Zoe Lofgren (D),2014,Crop Production & Basic Processing,9850,21000,30850
L000397,N00007479,Zoe Lofgren (D),2014,Lobbyists,26950,0,26950
F000010,N00007632,Eni F H Faleomavaega (D),2014,Food & Beverage,6500,0,6500
F000010,N00007632,Eni F H Faleomavaega (D),2014,Transportation Unions,0,5000,5000
F000010,N00007632,Eni F H Faleomavaega (D),2014,Lawyers/Law Firms,3000,1500,4500
F000010,N00007632,Eni F H Faleomavaega (D),2014,Civil Servants/Public Officials,3000,0,3000
F000010,N00007632,Eni F H Faleomavaega (D),2014,Misc Finance,2600,0,2600
F000010,N00007632,Eni F H Faleomavaega (D),2014,Sea Transport,2500,0,2500
F000010,N00007632,Eni F H Faleomavaega (D),2014,Hospitals/Nursing Homes,2000,0,2000
F000010,N00007632,Eni F H Faleomavaega (D),2014,Health Professionals,1000,0,1000
R000600,N00007635,Amata Coleman Radewagen (R),2014,Retired,3450,0,3450
R000600,N00007635,Amata Coleman Radewagen (R),2014,Misc Business,2800,0,2800
R000600,N00007635,Amata Coleman Radewagen (R),2014,Civil Servants/Public Officials,2500,0,2500
R000600,N00007635,Amata Coleman Radewagen (R),2014,Real Estate,600,0,600
R000600,N00007635,Amata Coleman Radewagen (R),2014,Lobbyists,500,0,500
R000600,N00007635,Amata Coleman Radewagen (R),2014,Health Professionals,500,0,500
R000600,N00007635,Amata Coleman Radewagen (R),2014,Lawyers/Law Firms,250,0,250
W000791,N00007690,Greg Walden (R),2014,Telecom Services,43600,140000,183600
W000791,N00007690,Greg Walden (R),2014,Health Professionals,25050,155500,180550
W000791,N00007690,Greg Walden (R),2014,TV/Movies/Music,89150,63757,152907
W000791,N00007690,Greg Walden (R),2014,Retired,134737,0,134737
W000791,N00007690,Greg Walden (R),2014,Electric Utilities,1950,124750,126700
W000791,N00007690,Greg Walden (R),2014,Pharmaceuticals/Health Products,16650,109348,125998
W000791,N00007690,Greg Walden (R),2014,Oil & Gas,10150,98500,108650
W000791,N00007690,Greg Walden (R),2014,Insurance,12000,91000,103000
W000791,N00007690,Greg Walden (R),2014,Lobbyists,95953,5000,100953
W000791,N00007690,Greg Walden (R),2014,Real Estate,29650,69000,98650
W000779,N00007724,Ron Wyden (D),2014,Lawyers/Law Firms,633625,202935,836560
W000779,N00007724,Ron Wyden (D),2014,Securities & Investment,551450,134500,685950
W000779,N00007724,Ron Wyden (D),2014,Health Professionals,315335,356055,671390
W000779,N00007724,Ron Wyden (D),2014,Hospitals/Nursing Homes,214725,174900,389625
W000779,N00007724,Ron Wyden (D),2014,Insurance,119450,264000,383450
W000779,N00007724,Ron Wyden (D),2014,Pharmaceuticals/Health Products,63711,295017,358728
W000779,N00007724,Ron Wyden (D),2014,Lobbyists,334444,13500,347944
W000779,N00007724,Ron Wyden (D),2014,Electric Utilities,63300,259750,323050
W000779,N00007724,Ron Wyden (D),2014,Real Estate,258690,61010,319700
W000779,N00007724,Ron Wyden (D),2014,Health Services/HMOs,107700,187650,295350
B000574,N00007727,Earl Blumenauer (D),2014,Health Professionals,500,104750,105250
B000574,N00007727,Earl Blumenauer (D),2014,Construction Services,20500,53000,73500
B000574,N00007727,Earl Blumenauer (D),2014,Railroads,11350,53600,64950
B000574,N00007727,Earl Blumenauer (D),2014,Transportation Unions,0,58500,58500
B000574,N00007727,Earl Blumenauer (D),2014,Insurance,6525,50500,57025
B000574,N00007727,Earl Blumenauer (D),2014,Misc Manufacturing & Distributing,27375,27500,54875
B000574,N00007727,Earl Blumenauer (D),2014,Public Sector Unions,0,50125,50125
B000574,N00007727,Earl Blumenauer (D),2014,Real Estate,15600,27500,43100
B000574,N00007727,Earl Blumenauer (D),2014,Lobbyists,39500,2231,41731
B000574,N00007727,Earl Blumenauer (D),2014,Building Trade Unions,0,38500,38500
D000191,N00007781,Peter DeFazio (D),2014,Air Transport,9750,70000,79750
D000191,N00007781,Peter DeFazio (D),2014,Transportation Unions,0,79000,79000
D000191,N00007781,Peter DeFazio (D),2014,Casinos/Gambling,58800,0,58800
D000191,N00007781,Peter DeFazio (D),2014,Building Materials & Equipment,10700,41500,52200
D000191,N00007781,Peter DeFazio (D),2014,Railroads,5950,44000,49950
D000191,N00007781,Peter DeFazio (D),2014,Building Trade Unions,0,47000,47000
D000191,N00007781,Peter DeFazio (D),2014,Retired,46965,0,46965
D000191,N00007781,Peter DeFazio (D),2014,Public Sector Unions,0,40500,40500
D000191,N00007781,Peter DeFazio (D),2014,Lobbyists,30250,4500,34750
D000191,N00007781,Peter DeFazio (D),2014,Lawyers/Law Firms,12487,21888,34375
S000510,N00007833,Adam Smith (D),2014,Defense Aerospace,31700,87000,118700
S000510,N00007833,Adam Smith (D),2014,Lawyers/Law Firms,27300,29500,56800
S000510,N00007833,Adam Smith (D),2014,Electronics Mfg & Equip,31900,22000,53900
S000510,N00007833,Adam Smith (D),2014,Defense Electronics,0,52500,52500
S000510,N00007833,Adam Smith (D),2014,Misc Defense,0,44000,44000
S000510,N00007833,Adam Smith (D),2014,Real Estate,29200,13500,42700
S000510,N00007833,Adam Smith (D),2014,Building Trade Unions,0,41000,41000
S000510,N00007833,Adam Smith (D),2014,Lobbyists,37078,2000,39078
S000510,N00007833,Adam Smith (D),2014,Pharmaceuticals/Health Products,3350,30000,33350
S000510,N00007833,Adam Smith (D),2014,Air Transport,0,32500,32500
C000127,N00007836,Maria Cantwell (D),2014,Lawyers/Law Firms,759909,10500,770409
C000127,N00007836,Maria Cantwell (D),2014,Retired,696466,0,696466
C000127,N00007836,Maria Cantwell (D),2014,Lobbyists,580332,250,580582
C000127,N00007836,Maria Cantwell (D),2014,Securities & Investment,354237,0,354237
C000127,N00007836,Maria Cantwell (D),2014,Casinos/Gambling,260950,0,260950
C000127,N00007836,Maria Cantwell (D),2014,Real Estate,236685,2500,239185
C000127,N00007836,Maria Cantwell (D),2014,Electronics Mfg & Equip,192949,3512,196461
C000127,N00007836,Maria Cantwell (D),2014,Business Services,196027,0,196027
C000127,N00007836,Maria Cantwell (D),2014,Health Professionals,182862,6750,189612
C000127,N00007836,Maria Cantwell (D),2014,Electric Utilities,131539,3750,135289
M001111,N00007876,Patty Murray (D),2014,Retired,894796,0,894796
M001111,N00007876,Patty Murray (D),2014,Lawyers/Law Firms,702118,137838,839956
M001111,N00007876,Patty Murray (D),2014,Lobbyists,578597,21987,600584
M001111,N00007876,Patty Murray (D),2014,Health Professionals,198708,287880,486588
M001111,N00007876,Patty Murray (D),2014,Electronics Mfg & Equip,351962,111998,463960
M001111,N00007876,Patty Murray (D),2014,Women's Issues,436608,18048,454656
M001111,N00007876,Patty Murray (D),2014,Leadership PACs,1000,335450,336450
M001111,N00007876,Patty Murray (D),2014,Securities & Investment,281215,52400,333615
M001111,N00007876,Patty Murray (D),2014,Pharmaceuticals/Health Products,91100,233450,324550
M001111,N00007876,Patty Murray (D),2014,Business Services,267123,39750,306873
J000174,N00008028,Sam Johnson (R),2014,Insurance,3600,83800,87400
J000174,N00008028,Sam Johnson (R),2014,Health Professionals,24200,40500,64700
J000174,N00008028,Sam Johnson (R),2014,Real Estate,31929,26200,58129
J000174,N00008028,Sam Johnson (R),2014,Retired,51000,0,51000
J000174,N00008028,Sam Johnson (R),2014,Oil & Gas,24850,20450,45300
J000174,N00008028,Sam Johnson (R),2014,Automotive,15450,18000,33450
J000174,N00008028,Sam Johnson (R),2014,Misc Finance,19450,9300,28750
J000174,N00008028,Sam Johnson (R),2014,Food & Beverage,8940,18700,27640
J000174,N00008028,Sam Johnson (R),2014,Securities & Investment,6100,21000,27100
J000174,N00008028,Sam Johnson (R),2014,Air Transport,750,22900,23650
L000551,N00008046,Barbara Lee (D),2014,Retired,56100,0,56100
L000551,N00008046,Barbara Lee (D),2014,Real Estate,43700,9000,52700
L000551,N00008046,Barbara Lee (D),2014,Lawyers/Law Firms,34900,17000,51900
L000551,N00008046,Barbara Lee (D),2014,Public Sector Unions,0,46500,46500
L000551,N00008046,Barbara Lee (D),2014,Business Services,45750,0,45750
L000551,N00008046,Barbara Lee (D),2014,Industrial Unions,3600,32000,35600
L000551,N00008046,Barbara Lee (D),2014,Health Professionals,15975,17500,33475
L000551,N00008046,Barbara Lee (D),2014,Building Trade Unions,0,27500,27500
L000551,N00008046,Barbara Lee (D),2014,Lobbyists,25050,0,25050
L000551,N00008046,Barbara Lee (D),2014,Democratic/Liberal,24769,250,25019
U000038,N00008051,Mark Udall (D),2014,Retired,1556968,0,1556968
U000038,N00008051,Mark Udall (D),2014,Lawyers/Law Firms,1356763,198052,1554815
U000038,N00008051,Mark Udall (D),2014,Securities & Investment,671473,74000,745473
U000038,N00008051,Mark Udall (D),2014,Environment,554631,55274,609905
U000038,N00008051,Mark Udall (D),2014,Lobbyists,576433,19440,595873
U000038,N00008051,Mark Udall (D),2014,Real Estate,515609,70500,586109
U000038,N00008051,Mark Udall (D),2014,Leadership PACs,2600,534200,536800
U000038,N00008051,Mark Udall (D),2014,Health Professionals,229162,109200,338362
U000038,N00008051,Mark Udall (D),2014,Pro-Israel,261830,70499,332329
U000038,N00008051,Mark Udall (D),2014,Education,310926,11500,322426
C000071,N00008086,Dave Camp (R),2014,Insurance,28650,136460,165110
C000071,N00008086,Dave Camp (R),2014,Health Professionals,8000,149000,157000
C000071,N00008086,Dave Camp (R),2014,Hospitals/Nursing Homes,35750,85000,120750
C000071,N00008086,Dave Camp (R),2014,Pharmaceuticals/Health Products,0,115500,115500
C000071,N00008086,Dave Camp (R),2014,Health Services/HMOs,9950,86000,95950
C000071,N00008086,Dave Camp (R),2014,Oil & Gas,8500,82499,90999
C000071,N00008086,Dave Camp (R),2014,Securities & Investment,16500,71500,88000
C000071,N00008086,Dave Camp (R),2014,Lobbyists,80300,0,80300
C000071,N00008086,Dave Camp (R),2014,Misc Manufacturing & Distributing,15700,56000,71700
C000071,N00008086,Dave Camp (R),2014,Misc Issues,67250,0,67250
B000013,N00008091,Spencer Bachus (R),2014,Real Estate,500,23500,24000
B000013,N00008091,Spencer Bachus (R),2014,Insurance,0,23500,23500
B000013,N00008091,Spencer Bachus (R),2014,Accountants,0,23000,23000
B000013,N00008091,Spencer Bachus (R),2014,Commercial Banks,1000,20500,21500
B000013,N00008091,Spencer Bachus (R),2014,Securities & Investment,1000,20500,21500
B000013,N00008091,Spencer Bachus (R),2014,Railroads,0,21000,21000
B000013,N00008091,Spencer Bachus (R),2014,Lawyers/Law Firms,1500,18500,20000
B000013,N00008091,Spencer Bachus (R),2014,Finance/Credit Companies,2500,11000,13500
B000013,N00008091,Spencer Bachus (R),2014,Retail Sales,0,13000,13000
B000013,N00008091,Spencer Bachus (R),2014,Lobbyists,10250,0,10250
J000126,N00008122,Eddie Bernice Johnson (D),2014,Transportation Unions,0,47500,47500
J000126,N00008122,Eddie Bernice Johnson (D),2014,Lawyers/Law Firms,27702,14250,41952
J000126,N00008122,Eddie Bernice Johnson (D),2014,Air Transport,0,40500,40500
J000126,N00008122,Eddie Bernice Johnson (D),2014,Railroads,0,36500,36500
J000126,N00008122,Eddie Bernice Johnson (D),2014,Industrial Unions,0,32000,32000
J000126,N00008122,Eddie Bernice Johnson (D),2014,Health Professionals,3300,21000,24300
J000126,N00008122,Eddie Bernice Johnson (D),2014,Building Trade Unions,0,22500,22500
J000126,N00008122,Eddie Bernice Johnson (D),2014,Public Sector Unions,0,19500,19500
J000126,N00008122,Eddie Bernice Johnson (D),2014,General Contractors,6700,7000,13700
J000126,N00008122,Eddie Bernice Johnson (D),2014,Telephone Utilities,0,13000,13000
R000487,N00008264,Ed Royce (R),2014,Insurance,22450,229150,251600
R000487,N00008264,Ed Royce (R),2014,Securities & Investment,108149,121500,229649
R000487,N00008264,Ed Royce (R),2014,Retired,208202,0,208202
R000487,N00008264,Ed Royce (R),2014,Real Estate,148591,57850,206441
R000487,N00008264,Ed Royce (R),2014,Pro-Israel,101500,47450,148950
R000487,N00008264,Ed Royce (R),2014,Health Professionals,95751,8300,104051
R000487,N00008264,Ed Royce (R),2014,Lawyers/Law Firms,64990,35879,100869
R000487,N00008264,Ed Royce (R),2014,Accountants,19150,54427,73577
R000487,N00008264,Ed Royce (R),2014,Misc Finance,46951,22000,68951
R000487,N00008264,Ed Royce (R),2014,Commercial Banks,10000,58000,68000
S000030,N00008274,Loretta Sanchez (D),2014,Lawyers/Law Firms,93078,29000,122078
S000030,N00008274,Loretta Sanchez (D),2014,Defense Aerospace,0,52500,52500
S000030,N00008274,Loretta Sanchez (D),2014,Building Trade Unions,0,49500,49500
S000030,N00008274,Loretta Sanchez (D),2014,Public Sector Unions,0,46200,46200
S000030,N00008274,Loretta Sanchez (D),2014,Health Professionals,40033,3000,43033
S000030,N00008274,Loretta Sanchez (D),2014,Real Estate,37940,4000,41940
S000030,N00008274,Loretta Sanchez (D),2014,Industrial Unions,0,38000,38000
S000030,N00008274,Loretta Sanchez (D),2014,Defense Electronics,0,36000,36000
S000030,N00008274,Loretta Sanchez (D),2014,Transportation Unions,0,31000,31000
S000030,N00008274,Loretta Sanchez (D),2014,Air Transport,10900,18000,28900
G000377,N00008799,Kay Granger (R),2014,Defense Aerospace,63350,59500,122850
G000377,N00008799,Kay Granger (R),2014,Real Estate,63750,23000,86750
G000377,N00008799,Kay Granger (R),2014,Oil & Gas,72700,11000,83700
G000377,N00008799,Kay Granger (R),2014,Retired,70150,0,70150
G000377,N00008799,Kay Granger (R),2014,Lawyers/Law Firms,28194,28000,56194
G000377,N00008799,Kay Granger (R),2014,Misc Manufacturing & Distributing,27150,19500,46650
G000377,N00008799,Kay Granger (R),2014,Defense Electronics,500,46000,46500
G000377,N00008799,Kay Granger (R),2014,Securities & Investment,35300,11000,46300
G000377,N00008799,Kay Granger (R),2014,Lobbyists,31599,3500,35099
G000377,N00008799,Kay Granger (R),2014,Air Transport,1000,33500,34500
G000289,N00009154,Bob Goodlatte (R),2014,TV/Movies/Music,105105,59504,164609
G000289,N00009154,Bob Goodlatte (R),2014,Lawyers/Law Firms,66200,60807,127007
G000289,N00009154,Bob Goodlatte (R),2014,Electronics Mfg & Equip,50800,75536,126336
G000289,N00009154,Bob Goodlatte (R),2014,Telecom Services,41700,77000,118700
G000289,N00009154,Bob Goodlatte (R),2014,Lobbyists,92649,2000,94649
G000289,N00009154,Bob Goodlatte (R),2014,Retired,72000,0,72000
G000289,N00009154,Bob Goodlatte (R),2014,Retail Sales,12200,59500,71700
G000289,N00009154,Bob Goodlatte (R),2014,Internet,20900,42300,63200
G000289,N00009154,Bob Goodlatte (R),2014,Food Processing & Sales,8250,46500,54750
G000289,N00009154,Bob Goodlatte (R),2014,Securities & Investment,25400,28000,53400
H000329,N00009157,Doc Hastings (R),2014,Oil & Gas,1500,53500,55000
H000329,N00009157,Doc Hastings (R),2014,Casinos/Gambling,28900,0,28900
H000329,N00009157,Doc Hastings (R),2014,Forestry & Forest Products,10750,12750,23500
H000329,N00009157,Doc Hastings (R),2014,Crop Production & Basic Processing,14350,8000,22350
H000329,N00009157,Doc Hastings (R),2014,Retired,20058,0,20058
H000329,N00009157,Doc Hastings (R),2014,Electronics Mfg & Equip,500,19500,20000
H000329,N00009157,Doc Hastings (R),2014,Lawyers/Law Firms,4500,12500,17000
H000329,N00009157,Doc Hastings (R),2014,Mining,3800,8000,11800
H000329,N00009157,Doc Hastings (R),2014,General Contractors,6750,4500,11250
H000329,N00009157,Doc Hastings (R),2014,Electric Utilities,1000,10100,11100
F000444,N00009573,Jeff Flake (R),2014,Republican/Conservative,1261837,61567,1323404
F000444,N00009573,Jeff Flake (R),2014,Retired,646343,0,646343
F000444,N00009573,Jeff Flake (R),2014,Securities & Investment,330129,15000,345129
F000444,N00009573,Jeff Flake (R),2014,Real Estate,311947,20500,332447
F000444,N00009573,Jeff Flake (R),2014,Leadership PACs,0,328868,328868
F000444,N00009573,Jeff Flake (R),2014,Misc Finance,215022,2500,217522
F000444,N00009573,Jeff Flake (R),2014,Lawyers/Law Firms,168452,42250,210702
F000444,N00009573,Jeff Flake (R),2014,Mining,129602,54000,183602
F000444,N00009573,Jeff Flake (R),2014,Health Professionals,135057,46500,181557
F000444,N00009573,Jeff Flake (R),2014,Oil & Gas,70860,98500,169360
S001150,N00009585,Adam Schiff (D),2014,Lawyers/Law Firms,78300,19000,97300
S001150,N00009585,Adam Schiff (D),2014,Real Estate,46350,9000,55350
S001150,N00009585,Adam Schiff (D),2014,TV/Movies/Music,19950,33000,52950
S001150,N00009585,Adam Schiff (D),2014,Health Professionals,22650,22000,44650
S001150,N00009585,Adam Schiff (D),2014,Public Sector Unions,0,41000,41000
S001150,N00009585,Adam Schiff (D),2014,Retired,37600,0,37600
S001150,N00009585,Adam Schiff (D),2014,Building Trade Unions,0,33300,33300
S001150,N00009585,Adam Schiff (D),2014,Defense Aerospace,0,29000,29000
S001150,N00009585,Adam Schiff (D),2014,Pro-Israel,12900,13416,26316
S001150,N00009585,Adam Schiff (D),2014,Misc Manufacturing & Distributing,7450,14000,21450
D000598,N00009604,Susan A Davis (D),2014,Retired,41700,0,41700
D000598,N00009604,Susan A Davis (D),2014,Public Sector Unions,0,35250,35250
D000598,N00009604,Susan A Davis (D),2014,Electronics Mfg & Equip,9200,26000,35200
D000598,N00009604,Susan A Davis (D),2014,Pharmaceuticals/Health Products,2850,24500,27350
D000598,N00009604,Susan A Davis (D),2014,Misc Defense,9250,18000,27250
D000598,N00009604,Susan A Davis (D),2014,Defense Aerospace,0,26000,26000
D000598,N00009604,Susan A Davis (D),2014,Real Estate,10300,9500,19800
D000598,N00009604,Susan A Davis (D),2014,Defense Electronics,0,17500,17500
D000598,N00009604,Susan A Davis (D),2014,Lawyers/Law Firms,6600,10500,17100
D000598,N00009604,Susan A Davis (D),2014,Building Trade Unions,0,17000,17000
V000127,N00009659,David Vitter (R),2014,Oil & Gas,427750,229200,656950
V000127,N00009659,David Vitter (R),2014,Health Professionals,389176,79500,468676
V000127,N00009659,David Vitter (R),2014,Retired,406614,0,406614
V000127,N00009659,David Vitter (R),2014,Lawyers/Law Firms,263511,117499,381010
V000127,N00009659,David Vitter (R),2014,Real Estate,277400,50500,327900
V000127,N00009659,David Vitter (R),2014,Leadership PACs,0,286714,286714
V000127,N00009659,David Vitter (R),2014,Insurance,136525,122000,258525
V000127,N00009659,David Vitter (R),2014,Sea Transport,149324,87000,236324
V000127,N00009659,David Vitter (R),2014,General Contractors,192700,26000,218700
V000127,N00009659,David Vitter (R),2014,Securities & Investment,141890,75000,216890
S001176,N00009660,Steve Scalise (R),2014,Oil & Gas,73300,182474,255774
S001176,N00009660,Steve Scalise (R),2014,Health Professionals,14100,120500,134600
S001176,N00009660,Steve Scalise (R),2014,Insurance,24500,106200,130700
S001176,N00009660,Steve Scalise (R),2014,Electric Utilities,18500,90500,109000
S001176,N00009660,Steve Scalise (R),2014,Pharmaceuticals/Health Products,7700,98000,105700
S001176,N00009660,Steve Scalise (R),2014,Sea Transport,54349,49900,104249
S001176,N00009660,Steve Scalise (R),2014,Telecom Services,1500,93500,95000
S001176,N00009660,Steve Scalise (R),2014,Lobbyists,82350,2500,84850
S001176,N00009660,Steve Scalise (R),2014,Real Estate,43200,40000,83200
S001176,N00009660,Steve Scalise (R),2014,Securities & Investment,20400,48000,68400
R000572,N00009668,Mike Rogers (R),2014,Health Services/HMOs,24800,0,24800
R000572,N00009668,Mike Rogers (R),2014,Lobbyists,24500,0,24500
R000572,N00009668,Mike Rogers (R),2014,Real Estate,15600,0,15600
R000572,N00009668,Mike Rogers (R),2014,Retired,13100,0,13100
R000572,N00009668,Mike Rogers (R),2014,Chemical & Related Manufacturing,6100,0,6100
R000572,N00009668,Mike Rogers (R),2014,Misc Defense,6700,-1000,5700
R000572,N00009668,Mike Rogers (R),2014,Lawyers/Law Firms,5500,0,5500
R000572,N00009668,Mike Rogers (R),2014,Livestock,5200,0,5200
R000572,N00009668,Mike Rogers (R),2014,Securities & Investment,5100,0,5100
R000572,N00009668,Mike Rogers (R),2014,TV/Movies/Music,5100,0,5100
T000462,N00009699,Pat Tiberi (R),2014,Insurance,88600,239100,327700
T000462,N00009699,Pat Tiberi (R),2014,Real Estate,120832,74500,195332
T000462,N00009699,Pat Tiberi (R),2014,Securities & Investment,49136,119000,168136
T000462,N00009699,Pat Tiberi (R),2014,Pharmaceuticals/Health Products,7950,133200,141150
T000462,N00009699,Pat Tiberi (R),2014,Lawyers/Law Firms,73700,64700,138400
T000462,N00009699,Pat Tiberi (R),2014,Health Professionals,18150,99200,117350
T000462,N00009699,Pat Tiberi (R),2014,Commercial Banks,14550,83900,98450
T000462,N00009699,Pat Tiberi (R),2014,Electric Utilities,6050,84450,90500
T000462,N00009699,Pat Tiberi (R),2014,Oil & Gas,13850,73500,87350
T000462,N00009699,Pat Tiberi (R),2014,Misc Finance,56014,24100,80114
L000559,N00009724,Jim Langevin (D),2014,Health Professionals,22360,48500,70860
L000559,N00009724,Jim Langevin (D),2014,Building Trade Unions,0,64000,64000
L000559,N00009724,Jim Langevin (D),2014,Defense Aerospace,5200,56000,61200
L000559,N00009724,Jim Langevin (D),2014,Lawyers/Law Firms,45025,15750,60775
L000559,N00009724,Jim Langevin (D),2014,Defense Electronics,12350,36000,48350
L000559,N00009724,Jim Langevin (D),2014,Retired,39550,0,39550
L000559,N00009724,Jim Langevin (D),2014,Public Sector Unions,1250,38200,39450
L000559,N00009724,Jim Langevin (D),2014,Transportation Unions,0,33500,33500
L000559,N00009724,Jim Langevin (D),2014,Leadership PACs,0,29050,29050
L000559,N00009724,Jim Langevin (D),2014,Misc Defense,16200,11500,27700
C001048,N00009738,John Culberson (R),2014,Oil & Gas,24550,63500,88050
C001048,N00009738,John Culberson (R),2014,Retired,69250,0,69250
C001048,N00009738,John Culberson (R),2014,Real Estate,33350,16000,49350
C001048,N00009738,John Culberson (R),2014,Defense Aerospace,0,28000,28000
C001048,N00009738,John Culberson (R),2014,Misc Manufacturing & Distributing,11450,13500,24950
C001048,N00009738,John Culberson (R),2014,Lawyers/Law Firms,18300,6250,24550
C001048,N00009738,John Culberson (R),2014,Construction Services,13650,9000,22650
C001048,N00009738,John Culberson (R),2014,Air Transport,6100,16000,22100
C001048,N00009738,John Culberson (R),2014,Automotive,7600,14000,21600
C001048,N00009738,John Culberson (R),2014,Defense Electronics,0,18000,18000
M001142,N00009753,Jim Matheson (D),2014,Pharmaceuticals/Health Products,1000,108977,109977
M001142,N00009753,Jim Matheson (D),2014,Health Professionals,250,76000,76250
M001142,N00009753,Jim Matheson (D),2014,Health Services/HMOs,9950,39000,48950
M001142,N00009753,Jim Matheson (D),2014,Insurance,4750,39500,44250
M001142,N00009753,Jim Matheson (D),2014,Oil & Gas,1500,40000,41500
M001142,N00009753,Jim Matheson (D),2014,Electric Utilities,500,37000,37500
M001142,N00009753,Jim Matheson (D),2014,Securities & Investment,2600,22500,25100
M001142,N00009753,Jim Matheson (D),2014,Leadership PACs,0,23100,23100
M001142,N00009753,Jim Matheson (D),2014,Lobbyists,22500,0,22500
M001142,N00009753,Jim Matheson (D),2014,Commercial Banks,2750,19500,22250
L000560,N00009759,Rick Larsen (D),2014,Air Transport,1250,109000,110250
L000560,N00009759,Rick Larsen (D),2014,Transportation Unions,0,81000,81000
L000560,N00009759,Rick Larsen (D),2014,Sea Transport,15015,38000,53015
L000560,N00009759,Rick Larsen (D),2014,Defense Aerospace,2000,45500,47500
L000560,N00009759,Rick Larsen (D),2014,Health Professionals,10650,29000,39650
L000560,N00009759,Rick Larsen (D),2014,Railroads,2500,32000,34500
L000560,N00009759,Rick Larsen (D),2014,Oil & Gas,0,29500,29500
L000560,N00009759,Rick Larsen (D),2014,Lawyers/Law Firms,7750,20750,28500
L000560,N00009759,Rick Larsen (D),2014,Building Trade Unions,0,27500,27500
L000560,N00009759,Rick Larsen (D),2014,Securities & Investment,11200,16000,27200
C001047,N00009771,Shelley Moore Capito (R),2014,Securities & Investment,384415,51400,435815
C001047,N00009771,Shelley Moore Capito (R),2014,Retired,410186,0,410186
C001047,N00009771,Shelley Moore Capito (R),2014,Lawyers/Law Firms,291500,44513,336013
C001047,N00009771,Shelley Moore Capito (R),2014,Leadership PACs,0,330100,330100
C001047,N00009771,Shelley Moore Capito (R),2014,Mining,218874,83375,302249
C001047,N00009771,Shelley Moore Capito (R),2014,Oil & Gas,102866,162500,265366
C001047,N00009771,Shelley Moore Capito (R),2014,Commercial Banks,127175,125000,252175
C001047,N00009771,Shelley Moore Capito (R),2014,Insurance,77338,173600,250938
C001047,N00009771,Shelley Moore Capito (R),2014,Health Professionals,117566,104500,222066
C001047,N00009771,Shelley Moore Capito (R),2014,Real Estate,134178,51500,185678
B000287,N00009774,Xavier Becerra (D),2014,Health Professionals,29250,162500,191750
B000287,N00009774,Xavier Becerra (D),2014,Securities & Investment,44700,81500,126200
B000287,N00009774,Xavier Becerra (D),2014,Insurance,10200,102500,112700
B000287,N00009774,Xavier Becerra (D),2014,Lawyers/Law Firms,56910,41000,97910
B000287,N00009774,Xavier Becerra (D),2014,Real Estate,40950,44000,84950
B000287,N00009774,Xavier Becerra (D),2014,Pharmaceuticals/Health Products,5500,62000,67500
B000287,N00009774,Xavier Becerra (D),2014,Public Sector Unions,0,57500,57500
B000287,N00009774,Xavier Becerra (D),2014,Misc Issues,48500,5000,53500
B000287,N00009774,Xavier Becerra (D),2014,TV/Movies/Music,13700,38000,51700
B000287,N00009774,Xavier Becerra (D),2014,Casinos/Gambling,48700,0,48700
M001150,N00009795,Candice S Miller (R),2014,Air Transport,1250,58000,59250
M001150,N00009795,Candice S Miller (R),2014,Real Estate,33550,16555,50105
M001150,N00009795,Candice S Miller (R),2014,Automotive,24650,23000,47650
M001150,N00009795,Candice S Miller (R),2014,Transportation Unions,0,32000,32000
M001150,N00009795,Candice S Miller (R),2014,Railroads,0,32000,32000
M001150,N00009795,Candice S Miller (R),2014,Oil & Gas,3000,27500,30500
M001150,N00009795,Candice S Miller (R),2014,Electric Utilities,0,29000,29000
M001150,N00009795,Candice S Miller (R),2014,Leadership PACs,0,25553,25553
M001150,N00009795,Candice S Miller (R),2014,Crop Production & Basic Processing,0,25100,25100
M001150,N00009795,Candice S Miller (R),2014,Lawyers/Law Firms,10589,13250,23839
S000522,N00009816,Chris Smith (R),2014,Building Trade Unions,0,41000,41000
S000522,N00009816,Chris Smith (R),2014,Pro-Israel,16650,7000,23650
S000522,N00009816,Chris Smith (R),2014,Retired,21100,0,21100
S000522,N00009816,Chris Smith (R),2014,Lawyers/Law Firms,8650,9000,17650
S000522,N00009816,Chris Smith (R),2014,Public Sector Unions,0,15500,15500
S000522,N00009816,Chris Smith (R),2014,Transportation Unions,0,15500,15500
S000522,N00009816,Chris Smith (R),2014,Republican/Conservative,1800,12500,14300
S000522,N00009816,Chris Smith (R),2014,Health Professionals,3300,10500,13800
S000522,N00009816,Chris Smith (R),2014,Real Estate,5000,8000,13000
S000522,N00009816,Chris Smith (R),2014,Lobbyists,9250,3000,12250
M000404,N00009829,Jim McDermott (D),2014,Health Professionals,6850,101600,108450
M000404,N00009829,Jim McDermott (D),2014,Building Trade Unions,0,52500,52500
M000404,N00009829,Jim McDermott (D),2014,Public Sector Unions,0,30500,30500
M000404,N00009829,Jim McDermott (D),2014,Insurance,0,29500,29500
M000404,N00009829,Jim McDermott (D),2014,Retired,28400,0,28400
M000404,N00009829,Jim McDermott (D),2014,Industrial Unions,0,25000,25000
M000404,N00009829,Jim McDermott (D),2014,Lawyers/Law Firms,9750,13100,22850
M000404,N00009829,Jim McDermott (D),2014,Health Services/HMOs,750,22000,22750
M000404,N00009829,Jim McDermott (D),2014,Real Estate,3000,18500,21500
M000404,N00009829,Jim McDermott (D),2014,Misc Unions,250,17500,17750
H000338,N00009869,Orrin G Hatch (R),2014,Securities & Investment,1023375,215571,1238946
H000338,N00009869,Orrin G Hatch (R),2014,Pharmaceuticals/Health Products,282060,582941,865001
H000338,N00009869,Orrin G Hatch (R),2014,Insurance,142514,373674,516188
H000338,N00009869,Orrin G Hatch (R),2014,Lobbyists,492657,14154,506811
H000338,N00009869,Orrin G Hatch (R),2014,Lawyers/Law Firms,262975,222131,485106
H000338,N00009869,Orrin G Hatch (R),2014,Health Professionals,95465,359700,455165
H000338,N00009869,Orrin G Hatch (R),2014,Real Estate,325792,105900,431692
H000338,N00009869,Orrin G Hatch (R),2014,Oil & Gas,175650,236000,411650
H000338,N00009869,Orrin G Hatch (R),2014,Health Services/HMOs,161382,238500,399882
H000338,N00009869,Orrin G Hatch (R),2014,Leadership PACs,0,397378,397378
A000360,N00009888,Lamar Alexander (R),2014,Leadership PACs,0,307215,307215
A000360,N00009888,Lamar Alexander (R),2014,Pharmaceuticals/Health Products,32450,258100,290550
A000360,N00009888,Lamar Alexander (R),2014,Real Estate,218250,37000,255250
A000360,N00009888,Lamar Alexander (R),2014,Health Professionals,59150,193000,252150
A000360,N00009888,Lamar Alexander (R),2014,Securities & Investment,159150,89500,248650
A000360,N00009888,Lamar Alexander (R),2014,Retired,248065,0,248065
A000360,N00009888,Lamar Alexander (R),2014,Lawyers/Law Firms,125739,107488,233227
A000360,N00009888,Lamar Alexander (R),2014,Insurance,59600,150000,209600
A000360,N00009888,Lamar Alexander (R),2014,Hospitals/Nursing Homes,85000,109267,194267
A000360,N00009888,Lamar Alexander (R),2014,Education,112188,56400,168588
L000174,N00009918,Patrick Leahy (D),2014,Lawyers/Law Firms,527745,104030,631775
L000174,N00009918,Patrick Leahy (D),2014,TV/Movies/Music,304456,110800,415256
L000174,N00009918,Patrick Leahy (D),2014,Lobbyists,272900,8250,281150
L000174,N00009918,Patrick Leahy (D),2014,Electronics Mfg & Equip,106750,52170,158920
L000174,N00009918,Patrick Leahy (D),2014,Leadership PACs,0,152400,152400
L000174,N00009918,Patrick Leahy (D),2014,Securities & Investment,113600,17250,130850
L000174,N00009918,Patrick Leahy (D),2014,Public Sector Unions,0,87750,87750
L000174,N00009918,Patrick Leahy (D),2014,Retired,81500,0,81500
L000174,N00009918,Patrick Leahy (D),2014,Pro-Israel,48851,27711,76562
L000174,N00009918,Patrick Leahy (D),2014,Real Estate,58750,12000,70750
S000320,N00009920,Richard C Shelby (R),2014,Securities & Investment,461338,254400,715738
S000320,N00009920,Richard C Shelby (R),2014,Insurance,92800,269250,362050
S000320,N00009920,Richard C Shelby (R),2014,Lawyers/Law Firms,233050,121550,354600
S000320,N00009920,Richard C Shelby (R),2014,Real Estate,176700,109300,286000
S000320,N00009920,Richard C Shelby (R),2014,Finance/Credit Companies,161700,112000,273700
S000320,N00009920,Richard C Shelby (R),2014,Commercial Banks,85150,132600,217750
S000320,N00009920,Richard C Shelby (R),2014,Lobbyists,167489,5000,172489
S000320,N00009920,Richard C Shelby (R),2014,Misc Finance,126150,44500,170650
S000320,N00009920,Richard C Shelby (R),2014,Defense Aerospace,27700,136000,163700
S000320,N00009920,Richard C Shelby (R),2014,Leadership PACs,0,158000,158000
R000146,N00009922,Harry Reid (D),2014,Lawyers/Law Firms,3417451,332446,3749897
R000146,N00009922,Harry Reid (D),2014,Securities & Investment,1142568,160600,1303168
R000146,N00009922,Harry Reid (D),2014,Lobbyists,1060056,31563,1091619
R000146,N00009922,Harry Reid (D),2014,Health Professionals,495256,352300,847556
R000146,N00009922,Harry Reid (D),2014,Real Estate,704184,101860,806044
R000146,N00009922,Harry Reid (D),2014,Retired,760153,0,760153
R000146,N00009922,Harry Reid (D),2014,Business Services,496105,47000,543105
R000146,N00009922,Harry Reid (D),2014,TV/Movies/Music,423600,90500,514100
R000146,N00009922,Harry Reid (D),2014,Hospitals/Nursing Homes,290950,202950,493900
R000146,N00009922,Harry Reid (D),2014,Pharmaceuticals/Health Products,147058,334150,481208
N000032,N00009926,Bill Nelson (D),2014,Lawyers/Law Firms,2111281,198722,2310003
N000032,N00009926,Bill Nelson (D),2014,Retired,890753,0,890753
N000032,N00009926,Bill Nelson (D),2014,Real Estate,539936,56500,596436
N000032,N00009926,Bill Nelson (D),2014,Health Professionals,460332,63550,523882
N000032,N00009926,Bill Nelson (D),2014,Securities & Investment,458450,32000,490450
N000032,N00009926,Bill Nelson (D),2014,Lobbyists,428610,22356,450966
N000032,N00009926,Bill Nelson (D),2014,Hospitals/Nursing Homes,246430,139882,386312
N000032,N00009926,Bill Nelson (D),2014,Insurance,188658,149150,337808
N000032,N00009926,Bill Nelson (D),2014,Leadership PACs,0,336500,336500
N000032,N00009926,Bill Nelson (D),2014,Health Services/HMOs,102400,158762,261162
G000359,N00009975,Lindsey Graham (R),2014,Lawyers/Law Firms,955717,88250,1043967
G000359,N00009975,Lindsey Graham (R),2014,Securities & Investment,877001,48982,925983
G000359,N00009975,Lindsey Graham (R),2014,Retired,631405,0,631405
G000359,N00009975,Lindsey Graham (R),2014,Real Estate,506666,31750,538416
G000359,N00009975,Lindsey Graham (R),2014,Electric Utilities,158506,153250,311756
G000359,N00009975,Lindsey Graham (R),2014,Leadership PACs,0,305500,305500
G000359,N00009975,Lindsey Graham (R),2014,Pro-Israel,223150,61200,284350
G000359,N00009975,Lindsey Graham (R),2014,Health Professionals,186675,33000,219675
G000359,N00009975,Lindsey Graham (R),2014,Business Services,209310,8000,217310
G000359,N00009975,Lindsey Graham (R),2014,Lobbyists,205346,9500,214846
J000177,N00010084,Tim Johnson (D),2014,Insurance,38000,178000,216000
J000177,N00010084,Tim Johnson (D),2014,Securities & Investment,87050,114250,201300
J000177,N00010084,Tim Johnson (D),2014,Commercial Banks,85050,85500,170550
J000177,N00010084,Tim Johnson (D),2014,Finance/Credit Companies,70950,39500,110450
J000177,N00010084,Tim Johnson (D),2014,Lawyers/Law Firms,60790,30649,91439
J000177,N00010084,Tim Johnson (D),2014,Lobbyists,82250,2250,84500
J000177,N00010084,Tim Johnson (D),2014,Real Estate,44000,35999,79999
J000177,N00010084,Tim Johnson (D),2014,Health Professionals,12500,31000,43500
J000177,N00010084,Tim Johnson (D),2014,Misc Finance,29350,11500,40850
J000177,N00010084,Tim Johnson (D),2014,Oil & Gas,29900,6000,35900
L000566,N00012233,Robert E Latta (R),2014,Oil & Gas,26700,57000,83700
L000566,N00012233,Robert E Latta (R),2014,Telecom Services,11100,69500,80600
L000566,N00012233,Robert E Latta (R),2014,Pharmaceuticals/Health Products,6000,71000,77000
L000566,N00012233,Robert E Latta (R),2014,Retired,55250,0,55250
L000566,N00012233,Robert E Latta (R),2014,Electric Utilities,7900,43000,50900
L000566,N00012233,Robert E Latta (R),2014,Telephone Utilities,0,40500,40500
L000566,N00012233,Robert E Latta (R),2014,Insurance,15958,15000,30958
L000566,N00012233,Robert E Latta (R),2014,Chemical & Related Manufacturing,10800,19000,29800
L000566,N00012233,Robert E Latta (R),2014,Lobbyists,17870,7500,25370
L000566,N00012233,Robert E Latta (R),2014,Health Professionals,10500,14500,25000
C001049,N00012460,William L Clay Jr (D),2014,Public Sector Unions,0,40500,40500
C001049,N00012460,William L Clay Jr (D),2014,Industrial Unions,0,35500,35500
C001049,N00012460,William L Clay Jr (D),2014,Lawyers/Law Firms,13330,17000,30330
C001049,N00012460,William L Clay Jr (D),2014,Insurance,0,30000,30000
C001049,N00012460,William L Clay Jr (D),2014,Real Estate,2000,27500,29500
C001049,N00012460,William L Clay Jr (D),2014,Building Trade Unions,0,29000,29000
C001049,N00012460,William L Clay Jr (D),2014,Securities & Investment,2000,21500,23500
C001049,N00012460,William L Clay Jr (D),2014,Health Professionals,5750,13500,19250
C001049,N00012460,William L Clay Jr (D),2014,Automotive,0,16500,16500
C001049,N00012460,William L Clay Jr (D),2014,Finance/Credit Companies,0,16000,16000
C001049,N00012460,William L Clay Jr (D),2014,Transportation Unions,0,16000,16000
C000174,N00012508,Tom Carper (D),2014,Insurance,106920,295740,402660
C000174,N00012508,Tom Carper (D),2014,Securities & Investment,137690,210500,348190
C000174,N00012508,Tom Carper (D),2014,Lawyers/Law Firms,184095,124621,308716
C000174,N00012508,Tom Carper (D),2014,Lobbyists,213812,9220,223032
C000174,N00012508,Tom Carper (D),2014,Pharmaceuticals/Health Products,50950,166410,217360
C000174,N00012508,Tom Carper (D),2014,Commercial Banks,76920,103490,180410
C000174,N00012508,Tom Carper (D),2014,Chemical & Related Manufacturing,58287,111060,169347
C000174,N00012508,Tom Carper (D),2014,Health Professionals,24950,138820,163770
C000174,N00012508,Tom Carper (D),2014,Leadership PACs,0,162500,162500
C000174,N00012508,Tom Carper (D),2014,Retired,133470,0,133470
K000360,N00012539,Mark Kirk (R),2014,Securities & Investment,2146636,129900,2276536
K000360,N00012539,Mark Kirk (R),2014,Retired,1434530,0,1434530
K000360,N00012539,Mark Kirk (R),2014,Lawyers/Law Firms,803945,83639,887584
K000360,N00012539,Mark Kirk (R),2014,Pro-Israel,748492,127004,875496
K000360,N00012539,Mark Kirk (R),2014,Health Professionals,355288,357150,712438
K000360,N00012539,Mark Kirk (R),2014,Real Estate,601494,28300,629794
K000360,N00012539,Mark Kirk (R),2014,Misc Finance,493827,40000,533827
K000360,N00012539,Mark Kirk (R),2014,Insurance,182989,234000,416989
K000360,N00012539,Mark Kirk (R),2014,Business Services,350688,26500,377188
K000360,N00012539,Mark Kirk (R),2014,Misc Manufacturing & Distributing,284299,83900,368199
M001189,N00012546,Luke Messer (R),2014,Insurance,20900,67500,88400
M001189,N00012546,Luke Messer (R),2014,Securities & Investment,29850,42500,72350
M001189,N00012546,Luke Messer (R),2014,Lawyers/Law Firms,48410,12750,61160
M001189,N00012546,Luke Messer (R),2014,Real Estate,26910,33500,60410
M001189,N00012546,Luke Messer (R),2014,Commercial Banks,14900,39600,54500
M001189,N00012546,Luke Messer (R),2014,Misc Manufacturing & Distributing,25350,22476,47826
M001189,N00012546,Luke Messer (R),2014,Building Materials & Equipment,30400,15500,45900
M001189,N00012546,Luke Messer (R),2014,Pharmaceuticals/Health Products,19925,25750,45675
M001189,N00012546,Luke Messer (R),2014,Leadership PACs,0,38708,38708
M001189,N00012546,Luke Messer (R),2014,Health Professionals,11800,25000,36800
H001034,N00012611,Mike Honda (D),2014,Retired,257802,0,257802
H001034,N00012611,Mike Honda (D),2014,Lawyers/Law Firms,138200,14950,153150
H001034,N00012611,Mike Honda (D),2014,Electronics Mfg & Equip,79950,50340,130290
H001034,N00012611,Mike Honda (D),2014,Leadership PACs,0,124100,124100
H001034,N00012611,Mike Honda (D),2014,Real Estate,110608,11000,121608
H001034,N00012611,Mike Honda (D),2014,Health Professionals,71160,42750,113910
H001034,N00012611,Mike Honda (D),2014,Human Rights,50351,41942,92293
H001034,N00012611,Mike Honda (D),2014,Public Sector Unions,1050,81500,82550
H001034,N00012611,Mike Honda (D),2014,Education,68140,0,68140
H001034,N00012611,Mike Honda (D),2014,Securities & Investment,66100,0,66100
P000588,N00012672,Steve Pearce (R),2014,Oil & Gas,206605,99700,306305
P000588,N00012672,Steve Pearce (R),2014,Retired,123615,0,123615
P000588,N00012672,Steve Pearce (R),2014,Livestock,69967,3500,73467
P000588,N00012672,Steve Pearce (R),2014,Commercial Banks,32899,38500,71399
P000588,N00012672,Steve Pearce (R),2014,Real Estate,42701,25500,68201
P000588,N00012672,Steve Pearce (R),2014,Insurance,14350,46500,60850
P000588,N00012672,Steve Pearce (R),2014,Accountants,15650,42000,57650
P000588,N00012672,Steve Pearce (R),2014,Crop Production & Basic Processing,37350,7500,44850
P000588,N00012672,Steve Pearce (R),2014,Casinos/Gambling,42300,0,42300
P000588,N00012672,Steve Pearce (R),2014,Retail Sales,39100,1500,40600
C001045,N00012739,Ander Crenshaw (R),2014,Defense Aerospace,33200,55500,88700
C001045,N00012739,Ander Crenshaw (R),2014,Defense Electronics,10100,68000,78100
C001045,N00012739,Ander Crenshaw (R),2014,Securities & Investment,14000,51500,65500
C001045,N00012739,Ander Crenshaw (R),2014,Insurance,7450,56000,63450
C001045,N00012739,Ander Crenshaw (R),2014,Lobbyists,56400,2070,58470
C001045,N00012739,Ander Crenshaw (R),2014,Real Estate,31700,21500,53200
C001045,N00012739,Ander Crenshaw (R),2014,Commercial Banks,750,48500,49250
C001045,N00012739,Ander Crenshaw (R),2014,Misc Defense,13600,29418,43018
C001045,N00012739,Ander Crenshaw (R),2014,Lawyers/Law Firms,8200,32250,40450
C001045,N00012739,Ander Crenshaw (R),2014,Misc Manufacturing & Distributing,2500,34100,36600
M001143,N00012942,Betty McCollum (D),2014,Casinos/Gambling,85100,2500,87600
M001143,N00012942,Betty McCollum (D),2014,Health Professionals,6700,45500,52200
M001143,N00012942,Betty McCollum (D),2014,Retired,48541,0,48541
M001143,N00012942,Betty McCollum (D),2014,Lawyers/Law Firms,16000,28850,44850
M001143,N00012942,Betty McCollum (D),2014,Building Trade Unions,0,40750,40750
M001143,N00012942,Betty McCollum (D),2014,Public Sector Unions,0,38000,38000
M001143,N00012942,Betty McCollum (D),2014,Industrial Unions,0,36750,36750
M001143,N00012942,Betty McCollum (D),2014,Transportation Unions,0,36250,36250
M001143,N00012942,Betty McCollum (D),2014,Real Estate,25350,9000,34350
M001143,N00012942,Betty McCollum (D),2014,Crop Production & Basic Processing,500,30000,30500
C001046,N00013131,Eric Cantor (R),2014,Securities & Investment,573725,73197,646922
C001046,N00013131,Eric Cantor (R),2014,Real Estate,355651,53000,408651
C001046,N00013131,Eric Cantor (R),2014,Insurance,80241,161900,242141
C001046,N00013131,Eric Cantor (R),2014,Leadership PACs,0,213397,213397
C001046,N00013131,Eric Cantor (R),2014,Lawyers/Law Firms,159131,52250,211381
C001046,N00013131,Eric Cantor (R),2014,Retired,203826,0,203826
C001046,N00013131,Eric Cantor (R),2014,Pro-Israel,174156,21625,195781
C001046,N00013131,Eric Cantor (R),2014,Health Professionals,45370,149525,194895
C001046,N00013131,Eric Cantor (R),2014,Lobbyists,162625,9500,172125
C001046,N00013131,Eric Cantor (R),2014,Oil & Gas,29065,118600,147665
G000546,N00013323,Sam Graves (R),2014,Air Transport,4850,99750,104600
G000546,N00013323,Sam Graves (R),2014,Trucking,6100,73000,79100
G000546,N00013323,Sam Graves (R),2014,Crop Production & Basic Processing,3550,49500,53050
G000546,N00013323,Sam Graves (R),2014,Agricultural Services/Products,7700,38500,46200
G000546,N00013323,Sam Graves (R),2014,Public Sector Unions,0,42500,42500
G000546,N00013323,Sam Graves (R),2014,Railroads,0,42000,42000
G000546,N00013323,Sam Graves (R),2014,Transportation Unions,0,40500,40500
G000546,N00013323,Sam Graves (R),2014,Building Materials & Equipment,5200,32500,37700
G000546,N00013323,Sam Graves (R),2014,Construction Services,750,32500,33250
G000546,N00013323,Sam Graves (R),2014,Automotive,3500,29500,33000
I000057,N00013345,Steve Israel (D),2014,Real Estate,315202,62500,377702
I000057,N00013345,Steve Israel (D),2014,Securities & Investment,218750,56500,275250
I000057,N00013345,Steve Israel (D),2014,Lawyers/Law Firms,127550,26250,153800
I000057,N00013345,Steve Israel (D),2014,Misc Manufacturing & Distributing,115950,25500,141450
I000057,N00013345,Steve Israel (D),2014,Health Professionals,44210,91850,136060
I000057,N00013345,Steve Israel (D),2014,Pharmaceuticals/Health Products,50900,61100,112000
I000057,N00013345,Steve Israel (D),2014,Business Services,111500,0,111500
I000057,N00013345,Steve Israel (D),2014,Insurance,23000,86000,109000
I000057,N00013345,Steve Israel (D),2014,Retired,90660,0,90660
I000057,N00013345,Steve Israel (D),2014,Public Sector Unions,0,79000,79000
S001154,N00013770,Bill Shuster (R),2014,Air Transport,124700,132000,256700
S001154,N00013770,Bill Shuster (R),2014,Construction Services,110375,115100,225475
S001154,N00013770,Bill Shuster (R),2014,Oil & Gas,33600,167798,201398
S001154,N00013770,Bill Shuster (R),2014,Building Materials & Equipment,82900,99100,182000
S001154,N00013770,Bill Shuster (R),2014,Lawyers/Law Firms,66500,107013,173513
S001154,N00013770,Bill Shuster (R),2014,General Contractors,124849,41700,166549
S001154,N00013770,Bill Shuster (R),2014,Lobbyists,129157,15990,145147
S001154,N00013770,Bill Shuster (R),2014,Railroads,64484,76000,140484
S001154,N00013770,Bill Shuster (R),2014,Trucking,40074,100000,140074
S001154,N00013770,Bill Shuster (R),2014,Sea Transport,33400,95000,128400
F000445,N00013799,Randy Forbes (R),2014,Retired,85220,0,85220
F000445,N00013799,Randy Forbes (R),2014,Misc Defense,40006,39500,79506
F000445,N00013799,Randy Forbes (R),2014,Real Estate,62375,8000,70375
F000445,N00013799,Randy Forbes (R),2014,Defense Aerospace,3000,61000,64000
F000445,N00013799,Randy Forbes (R),2014,Defense Electronics,7700,52000,59700
F000445,N00013799,Randy Forbes (R),2014,Lawyers/Law Firms,41953,2000,43953
F000445,N00013799,Randy Forbes (R),2014,General Contractors,31450,5000,36450
F000445,N00013799,Randy Forbes (R),2014,Health Professionals,30701,4500,35201
F000445,N00013799,Randy Forbes (R),2014,Electronics Mfg & Equip,18400,12680,31080
F000445,N00013799,Randy Forbes (R),2014,Commercial Banks,12650,18000,30650
P000597,N00013817,Chellie Pingree (D),2014,Retired,37400,0,37400
P000597,N00013817,Chellie Pingree (D),2014,Securities & Investment,20300,0,20300
P000597,N00013817,Chellie Pingree (D),2014,Public Sector Unions,0,18000,18000
P000597,N00013817,Chellie Pingree (D),2014,Education,15300,0,15300
P000597,N00013817,Chellie Pingree (D),2014,Business Services,12800,0,12800
P000597,N00013817,Chellie Pingree (D),2014,Environment,7950,3000,10950
P000597,N00013817,Chellie Pingree (D),2014,Real Estate,2750,8000,10750
P000597,N00013817,Chellie Pingree (D),2014,Industrial Unions,0,10000,10000
P000597,N00013817,Chellie Pingree (D),2014,Lawyers/Law Firms,9898,0,9898
P000597,N00013817,Chellie Pingree (D),2014,Abortion Policy/Pro-Abortion Rights,6100,2500,8600
V000128,N00013820,Chris Van Hollen (D),2014,Health Professionals,18450,90500,108950
V000128,N00013820,Chris Van Hollen (D),2014,Insurance,30900,68000,98900
V000128,N00013820,Chris Van Hollen (D),2014,Lawyers/Law Firms,65300,24318,89618
V000128,N00013820,Chris Van Hollen (D),2014,Public Sector Unions,0,82000,82000
V000128,N00013820,Chris Van Hollen (D),2014,Retired,67325,0,67325
V000128,N00013820,Chris Van Hollen (D),2014,Real Estate,18700,28500,47200
V000128,N00013820,Chris Van Hollen (D),2014,Defense Aerospace,500,34500,35000
V000128,N00013820,Chris Van Hollen (D),2014,Securities & Investment,9000,21000,30000
V000128,N00013820,Chris Van Hollen (D),2014,Building Trade Unions,0,28500,28500
V000128,N00013820,Chris Van Hollen (D),2014,Lodging/Tourism,11400,16000,27400
P000590,N00013823,Mark Pryor (D),2014,Lawyers/Law Firms,1225549,193542,1419091
P000590,N00013823,Mark Pryor (D),2014,Leadership PACs,13000,502349,515349
P000590,N00013823,Mark Pryor (D),2014,Lobbyists,458918,23676,482594
P000590,N00013823,Mark Pryor (D),2014,Retired,318428,0,318428
P000590,N00013823,Mark Pryor (D),2014,Real Estate,249258,49500,298758
P000590,N00013823,Mark Pryor (D),2014,Telecom Services,134150,160750,294900
P000590,N00013823,Mark Pryor (D),2014,Securities & Investment,243225,48600,291825
P000590,N00013823,Mark Pryor (D),2014,Health Professionals,170812,105500,276312
P000590,N00013823,Mark Pryor (D),2014,Oil & Gas,140719,112500,253219
P000590,N00013823,Mark Pryor (D),2014,Crop Production & Basic Processing,130233,104000,234233
M001144,N00013846,Jeff Miller (R),2014,Defense Aerospace,2000,59000,61000
M001144,N00013846,Jeff Miller (R),2014,Defense Electronics,0,42600,42600
M001144,N00013846,Jeff Miller (R),2014,Health Professionals,2550,31000,33550
M001144,N00013846,Jeff Miller (R),2014,Misc Defense,500,29500,30000
M001144,N00013846,Jeff Miller (R),2014,Pharmaceuticals/Health Products,9700,19200,28900
M001144,N00013846,Jeff Miller (R),2014,Education,11000,16500,27500
M001144,N00013846,Jeff Miller (R),2014,Electric Utilities,2500,19250,21750
M001144,N00013846,Jeff Miller (R),2014,Lobbyists,15984,2500,18484
M001144,N00013846,Jeff Miller (R),2014,Retired,16400,0,16400
M001144,N00013846,Jeff Miller (R),2014,Commercial Banks,2250,13000,15250
L000562,N00013855,Stephen F Lynch (D),2014,Lawyers/Law Firms,215120,16500,231620
L000562,N00013855,Stephen F Lynch (D),2014,Real Estate,177219,15000,192219
L000562,N00013855,Stephen F Lynch (D),2014,General Contractors,86200,5500,91700
L000562,N00013855,Stephen F Lynch (D),2014,Building Trade Unions,13800,76500,90300
L000562,N00013855,Stephen F Lynch (D),2014,Securities & Investment,42375,43100,85475
L000562,N00013855,Stephen F Lynch (D),2014,Retired,68905,0,68905
L000562,N00013855,Stephen F Lynch (D),2014,Special Trade Contractors,53450,14000,67450
L000562,N00013855,Stephen F Lynch (D),2014,Insurance,26300,40500,66800
L000562,N00013855,Stephen F Lynch (D),2014,Civil Servants/Public Officials,53900,0,53900
L000562,N00013855,Stephen F Lynch (D),2014,Transportation Unions,0,46000,46000
B001236,N00013873,John Boozman (R),2014,Retired,317326,0,317326
B001236,N00013873,John Boozman (R),2014,Health Professionals,219714,64000,283714
B001236,N00013873,John Boozman (R),2014,Leadership PACs,0,247536,247536
B001236,N00013873,John Boozman (R),2014,Securities & Investment,210729,20000,230729
B001236,N00013873,John Boozman (R),2014,Real Estate,94748,9500,104248
B001236,N00013873,John Boozman (R),2014,Retail Sales,77900,26000,103900
B001236,N00013873,John Boozman (R),2014,Oil & Gas,67502,30000,97502
B001236,N00013873,John Boozman (R),2014,Commercial Banks,65230,30500,95730
B001236,N00013873,John Boozman (R),2014,Lawyers/Law Firms,65541,26798,92339
B001236,N00013873,John Boozman (R),2014,Lobbyists,85443,918,86361
N000127,N00021207,Rick Nolan (D),2014,Leadership PACs,11750,178447,190197
N000127,N00021207,Rick Nolan (D),2014,Retired,135185,0,135185
N000127,N00021207,Rick Nolan (D),2014,Lawyers/Law Firms,70350,27662,98012
N000127,N00021207,Rick Nolan (D),2014,Public Sector Unions,0,76000,76000
N000127,N00021207,Rick Nolan (D),2014,Candidate Committees,0,75000,75000
N000127,N00021207,Rick Nolan (D),2014,Building Trade Unions,250,74100,74350
N000127,N00021207,Rick Nolan (D),2014,Transportation Unions,250,71650,71900
N000127,N00021207,Rick Nolan (D),2014,Democratic/Liberal,35421,18833,54254
N000127,N00021207,Rick Nolan (D),2014,Securities & Investment,44800,6000,50800
N000127,N00021207,Rick Nolan (D),2014,Industrial Unions,2000,45000,47000
C001077,N00024753,Mike Coffman (R),2014,Retired,515142,0,515142
C001077,N00024753,Mike Coffman (R),2014,Leadership PACs,0,396930,396930
C001077,N00024753,Mike Coffman (R),2014,Oil & Gas,190650,116600,307250
C001077,N00024753,Mike Coffman (R),2014,Real Estate,227246,26000,253246
C001077,N00024753,Mike Coffman (R),2014,Securities & Investment,148872,16500,165372
C001077,N00024753,Mike Coffman (R),2014,Lawyers/Law Firms,127511,13680,141191
C001077,N00024753,Mike Coffman (R),2014,Health Professionals,34300,76500,110800
C001077,N00024753,Mike Coffman (R),2014,Candidate Committees,0,93619,93619
C001077,N00024753,Mike Coffman (R),2014,Republican/Conservative,66518,24600,91118
C001077,N00024753,Mike Coffman (R),2014,Commercial Banks,59882,23500,83382
R000575,N00024759,Mike D Rogers (R),2014,Defense Aerospace,1000,83499,84499
R000575,N00024759,Mike D Rogers (R),2014,Health Professionals,37250,36000,73250
R000575,N00024759,Mike D Rogers (R),2014,Crop Production & Basic Processing,2750,50000,52750
R000575,N00024759,Mike D Rogers (R),2014,Lawyers/Law Firms,18250,26750,45000
R000575,N00024759,Mike D Rogers (R),2014,Insurance,6500,38200,44700
R000575,N00024759,Mike D Rogers (R),2014,Defense Electronics,1250,37500,38750
R000575,N00024759,Mike D Rogers (R),2014,General Contractors,25250,5000,30250
R000575,N00024759,Mike D Rogers (R),2014,Electric Utilities,5350,24500,29850
R000575,N00024759,Mike D Rogers (R),2014,Real Estate,15350,13390,28740
R000575,N00024759,Mike D Rogers (R),2014,Agricultural Services/Products,2000,25500,27500
G000550,N00024760,Phil Gingrey (R),2014,Health Professionals,331850,93500,425350
G000550,N00024760,Phil Gingrey (R),2014,Retired,173325,0,173325
G000550,N00024760,Phil Gingrey (R),2014,Real Estate,66158,4890,71048
G000550,N00024760,Phil Gingrey (R),2014,Lawyers/Law Firms,60374,5000,65374
G000550,N00024760,Phil Gingrey (R),2014,Insurance,40150,14000,54150
G000550,N00024760,Phil Gingrey (R),2014,Securities & Investment,52000,0,52000
G000550,N00024760,Phil Gingrey (R),2014,Hospitals/Nursing Homes,45310,2500,47810
G000550,N00024760,Phil Gingrey (R),2014,Pharmaceuticals/Health Products,7450,38200,45650
G000550,N00024760,Phil Gingrey (R),2014,Automotive,32200,6000,38200
G000550,N00024760,Phil Gingrey (R),2014,Special Trade Contractors,34252,1000,35252
M001149,N00024770,Mike Michaud (D),2014,Health Professionals,0,20500,20500
M001149,N00024770,Mike Michaud (D),2014,Building Trade Unions,0,13000,13000
M001149,N00024770,Mike Michaud (D),2014,Transportation Unions,0,13000,13000
M001149,N00024770,Mike Michaud (D),2014,Insurance,0,10500,10500
M001149,N00024770,Mike Michaud (D),2014,Public Sector Unions,0,9500,9500
M001149,N00024770,Mike Michaud (D),2014,Crop Production & Basic Processing,0,9500,9500
M001149,N00024770,Mike Michaud (D),2014,Air Transport,0,8000,8000
M001149,N00024770,Mike Michaud (D),2014,Forestry & Forest Products,0,7500,7500
M001149,N00024770,Mike Michaud (D),2014,Lawyers/Law Firms,1500,5000,6500
M001149,N00024770,Mike Michaud (D),2014,Credit Unions,500,5000,5500
S001181,N00024790,Jeanne Shaheen (D),2014,Women's Issues,760879,34500,795379
S001181,N00024790,Jeanne Shaheen (D),2014,Lawyers/Law Firms,664270,117716,781986
S001181,N00024790,Jeanne Shaheen (D),2014,Retired,609573,0,609573
S001181,N00024790,Jeanne Shaheen (D),2014,Leadership PACs,0,470100,470100
S001181,N00024790,Jeanne Shaheen (D),2014,Real Estate,296568,50040,346608
S001181,N00024790,Jeanne Shaheen (D),2014,Securities & Investment,272641,48833,321474
S001181,N00024790,Jeanne Shaheen (D),2014,Lobbyists,278768,12000,290768
S001181,N00024790,Jeanne Shaheen (D),2014,TV/Movies/Music,213981,16500,230481
S001181,N00024790,Jeanne Shaheen (D),2014,Environment,181328,37735,219063
S001181,N00024790,Jeanne Shaheen (D),2014,Health Professionals,92315,111000,203315
W000795,N00024809,Joe Wilson (R),2014,Defense Aerospace,1000,76000,77000
W000795,N00024809,Joe Wilson (R),2014,Health Professionals,12751,37500,50251
W000795,N00024809,Joe Wilson (R),2014,Misc Defense,27000,21750,48750
W000795,N00024809,Joe Wilson (R),2014,Electric Utilities,9050,36000,45050
W000795,N00024809,Joe Wilson (R),2014,Lawyers/Law Firms,17350,15126,32476
W000795,N00024809,Joe Wilson (R),2014,General Contractors,10950,21500,32450
W000795,N00024809,Joe Wilson (R),2014,Retired,32228,0,32228
W000795,N00024809,Joe Wilson (R),2014,Real Estate,20050,10000,30050
W000795,N00024809,Joe Wilson (R),2014,Insurance,8300,18500,26800
W000795,N00024809,Joe Wilson (R),2014,Lobbyists,26200,0,26200
C001069,N00024842,Joe Courtney (D),2014,Lawyers/Law Firms,71837,13000,84837
C001069,N00024842,Joe Courtney (D),2014,Health Professionals,13151,71250,84401
C001069,N00024842,Joe Courtney (D),2014,Building Trade Unions,0,64000,64000
C001069,N00024842,Joe Courtney (D),2014,Public Sector Unions,0,63500,63500
C001069,N00024842,Joe Courtney (D),2014,Defense Aerospace,500,61500,62000
C001069,N00024842,Joe Courtney (D),2014,Insurance,2350,53000,55350
C001069,N00024842,Joe Courtney (D),2014,Misc Defense,20400,32500,52900
C001069,N00024842,Joe Courtney (D),2014,Retired,48950,0,48950
C001069,N00024842,Joe Courtney (D),2014,Industrial Unions,0,48000,48000
C001069,N00024842,Joe Courtney (D),2014,Defense Electronics,7250,30500,37750
C001056,N00024852,John Cornyn (R),2014,Oil & Gas,971181,283900,1255081
C001056,N00024852,John Cornyn (R),2014,Securities & Investment,1024463,166500,1190963
C001056,N00024852,John Cornyn (R),2014,Health Professionals,627550,240546,868096
C001056,N00024852,John Cornyn (R),2014,Retired,720767,0,720767
C001056,N00024852,John Cornyn (R),2014,Lawyers/Law Firms,547132,172300,719432
C001056,N00024852,John Cornyn (R),2014,Real Estate,498424,90000,588424
C001056,N00024852,John Cornyn (R),2014,Insurance,218025,246353,464378
C001056,N00024852,John Cornyn (R),2014,Misc Finance,406245,32600,438845
C001056,N00024852,John Cornyn (R),2014,Commercial Banks,230590,109400,339990
C001056,N00024852,John Cornyn (R),2014,Leadership PACs,0,327358,327358
B001245,N00024866,Madeleine Z Bordallo (D),2014,Defense Aerospace,0,12000,12000
B001245,N00024866,Madeleine Z Bordallo (D),2014,Food Processing & Sales,9400,0,9400
B001245,N00024866,Madeleine Z Bordallo (D),2014,Retail Sales,8500,0,8500
B001245,N00024866,Madeleine Z Bordallo (D),2014,Lobbyists,7400,0,7400
B001245,N00024866,Madeleine Z Bordallo (D),2014,Sea Transport,1800,4000,5800
B001245,N00024866,Madeleine Z Bordallo (D),2014,Misc Defense,2500,2000,4500
B001245,N00024866,Madeleine Z Bordallo (D),2014,Candidate Committees,0,4000,4000
B001245,N00024866,Madeleine Z Bordallo (D),2014,Insurance,3250,0,3250
B001245,N00024866,Madeleine Z Bordallo (D),2014,Retired,3090,0,3090
B001245,N00024866,Madeleine Z Bordallo (D),2014,Securities & Investment,3000,0,3000
B001245,N00024866,Madeleine Z Bordallo (D),2014,Real Estate,1000,2000,3000
S001156,N00024870,Linda Sanchez (D),2014,Insurance,16250,98000,114250
S001156,N00024870,Linda Sanchez (D),2014,Health Professionals,17825,61500,79325
S001156,N00024870,Linda Sanchez (D),2014,Pharmaceuticals/Health Products,500,76611,77111
S001156,N00024870,Linda Sanchez (D),2014,Lawyers/Law Firms,45425,22000,67425
S001156,N00024870,Linda Sanchez (D),2014,Lobbyists,63101,0,63101
S001156,N00024870,Linda Sanchez (D),2014,Transportation Unions,0,60500,60500
S001156,N00024870,Linda Sanchez (D),2014,Real Estate,10100,41500,51600
S001156,N00024870,Linda Sanchez (D),2014,Building Trade Unions,0,45000,45000
S001156,N00024870,Linda Sanchez (D),2014,Public Sector Unions,0,45000,45000
S001156,N00024870,Linda Sanchez (D),2014,Securities & Investment,7250,35000,42250
S001157,N00024871,David Scott (D),2014,Insurance,1500,95500,97000
S001157,N00024871,David Scott (D),2014,Securities & Investment,3500,85500,89000
S001157,N00024871,David Scott (D),2014,Health Professionals,7750,80000,87750
S001157,N00024871,David Scott (D),2014,Commercial Banks,1750,85100,86850
S001157,N00024871,David Scott (D),2014,Real Estate,6250,41499,47749
S001157,N00024871,David Scott (D),2014,Accountants,1250,44911,46161
S001157,N00024871,David Scott (D),2014,Industrial Unions,0,30000,30000
S001157,N00024871,David Scott (D),2014,Transportation Unions,0,30000,30000
S001157,N00024871,David Scott (D),2014,Building Trade Unions,0,28500,28500
S001157,N00024871,David Scott (D),2014,Crop Production & Basic Processing,250,26500,26750
H001036,N00024922,Jeb Hensarling (R),2014,Insurance,65014,280000,345014
H001036,N00024922,Jeb Hensarling (R),2014,Securities & Investment,113204,199500,312704
H001036,N00024922,Jeb Hensarling (R),2014,Commercial Banks,104652,201200,305852
H001036,N00024922,Jeb Hensarling (R),2014,Real Estate,108700,105500,214200
H001036,N00024922,Jeb Hensarling (R),2014,Finance/Credit Companies,69650,118500,188150
H001036,N00024922,Jeb Hensarling (R),2014,Misc Finance,105267,69000,174267
H001036,N00024922,Jeb Hensarling (R),2014,Retired,98530,0,98530
H001036,N00024922,Jeb Hensarling (R),2014,Lawyers/Law Firms,45500,51000,96500
H001036,N00024922,Jeb Hensarling (R),2014,Oil & Gas,37400,43500,80900
H001036,N00024922,Jeb Hensarling (R),2014,Lobbyists,70299,7000,77299
C001063,N00024978,Henry Cuellar (D),2014,Oil & Gas,35800,89000,124800
C001063,N00024978,Henry Cuellar (D),2014,Health Professionals,32150,30500,62650
C001063,N00024978,Henry Cuellar (D),2014,Lawyers/Law Firms,34825,18625,53450
C001063,N00024978,Henry Cuellar (D),2014,Automotive,9200,39000,48200
C001063,N00024978,Henry Cuellar (D),2014,Construction Services,32300,14000,46300
C001063,N00024978,Henry Cuellar (D),2014,Crop Production & Basic Processing,7000,35850,42850
C001063,N00024978,Henry Cuellar (D),2014,"Beer, Wine & Liquor",20200,17500,37700
C001063,N00024978,Henry Cuellar (D),2014,Retail Sales,26158,11000,37158
C001063,N00024978,Henry Cuellar (D),2014,Defense Aerospace,1250,30000,31250
C001063,N00024978,Henry Cuellar (D),2014,Insurance,1500,25500,27000
M001151,N00024992,Tim Murphy (R),2014,Health Professionals,18080,135000,153080
M001151,N00024992,Tim Murphy (R),2014,Oil & Gas,10500,96500,107000
M001151,N00024992,Tim Murphy (R),2014,Pharmaceuticals/Health Products,1750,94580,96330
M001151,N00024992,Tim Murphy (R),2014,Lawyers/Law Firms,42387,50887,93274
M001151,N00024992,Tim Murphy (R),2014,Electric Utilities,7250,68500,75750
M001151,N00024992,Tim Murphy (R),2014,Chemical & Related Manufacturing,6700,50500,57200
M001151,N00024992,Tim Murphy (R),2014,Real Estate,37450,18500,55950
M001151,N00024992,Tim Murphy (R),2014,Insurance,9550,44000,53550
M001151,N00024992,Tim Murphy (R),2014,Hospitals/Nursing Homes,30000,19170,49170
M001151,N00024992,Tim Murphy (R),2014,Mining,12400,31000,43400
G000549,N00025025,Jim Gerlach (R),2014,Insurance,7050,91500,98550
G000549,N00025025,Jim Gerlach (R),2014,Pharmaceuticals/Health Products,8950,77100,86050
G000549,N00025025,Jim Gerlach (R),2014,Health Professionals,3000,80500,83500
G000549,N00025025,Jim Gerlach (R),2014,Securities & Investment,26799,25000,51799
G000549,N00025025,Jim Gerlach (R),2014,Lawyers/Law Firms,25150,23700,48850
G000549,N00025025,Jim Gerlach (R),2014,Retired,30300,0,30300
G000549,N00025025,Jim Gerlach (R),2014,Real Estate,17300,13000,30300
G000549,N00025025,Jim Gerlach (R),2014,Electric Utilities,1250,24500,25750
G000549,N00025025,Jim Gerlach (R),2014,Oil & Gas,2500,21500,24000
G000549,N00025025,Jim Gerlach (R),2014,Health Services/HMOs,3950,20000,23950
C001051,N00025095,John Carter (R),2014,Defense Aerospace,0,50500,50500
C001051,N00025095,John Carter (R),2014,Real Estate,37600,9000,46600
C001051,N00025095,John Carter (R),2014,Oil & Gas,10600,36000,46600
C001051,N00025095,John Carter (R),2014,Lawyers/Law Firms,32100,13250,45350
C001051,N00025095,John Carter (R),2014,Air Transport,250,41000,41250
C001051,N00025095,John Carter (R),2014,Health Professionals,28965,12000,40965
C001051,N00025095,John Carter (R),2014,Commercial Banks,18000,15500,33500
C001051,N00025095,John Carter (R),2014,Lobbyists,32200,1000,33200
C001051,N00025095,John Carter (R),2014,Retired,28600,0,28600
C001051,N00025095,John Carter (R),2014,Construction Services,15200,12500,27700
T000463,N00025175,Michael R Turner (R),2014,Defense Aerospace,1000,73000,74000
T000463,N00025175,Michael R Turner (R),2014,Defense Electronics,9700,58600,68300
T000463,N00025175,Michael R Turner (R),2014,Real Estate,24850,31000,55850
T000463,N00025175,Michael R Turner (R),2014,Misc Manufacturing & Distributing,35750,8500,44250
T000463,N00025175,Michael R Turner (R),2014,Building Trade Unions,0,42000,42000
T000463,N00025175,Michael R Turner (R),2014,Retired,32450,0,32450
T000463,N00025175,Michael R Turner (R),2014,Securities & Investment,24700,7500,32200
T000463,N00025175,Michael R Turner (R),2014,Food Processing & Sales,31600,0,31600
T000463,N00025175,Michael R Turner (R),2014,Misc Defense,3275,26100,29375
T000463,N00025175,Michael R Turner (R),2014,General Contractors,20900,3500,24400
B001248,N00025219,Michael Burgess (R),2014,Health Professionals,53396,322093,375489
B001248,N00025219,Michael Burgess (R),2014,Pharmaceuticals/Health Products,1500,122550,124050
B001248,N00025219,Michael Burgess (R),2014,Health Services/HMOs,10750,74500,85250
B001248,N00025219,Michael Burgess (R),2014,Oil & Gas,1650,63500,65150
B001248,N00025219,Michael Burgess (R),2014,Insurance,1750,38250,40000
B001248,N00025219,Michael Burgess (R),2014,Lawyers/Law Firms,6450,26000,32450
B001248,N00025219,Michael Burgess (R),2014,Electric Utilities,0,30000,30000
B001248,N00025219,Michael Burgess (R),2014,Lobbyists,23925,1000,24925
B001248,N00025219,Michael Burgess (R),2014,Hospitals/Nursing Homes,3050,19500,22550
B001248,N00025219,Michael Burgess (R),2014,Telecom Services,0,20000,20000
K000362,N00025237,Steven A King (R),2014,Retired,171435,0,171435
K000362,N00025237,Steven A King (R),2014,Crop Production & Basic Processing,74840,45000,119840
K000362,N00025237,Steven A King (R),2014,Republican/Conservative,61205,54500,115705
K000362,N00025237,Steven A King (R),2014,Agricultural Services/Products,25500,26250,51750
K000362,N00025237,Steven A King (R),2014,Leadership PACs,0,36945,36945
K000362,N00025237,Steven A King (R),2014,Real Estate,32500,3000,35500
K000362,N00025237,Steven A King (R),2014,Misc Business,30100,0,30100
K000362,N00025237,Steven A King (R),2014,Health Professionals,23900,5000,28900
K000362,N00025237,Steven A King (R),2014,Misc Energy,10600,18250,28850
K000362,N00025237,Steven A King (R),2014,Trucking,25300,3500,28800
R000577,N00025280,Tim Ryan (D),2014,Lawyers/Law Firms,37800,19600,57400
R000577,N00025280,Tim Ryan (D),2014,Building Trade Unions,0,57100,57100
R000577,N00025280,Tim Ryan (D),2014,Industrial Unions,0,47000,47000
R000577,N00025280,Tim Ryan (D),2014,Electric Utilities,0,45000,45000
R000577,N00025280,Tim Ryan (D),2014,Public Sector Unions,0,42000,42000
R000577,N00025280,Tim Ryan (D),2014,Transportation Unions,0,38000,38000
R000577,N00025280,Tim Ryan (D),2014,Oil & Gas,8000,30000,38000
R000577,N00025280,Tim Ryan (D),2014,Real Estate,30150,7000,37150
R000577,N00025280,Tim Ryan (D),2014,Misc Manufacturing & Distributing,2600,27500,30100
R000577,N00025280,Tim Ryan (D),2014,Health Professionals,4700,21331,26031
G000551,N00025284,Raul M Grijalva (D),2014,Public Sector Unions,0,47000,47000
G000551,N00025284,Raul M Grijalva (D),2014,Casinos/Gambling,41050,1000,42050
G000551,N00025284,Raul M Grijalva (D),2014,Transportation Unions,0,31500,31500
G000551,N00025284,Raul M Grijalva (D),2014,Industrial Unions,0,28000,28000
G000551,N00025284,Raul M Grijalva (D),2014,Misc Unions,0,27250,27250
G000551,N00025284,Raul M Grijalva (D),2014,Lawyers/Law Firms,17400,6000,23400
G000551,N00025284,Raul M Grijalva (D),2014,Crop Production & Basic Processing,11650,11000,22650
G000551,N00025284,Raul M Grijalva (D),2014,Lobbyists,20692,0,20692
G000551,N00025284,Raul M Grijalva (D),2014,Retired,20180,0,20180
G000551,N00025284,Raul M Grijalva (D),2014,Credit Unions,0,15000,15000
B001250,N00025292,Rob Bishop (R),2014,Oil & Gas,14500,95600,110100
B001250,N00025292,Rob Bishop (R),2014,Defense Aerospace,0,50500,50500
B001250,N00025292,Rob Bishop (R),2014,Casinos/Gambling,31800,0,31800
B001250,N00025292,Rob Bishop (R),2014,Defense Electronics,0,23000,23000
B001250,N00025292,Rob Bishop (R),2014,Lobbyists,20448,2500,22948
B001250,N00025292,Rob Bishop (R),2014,Lawyers/Law Firms,11850,8750,20600
B001250,N00025292,Rob Bishop (R),2014,Mining,250,17500,17750
B001250,N00025292,Rob Bishop (R),2014,Misc Defense,0,17500,17500
B001250,N00025292,Rob Bishop (R),2014,Real Estate,4100,10000,14100
B001250,N00025292,Rob Bishop (R),2014,Electric Utilities,0,14000,14000
B001244,N00025330,Jo Bonner (R),2014,Retired,10500,0,10500
B001244,N00025330,Jo Bonner (R),2014,Defense Aerospace,0,9000,9000
B001244,N00025330,Jo Bonner (R),2014,Lawyers/Law Firms,2700,4000,6700
B001244,N00025330,Jo Bonner (R),2014,Crop Production & Basic Processing,0,5500,5500
B001244,N00025330,Jo Bonner (R),2014,Air Transport,0,5000,5000
B001244,N00025330,Jo Bonner (R),2014,Misc Manufacturing & Distributing,500,3500,4000
B001244,N00025330,Jo Bonner (R),2014,Real Estate,3000,0,3000
B001244,N00025330,Jo Bonner (R),2014,Building Materials & Equipment,2500,0,2500
B001244,N00025330,Jo Bonner (R),2014,"Beer, Wine & Liquor",2500,0,2500
B001244,N00025330,Jo Bonner (R),2014,Candidate Committees,0,2000,2000
B001244,N00025330,Jo Bonner (R),2014,Telephone Utilities,0,2000,2000
B001244,N00025330,Jo Bonner (R),2014,Misc Defense,0,2000,2000
B001244,N00025330,Jo Bonner (R),2014,Defense Electronics,0,2000,2000
D000600,N00025337,Mario Diaz-Balart (R),2014,Real Estate,28923,24500,53423
D000600,N00025337,Mario Diaz-Balart (R),2014,Building Trade Unions,0,49500,49500
D000600,N00025337,Mario Diaz-Balart (R),2014,Transportation Unions,0,36500,36500
D000600,N00025337,Mario Diaz-Balart (R),2014,Pro-Israel,19950,16000,35950
D000600,N00025337,Mario Diaz-Balart (R),2014,Crop Production & Basic Processing,11350,24500,35850
D000600,N00025337,Mario Diaz-Balart (R),2014,Lobbyists,33000,0,33000
D000600,N00025337,Mario Diaz-Balart (R),2014,Lawyers/Law Firms,24250,7250,31500
D000600,N00025337,Mario Diaz-Balart (R),2014,Railroads,500,29000,29500
D000600,N00025337,Mario Diaz-Balart (R),2014,Air Transport,5200,24000,29200
D000600,N00025337,Mario Diaz-Balart (R),2014,Securities & Investment,25100,3500,28600
B001242,N00025413,Timothy H Bishop (D),2014,Leadership PACs,5700,232850,238550
B001242,N00025413,Timothy H Bishop (D),2014,Retired,136915,0,136915
B001242,N00025413,Timothy H Bishop (D),2014,Securities & Investment,100099,34000,134099
B001242,N00025413,Timothy H Bishop (D),2014,Transportation Unions,200,113500,113700
B001242,N00025413,Timothy H Bishop (D),2014,Public Sector Unions,250,96000,96250
B001242,N00025413,Timothy H Bishop (D),2014,Lawyers/Law Firms,72260,23750,96010
B001242,N00025413,Timothy H Bishop (D),2014,Candidate Committees,0,88000,88000
B001242,N00025413,Timothy H Bishop (D),2014,Health Professionals,31650,54000,85650
B001242,N00025413,Timothy H Bishop (D),2014,Education,79375,1000,80375
B001242,N00025413,Timothy H Bishop (D),2014,Building Trade Unions,0,69250,69250
A000361,N00025464,Rodney Alexander (R),2014,General Contractors,14000,2500,16500
A000361,N00025464,Rodney Alexander (R),2014,Crop Production & Basic Processing,12549,1000,13549
A000361,N00025464,Rodney Alexander (R),2014,Oil & Gas,6750,6500,13250
A000361,N00025464,Rodney Alexander (R),2014,Commercial Banks,9000,3500,12500
A000361,N00025464,Rodney Alexander (R),2014,Lawyers/Law Firms,8860,2500,11360
A000361,N00025464,Rodney Alexander (R),2014,Hospitals/Nursing Homes,5250,3500,8750
A000361,N00025464,Rodney Alexander (R),2014,Real Estate,7500,1000,8500
A000361,N00025464,Rodney Alexander (R),2014,Trucking,7500,1000,8500
A000361,N00025464,Rodney Alexander (R),2014,Automotive,5850,2500,8350
A000361,N00025464,Rodney Alexander (R),2014,Health Professionals,7250,1000,8250
R000576,N00025482,Dutch Ruppersberger (D),2014,Health Professionals,2750,59500,62250
R000576,N00025482,Dutch Ruppersberger (D),2014,Misc Defense,16000,44500,60500
R000576,N00025482,Dutch Ruppersberger (D),2014,Defense Electronics,1000,58500,59500
R000576,N00025482,Dutch Ruppersberger (D),2014,Lawyers/Law Firms,30900,23316,54216
R000576,N00025482,Dutch Ruppersberger (D),2014,Defense Aerospace,750,52250,53000
R000576,N00025482,Dutch Ruppersberger (D),2014,Real Estate,33400,7000,40400
R000576,N00025482,Dutch Ruppersberger (D),2014,Air Transport,10400,29000,39400
R000576,N00025482,Dutch Ruppersberger (D),2014,Public Sector Unions,0,39000,39000
R000576,N00025482,Dutch Ruppersberger (D),2014,Electronics Mfg & Equip,1000,34500,35500
R000576,N00025482,Dutch Ruppersberger (D),2014,Electric Utilities,500,31750,32250
B001269,N00025495,Lou Barletta (R),2014,Railroads,10000,79950,89950
B001269,N00025495,Lou Barletta (R),2014,Real Estate,70908,8000,78908
B001269,N00025495,Lou Barletta (R),2014,Building Materials & Equipment,11000,25750,36750
B001269,N00025495,Lou Barletta (R),2014,Transportation Unions,0,34000,34000
B001269,N00025495,Lou Barletta (R),2014,Air Transport,2200,31000,33200
B001269,N00025495,Lou Barletta (R),2014,Oil & Gas,1800,31000,32800
B001269,N00025495,Lou Barletta (R),2014,Construction Services,12900,18500,31400
B001269,N00025495,Lou Barletta (R),2014,Retired,30208,0,30208
B001269,N00025495,Lou Barletta (R),2014,Lawyers/Law Firms,21678,8250,29928
B001269,N00025495,Lou Barletta (R),2014,General Contractors,12275,16500,28775
C001053,N00025726,Tom Cole (R),2014,Human Rights,156025,2000,158025
C001053,N00025726,Tom Cole (R),2014,Oil & Gas,45500,74000,119500
C001053,N00025726,Tom Cole (R),2014,Lobbyists,53048,2000,55048
C001053,N00025726,Tom Cole (R),2014,Defense Aerospace,500,50000,50500
C001053,N00025726,Tom Cole (R),2014,Commercial Banks,33900,14500,48400
C001053,N00025726,Tom Cole (R),2014,Real Estate,16900,27000,43900
C001053,N00025726,Tom Cole (R),2014,Lawyers/Law Firms,25700,10750,36450
C001053,N00025726,Tom Cole (R),2014,Health Professionals,4850,28500,33350
C001053,N00025726,Tom Cole (R),2014,Defense Electronics,0,33000,33000
C001053,N00025726,Tom Cole (R),2014,Insurance,8600,24100,32700
H001050,N00025881,Colleen Hanabusa (D),2014,Retired,244621,0,244621
H001050,N00025881,Colleen Hanabusa (D),2014,Women's Issues,133845,14500,148345
H001050,N00025881,Colleen Hanabusa (D),2014,Lawyers/Law Firms,126351,7500,133851
H001050,N00025881,Colleen Hanabusa (D),2014,Real Estate,101863,2000,103863
H001050,N00025881,Colleen Hanabusa (D),2014,Pro-Israel,78068,25000,103068
H001050,N00025881,Colleen Hanabusa (D),2014,Securities & Investment,70536,0,70536
H001050,N00025881,Colleen Hanabusa (D),2014,Sea Transport,46850,16500,63350
H001050,N00025881,Colleen Hanabusa (D),2014,Health Professionals,52100,9500,61600
H001050,N00025881,Colleen Hanabusa (D),2014,Construction Services,45895,0,45895
H001050,N00025881,Colleen Hanabusa (D),2014,Education,45801,0,45801
C001062,N00026041,Mike Conaway (R),2014,Crop Production & Basic Processing,112350,173750,286100
C001062,N00026041,Mike Conaway (R),2014,Oil & Gas,177250,63000,240250
C001062,N00026041,Mike Conaway (R),2014,Agricultural Services/Products,2700,125132,127832
C001062,N00026041,Mike Conaway (R),2014,Securities & Investment,20450,80500,100950
C001062,N00026041,Mike Conaway (R),2014,Livestock,58600,29500,88100
C001062,N00026041,Mike Conaway (R),2014,Accountants,22750,45000,67750
C001062,N00026041,Mike Conaway (R),2014,Retired,59650,0,59650
C001062,N00026041,Mike Conaway (R),2014,Commercial Banks,18650,39000,57650
C001062,N00026041,Mike Conaway (R),2014,Lawyers/Law Firms,35750,17500,53250
C001062,N00026041,Mike Conaway (R),2014,Defense Aerospace,0,44000,44000
N000182,N00026043,Randy Neugebauer (R),2014,Insurance,20050,237500,257550
N000182,N00026043,Randy Neugebauer (R),2014,Securities & Investment,13764,138500,152264
N000182,N00026043,Randy Neugebauer (R),2014,Commercial Banks,23799,122000,145799
N000182,N00026043,Randy Neugebauer (R),2014,Real Estate,28200,73500,101700
N000182,N00026043,Randy Neugebauer (R),2014,Oil & Gas,55150,34000,89150
N000182,N00026043,Randy Neugebauer (R),2014,Misc Finance,42854,19500,62354
N000182,N00026043,Randy Neugebauer (R),2014,Finance/Credit Companies,9600,46650,56250
N000182,N00026043,Randy Neugebauer (R),2014,Agricultural Services/Products,250,55132,55382
N000182,N00026043,Randy Neugebauer (R),2014,Accountants,2500,48500,51000
N000182,N00026043,Randy Neugebauer (R),2014,Livestock,27800,20000,47800
M001153,N00026050,Lisa Murkowski (R),2014,Electric Utilities,124846,448750,573596
M001153,N00026050,Lisa Murkowski (R),2014,Oil & Gas,221081,336300,557381
M001153,N00026050,Lisa Murkowski (R),2014,Lobbyists,354001,5500,359501
M001153,N00026050,Lisa Murkowski (R),2014,Leadership PACs,0,266393,266393
M001153,N00026050,Lisa Murkowski (R),2014,Lawyers/Law Firms,101872,120750,222622
M001153,N00026050,Lisa Murkowski (R),2014,Real Estate,111744,31500,143244
M001153,N00026050,Lisa Murkowski (R),2014,Food & Beverage,61750,73100,134850
M001153,N00026050,Lisa Murkowski (R),2014,Sea Transport,46600,85100,131700
M001153,N00026050,Lisa Murkowski (R),2014,Retired,130761,0,130761
M001153,N00026050,Lisa Murkowski (R),2014,Misc Energy,31200,94368,125568
B001252,N00026080,John Barrow (D),2014,Lawyers/Law Firms,371330,46750,418080
B001252,N00026080,John Barrow (D),2014,Leadership PACs,9300,211700,221000
B001252,N00026080,John Barrow (D),2014,Health Professionals,34650,182500,217150
B001252,N00026080,John Barrow (D),2014,Pharmaceuticals/Health Products,1750,133500,135250
B001252,N00026080,John Barrow (D),2014,Oil & Gas,11150,120500,131650
B001252,N00026080,John Barrow (D),2014,Insurance,25650,102000,127650
B001252,N00026080,John Barrow (D),2014,Electric Utilities,11300,105500,116800
B001252,N00026080,John Barrow (D),2014,Retired,95998,0,95998
B001252,N00026080,John Barrow (D),2014,Real Estate,33555,50000,83555
B001252,N00026080,John Barrow (D),2014,Candidate Committees,0,80000,80000
W000797,N00026106,Debbie Wasserman Schultz (D),2014,Retired,168140,0,168140
W000797,N00026106,Debbie Wasserman Schultz (D),2014,Lawyers/Law Firms,167725,250,167975
W000797,N00026106,Debbie Wasserman Schultz (D),2014,Real Estate,89891,0,89891
W000797,N00026106,Debbie Wasserman Schultz (D),2014,Securities & Investment,53350,0,53350
W000797,N00026106,Debbie Wasserman Schultz (D),2014,Education,36676,0,36676
W000797,N00026106,Debbie Wasserman Schultz (D),2014,Health Professionals,36000,0,36000
W000797,N00026106,Debbie Wasserman Schultz (D),2014,Business Services,30800,0,30800
W000797,N00026106,Debbie Wasserman Schultz (D),2014,Misc Finance,30294,0,30294
W000797,N00026106,Debbie Wasserman Schultz (D),2014,Environment,22950,1000,23950
W000797,N00026106,Debbie Wasserman Schultz (D),2014,Telecom Services,15500,7500,23000
G000552,N00026148,Louis B Gohmert Jr (R),2014,Retired,73400,0,73400
G000552,N00026148,Louis B Gohmert Jr (R),2014,Republican/Conservative,16750,31500,48250
G000552,N00026148,Louis B Gohmert Jr (R),2014,Oil & Gas,26500,17500,44000
G000552,N00026148,Louis B Gohmert Jr (R),2014,Health Professionals,37450,4000,41450
G000552,N00026148,Louis B Gohmert Jr (R),2014,Misc Finance,32950,0,32950
G000552,N00026148,Louis B Gohmert Jr (R),2014,Real Estate,26088,5000,31088
G000552,N00026148,Louis B Gohmert Jr (R),2014,Forestry & Forest Products,9350,11500,20850
G000552,N00026148,Louis B Gohmert Jr (R),2014,Commercial Banks,19250,1000,20250
G000552,N00026148,Louis B Gohmert Jr (R),2014,Construction Services,20000,0,20000
G000552,N00026148,Louis B Gohmert Jr (R),2014,Lawyers/Law Firms,13550,4000,17550
P000591,N00026160,Tom Price (R),2014,Health Professionals,241448,204500,445948
P000591,N00026160,Tom Price (R),2014,Insurance,48050,125000,173050
P000591,N00026160,Tom Price (R),2014,Securities & Investment,24300,84100,108400
P000591,N00026160,Tom Price (R),2014,Pharmaceuticals/Health Products,17400,89800,107200
P000591,N00026160,Tom Price (R),2014,Retired,106300,0,106300
P000591,N00026160,Tom Price (R),2014,Health Services/HMOs,16950,81000,97950
P000591,N00026160,Tom Price (R),2014,Real Estate,65450,24945,90395
P000591,N00026160,Tom Price (R),2014,Hospitals/Nursing Homes,29800,34500,64300
P000591,N00026160,Tom Price (R),2014,Commercial Banks,2250,46000,48250
P000591,N00026160,Tom Price (R),2014,Lawyers/Law Firms,26700,21350,48050
W000796,N00026163,Lynn A Westmoreland (R),2014,Real Estate,34350,54890,89240
W000796,N00026163,Lynn A Westmoreland (R),2014,Commercial Banks,10050,54000,64050
W000796,N00026163,Lynn A Westmoreland (R),2014,Accountants,1250,44500,45750
W000796,N00026163,Lynn A Westmoreland (R),2014,Insurance,3500,40000,43500
W000796,N00026163,Lynn A Westmoreland (R),2014,Food & Beverage,26500,13000,39500
W000796,N00026163,Lynn A Westmoreland (R),2014,Retired,37100,0,37100
W000796,N00026163,Lynn A Westmoreland (R),2014,Securities & Investment,5600,30000,35600
W000796,N00026163,Lynn A Westmoreland (R),2014,Finance/Credit Companies,0,33000,33000
W000796,N00026163,Lynn A Westmoreland (R),2014,Automotive,16500,16000,32500
W000796,N00026163,Lynn A Westmoreland (R),2014,Health Professionals,9850,22500,32350
F000450,N00026166,Virginia Foxx (R),2014,Retired,131100,0,131100
F000450,N00026166,Virginia Foxx (R),2014,Education,87730,37500,125230
F000450,N00026166,Virginia Foxx (R),2014,Lawyers/Law Firms,16850,27051,43901
F000450,N00026166,Virginia Foxx (R),2014,Commercial Banks,9350,24000,33350
F000450,N00026166,Virginia Foxx (R),2014,Misc Manufacturing & Distributing,19900,13000,32900
F000450,N00026166,Virginia Foxx (R),2014,Food & Beverage,11700,20000,31700
F000450,N00026166,Virginia Foxx (R),2014,Insurance,5700,25000,30700
F000450,N00026166,Virginia Foxx (R),2014,Health Professionals,14250,16000,30250
F000450,N00026166,Virginia Foxx (R),2014,Lobbyists,25700,2500,28200
F000450,N00026166,Virginia Foxx (R),2014,Pharmaceuticals/Health Products,10500,15500,26000
D000604,N00026171,Charlie Dent (R),2014,Health Professionals,21800,109500,131300
D000604,N00026171,Charlie Dent (R),2014,Pharmaceuticals/Health Products,11300,86000,97300
D000604,N00026171,Charlie Dent (R),2014,Electric Utilities,35299,51500,86799
D000604,N00026171,Charlie Dent (R),2014,Chemical & Related Manufacturing,38900,43250,82150
D000604,N00026171,Charlie Dent (R),2014,Misc Issues,79500,0,79500
D000604,N00026171,Charlie Dent (R),2014,Retired,77016,0,77016
D000604,N00026171,Charlie Dent (R),2014,Lawyers/Law Firms,43300,20500,63800
D000604,N00026171,Charlie Dent (R),2014,Oil & Gas,11400,45250,56650
D000604,N00026171,Charlie Dent (R),2014,Insurance,22200,32100,54300
D000604,N00026171,Charlie Dent (R),2014,Misc Manufacturing & Distributing,27050,21999,49049
M001159,N00026314,Cathy McMorris Rodgers (R),2014,Health Professionals,17340,147850,165190
M001159,N00026314,Cathy McMorris Rodgers (R),2014,Real Estate,84520,34000,118520
M001159,N00026314,Cathy McMorris Rodgers (R),2014,Insurance,19767,88500,108267
M001159,N00026314,Cathy McMorris Rodgers (R),2014,Securities & Investment,74100,30000,104100
M001159,N00026314,Cathy McMorris Rodgers (R),2014,Retired,102921,0,102921
M001159,N00026314,Cathy McMorris Rodgers (R),2014,Oil & Gas,8500,83500,92000
M001159,N00026314,Cathy McMorris Rodgers (R),2014,Pharmaceuticals/Health Products,9900,72700,82600
M001159,N00026314,Cathy McMorris Rodgers (R),2014,Forestry & Forest Products,30285,48750,79035
M001159,N00026314,Cathy McMorris Rodgers (R),2014,Telecom Services,24350,51750,76100
M001159,N00026314,Cathy McMorris Rodgers (R),2014,Misc Issues,54200,1000,55200
C001059,N00026341,Jim Costa (D),2014,Crop Production & Basic Processing,130900,94650,225550
C001059,N00026341,Jim Costa (D),2014,Oil & Gas,0,98499,98499
C001059,N00026341,Jim Costa (D),2014,Dairy,33350,30500,63850
C001059,N00026341,Jim Costa (D),2014,Real Estate,49605,9990,59595
C001059,N00026341,Jim Costa (D),2014,Agricultural Services/Products,4300,53500,57800
C001059,N00026341,Jim Costa (D),2014,Livestock,20650,26500,47150
C001059,N00026341,Jim Costa (D),2014,Lawyers/Law Firms,38400,7750,46150
C001059,N00026341,Jim Costa (D),2014,Health Professionals,33950,2000,35950
C001059,N00026341,Jim Costa (D),2014,Electric Utilities,6750,28750,35500
C001059,N00026341,Jim Costa (D),2014,Public Sector Unions,0,35500,35500
W000798,N00026368,Tim Walberg (R),2014,Leadership PACs,0,205068,205068
W000798,N00026368,Tim Walberg (R),2014,Misc Manufacturing & Distributing,77245,11056,88301
W000798,N00026368,Tim Walberg (R),2014,Retired,73025,0,73025
W000798,N00026368,Tim Walberg (R),2014,Automotive,28774,28000,56774
W000798,N00026368,Tim Walberg (R),2014,Real Estate,39100,14100,53200
W000798,N00026368,Tim Walberg (R),2014,Oil & Gas,15150,38000,53150
W000798,N00026368,Tim Walberg (R),2014,Health Professionals,17750,34500,52250
W000798,N00026368,Tim Walberg (R),2014,Lawyers/Law Firms,22500,19850,42350
W000798,N00026368,Tim Walberg (R),2014,Securities & Investment,30190,11000,41190
W000798,N00026368,Tim Walberg (R),2014,Electric Utilities,10250,29000,39250
K000389,N00026427,Ro Khanna (D),2014,Securities & Investment,652150,0,652150
K000389,N00026427,Ro Khanna (D),2014,Electronics Mfg & Equip,272345,0,272345
K000389,N00026427,Ro Khanna (D),2014,Internet,210276,0,210276
K000389,N00026427,Ro Khanna (D),2014,Retired,159411,0,159411
K000389,N00026427,Ro Khanna (D),2014,Lawyers/Law Firms,153575,0,153575
K000389,N00026427,Ro Khanna (D),2014,Business Services,100591,0,100591
K000389,N00026427,Ro Khanna (D),2014,Misc Finance,85700,0,85700
K000389,N00026427,Ro Khanna (D),2014,Health Professionals,68502,0,68502
K000389,N00026427,Ro Khanna (D),2014,Real Estate,58400,0,58400
K000389,N00026427,Ro Khanna (D),2014,Education,49750,0,49750
P000592,N00026457,Ted Poe (R),2014,Oil & Gas,31600,55600,87200
P000592,N00026457,Ted Poe (R),2014,Real Estate,36376,10000,46376
P000592,N00026457,Ted Poe (R),2014,Health Professionals,33692,12487,46179
P000592,N00026457,Ted Poe (R),2014,Lawyers/Law Firms,28050,12500,40550
P000592,N00026457,Ted Poe (R),2014,General Contractors,24450,7500,31950
P000592,N00026457,Ted Poe (R),2014,Retail Sales,7250,21000,28250
P000592,N00026457,Ted Poe (R),2014,Construction Services,18400,9000,27400
P000592,N00026457,Ted Poe (R),2014,Retired,27050,0,27050
P000592,N00026457,Ted Poe (R),2014,Crop Production & Basic Processing,500,25500,26000
P000592,N00026457,Ted Poe (R),2014,Automotive,3000,23000,26000
M001157,N00026460,Michael McCaul (R),2014,Oil & Gas,20300,60500,80800
M001157,N00026460,Michael McCaul (R),2014,Retired,77150,0,77150
M001157,N00026460,Michael McCaul (R),2014,Electronics Mfg & Equip,2711,60190,62901
M001157,N00026460,Michael McCaul (R),2014,Real Estate,44500,15500,60000
M001157,N00026460,Michael McCaul (R),2014,Lawyers/Law Firms,23311,33750,57061
M001157,N00026460,Michael McCaul (R),2014,Misc Finance,51400,1000,52400
M001157,N00026460,Michael McCaul (R),2014,Commercial Banks,26234,25500,51734
M001157,N00026460,Michael McCaul (R),2014,Air Transport,5200,44500,49700
M001157,N00026460,Michael McCaul (R),2014,Securities & Investment,29600,20000,49600
M001157,N00026460,Michael McCaul (R),2014,"Beer, Wine & Liquor",35900,13000,48900
D000607,N00026586,Joe Donnelly (D),2014,Lawyers/Law Firms,719995,39500,759495
D000607,N00026586,Joe Donnelly (D),2014,Leadership PACs,2750,347750,350500
D000607,N00026586,Joe Donnelly (D),2014,Retired,294618,0,294618
D000607,N00026586,Joe Donnelly (D),2014,Securities & Investment,182005,50000,232005
D000607,N00026586,Joe Donnelly (D),2014,Lobbyists,150391,26000,176391
D000607,N00026586,Joe Donnelly (D),2014,Pharmaceuticals/Health Products,63612,97571,161183
D000607,N00026586,Joe Donnelly (D),2014,Real Estate,121118,30000,151118
D000607,N00026586,Joe Donnelly (D),2014,Education,139113,2500,141613
D000607,N00026586,Joe Donnelly (D),2014,Building Trade Unions,3690,107000,110690
D000607,N00026586,Joe Donnelly (D),2014,Health Professionals,87688,20000,107688
B001255,N00026595,Charles W Boustany Jr (R),2014,Oil & Gas,67450,168100,235550
B001255,N00026595,Charles W Boustany Jr (R),2014,Health Professionals,78450,147750,226200
B001255,N00026595,Charles W Boustany Jr (R),2014,Insurance,13707,130000,143707
B001255,N00026595,Charles W Boustany Jr (R),2014,Securities & Investment,25250,64500,89750
B001255,N00026595,Charles W Boustany Jr (R),2014,Pharmaceuticals/Health Products,500,85300,85800
B001255,N00026595,Charles W Boustany Jr (R),2014,Health Services/HMOs,7200,58890,66090
B001255,N00026595,Charles W Boustany Jr (R),2014,Lobbyists,61949,2123,64072
B001255,N00026595,Charles W Boustany Jr (R),2014,Crop Production & Basic Processing,24760,31000,55760
B001255,N00026595,Charles W Boustany Jr (R),2014,Real Estate,33150,18000,51150
B001255,N00026595,Charles W Boustany Jr (R),2014,Retired,48992,0,48992
M001156,N00026627,Patrick McHenry (R),2014,Securities & Investment,57900,131000,188900
M001156,N00026627,Patrick McHenry (R),2014,Commercial Banks,56350,103500,159850
M001156,N00026627,Patrick McHenry (R),2014,Insurance,15900,143000,158900
M001156,N00026627,Patrick McHenry (R),2014,Finance/Credit Companies,27000,90250,117250
M001156,N00026627,Patrick McHenry (R),2014,Real Estate,25700,72000,97700
M001156,N00026627,Patrick McHenry (R),2014,Lawyers/Law Firms,41500,24400,65900
M001156,N00026627,Patrick McHenry (R),2014,Health Professionals,32750,33000,65750
M001156,N00026627,Patrick McHenry (R),2014,Accountants,1750,52500,54250
M001156,N00026627,Patrick McHenry (R),2014,Lobbyists,43142,500,43642
M001156,N00026627,Patrick McHenry (R),2014,Textiles,32150,6000,38150
F000449,N00026631,Jeff Fortenberry (R),2014,Health Professionals,37663,15000,52663
F000449,N00026631,Jeff Fortenberry (R),2014,Commercial Banks,11150,27750,38900
F000449,N00026631,Jeff Fortenberry (R),2014,Insurance,6850,31500,38350
F000449,N00026631,Jeff Fortenberry (R),2014,Crop Production & Basic Processing,8950,27500,36450
F000449,N00026631,Jeff Fortenberry (R),2014,Real Estate,21950,9500,31450
F000449,N00026631,Jeff Fortenberry (R),2014,Defense Aerospace,0,27500,27500
F000449,N00026631,Jeff Fortenberry (R),2014,Lawyers/Law Firms,14950,12500,27450
F000449,N00026631,Jeff Fortenberry (R),2014,Retired,24500,0,24500
F000449,N00026631,Jeff Fortenberry (R),2014,Securities & Investment,23350,1000,24350
F000449,N00026631,Jeff Fortenberry (R),2014,Agricultural Services/Products,4700,17000,21700
G000553,N00026686,Al Green (D),2014,Lawyers/Law Firms,92118,9500,101618
G000553,N00026686,Al Green (D),2014,Real Estate,20750,18500,39250
G000553,N00026686,Al Green (D),2014,Industrial Unions,0,27000,27000
G000553,N00026686,Al Green (D),2014,Building Trade Unions,0,25000,25000
G000553,N00026686,Al Green (D),2014,Commercial Banks,6775,17000,23775
G000553,N00026686,Al Green (D),2014,Transportation Unions,0,21500,21500
G000553,N00026686,Al Green (D),2014,Education,17500,0,17500
G000553,N00026686,Al Green (D),2014,Insurance,3850,7500,11350
G000553,N00026686,Al Green (D),2014,Public Sector Unions,0,11000,11000
G000553,N00026686,Al Green (D),2014,Oil & Gas,4000,5000,9000
M001158,N00026710,Kenny Marchant (R),2014,Insurance,0,88500,88500
M001158,N00026710,Kenny Marchant (R),2014,Oil & Gas,13000,45500,58500
M001158,N00026710,Kenny Marchant (R),2014,Securities & Investment,11950,46000,57950
M001158,N00026710,Kenny Marchant (R),2014,Real Estate,7550,37000,44550
M001158,N00026710,Kenny Marchant (R),2014,Commercial Banks,1000,43000,44000
M001158,N00026710,Kenny Marchant (R),2014,Automotive,2000,22000,24000
M001158,N00026710,Kenny Marchant (R),2014,Accountants,500,22500,23000
M001158,N00026710,Kenny Marchant (R),2014,Defense Aerospace,0,21500,21500
M001158,N00026710,Kenny Marchant (R),2014,Electric Utilities,7816,13499,21315
M001158,N00026710,Kenny Marchant (R),2014,Lobbyists,20200,0,20200
C001061,N00026790,Emanuel Cleaver (D),2014,Lawyers/Law Firms,53150,36500,89650
C001061,N00026790,Emanuel Cleaver (D),2014,Building Trade Unions,250,55000,55250
C001061,N00026790,Emanuel Cleaver (D),2014,Insurance,0,52000,52000
C001061,N00026790,Emanuel Cleaver (D),2014,Public Sector Unions,0,49516,49516
C001061,N00026790,Emanuel Cleaver (D),2014,Industrial Unions,0,49000,49000
C001061,N00026790,Emanuel Cleaver (D),2014,Real Estate,9350,39500,48850
C001061,N00026790,Emanuel Cleaver (D),2014,Securities & Investment,1950,31500,33450
C001061,N00026790,Emanuel Cleaver (D),2014,Accountants,0,31500,31500
C001061,N00026790,Emanuel Cleaver (D),2014,Finance/Credit Companies,0,25500,25500
C001061,N00026790,Emanuel Cleaver (D),2014,Retired,25100,0,25100
R000578,N00026885,Dave Reichert (R),2014,Retired,108238,0,108238
R000578,N00026885,Dave Reichert (R),2014,Insurance,2500,75500,78000
R000578,N00026885,Dave Reichert (R),2014,Real Estate,31000,28500,59500
R000578,N00026885,Dave Reichert (R),2014,Securities & Investment,16150,37500,53650
R000578,N00026885,Dave Reichert (R),2014,Health Professionals,7700,37500,45200
R000578,N00026885,Dave Reichert (R),2014,Pharmaceuticals/Health Products,0,42000,42000
R000578,N00026885,Dave Reichert (R),2014,Building Trade Unions,0,36000,36000
R000578,N00026885,Dave Reichert (R),2014,Casinos/Gambling,29799,6000,35799
R000578,N00026885,Dave Reichert (R),2014,Defense Aerospace,3000,28000,31000
R000578,N00026885,Dave Reichert (R),2014,Misc Manufacturing & Distributing,2500,26999,29499
M001160,N00026914,Gwen Moore (D),2014,Securities & Investment,21000,104500,125500
M001160,N00026914,Gwen Moore (D),2014,Insurance,500,115750,116250
M001160,N00026914,Gwen Moore (D),2014,Commercial Banks,750,51000,51750
M001160,N00026914,Gwen Moore (D),2014,Casinos/Gambling,46800,1000,47800
M001160,N00026914,Gwen Moore (D),2014,Building Trade Unions,0,45000,45000
M001160,N00026914,Gwen Moore (D),2014,Accountants,3000,40500,43500
M001160,N00026914,Gwen Moore (D),2014,Real Estate,6600,33500,40100
M001160,N00026914,Gwen Moore (D),2014,Public Sector Unions,500,38500,39000
M001160,N00026914,Gwen Moore (D),2014,Industrial Unions,0,37250,37250
M001160,N00026914,Gwen Moore (D),2014,Leadership PACs,0,36500,36500
M001166,N00026926,Jerry McNerney (D),2014,Retired,145754,0,145754
M001166,N00026926,Jerry McNerney (D),2014,Lawyers/Law Firms,77523,12250,89773
M001166,N00026926,Jerry McNerney (D),2014,Building Trade Unions,0,66000,66000
M001166,N00026926,Jerry McNerney (D),2014,Health Professionals,20950,31500,52450
M001166,N00026926,Jerry McNerney (D),2014,Real Estate,26950,10000,36950
M001166,N00026926,Jerry McNerney (D),2014,Public Sector Unions,0,36500,36500
M001166,N00026926,Jerry McNerney (D),2014,Electric Utilities,7700,26249,33949
M001166,N00026926,Jerry McNerney (D),2014,Environment,19500,14000,33500
M001166,N00026926,Jerry McNerney (D),2014,Transportation Unions,0,33500,33500
M001166,N00026926,Jerry McNerney (D),2014,Industrial Unions,0,32000,32000
C001067,N00026961,Yvette D Clarke (D),2014,Building Trade Unions,0,54350,54350
C001067,N00026961,Yvette D Clarke (D),2014,Public Sector Unions,0,34465,34465
C001067,N00026961,Yvette D Clarke (D),2014,Transportation Unions,0,26000,26000
C001067,N00026961,Yvette D Clarke (D),2014,Industrial Unions,0,19500,19500
C001067,N00026961,Yvette D Clarke (D),2014,Real Estate,14200,4000,18200
C001067,N00026961,Yvette D Clarke (D),2014,Defense Aerospace,0,18000,18000
C001067,N00026961,Yvette D Clarke (D),2014,Lawyers/Law Firms,8700,9250,17950
C001067,N00026961,Yvette D Clarke (D),2014,Health Professionals,12840,4500,17340
C001067,N00026961,Yvette D Clarke (D),2014,Food & Beverage,5500,11500,17000
C001067,N00026961,Yvette D Clarke (D),2014,Telecom Services,0,16000,16000
B001251,N00027035,G K Butterfield (D),2014,Pharmaceuticals/Health Products,2950,79500,82450
B001251,N00027035,G K Butterfield (D),2014,Health Professionals,6966,60000,66966
B001251,N00027035,G K Butterfield (D),2014,Telecom Services,5500,44000,49500
B001251,N00027035,G K Butterfield (D),2014,Lawyers/Law Firms,12900,25536,38436
B001251,N00027035,G K Butterfield (D),2014,Electric Utilities,3000,29250,32250
B001251,N00027035,G K Butterfield (D),2014,Telephone Utilities,250,30000,30250
B001251,N00027035,G K Butterfield (D),2014,Building Trade Unions,0,25000,25000
B001251,N00027035,G K Butterfield (D),2014,Automotive,1000,23500,24500
B001251,N00027035,G K Butterfield (D),2014,Insurance,5916,18000,23916
B001251,N00027035,G K Butterfield (D),2014,TV/Movies/Music,750,22004,22754
H001038,N00027060,Brian M Higgins (D),2014,Lawyers/Law Firms,79073,11000,90073
H001038,N00027060,Brian M Higgins (D),2014,Transportation Unions,0,46500,46500
H001038,N00027060,Brian M Higgins (D),2014,Building Trade Unions,0,42000,42000
H001038,N00027060,Brian M Higgins (D),2014,Industrial Unions,0,35500,35500
H001038,N00027060,Brian M Higgins (D),2014,Public Sector Unions,0,26000,26000
H001038,N00027060,Brian M Higgins (D),2014,Hospitals/Nursing Homes,21500,2250,23750
H001038,N00027060,Brian M Higgins (D),2014,Real Estate,14500,8000,22500
H001038,N00027060,Brian M Higgins (D),2014,Commercial Banks,12250,9500,21750
H001038,N00027060,Brian M Higgins (D),2014,Health Professionals,17100,3000,20100
H001038,N00027060,Brian M Higgins (D),2014,Misc Manufacturing & Distributing,4500,14000,18500
F000451,N00027229,Michael G Fitzpatrick (R),2014,Insurance,72592,115250,187842
F000451,N00027229,Michael G Fitzpatrick (R),2014,Securities & Investment,116394,56000,172394
F000451,N00027229,Michael G Fitzpatrick (R),2014,Leadership PACs,0,163135,163135
F000451,N00027229,Michael G Fitzpatrick (R),2014,Lawyers/Law Firms,106703,34300,141003
F000451,N00027229,Michael G Fitzpatrick (R),2014,Real Estate,68254,65240,133494
F000451,N00027229,Michael G Fitzpatrick (R),2014,Commercial Banks,20455,83500,103955
F000451,N00027229,Michael G Fitzpatrick (R),2014,Retired,86886,0,86886
F000451,N00027229,Michael G Fitzpatrick (R),2014,Health Professionals,24075,54000,78075
F000451,N00027229,Michael G Fitzpatrick (R),2014,Construction Services,62136,8600,70736
F000451,N00027229,Michael G Fitzpatrick (R),2014,Misc Issues,56000,6000,62000
L000563,N00027239,Daniel Lipinski (D),2014,Transportation Unions,0,70500,70500
L000563,N00027239,Daniel Lipinski (D),2014,Air Transport,480,58000,58480
L000563,N00027239,Daniel Lipinski (D),2014,Building Trade Unions,0,55500,55500
L000563,N00027239,Daniel Lipinski (D),2014,Railroads,3850,51550,55400
L000563,N00027239,Daniel Lipinski (D),2014,Construction Services,26350,24600,50950
L000563,N00027239,Daniel Lipinski (D),2014,"Beer, Wine & Liquor",18600,20999,39599
L000563,N00027239,Daniel Lipinski (D),2014,Lawyers/Law Firms,27700,9000,36700
L000563,N00027239,Daniel Lipinski (D),2014,Food & Beverage,6750,16500,23250
L000563,N00027239,Daniel Lipinski (D),2014,Building Materials & Equipment,0,22000,22000
L000563,N00027239,Daniel Lipinski (D),2014,Industrial Unions,0,18500,18500
C001071,N00027441,Bob Corker (R),2014,Securities & Investment,898114,212070,1110184
C001071,N00027441,Bob Corker (R),2014,Real Estate,544050,115600,659650
C001071,N00027441,Bob Corker (R),2014,Insurance,198383,297300,495683
C001071,N00027441,Bob Corker (R),2014,Retired,484394,0,484394
C001071,N00027441,Bob Corker (R),2014,Lawyers/Law Firms,375213,107500,482713
C001071,N00027441,Bob Corker (R),2014,Health Professionals,365329,90000,455329
C001071,N00027441,Bob Corker (R),2014,Misc Finance,389545,38500,428045
C001071,N00027441,Bob Corker (R),2014,Commercial Banks,254690,161300,415990
C001071,N00027441,Bob Corker (R),2014,Lobbyists,269950,8265,278215
C001071,N00027441,Bob Corker (R),2014,Oil & Gas,115627,139000,254627
M001163,N00027459,Doris O Matsui (D),2014,Health Professionals,2000,84800,86800
M001163,N00027459,Doris O Matsui (D),2014,Lawyers/Law Firms,28150,46000,74150
M001163,N00027459,Doris O Matsui (D),2014,Telecom Services,3000,67000,70000
M001163,N00027459,Doris O Matsui (D),2014,Insurance,12300,50000,62300
M001163,N00027459,Doris O Matsui (D),2014,Pharmaceuticals/Health Products,0,57500,57500
M001163,N00027459,Doris O Matsui (D),2014,Electronics Mfg & Equip,2000,43160,45160
M001163,N00027459,Doris O Matsui (D),2014,Telephone Utilities,0,45000,45000
M001163,N00027459,Doris O Matsui (D),2014,Public Sector Unions,0,42500,42500
M001163,N00027459,Doris O Matsui (D),2014,Electric Utilities,5600,35749,41349
M001163,N00027459,Doris O Matsui (D),2014,Lobbyists,36993,2050,39043
B001257,N00027462,Gus Bilirakis (R),2014,Health Professionals,46529,127500,174029
B001257,N00027462,Gus Bilirakis (R),2014,Pharmaceuticals/Health Products,2000,62850,64850
B001257,N00027462,Gus Bilirakis (R),2014,Health Services/HMOs,3100,50600,53700
B001257,N00027462,Gus Bilirakis (R),2014,Real Estate,23297,19000,42297
B001257,N00027462,Gus Bilirakis (R),2014,Insurance,3150,38000,41150
B001257,N00027462,Gus Bilirakis (R),2014,Telecom Services,1250,36000,37250
B001257,N00027462,Gus Bilirakis (R),2014,Lobbyists,30485,2500,32985
B001257,N00027462,Gus Bilirakis (R),2014,Lodging/Tourism,1750,31000,32750
B001257,N00027462,Gus Bilirakis (R),2014,Oil & Gas,5000,27500,32500
B001257,N00027462,Gus Bilirakis (R),2014,Electric Utilities,0,28000,28000
B001259,N00027464,Bruce Braley (D),2014,Lawyers/Law Firms,1615522,45000,1660522
B001259,N00027464,Bruce Braley (D),2014,Leadership PACs,0,486100,486100
B001259,N00027464,Bruce Braley (D),2014,Health Professionals,92600,138500,231100
B001259,N00027464,Bruce Braley (D),2014,Retired,208557,0,208557
B001259,N00027464,Bruce Braley (D),2014,Environment,96094,37305,133399
B001259,N00027464,Bruce Braley (D),2014,Public Sector Unions,450,103500,103950
B001259,N00027464,Bruce Braley (D),2014,Pro-Israel,63860,30999,94859
B001259,N00027464,Bruce Braley (D),2014,Real Estate,76250,15000,91250
B001259,N00027464,Bruce Braley (D),2014,Democratic/Liberal,59138,28701,87839
B001259,N00027464,Bruce Braley (D),2014,Education,87037,0,87037
B001256,N00027493,Michele Bachmann (R),2014,Retired,85367,0,85367
B001256,N00027493,Michele Bachmann (R),2014,Misc Issues,12876,-200,12676
B001256,N00027493,Michele Bachmann (R),2014,Oil & Gas,11900,0,11900
B001256,N00027493,Michele Bachmann (R),2014,Real Estate,9452,1000,10452
B001256,N00027493,Michele Bachmann (R),2014,Misc Finance,7800,0,7800
B001256,N00027493,Michele Bachmann (R),2014,Leadership PACs,0,7500,7500
B001256,N00027493,Michele Bachmann (R),2014,General Contractors,7450,0,7450
B001256,N00027493,Michele Bachmann (R),2014,Food & Beverage,4251,0,4251
B001256,N00027493,Michele Bachmann (R),2014,Pro-Israel,3550,500,4050
B001256,N00027493,Michele Bachmann (R),2014,Agricultural Services/Products,3250,0,3250
K000367,N00027500,Amy Klobuchar (D),2014,Lawyers/Law Firms,786304,158910,945214
K000367,N00027500,Amy Klobuchar (D),2014,Retired,494006,0,494006
K000367,N00027500,Amy Klobuchar (D),2014,Leadership PACs,0,322677,322677
K000367,N00027500,Amy Klobuchar (D),2014,Securities & Investment,283766,37500,321266
K000367,N00027500,Amy Klobuchar (D),2014,Lobbyists,260730,22100,282830
K000367,N00027500,Amy Klobuchar (D),2014,Pharmaceuticals/Health Products,95775,129650,225425
K000367,N00027500,Amy Klobuchar (D),2014,TV/Movies/Music,157961,45000,202961
K000367,N00027500,Amy Klobuchar (D),2014,Women's Issues,187016,15594,202610
K000367,N00027500,Amy Klobuchar (D),2014,Retail Sales,129633,63700,193333
K000367,N00027500,Amy Klobuchar (D),2014,Real Estate,153166,21500,174666
C001070,N00027503,Bob Casey (D),2014,Lawyers/Law Firms,1901201,237008,2138209
C001070,N00027503,Bob Casey (D),2014,Securities & Investment,325962,131100,457062
C001070,N00027503,Bob Casey (D),2014,Pharmaceuticals/Health Products,121000,297979,418979
C001070,N00027503,Bob Casey (D),2014,Real Estate,351158,50500,401658
C001070,N00027503,Bob Casey (D),2014,Lobbyists,376170,8300,384470
C001070,N00027503,Bob Casey (D),2014,Health Professionals,212985,162250,375235
C001070,N00027503,Bob Casey (D),2014,Retired,362371,0,362371
C001070,N00027503,Bob Casey (D),2014,Insurance,149050,172750,321800
C001070,N00027503,Bob Casey (D),2014,Hospitals/Nursing Homes,197297,112250,309547
C001070,N00027503,Bob Casey (D),2014,Leadership PACs,1000,258364,259364
T000470,N00027509,Scott Tipton (R),2014,Retired,151200,0,151200
T000470,N00027509,Scott Tipton (R),2014,Oil & Gas,41989,70000,111989
T000470,N00027509,Scott Tipton (R),2014,Real Estate,61000,12000,73000
T000470,N00027509,Scott Tipton (R),2014,Mining,18150,29000,47150
T000470,N00027509,Scott Tipton (R),2014,Livestock,28300,12000,40300
T000470,N00027509,Scott Tipton (R),2014,Misc Finance,35800,1000,36800
T000470,N00027509,Scott Tipton (R),2014,General Contractors,31788,4500,36288
T000470,N00027509,Scott Tipton (R),2014,Lawyers/Law Firms,26650,7000,33650
T000470,N00027509,Scott Tipton (R),2014,Crop Production & Basic Processing,1500,29000,30500
T000470,N00027509,Scott Tipton (R),2014,Electric Utilities,500,28600,29100
P000593,N00027510,Edwin G Perlmutter (D),2014,Lawyers/Law Firms,119904,45500,165404
P000593,N00027510,Edwin G Perlmutter (D),2014,Insurance,1500,161500,163000
P000593,N00027510,Edwin G Perlmutter (D),2014,Real Estate,40091,101000,141091
P000593,N00027510,Edwin G Perlmutter (D),2014,Securities & Investment,24522,105500,130022
P000593,N00027510,Edwin G Perlmutter (D),2014,Commercial Banks,24968,95000,119968
P000593,N00027510,Edwin G Perlmutter (D),2014,Retired,87574,0,87574
P000593,N00027510,Edwin G Perlmutter (D),2014,Health Professionals,24750,47500,72250
P000593,N00027510,Edwin G Perlmutter (D),2014,Finance/Credit Companies,2250,63500,65750
P000593,N00027510,Edwin G Perlmutter (D),2014,Public Sector Unions,0,60000,60000
P000593,N00027510,Edwin G Perlmutter (D),2014,Accountants,1000,51999,52999
C001066,N00027514,Kathy Castor (D),2014,Health Professionals,9950,64000,73950
C001066,N00027514,Kathy Castor (D),2014,Lawyers/Law Firms,23450,17000,40450
C001066,N00027514,Kathy Castor (D),2014,Telecom Services,500,37500,38000
C001066,N00027514,Kathy Castor (D),2014,Insurance,9250,18000,27250
C001066,N00027514,Kathy Castor (D),2014,Hospitals/Nursing Homes,10000,14000,24000
C001066,N00027514,Kathy Castor (D),2014,Retired,20800,0,20800
C001066,N00027514,Kathy Castor (D),2014,Transportation Unions,0,20500,20500
C001066,N00027514,Kathy Castor (D),2014,Real Estate,11200,8000,19200
C001066,N00027514,Kathy Castor (D),2014,Building Trade Unions,500,15000,15500
C001066,N00027514,Kathy Castor (D),2014,Public Sector Unions,0,15500,15500
H001041,N00027522,Dean Heller (R),2014,Retired,526892,0,526892
H001041,N00027522,Dean Heller (R),2014,Securities & Investment,337865,113000,450865
H001041,N00027522,Dean Heller (R),2014,Leadership PACs,500,448092,448592
H001041,N00027522,Dean Heller (R),2014,Casinos/Gambling,234632,89000,323632
H001041,N00027522,Dean Heller (R),2014,Real Estate,259990,47500,307490
H001041,N00027522,Dean Heller (R),2014,Insurance,84405,215000,299405
H001041,N00027522,Dean Heller (R),2014,Mining,155275,104825,260100
H001041,N00027522,Dean Heller (R),2014,Health Professionals,132734,123000,255734
H001041,N00027522,Dean Heller (R),2014,Oil & Gas,106200,147750,253950
H001041,N00027522,Dean Heller (R),2014,Lobbyists,199512,10500,210012
S001165,N00027523,Albio Sires (D),2014,Transportation Unions,0,53100,53100
S001165,N00027523,Albio Sires (D),2014,Education,43200,1000,44200
S001165,N00027523,Albio Sires (D),2014,Lawyers/Law Firms,25360,14000,39360
S001165,N00027523,Albio Sires (D),2014,Real Estate,21300,14000,35300
S001165,N00027523,Albio Sires (D),2014,Building Trade Unions,0,33000,33000
S001165,N00027523,Albio Sires (D),2014,Public Sector Unions,0,30000,30000
S001165,N00027523,Albio Sires (D),2014,Railroads,0,25000,25000
S001165,N00027523,Albio Sires (D),2014,Pro-Israel,9400,10000,19400
S001165,N00027523,Albio Sires (D),2014,Telephone Utilities,0,19000,19000
S001165,N00027523,Albio Sires (D),2014,Air Transport,1000,18000,19000
C001064,N00027565,John Campbell (R),2014,Accountants,0,22500,22500
C001064,N00027565,John Campbell (R),2014,Securities & Investment,6800,15600,22400
C001064,N00027565,John Campbell (R),2014,Credit Unions,6150,10000,16150
C001064,N00027565,John Campbell (R),2014,Insurance,0,13500,13500
C001064,N00027565,John Campbell (R),2014,Real Estate,5000,8000,13000
C001064,N00027565,John Campbell (R),2014,Automotive,6200,5000,11200
C001064,N00027565,John Campbell (R),2014,Misc Finance,3200,3250,6450
C001064,N00027565,John Campbell (R),2014,Retired,6250,0,6250
C001064,N00027565,John Campbell (R),2014,Finance/Credit Companies,0,6000,6000
C001064,N00027565,John Campbell (R),2014,Commercial Banks,0,5000,5000
M001169,N00027566,Christopher S Murphy (D),2014,Retired,1061667,0,1061667
M001169,N00027566,Christopher S Murphy (D),2014,Lawyers/Law Firms,857958,50650,908608
M001169,N00027566,Christopher S Murphy (D),2014,Securities & Investment,602070,81000,683070
M001169,N00027566,Christopher S Murphy (D),2014,Insurance,119025,228000,347025
M001169,N00027566,Christopher S Murphy (D),2014,Real Estate,282666,60500,343166
M001169,N00027566,Christopher S Murphy (D),2014,Health Professionals,164815,139410,304225
M001169,N00027566,Christopher S Murphy (D),2014,Leadership PACs,15000,287500,302500
M001169,N00027566,Christopher S Murphy (D),2014,Democratic/Liberal,143271,124247,267518
M001169,N00027566,Christopher S Murphy (D),2014,Lobbyists,245959,7000,252959
M001169,N00027566,Christopher S Murphy (D),2014,Business Services,237700,15000,252700
T000464,N00027605,Jon Tester (D),2014,Lawyers/Law Firms,1255950,162371,1418321
T000464,N00027605,Jon Tester (D),2014,Securities & Investment,599566,227500,827066
T000464,N00027605,Jon Tester (D),2014,Retired,814131,0,814131
T000464,N00027605,Jon Tester (D),2014,Lobbyists,607169,18105,625274
T000464,N00027605,Jon Tester (D),2014,Leadership PACs,15750,408000,423750
T000464,N00027605,Jon Tester (D),2014,Commercial Banks,182018,192350,374368
T000464,N00027605,Jon Tester (D),2014,Real Estate,292034,73820,365854
T000464,N00027605,Jon Tester (D),2014,Insurance,69133,275544,344677
T000464,N00027605,Jon Tester (D),2014,Health Professionals,158273,126400,284673
T000464,N00027605,Jon Tester (D),2014,Environment,252321,16814,269135
S001172,N00027623,Adrian Smith (R),2014,Insurance,13350,77500,90850
S001172,N00027623,Adrian Smith (R),2014,Commercial Banks,11100,49500,60600
S001172,N00027623,Adrian Smith (R),2014,Health Professionals,11400,47750,59150
S001172,N00027623,Adrian Smith (R),2014,Agricultural Services/Products,4450,48000,52450
S001172,N00027623,Adrian Smith (R),2014,Crop Production & Basic Processing,6700,44250,50950
S001172,N00027623,Adrian Smith (R),2014,Real Estate,8850,34500,43350
S001172,N00027623,Adrian Smith (R),2014,Securities & Investment,2250,33500,35750
S001172,N00027623,Adrian Smith (R),2014,Accountants,450,31000,31450
S001172,N00027623,Adrian Smith (R),2014,Electric Utilities,500,28500,29000
S001172,N00027623,Adrian Smith (R),2014,Livestock,5250,20000,25250
B001260,N00027626,Vernon Buchanan (R),2014,Health Professionals,174100,101218,275318
B001260,N00027626,Vernon Buchanan (R),2014,Retired,130275,0,130275
B001260,N00027626,Vernon Buchanan (R),2014,Real Estate,67000,20000,87000
B001260,N00027626,Vernon Buchanan (R),2014,Food & Beverage,42400,24000,66400
B001260,N00027626,Vernon Buchanan (R),2014,Insurance,2500,51000,53500
B001260,N00027626,Vernon Buchanan (R),2014,Health Services/HMOs,8550,41200,49750
B001260,N00027626,Vernon Buchanan (R),2014,Lobbyists,42000,1000,43000
B001260,N00027626,Vernon Buchanan (R),2014,Pharmaceuticals/Health Products,14150,28000,42150
B001260,N00027626,Vernon Buchanan (R),2014,Retail Sales,23150,15000,38150
B001260,N00027626,Vernon Buchanan (R),2014,Commercial Banks,2250,35500,37750
H001057,N00027649,Tim Huelskamp (R),2014,Oil & Gas,46750,19500,66250
H001057,N00027649,Tim Huelskamp (R),2014,Republican/Conservative,12300,25025,37325
H001057,N00027649,Tim Huelskamp (R),2014,Retired,30550,0,30550
H001057,N00027649,Tim Huelskamp (R),2014,Health Professionals,12550,17500,30050
H001057,N00027649,Tim Huelskamp (R),2014,Crop Production & Basic Processing,27525,2000,29525
H001057,N00027649,Tim Huelskamp (R),2014,Misc Manufacturing & Distributing,20900,0,20900
H001057,N00027649,Tim Huelskamp (R),2014,Leadership PACs,0,19500,19500
H001057,N00027649,Tim Huelskamp (R),2014,Commercial Banks,5300,12000,17300
H001057,N00027649,Tim Huelskamp (R),2014,Railroads,7800,9498,17298
H001057,N00027649,Tim Huelskamp (R),2014,Real Estate,11700,4500,16200
G000555,N00027658,Kirsten Gillibrand (D),2014,Lawyers/Law Firms,3998631,319942,4318573
G000555,N00027658,Kirsten Gillibrand (D),2014,Securities & Investment,2879148,315300,3194448
G000555,N00027658,Kirsten Gillibrand (D),2014,Real Estate,1262052,123000,1385052
G000555,N00027658,Kirsten Gillibrand (D),2014,Women's Issues,968246,27500,995746
G000555,N00027658,Kirsten Gillibrand (D),2014,Retired,963266,0,963266
G000555,N00027658,Kirsten Gillibrand (D),2014,Lobbyists,757472,33674,791146
G000555,N00027658,Kirsten Gillibrand (D),2014,TV/Movies/Music,694117,80500,774617
G000555,N00027658,Kirsten Gillibrand (D),2014,Business Services,618902,45400,664302
G000555,N00027658,Kirsten Gillibrand (D),2014,Misc Finance,601753,16600,618353
G000555,N00027658,Kirsten Gillibrand (D),2014,Insurance,292850,310416,603266
M001170,N00027694,Claire McCaskill (D),2014,Lawyers/Law Firms,2321390,161166,2482556
M001170,N00027694,Claire McCaskill (D),2014,Retired,1351047,0,1351047
M001170,N00027694,Claire McCaskill (D),2014,Women's Issues,1172415,26500,1198915
M001170,N00027694,Claire McCaskill (D),2014,Securities & Investment,533934,43500,577434
M001170,N00027694,Claire McCaskill (D),2014,Education,407580,0,407580
M001170,N00027694,Claire McCaskill (D),2014,Real Estate,351764,28500,380264
M001170,N00027694,Claire McCaskill (D),2014,Leadership PACs,0,352000,352000
M001170,N00027694,Claire McCaskill (D),2014,TV/Movies/Music,292684,50750,343434
M001170,N00027694,Claire McCaskill (D),2014,Business Services,320828,22525,343353
M001170,N00027694,Claire McCaskill (D),2014,Lobbyists,320093,10490,330583
L000565,N00027741,David Loebsack (D),2014,Leadership PACs,1000,153858,154858
L000565,N00027741,David Loebsack (D),2014,Retired,94400,0,94400
L000565,N00027741,David Loebsack (D),2014,Health Professionals,17067,68500,85567
L000565,N00027741,David Loebsack (D),2014,Lawyers/Law Firms,66900,13750,80650
L000565,N00027741,David Loebsack (D),2014,Education,74050,4000,78050
L000565,N00027741,David Loebsack (D),2014,Building Trade Unions,500,69500,70000
L000565,N00027741,David Loebsack (D),2014,Candidate Committees,0,63500,63500
L000565,N00027741,David Loebsack (D),2014,Public Sector Unions,0,57000,57000
L000565,N00027741,David Loebsack (D),2014,Industrial Unions,250,53000,53250
L000565,N00027741,David Loebsack (D),2014,Defense Aerospace,3750,45000,48750
S001168,N00027751,John Sarbanes (D),2014,Retired,124200,0,124200
S001168,N00027751,John Sarbanes (D),2014,Lawyers/Law Firms,100014,0,100014
S001168,N00027751,John Sarbanes (D),2014,Real Estate,59900,0,59900
S001168,N00027751,John Sarbanes (D),2014,Securities & Investment,55700,0,55700
S001168,N00027751,John Sarbanes (D),2014,Education,54550,0,54550
S001168,N00027751,John Sarbanes (D),2014,General Contractors,20600,0,20600
S001168,N00027751,John Sarbanes (D),2014,Health Professionals,18255,0,18255
S001168,N00027751,John Sarbanes (D),2014,Misc Finance,17700,0,17700
S001168,N00027751,John Sarbanes (D),2014,Food & Beverage,17500,0,17500
S001168,N00027751,John Sarbanes (D),2014,Misc Manufacturing & Distributing,16400,0,16400
J000288,N00027848,Hank Johnson (D),2014,Industrial Unions,0,43000,43000
J000288,N00027848,Hank Johnson (D),2014,Lawyers/Law Firms,16573,25000,41573
J000288,N00027848,Hank Johnson (D),2014,Telecom Services,0,35000,35000
J000288,N00027848,Hank Johnson (D),2014,Building Trade Unions,0,33000,33000
J000288,N00027848,Hank Johnson (D),2014,Public Sector Unions,0,30000,30000
J000288,N00027848,Hank Johnson (D),2014,Transportation Unions,0,28000,28000
J000288,N00027848,Hank Johnson (D),2014,Insurance,0,26500,26500
J000288,N00027848,Hank Johnson (D),2014,Leadership PACs,0,21000,21000
J000288,N00027848,Hank Johnson (D),2014,Pharmaceuticals/Health Products,0,20500,20500
J000288,N00027848,Hank Johnson (D),2014,Food & Beverage,3350,15000,18350
D000622,N00027860,Tammy Duckworth (D),2014,Lawyers/Law Firms,142567,21000,163567
D000622,N00027860,Tammy Duckworth (D),2014,Women's Issues,106125,3000,109125
D000622,N00027860,Tammy Duckworth (D),2014,Health Professionals,22250,78500,100750
D000622,N00027860,Tammy Duckworth (D),2014,Retired,87993,0,87993
D000622,N00027860,Tammy Duckworth (D),2014,Insurance,24506,53500,78006
D000622,N00027860,Tammy Duckworth (D),2014,Pro-Israel,69451,5200,74651
D000622,N00027860,Tammy Duckworth (D),2014,Securities & Investment,54200,18000,72200
D000622,N00027860,Tammy Duckworth (D),2014,Public Sector Unions,250,68000,68250
D000622,N00027860,Tammy Duckworth (D),2014,Building Trade Unions,500,65000,65500
D000622,N00027860,Tammy Duckworth (D),2014,Real Estate,48100,12500,60600
M001171,N00027891,Dan Maffei (D),2014,Leadership PACs,500,193300,193800
M001171,N00027891,Dan Maffei (D),2014,Lawyers/Law Firms,137400,40000,177400
M001171,N00027891,Dan Maffei (D),2014,Securities & Investment,102007,37500,139507
M001171,N00027891,Dan Maffei (D),2014,Health Professionals,21251,103500,124751
M001171,N00027891,Dan Maffei (D),2014,Lobbyists,108655,6700,115355
M001171,N00027891,Dan Maffei (D),2014,Insurance,8350,91000,99350
M001171,N00027891,Dan Maffei (D),2014,Education,90119,8500,98619
M001171,N00027891,Dan Maffei (D),2014,Candidate Committees,0,79250,79250
M001171,N00027891,Dan Maffei (D),2014,Public Sector Unions,0,75500,75500
M001171,N00027891,Dan Maffei (D),2014,Building Trade Unions,0,70500,70500
J000289,N00027894,Jim Jordan (R),2014,Misc Manufacturing & Distributing,25300,24500,49800
J000289,N00027894,Jim Jordan (R),2014,Insurance,8000,31500,39500
J000289,N00027894,Jim Jordan (R),2014,Electric Utilities,250,28000,28250
J000289,N00027894,Jim Jordan (R),2014,Automotive,7250,19000,26250
J000289,N00027894,Jim Jordan (R),2014,Crop Production & Basic Processing,23600,1000,24600
J000289,N00027894,Jim Jordan (R),2014,Telecom Services,500,23500,24000
J000289,N00027894,Jim Jordan (R),2014,Retired,23200,0,23200
J000289,N00027894,Jim Jordan (R),2014,Oil & Gas,3400,19500,22900
J000289,N00027894,Jim Jordan (R),2014,Health Professionals,15279,7000,22279
J000289,N00027894,Jim Jordan (R),2014,General Contractors,12000,9000,21000
S001170,N00028091,Carol Shea-Porter (D),2014,Leadership PACs,5200,153325,158525
S001170,N00028091,Carol Shea-Porter (D),2014,Women's Issues,120150,20500,140650
S001170,N00028091,Carol Shea-Porter (D),2014,Retired,131120,0,131120
S001170,N00028091,Carol Shea-Porter (D),2014,Public Sector Unions,0,88350,88350
S001170,N00028091,Carol Shea-Porter (D),2014,Candidate Committees,0,70984,70984
S001170,N00028091,Carol Shea-Porter (D),2014,Democratic/Liberal,55958,13958,69916
S001170,N00028091,Carol Shea-Porter (D),2014,Environment,32822,25237,58059
S001170,N00028091,Carol Shea-Porter (D),2014,Securities & Investment,49900,0,49900
S001170,N00028091,Carol Shea-Porter (D),2014,Industrial Unions,0,49000,49000
S001170,N00028091,Carol Shea-Porter (D),2014,Building Trade Unions,0,41000,41000
L000564,N00028133,Douglas L Lamborn (R),2014,Oil & Gas,1500,54500,56000
L000564,N00028133,Douglas L Lamborn (R),2014,Defense Aerospace,500,49000,49500
L000564,N00028133,Douglas L Lamborn (R),2014,Pro-Israel,30853,6500,37353
L000564,N00028133,Douglas L Lamborn (R),2014,Leadership PACs,0,26000,26000
L000564,N00028133,Douglas L Lamborn (R),2014,Defense Electronics,0,21000,21000
L000564,N00028133,Douglas L Lamborn (R),2014,Real Estate,13250,7500,20750
L000564,N00028133,Douglas L Lamborn (R),2014,Mining,1000,19000,20000
L000564,N00028133,Douglas L Lamborn (R),2014,Retired,19350,0,19350
L000564,N00028133,Douglas L Lamborn (R),2014,Health Professionals,3476,12500,15976
L000564,N00028133,Douglas L Lamborn (R),2014,Misc Finance,14600,0,14600
S001194,N00028138,Brian Schatz (D),2014,Lawyers/Law Firms,599827,55676,655503
S001194,N00028138,Brian Schatz (D),2014,Real Estate,339678,29500,369178
S001194,N00028138,Brian Schatz (D),2014,Leadership PACs,0,260700,260700
S001194,N00028138,Brian Schatz (D),2014,Securities & Investment,214870,11500,226370
S001194,N00028138,Brian Schatz (D),2014,Sea Transport,130950,58650,189600
S001194,N00028138,Brian Schatz (D),2014,Retired,150209,0,150209
S001194,N00028138,Brian Schatz (D),2014,Misc Finance,144049,0,144049
S001194,N00028138,Brian Schatz (D),2014,Pro-Israel,104550,35200,139750
S001194,N00028138,Brian Schatz (D),2014,Environment,109450,25254,134704
S001194,N00028138,Brian Schatz (D),2014,Lobbyists,114600,13050,127650
H001042,N00028139,Mazie K Hirono (D),2014,Lawyers/Law Firms,586619,44250,630869
H001042,N00028139,Mazie K Hirono (D),2014,Women's Issues,310272,29500,339772
H001042,N00028139,Mazie K Hirono (D),2014,Retired,209907,0,209907
H001042,N00028139,Mazie K Hirono (D),2014,Leadership PACs,1000,198000,199000
H001042,N00028139,Mazie K Hirono (D),2014,Real Estate,135098,14500,149598
H001042,N00028139,Mazie K Hirono (D),2014,Lobbyists,140894,6750,147644
H001042,N00028139,Mazie K Hirono (D),2014,Transportation Unions,1400,115500,116900
H001042,N00028139,Mazie K Hirono (D),2014,Sea Transport,66885,50000,116885
H001042,N00028139,Mazie K Hirono (D),2014,Public Sector Unions,300,112500,112800
H001042,N00028139,Mazie K Hirono (D),2014,Construction Services,73849,16500,90349
M001165,N00028152,Kevin McCarthy (R),2014,Securities & Investment,326238,167900,494138
M001165,N00028152,Kevin McCarthy (R),2014,Real Estate,290350,100500,390850
M001165,N00028152,Kevin McCarthy (R),2014,Oil & Gas,144800,182600,327400
M001165,N00028152,Kevin McCarthy (R),2014,Insurance,65720,221000,286720
M001165,N00028152,Kevin McCarthy (R),2014,Pharmaceuticals/Health Products,35900,206000,241900
M001165,N00028152,Kevin McCarthy (R),2014,Health Professionals,61300,179600,240900
M001165,N00028152,Kevin McCarthy (R),2014,Crop Production & Basic Processing,130300,70900,201200
M001165,N00028152,Kevin McCarthy (R),2014,Lawyers/Law Firms,141770,54750,196520
M001165,N00028152,Kevin McCarthy (R),2014,Commercial Banks,55950,86986,142936
M001165,N00028152,Kevin McCarthy (R),2014,Electronics Mfg & Equip,57800,75093,132893
E000290,N00028249,Donna Edwards (D),2014,Public Sector Unions,0,57250,57250
E000290,N00028249,Donna Edwards (D),2014,Air Transport,2500,40500,43000
E000290,N00028249,Donna Edwards (D),2014,Transportation Unions,0,41000,41000
E000290,N00028249,Donna Edwards (D),2014,Building Trade Unions,0,35500,35500
E000290,N00028249,Donna Edwards (D),2014,Non-Profit Institutions,30950,0,30950
E000290,N00028249,Donna Edwards (D),2014,Industrial Unions,0,30000,30000
E000290,N00028249,Donna Edwards (D),2014,Lawyers/Law Firms,16000,12000,28000
E000290,N00028249,Donna Edwards (D),2014,Railroads,0,26500,26500
E000290,N00028249,Donna Edwards (D),2014,Misc Unions,250,18500,18750
E000290,N00028249,Donna Edwards (D),2014,Defense Electronics,0,16000,16000
E000288,N00028257,Keith Ellison (D),2014,Health Professionals,106812,7000,113812
E000288,N00028257,Keith Ellison (D),2014,Lawyers/Law Firms,47350,27730,75080
E000288,N00028257,Keith Ellison (D),2014,Retired,59365,0,59365
E000288,N00028257,Keith Ellison (D),2014,Industrial Unions,0,51000,51000
E000288,N00028257,Keith Ellison (D),2014,Real Estate,30700,16000,46700
E000288,N00028257,Keith Ellison (D),2014,Public Sector Unions,0,45000,45000
E000288,N00028257,Keith Ellison (D),2014,Insurance,9100,27500,36600
E000288,N00028257,Keith Ellison (D),2014,Misc Unions,0,35750,35750
E000288,N00028257,Keith Ellison (D),2014,Securities & Investment,26300,1000,27300
E000288,N00028257,Keith Ellison (D),2014,Building Trade Unions,0,25000,25000
G000556,N00028418,Alan Grayson (D),2014,Retired,89424,0,89424
G000556,N00028418,Alan Grayson (D),2014,Lawyers/Law Firms,28550,21500,50050
G000556,N00028418,Alan Grayson (D),2014,Transportation Unions,0,45000,45000
G000556,N00028418,Alan Grayson (D),2014,Public Sector Unions,0,43500,43500
G000556,N00028418,Alan Grayson (D),2014,Industrial Unions,0,38500,38500
G000556,N00028418,Alan Grayson (D),2014,Education,37100,1000,38100
G000556,N00028418,Alan Grayson (D),2014,Building Trade Unions,0,37500,37500
G000556,N00028418,Alan Grayson (D),2014,Securities & Investment,32750,0,32750
G000556,N00028418,Alan Grayson (D),2014,Real Estate,14957,9000,23957
G000556,N00028418,Alan Grayson (D),2014,Misc Unions,0,21500,21500
R000582,N00028463,Phil Roe (R),2014,Health Professionals,86136,0,86136
R000582,N00028463,Phil Roe (R),2014,General Contractors,35400,0,35400
R000582,N00028463,Phil Roe (R),2014,Retired,25940,0,25940
R000582,N00028463,Phil Roe (R),2014,Securities & Investment,24800,-5000,19800
R000582,N00028463,Phil Roe (R),2014,Retail Sales,15900,0,15900
R000582,N00028463,Phil Roe (R),2014,Real Estate,13600,0,13600
R000582,N00028463,Phil Roe (R),2014,Food Processing & Sales,13500,0,13500
R000582,N00028463,Phil Roe (R),2014,Home Builders,10400,0,10400
R000582,N00028463,Phil Roe (R),2014,Misc Transport,10400,0,10400
R000582,N00028463,Phil Roe (R),2014,Chemical & Related Manufacturing,9200,0,9200
C001076,N00028958,Jason Chaffetz (R),2014,Retail Sales,8100,62500,70600
C001076,N00028958,Jason Chaffetz (R),2014,Electronics Mfg & Equip,5100,45988,51088
C001076,N00028958,Jason Chaffetz (R),2014,Misc Manufacturing & Distributing,25600,20999,46599
C001076,N00028958,Jason Chaffetz (R),2014,Lobbyists,41796,1000,42796
C001076,N00028958,Jason Chaffetz (R),2014,Commercial Banks,13650,28000,41650
C001076,N00028958,Jason Chaffetz (R),2014,Pharmaceuticals/Health Products,5250,34514,39764
C001076,N00028958,Jason Chaffetz (R),2014,Oil & Gas,7850,29000,36850
C001076,N00028958,Jason Chaffetz (R),2014,Securities & Investment,23600,13000,36600
C001076,N00028958,Jason Chaffetz (R),2014,Lawyers/Law Firms,12850,17500,30350
C001076,N00028958,Jason Chaffetz (R),2014,Hospitals/Nursing Homes,26900,2000,28900
B001262,N00028986,Paul Broun (R),2014,Retired,142900,0,142900
B001262,N00028986,Paul Broun (R),2014,Republican/Conservative,112754,19025,131779
B001262,N00028986,Paul Broun (R),2014,Health Professionals,63756,5500,69256
B001262,N00028986,Paul Broun (R),2014,Securities & Investment,42768,0,42768
B001262,N00028986,Paul Broun (R),2014,Real Estate,40300,0,40300
B001262,N00028986,Paul Broun (R),2014,Misc Finance,36445,0,36445
B001262,N00028986,Paul Broun (R),2014,Oil & Gas,29200,0,29200
B001262,N00028986,Paul Broun (R),2014,Lawyers/Law Firms,22700,5000,27700
B001262,N00028986,Paul Broun (R),2014,Chemical & Related Manufacturing,22100,0,22100
B001262,N00028986,Paul Broun (R),2014,Business Services,19700,0,19700
F000457,N00029016,Al Franken (D),2014,Lawyers/Law Firms,1393991,93938,1487929
F000457,N00029016,Al Franken (D),2014,Retired,1346859,0,1346859
F000457,N00029016,Al Franken (D),2014,TV/Movies/Music,586096,22004,608100
F000457,N00029016,Al Franken (D),2014,Securities & Investment,480291,11000,491291
F000457,N00029016,Al Franken (D),2014,Leadership PACs,750,386450,387200
F000457,N00029016,Al Franken (D),2014,Real Estate,330413,15010,345423
F000457,N00029016,Al Franken (D),2014,Health Professionals,190931,72400,263331
F000457,N00029016,Al Franken (D),2014,Democratic/Liberal,236905,20867,257772
F000457,N00029016,Al Franken (D),2014,Printing & Publishing,247094,2000,249094
F000457,N00029016,Al Franken (D),2014,Education,238100,2000,240100
R000583,N00029018,Tom Rooney (R),2014,Defense Aerospace,0,48500,48500
R000583,N00029018,Tom Rooney (R),2014,Crop Production & Basic Processing,12500,26500,39000
R000583,N00029018,Tom Rooney (R),2014,Accountants,1750,30500,32250
R000583,N00029018,Tom Rooney (R),2014,Real Estate,7350,21000,28350
R000583,N00029018,Tom Rooney (R),2014,Insurance,1000,24000,25000
R000583,N00029018,Tom Rooney (R),2014,Electric Utilities,5000,19250,24250
R000583,N00029018,Tom Rooney (R),2014,Lobbyists,15641,1500,17141
R000583,N00029018,Tom Rooney (R),2014,Misc Defense,2600,13500,16100
R000583,N00029018,Tom Rooney (R),2014,Retired,15230,0,15230
R000583,N00029018,Tom Rooney (R),2014,Lawyers/Law Firms,11483,3500,14983
T000465,N00029026,Niki Tsongas (D),2014,Lawyers/Law Firms,82400,9500,91900
T000465,N00029026,Niki Tsongas (D),2014,Real Estate,76400,7000,83400
T000465,N00029026,Niki Tsongas (D),2014,Retired,55100,0,55100
T000465,N00029026,Niki Tsongas (D),2014,Defense Aerospace,0,49000,49000
T000465,N00029026,Niki Tsongas (D),2014,Business Services,31050,3000,34050
T000465,N00029026,Niki Tsongas (D),2014,Building Trade Unions,0,30000,30000
T000465,N00029026,Niki Tsongas (D),2014,Misc Manufacturing & Distributing,15850,9500,25350
T000465,N00029026,Niki Tsongas (D),2014,Leadership PACs,0,24500,24500
T000465,N00029026,Niki Tsongas (D),2014,Non-Profit Institutions,22000,500,22500
T000465,N00029026,Niki Tsongas (D),2014,Pharmaceuticals/Health Products,9000,13000,22000
T000465,N00029026,Niki Tsongas (D),2014,Public Sector Unions,0,22000,22000
H001047,N00029070,Jim Himes (D),2014,Securities & Investment,324238,178000,502238
H001047,N00029070,Jim Himes (D),2014,Insurance,10750,187500,198250
H001047,N00029070,Jim Himes (D),2014,Retired,195100,0,195100
H001047,N00029070,Jim Himes (D),2014,Lawyers/Law Firms,110761,22000,132761
H001047,N00029070,Jim Himes (D),2014,Real Estate,71000,58000,129000
H001047,N00029070,Jim Himes (D),2014,Commercial Banks,36450,86000,122450
H001047,N00029070,Jim Himes (D),2014,Business Services,68100,2500,70600
H001047,N00029070,Jim Himes (D),2014,Misc Finance,52400,16500,68900
H001047,N00029070,Jim Himes (D),2014,Accountants,9000,50000,59000
H001047,N00029070,Jim Himes (D),2014,Misc Manufacturing & Distributing,27800,28500,56300
J000290,N00029077,Lynn Jenkins (R),2014,Leadership PACs,0,230348,230348
J000290,N00029077,Lynn Jenkins (R),2014,Health Professionals,36358,145000,181358
J000290,N00029077,Lynn Jenkins (R),2014,Oil & Gas,70500,74500,145000
J000290,N00029077,Lynn Jenkins (R),2014,Insurance,15250,119500,134750
J000290,N00029077,Lynn Jenkins (R),2014,Securities & Investment,35750,67800,103550
J000290,N00029077,Lynn Jenkins (R),2014,Real Estate,55394,45500,100894
J000290,N00029077,Lynn Jenkins (R),2014,Railroads,31800,47848,79648
J000290,N00029077,Lynn Jenkins (R),2014,Lawyers/Law Firms,42150,29500,71650
J000290,N00029077,Lynn Jenkins (R),2014,Accountants,8000,54000,62000
J000290,N00029077,Lynn Jenkins (R),2014,General Contractors,31450,30000,61450
P000598,N00029127,Jared Polis (D),2014,Securities & Investment,108150,-4500,103650
P000598,N00029127,Jared Polis (D),2014,Retired,81300,0,81300
P000598,N00029127,Jared Polis (D),2014,Lawyers/Law Firms,34900,4500,39400
P000598,N00029127,Jared Polis (D),2014,Real Estate,34430,0,34430
P000598,N00029127,Jared Polis (D),2014,Misc Finance,30100,0,30100
P000598,N00029127,Jared Polis (D),2014,Printing & Publishing,29382,0,29382
P000598,N00029127,Jared Polis (D),2014,Business Services,28348,0,28348
P000598,N00029127,Jared Polis (D),2014,Non-Profit Institutions,27000,0,27000
P000598,N00029127,Jared Polis (D),2014,Environment,19900,-500,19400
P000598,N00029127,Jared Polis (D),2014,Misc Business,17700,0,17700
F000454,N00029139,Bill Foster (D),2014,Education,316900,0,316900
F000454,N00029139,Bill Foster (D),2014,Lawyers/Law Firms,166852,26499,193351
F000454,N00029139,Bill Foster (D),2014,Retired,177624,0,177624
F000454,N00029139,Bill Foster (D),2014,Securities & Investment,96700,71000,167700
F000454,N00029139,Bill Foster (D),2014,Civil Servants/Public Officials,102815,0,102815
F000454,N00029139,Bill Foster (D),2014,Real Estate,55250,41000,96250
F000454,N00029139,Bill Foster (D),2014,Insurance,6900,78400,85300
F000454,N00029139,Bill Foster (D),2014,Pro-Israel,68350,4700,73050
F000454,N00029139,Bill Foster (D),2014,Building Trade Unions,400,59500,59900
F000454,N00029139,Bill Foster (D),2014,Leadership PACs,0,58100,58100
H001052,N00029147,Andy Harris (R),2014,Health Professionals,192915,130000,322915
H001052,N00029147,Andy Harris (R),2014,Retired,64915,0,64915
H001052,N00029147,Andy Harris (R),2014,Securities & Investment,37750,1000,38750
H001052,N00029147,Andy Harris (R),2014,Oil & Gas,2000,36000,38000
H001052,N00029147,Andy Harris (R),2014,Real Estate,26996,9000,35996
H001052,N00029147,Andy Harris (R),2014,Education,32650,1000,33650
H001052,N00029147,Andy Harris (R),2014,Food & Beverage,20880,12600,33480
H001052,N00029147,Andy Harris (R),2014,Hospitals/Nursing Homes,17400,10500,27900
H001052,N00029147,Andy Harris (R),2014,Lawyers/Law Firms,18250,2500,20750
H001052,N00029147,Andy Harris (R),2014,Electric Utilities,1000,17500,18500
P000596,N00029168,Pedro Pierluisi (D),2014,Lawyers/Law Firms,57950,13000,70950
P000596,N00029168,Pedro Pierluisi (D),2014,Health Professionals,19650,0,19650
P000596,N00029168,Pedro Pierluisi (D),2014,Business Services,17150,0,17150
P000596,N00029168,Pedro Pierluisi (D),2014,Retired,16400,0,16400
P000596,N00029168,Pedro Pierluisi (D),2014,Food Processing & Sales,15500,0,15500
P000596,N00029168,Pedro Pierluisi (D),2014,Insurance,14200,0,14200
P000596,N00029168,Pedro Pierluisi (D),2014,Accountants,11600,0,11600
P000596,N00029168,Pedro Pierluisi (D),2014,Food & Beverage,10400,1000,11400
P000596,N00029168,Pedro Pierluisi (D),2014,Construction Services,10350,1000,11350
P000596,N00029168,Pedro Pierluisi (D),2014,Printing & Publishing,10000,0,10000
H001048,N00029258,Duncan D Hunter (R),2014,Sea Transport,44600,67000,111600
H001048,N00029258,Duncan D Hunter (R),2014,Defense Aerospace,2000,70500,72500
H001048,N00029258,Duncan D Hunter (R),2014,Misc Defense,1500,66365,67865
H001048,N00029258,Duncan D Hunter (R),2014,Air Transport,1500,58250,59750
H001048,N00029258,Duncan D Hunter (R),2014,Defense Electronics,2000,56500,58500
H001048,N00029258,Duncan D Hunter (R),2014,Transportation Unions,0,57000,57000
H001048,N00029258,Duncan D Hunter (R),2014,Oil & Gas,35200,7500,42700
H001048,N00029258,Duncan D Hunter (R),2014,Trucking,13500,28500,42000
H001048,N00029258,Duncan D Hunter (R),2014,Real Estate,14600,27000,41600
H001048,N00029258,Duncan D Hunter (R),2014,Lobbyists,32641,2823,35464
K000368,N00029260,Ann Kirkpatrick (D),2014,Retired,228748,0,228748
K000368,N00029260,Ann Kirkpatrick (D),2014,Women's Issues,167457,35000,202457
K000368,N00029260,Ann Kirkpatrick (D),2014,Leadership PACs,2850,197350,200200
K000368,N00029260,Ann Kirkpatrick (D),2014,Lawyers/Law Firms,132566,20750,153316
K000368,N00029260,Ann Kirkpatrick (D),2014,Candidate Committees,0,97000,97000
K000368,N00029260,Ann Kirkpatrick (D),2014,Public Sector Unions,200,90000,90200
K000368,N00029260,Ann Kirkpatrick (D),2014,Transportation Unions,0,84500,84500
K000368,N00029260,Ann Kirkpatrick (D),2014,Health Professionals,17776,57000,74776
K000368,N00029260,Ann Kirkpatrick (D),2014,Building Trade Unions,0,58500,58500
K000368,N00029260,Ann Kirkpatrick (D),2014,Real Estate,45600,10500,56100
S001179,N00029273,Aaron Schock (R),2014,Securities & Investment,149150,85500,234650
S001179,N00029273,Aaron Schock (R),2014,Insurance,36660,156500,193160
S001179,N00029273,Aaron Schock (R),2014,Health Professionals,42100,138000,180100
S001179,N00029273,Aaron Schock (R),2014,Real Estate,49280,69500,118780
S001179,N00029273,Aaron Schock (R),2014,Retired,100570,0,100570
S001179,N00029273,Aaron Schock (R),2014,Pharmaceuticals/Health Products,2750,77000,79750
S001179,N00029273,Aaron Schock (R),2014,Food & Beverage,18900,52500,71400
S001179,N00029273,Aaron Schock (R),2014,Retail Sales,12750,51000,63750
S001179,N00029273,Aaron Schock (R),2014,Electric Utilities,12600,48450,61050
S001179,N00029273,Aaron Schock (R),2014,Accountants,14150,40000,54150
P000595,N00029277,Gary Peters (D),2014,Lawyers/Law Firms,1015517,52500,1068017
P000595,N00029277,Gary Peters (D),2014,Securities & Investment,467128,109500,576628
P000595,N00029277,Gary Peters (D),2014,Leadership PACs,83700,464850,548550
P000595,N00029277,Gary Peters (D),2014,Retired,510705,0,510705
P000595,N00029277,Gary Peters (D),2014,Environment,423660,29647,453307
P000595,N00029277,Gary Peters (D),2014,Real Estate,385100,57500,442600
P000595,N00029277,Gary Peters (D),2014,Health Professionals,291296,43500,334796
P000595,N00029277,Gary Peters (D),2014,Insurance,127750,157700,285450
P000595,N00029277,Gary Peters (D),2014,Education,279550,2250,281800
P000595,N00029277,Gary Peters (D),2014,Lobbyists,234951,8550,243501
O000168,N00029285,Pete Olson (R),2014,Oil & Gas,97350,132600,229950
O000168,N00029285,Pete Olson (R),2014,Health Professionals,51450,52750,104200
O000168,N00029285,Pete Olson (R),2014,Chemical & Related Manufacturing,6200,61999,68199
O000168,N00029285,Pete Olson (R),2014,Real Estate,49950,8500,58450
O000168,N00029285,Pete Olson (R),2014,Electric Utilities,8100,46499,54599
O000168,N00029285,Pete Olson (R),2014,Pharmaceuticals/Health Products,23800,23000,46800
O000168,N00029285,Pete Olson (R),2014,Lawyers/Law Firms,21951,24000,45951
O000168,N00029285,Pete Olson (R),2014,Automotive,8900,32500,41400
O000168,N00029285,Pete Olson (R),2014,Retired,38600,0,38600
O000168,N00029285,Pete Olson (R),2014,Insurance,9200,28500,37700
M001176,N00029303,Jeff Merkley (D),2014,Lawyers/Law Firms,402905,85698,488603
M001176,N00029303,Jeff Merkley (D),2014,Retired,425274,0,425274
M001176,N00029303,Jeff Merkley (D),2014,Leadership PACs,0,399600,399600
M001176,N00029303,Jeff Merkley (D),2014,Securities & Investment,214006,25500,239506
M001176,N00029303,Jeff Merkley (D),2014,Health Professionals,101116,102500,203616
M001176,N00029303,Jeff Merkley (D),2014,Real Estate,116498,82000,198498
M001176,N00029303,Jeff Merkley (D),2014,Education,168598,3000,171598
M001176,N00029303,Jeff Merkley (D),2014,Environment,127118,18681,145799
M001176,N00029303,Jeff Merkley (D),2014,Insurance,8550,136500,145050
M001176,N00029303,Jeff Merkley (D),2014,Lobbyists,130125,10000,140125
P000594,N00029391,Erik Paulsen (R),2014,Insurance,72325,186250,258575
P000594,N00029391,Erik Paulsen (R),2014,Pharmaceuticals/Health Products,75930,161249,237179
P000594,N00029391,Erik Paulsen (R),2014,Retired,224285,0,224285
P000594,N00029391,Erik Paulsen (R),2014,Health Professionals,67809,119010,186819
P000594,N00029391,Erik Paulsen (R),2014,Securities & Investment,107600,62500,170100
P000594,N00029391,Erik Paulsen (R),2014,Misc Manufacturing & Distributing,74200,42998,117198
P000594,N00029391,Erik Paulsen (R),2014,Lawyers/Law Firms,70750,31967,102717
P000594,N00029391,Erik Paulsen (R),2014,Commercial Banks,37450,52500,89950
P000594,N00029391,Erik Paulsen (R),2014,Real Estate,35675,44500,80175
P000594,N00029391,Erik Paulsen (R),2014,Accountants,19250,54000,73250
L000580,N00029400,Michelle Lujan Grisham (D),2014,Lawyers/Law Firms,166480,12000,178480
L000580,N00029400,Michelle Lujan Grisham (D),2014,Health Professionals,17616,142000,159616
L000580,N00029400,Michelle Lujan Grisham (D),2014,Retired,67706,0,67706
L000580,N00029400,Michelle Lujan Grisham (D),2014,Public Sector Unions,0,67500,67500
L000580,N00029400,Michelle Lujan Grisham (D),2014,Building Trade Unions,0,61000,61000
L000580,N00029400,Michelle Lujan Grisham (D),2014,Industrial Unions,0,51000,51000
L000580,N00029400,Michelle Lujan Grisham (D),2014,Leadership PACs,0,45000,45000
L000580,N00029400,Michelle Lujan Grisham (D),2014,Insurance,12650,31000,43650
L000580,N00029400,Michelle Lujan Grisham (D),2014,Lobbyists,41049,0,41049
L000580,N00029400,Michelle Lujan Grisham (D),2014,Women's Issues,36975,500,37475
R000584,N00029441,James E Risch (R),2014,Leadership PACs,0,196109,196109
R000584,N00029441,James E Risch (R),2014,Oil & Gas,20850,103750,124600
R000584,N00029441,James E Risch (R),2014,Insurance,5750,91250,97000
R000584,N00029441,James E Risch (R),2014,Retired,90166,0,90166
R000584,N00029441,James E Risch (R),2014,Pro-Israel,46860,32200,79060
R000584,N00029441,James E Risch (R),2014,Mining,43900,28750,72650
R000584,N00029441,James E Risch (R),2014,Misc Manufacturing & Distributing,42000,27000,69000
R000584,N00029441,James E Risch (R),2014,Securities & Investment,43550,24500,68050
R000584,N00029441,James E Risch (R),2014,Real Estate,34511,30000,64511
R000584,N00029441,James E Risch (R),2014,Commercial Banks,8750,52750,61500
J000291,N00029444,Mike Johanns (R),2014,Insurance,11750,42500,54250
J000291,N00029444,Mike Johanns (R),2014,Crop Production & Basic Processing,2250,35500,37750
J000291,N00029444,Mike Johanns (R),2014,Real Estate,13850,21000,34850
J000291,N00029444,Mike Johanns (R),2014,Securities & Investment,9704,24500,34204
J000291,N00029444,Mike Johanns (R),2014,Telecom Services,14500,19500,34000
J000291,N00029444,Mike Johanns (R),2014,Agricultural Services/Products,1500,31000,32500
J000291,N00029444,Mike Johanns (R),2014,Lobbyists,28141,1500,29641
J000291,N00029444,Mike Johanns (R),2014,Lawyers/Law Firms,7000,18000,25000
J000291,N00029444,Mike Johanns (R),2014,Air Transport,-500,22500,22000
J000291,N00029444,Mike Johanns (R),2014,Food Processing & Sales,500,20500,21000
C001072,N00029513,Andre Carson (D),2014,Lawyers/Law Firms,73071,18800,91871
C001072,N00029513,Andre Carson (D),2014,Health Professionals,73380,13000,86380
C001072,N00029513,Andre Carson (D),2014,Building Trade Unions,400,51750,52150
C001072,N00029513,Andre Carson (D),2014,Transportation Unions,0,47000,47000
C001072,N00029513,Andre Carson (D),2014,Industrial Unions,0,45000,45000
C001072,N00029513,Andre Carson (D),2014,Defense Aerospace,250,43000,43250
C001072,N00029513,Andre Carson (D),2014,Real Estate,28800,14000,42800
C001072,N00029513,Andre Carson (D),2014,Air Transport,500,34000,34500
C001072,N00029513,Andre Carson (D),2014,Construction Services,24550,6000,30550
C001072,N00029513,Andre Carson (D),2014,Pharmaceuticals/Health Products,12700,15500,28200
L000570,N00029562,Ben R Lujan (D),2014,Casinos/Gambling,78550,3500,82050
L000570,N00029562,Ben R Lujan (D),2014,Lawyers/Law Firms,57450,13500,70950
L000570,N00029562,Ben R Lujan (D),2014,Pharmaceuticals/Health Products,1000,54178,55178
L000570,N00029562,Ben R Lujan (D),2014,Health Professionals,4750,50000,54750
L000570,N00029562,Ben R Lujan (D),2014,Building Trade Unions,0,49500,49500
L000570,N00029562,Ben R Lujan (D),2014,Telecom Services,0,46000,46000
L000570,N00029562,Ben R Lujan (D),2014,Electric Utilities,2500,42250,44750
L000570,N00029562,Ben R Lujan (D),2014,Retired,39950,0,39950
L000570,N00029562,Ben R Lujan (D),2014,Telephone Utilities,1000,38500,39500
L000570,N00029562,Ben R Lujan (D),2014,Electronics Mfg & Equip,3100,33500,36600
S001187,N00029574,Steve Stivers (R),2014,Insurance,55861,234650,290511
S001187,N00029574,Steve Stivers (R),2014,Securities & Investment,107411,117200,224611
S001187,N00029574,Steve Stivers (R),2014,Real Estate,75650,78000,153650
S001187,N00029574,Steve Stivers (R),2014,Commercial Banks,21500,131500,153000
S001187,N00029574,Steve Stivers (R),2014,Health Professionals,11950,119850,131800
S001187,N00029574,Steve Stivers (R),2014,Finance/Credit Companies,22200,85000,107200
S001187,N00029574,Steve Stivers (R),2014,Electric Utilities,49150,58000,107150
S001187,N00029574,Steve Stivers (R),2014,Retail Sales,25900,47000,72900
S001187,N00029574,Steve Stivers (R),2014,Lawyers/Law Firms,33950,38750,72700
S001187,N00029574,Steve Stivers (R),2014,Pharmaceuticals/Health Products,3600,63300,66900
H001049,N00029617,Kay R Hagan (D),2014,Retired,1306854,0,1306854
H001049,N00029617,Kay R Hagan (D),2014,Lawyers/Law Firms,785810,169350,955160
H001049,N00029617,Kay R Hagan (D),2014,Women's Issues,761762,34607,796369
H001049,N00029617,Kay R Hagan (D),2014,Securities & Investment,349393,233833,583226
H001049,N00029617,Kay R Hagan (D),2014,Pharmaceuticals/Health Products,128949,391559,520508
H001049,N00029617,Kay R Hagan (D),2014,Leadership PACs,2600,504100,506700
H001049,N00029617,Kay R Hagan (D),2014,Education,397943,8500,406443
H001049,N00029617,Kay R Hagan (D),2014,Insurance,85510,274500,360010
H001049,N00029617,Kay R Hagan (D),2014,Real Estate,209376,96800,306176
H001049,N00029617,Kay R Hagan (D),2014,Commercial Banks,122680,153000,275680
H001045,N00029632,Gregg Harper (R),2014,Oil & Gas,73050,60500,133550
H001045,N00029632,Gregg Harper (R),2014,Health Professionals,66150,53000,119150
H001045,N00029632,Gregg Harper (R),2014,Lawyers/Law Firms,45550,15000,60550
H001045,N00029632,Gregg Harper (R),2014,Electric Utilities,1250,54000,55250
H001045,N00029632,Gregg Harper (R),2014,Real Estate,40550,8000,48550
H001045,N00029632,Gregg Harper (R),2014,Retired,44150,0,44150
H001045,N00029632,Gregg Harper (R),2014,Commercial Banks,11750,30500,42250
H001045,N00029632,Gregg Harper (R),2014,General Contractors,31250,1000,32250
H001045,N00029632,Gregg Harper (R),2014,Defense Aerospace,5000,26500,31500
H001045,N00029632,Gregg Harper (R),2014,Telephone Utilities,6750,21000,27750
S001175,N00029649,Jackie Speier (D),2014,Retired,78753,0,78753
S001175,N00029649,Jackie Speier (D),2014,Health Professionals,12462,51100,63562
S001175,N00029649,Jackie Speier (D),2014,Lawyers/Law Firms,47800,13500,61300
S001175,N00029649,Jackie Speier (D),2014,Pharmaceuticals/Health Products,12200,41500,53700
S001175,N00029649,Jackie Speier (D),2014,Securities & Investment,48250,3000,51250
S001175,N00029649,Jackie Speier (D),2014,Retail Sales,1050,47500,48550
S001175,N00029649,Jackie Speier (D),2014,Building Trade Unions,0,40000,40000
S001175,N00029649,Jackie Speier (D),2014,Real Estate,28520,8000,36520
S001175,N00029649,Jackie Speier (D),2014,Education,35699,0,35699
S001175,N00029649,Jackie Speier (D),2014,Health Services/HMOs,15750,15000,30750
P000599,N00029662,Bill Posey (R),2014,Retired,97392,0,97392
P000599,N00029662,Bill Posey (R),2014,Health Professionals,21900,52000,73900
P000599,N00029662,Bill Posey (R),2014,Real Estate,25700,27000,52700
P000599,N00029662,Bill Posey (R),2014,Securities & Investment,26550,19500,46050
P000599,N00029662,Bill Posey (R),2014,Insurance,2500,43500,46000
P000599,N00029662,Bill Posey (R),2014,Commercial Banks,9500,36500,46000
P000599,N00029662,Bill Posey (R),2014,Defense Electronics,22000,19000,41000
P000599,N00029662,Bill Posey (R),2014,Lawyers/Law Firms,21000,16500,37500
P000599,N00029662,Bill Posey (R),2014,Tobacco,22700,13762,36462
P000599,N00029662,Bill Posey (R),2014,Defense Aerospace,3100,33000,36100
G000558,N00029675,Brett Guthrie (R),2014,Health Professionals,19950,210500,230450
G000558,N00029675,Brett Guthrie (R),2014,Pharmaceuticals/Health Products,18382,152700,171082
G000558,N00029675,Brett Guthrie (R),2014,Telecom Services,2250,65000,67250
G000558,N00029675,Brett Guthrie (R),2014,Oil & Gas,2250,62500,64750
G000558,N00029675,Brett Guthrie (R),2014,Health Services/HMOs,6250,55000,61250
G000558,N00029675,Brett Guthrie (R),2014,Lobbyists,59700,500,60200
G000558,N00029675,Brett Guthrie (R),2014,Insurance,5250,54500,59750
G000558,N00029675,Brett Guthrie (R),2014,Retail Sales,21250,29500,50750
G000558,N00029675,Brett Guthrie (R),2014,Retired,50230,0,50230
G000558,N00029675,Brett Guthrie (R),2014,Telephone Utilities,1500,39000,40500
F000456,N00029679,John Fleming (R),2014,Health Professionals,123027,66000,189027
F000456,N00029679,John Fleming (R),2014,Oil & Gas,138950,38500,177450
F000456,N00029679,John Fleming (R),2014,Hospitals/Nursing Homes,60650,0,60650
F000456,N00029679,John Fleming (R),2014,Real Estate,51700,4000,55700
F000456,N00029679,John Fleming (R),2014,Retired,54300,0,54300
F000456,N00029679,John Fleming (R),2014,Insurance,39296,15000,54296
F000456,N00029679,John Fleming (R),2014,Crop Production & Basic Processing,24850,17500,42350
F000456,N00029679,John Fleming (R),2014,General Contractors,26950,5500,32450
F000456,N00029679,John Fleming (R),2014,Lawyers/Law Firms,29900,2000,31900
F000456,N00029679,John Fleming (R),2014,Forestry & Forest Products,29400,0,29400
T000467,N00029736,Glenn Thompson (R),2014,Oil & Gas,36280,68700,104980
T000467,N00029736,Glenn Thompson (R),2014,Retired,71410,0,71410
T000467,N00029736,Glenn Thompson (R),2014,Real Estate,48097,9000,57097
T000467,N00029736,Glenn Thompson (R),2014,Health Professionals,24540,21500,46040
T000467,N00029736,Glenn Thompson (R),2014,Hospitals/Nursing Homes,29300,9500,38800
T000467,N00029736,Glenn Thompson (R),2014,Lawyers/Law Firms,32341,5500,37841
T000467,N00029736,Glenn Thompson (R),2014,Forestry & Forest Products,5269,32500,37769
T000467,N00029736,Glenn Thompson (R),2014,Electric Utilities,5100,32500,37600
T000467,N00029736,Glenn Thompson (R),2014,Insurance,15140,16500,31640
T000467,N00029736,Glenn Thompson (R),2014,Building Materials & Equipment,26000,5000,31000
L000571,N00029788,Cynthia Marie Lummis (R),2014,Oil & Gas,11800,79000,90800
L000571,N00029788,Cynthia Marie Lummis (R),2014,Mining,0,29500,29500
L000571,N00029788,Cynthia Marie Lummis (R),2014,Leadership PACs,0,22250,22250
L000571,N00029788,Cynthia Marie Lummis (R),2014,Crop Production & Basic Processing,500,17000,17500
L000571,N00029788,Cynthia Marie Lummis (R),2014,Real Estate,6750,7000,13750
L000571,N00029788,Cynthia Marie Lummis (R),2014,Electric Utilities,0,13500,13500
L000571,N00029788,Cynthia Marie Lummis (R),2014,Commercial Banks,500,12000,12500
L000571,N00029788,Cynthia Marie Lummis (R),2014,"Beer, Wine & Liquor",0,12000,12000
L000571,N00029788,Cynthia Marie Lummis (R),2014,Lawyers/Law Firms,7750,4000,11750
L000571,N00029788,Cynthia Marie Lummis (R),2014,Railroads,0,11500,11500
H001046,N00029835,Martin Heinrich (D),2014,Lawyers/Law Firms,577566,58925,636491
H001046,N00029835,Martin Heinrich (D),2014,Retired,508275,0,508275
H001046,N00029835,Martin Heinrich (D),2014,Lobbyists,291718,1474,293192
H001046,N00029835,Martin Heinrich (D),2014,Environment,217603,29666,247269
H001046,N00029835,Martin Heinrich (D),2014,Leadership PACs,0,222500,222500
H001046,N00029835,Martin Heinrich (D),2014,Health Professionals,108166,78500,186666
H001046,N00029835,Martin Heinrich (D),2014,Pro-Israel,134380,23993,158373
H001046,N00029835,Martin Heinrich (D),2014,Education,141243,3500,144743
H001046,N00029835,Martin Heinrich (D),2014,Casinos/Gambling,130850,8500,139350
H001046,N00029835,Martin Heinrich (D),2014,Real Estate,97465,18260,115725
C001078,N00029891,Gerry Connolly (D),2014,Electronics Mfg & Equip,30550,79500,110050
C001078,N00029891,Gerry Connolly (D),2014,Public Sector Unions,250,108500,108750
C001078,N00029891,Gerry Connolly (D),2014,Retired,84221,0,84221
C001078,N00029891,Gerry Connolly (D),2014,Business Services,62250,14000,76250
C001078,N00029891,Gerry Connolly (D),2014,Real Estate,55450,15500,70950
C001078,N00029891,Gerry Connolly (D),2014,Lobbyists,58151,1000,59151
C001078,N00029891,Gerry Connolly (D),2014,Lawyers/Law Firms,28866,24750,53616
C001078,N00029891,Gerry Connolly (D),2014,Defense Electronics,5330,46000,51330
C001078,N00029891,Gerry Connolly (D),2014,Defense Aerospace,8650,40000,48650
C001078,N00029891,Gerry Connolly (D),2014,Transportation Unions,250,47000,47250
B001265,N00029901,Mark Begich (D),2014,Lawyers/Law Firms,801884,180843,982727
B001265,N00029901,Mark Begich (D),2014,Leadership PACs,2600,477200,479800
B001265,N00029901,Mark Begich (D),2014,Lobbyists,417646,12500,430146
B001265,N00029901,Mark Begich (D),2014,Oil & Gas,198597,196000,394597
B001265,N00029901,Mark Begich (D),2014,Real Estate,287425,68471,355896
B001265,N00029901,Mark Begich (D),2014,Retired,345833,0,345833
B001265,N00029901,Mark Begich (D),2014,Securities & Investment,263450,44000,307450
B001265,N00029901,Mark Begich (D),2014,Health Professionals,137100,88400,225500
B001265,N00029901,Mark Begich (D),2014,TV/Movies/Music,166650,43000,209650
B001265,N00029901,Mark Begich (D),2014,Democratic/Liberal,151757,37313,189070
G000573,N00029908,Joe Garcia (D),2014,Lawyers/Law Firms,381460,43345,424805
G000573,N00029908,Joe Garcia (D),2014,Leadership PACs,15600,195792,211392
G000573,N00029908,Joe Garcia (D),2014,Retired,193649,0,193649
G000573,N00029908,Joe Garcia (D),2014,Real Estate,172063,12000,184063
G000573,N00029908,Joe Garcia (D),2014,Securities & Investment,117000,7000,124000
G000573,N00029908,Joe Garcia (D),2014,Candidate Committees,0,95000,95000
G000573,N00029908,Joe Garcia (D),2014,Pro-Israel,70638,9665,80303
G000573,N00029908,Joe Garcia (D),2014,Health Professionals,60875,11500,72375
G000573,N00029908,Joe Garcia (D),2014,Public Sector Unions,0,71000,71000
G000573,N00029908,Joe Garcia (D),2014,General Contractors,68544,0,68544
L000569,N00030026,Blaine Luetkemeyer (R),2014,Commercial Banks,38900,111850,150750
L000569,N00030026,Blaine Luetkemeyer (R),2014,Insurance,9200,116000,125200
L000569,N00030026,Blaine Luetkemeyer (R),2014,Finance/Credit Companies,27000,66000,93000
L000569,N00030026,Blaine Luetkemeyer (R),2014,Securities & Investment,9100,54500,63600
L000569,N00030026,Blaine Luetkemeyer (R),2014,Agricultural Services/Products,18000,25500,43500
L000569,N00030026,Blaine Luetkemeyer (R),2014,Real Estate,14270,28000,42270
L000569,N00030026,Blaine Luetkemeyer (R),2014,Retired,40590,0,40590
L000569,N00030026,Blaine Luetkemeyer (R),2014,Crop Production & Basic Processing,2548,37500,40048
L000569,N00030026,Blaine Luetkemeyer (R),2014,Health Professionals,9750,28000,37750
L000569,N00030026,Blaine Luetkemeyer (R),2014,Misc Manufacturing & Distributing,13850,22500,36350
S001180,N00030071,Kurt Schrader (D),2014,Agricultural Services/Products,18400,86500,104900
S001180,N00030071,Kurt Schrader (D),2014,Health Professionals,15300,72000,87300
S001180,N00030071,Kurt Schrader (D),2014,Forestry & Forest Products,38800,47000,85800
S001180,N00030071,Kurt Schrader (D),2014,Retired,69390,0,69390
S001180,N00030071,Kurt Schrader (D),2014,Pharmaceuticals/Health Products,0,66000,66000
S001180,N00030071,Kurt Schrader (D),2014,Building Trade Unions,0,51000,51000
S001180,N00030071,Kurt Schrader (D),2014,Misc Manufacturing & Distributing,19900,29500,49400
S001180,N00030071,Kurt Schrader (D),2014,Insurance,5400,43500,48900
S001180,N00030071,Kurt Schrader (D),2014,Lawyers/Law Firms,35523,12000,47523
S001180,N00030071,Kurt Schrader (D),2014,Transportation Unions,0,43000,43000
R000588,N00030184,Cedric Richmond (D),2014,Lawyers/Law Firms,95885,48659,144544
R000588,N00030184,Cedric Richmond (D),2014,Oil & Gas,7700,45000,52700
R000588,N00030184,Cedric Richmond (D),2014,Transportation Unions,0,50000,50000
R000588,N00030184,Cedric Richmond (D),2014,Public Sector Unions,0,42000,42000
R000588,N00030184,Cedric Richmond (D),2014,Lobbyists,37523,1500,39023
R000588,N00030184,Cedric Richmond (D),2014,Telecom Services,500,37500,38000
R000588,N00030184,Cedric Richmond (D),2014,Electric Utilities,0,38000,38000
R000588,N00030184,Cedric Richmond (D),2014,Sea Transport,9200,27000,36200
R000588,N00030184,Cedric Richmond (D),2014,Building Trade Unions,0,35500,35500
R000588,N00030184,Cedric Richmond (D),2014,Health Professionals,15250,18650,33900
T000468,N00030191,Dina Titus (D),2014,Lawyers/Law Firms,48750,22550,71300
T000468,N00030191,Dina Titus (D),2014,Real Estate,38100,20500,58600
T000468,N00030191,Dina Titus (D),2014,Casinos/Gambling,26350,25000,51350
T000468,N00030191,Dina Titus (D),2014,Building Trade Unions,0,46000,46000
T000468,N00030191,Dina Titus (D),2014,Transportation Unions,0,42500,42500
T000468,N00030191,Dina Titus (D),2014,Retired,38650,0,38650
T000468,N00030191,Dina Titus (D),2014,Industrial Unions,0,34500,34500
T000468,N00030191,Dina Titus (D),2014,Misc Unions,0,31000,31000
T000468,N00030191,Dina Titus (D),2014,Women's Issues,22450,7000,29450
T000468,N00030191,Dina Titus (D),2014,Public Sector Unions,0,24000,24000
T000469,N00030196,Paul Tonko (D),2014,Health Professionals,12400,101650,114050
T000469,N00030196,Paul Tonko (D),2014,Building Trade Unions,0,50000,50000
T000469,N00030196,Paul Tonko (D),2014,Public Sector Unions,0,48500,48500
T000469,N00030196,Paul Tonko (D),2014,Lawyers/Law Firms,27792,19750,47542
T000469,N00030196,Paul Tonko (D),2014,Industrial Unions,0,37000,37000
T000469,N00030196,Paul Tonko (D),2014,Telecom Services,0,33000,33000
T000469,N00030196,Paul Tonko (D),2014,Insurance,1000,29500,30500
T000469,N00030196,Paul Tonko (D),2014,Pharmaceuticals/Health Products,250,21848,22098
T000469,N00030196,Paul Tonko (D),2014,Electric Utilities,1250,20250,21500
T000469,N00030196,Paul Tonko (D),2014,Transportation Unions,0,21000,21000
H001051,N00030197,Richard Hanna (R),2014,Leadership PACs,0,75000,75000
H001051,N00030197,Richard Hanna (R),2014,Securities & Investment,48550,7500,56050
H001051,N00030197,Richard Hanna (R),2014,Air Transport,750,50000,50750
H001051,N00030197,Richard Hanna (R),2014,General Contractors,31690,17500,49190
H001051,N00030197,Richard Hanna (R),2014,Health Professionals,5000,30000,35000
H001051,N00030197,Richard Hanna (R),2014,Construction Services,500,31500,32000
H001051,N00030197,Richard Hanna (R),2014,Building Trade Unions,0,28500,28500
H001051,N00030197,Richard Hanna (R),2014,Insurance,4300,21750,26050
H001051,N00030197,Richard Hanna (R),2014,Transportation Unions,0,26000,26000
H001051,N00030197,Richard Hanna (R),2014,Lobbyists,24850,500,25350
C001075,N00030245,Bill Cassidy (R),2014,Health Professionals,812165,320600,1132765
C001075,N00030245,Bill Cassidy (R),2014,Retired,1091541,0,1091541
C001075,N00030245,Bill Cassidy (R),2014,Securities & Investment,937076,2500,939576
C001075,N00030245,Bill Cassidy (R),2014,Oil & Gas,641170,106500,747670
C001075,N00030245,Bill Cassidy (R),2014,Leadership PACs,0,614162,614162
C001075,N00030245,Bill Cassidy (R),2014,Real Estate,402150,5400,407550
C001075,N00030245,Bill Cassidy (R),2014,Republican/Conservative,195208,109714,304922
C001075,N00030245,Bill Cassidy (R),2014,Lawyers/Law Firms,240585,10500,251085
C001075,N00030245,Bill Cassidy (R),2014,General Contractors,211200,33500,244700
C001075,N00030245,Bill Cassidy (R),2014,Misc Finance,241467,1000,242467
S001177,N00030418,Gregorio Sablan (I),2014,Retired,9075,0,9075
S001177,N00030418,Gregorio Sablan (I),2014,Misc Finance,6100,0,6100
S001177,N00030418,Gregorio Sablan (I),2014,Misc Business,6050,0,6050
S001177,N00030418,Gregorio Sablan (I),2014,Human Rights,0,5000,5000
S001177,N00030418,Gregorio Sablan (I),2014,Securities & Investment,4950,0,4950
S001177,N00030418,Gregorio Sablan (I),2014,Lawyers/Law Firms,2450,0,2450
S001177,N00030418,Gregorio Sablan (I),2014,Commercial Banks,2000,0,2000
S001177,N00030418,Gregorio Sablan (I),2014,Democratic/Liberal,1921,0,1921
S001177,N00030418,Gregorio Sablan (I),2014,Livestock,1600,0,1600
S001177,N00030418,Gregorio Sablan (I),2014,Leadership PACs,0,1000,1000
F000455,N00030490,Marcia L Fudge (D),2014,Food & Beverage,4400,43000,47400
F000455,N00030490,Marcia L Fudge (D),2014,Pro-Israel,35452,9200,44652
F000455,N00030490,Marcia L Fudge (D),2014,Lawyers/Law Firms,15719,27850,43569
F000455,N00030490,Marcia L Fudge (D),2014,Pharmaceuticals/Health Products,0,43000,43000
F000455,N00030490,Marcia L Fudge (D),2014,Agricultural Services/Products,0,42000,42000
F000455,N00030490,Marcia L Fudge (D),2014,Public Sector Unions,0,42000,42000
F000455,N00030490,Marcia L Fudge (D),2014,Electric Utilities,500,41000,41500
F000455,N00030490,Marcia L Fudge (D),2014,Industrial Unions,0,41000,41000
F000455,N00030490,Marcia L Fudge (D),2014,Transportation Unions,0,36000,36000
F000455,N00030490,Marcia L Fudge (D),2014,Food Processing & Sales,1250,34000,35250
Q000023,N00030581,Mike Quigley (D),2014,Lawyers/Law Firms,79156,18000,97156
Q000023,N00030581,Mike Quigley (D),2014,Securities & Investment,37350,17000,54350
Q000023,N00030581,Mike Quigley (D),2014,Real Estate,39651,11500,51151
Q000023,N00030581,Mike Quigley (D),2014,Railroads,0,38500,38500
Q000023,N00030581,Mike Quigley (D),2014,Lodging/Tourism,0,31000,31000
Q000023,N00030581,Mike Quigley (D),2014,Accountants,2000,27000,29000
Q000023,N00030581,Mike Quigley (D),2014,Insurance,4000,20500,24500
Q000023,N00030581,Mike Quigley (D),2014,Public Sector Unions,0,22500,22500
Q000023,N00030581,Mike Quigley (D),2014,Business Services,17400,5000,22400
Q000023,N00030581,Mike Quigley (D),2014,Retired,22035,0,22035
C001080,N00030600,Judy Chu (D),2014,Lawyers/Law Firms,38290,16000,54290
C001080,N00030600,Judy Chu (D),2014,Health Professionals,34708,10500,45208
C001080,N00030600,Judy Chu (D),2014,Misc Unions,250,44750,45000
C001080,N00030600,Judy Chu (D),2014,Real Estate,35000,6000,41000
C001080,N00030600,Judy Chu (D),2014,TV/Movies/Music,8700,32000,40700
C001080,N00030600,Judy Chu (D),2014,Building Trade Unions,0,38100,38100
C001080,N00030600,Judy Chu (D),2014,Retired,36461,0,36461
C001080,N00030600,Judy Chu (D),2014,Public Sector Unions,0,34750,34750
C001080,N00030600,Judy Chu (D),2014,Pharmaceuticals/Health Products,14000,9000,23000
C001080,N00030600,Judy Chu (D),2014,Insurance,14450,8000,22450
B001267,N00030608,Michael F Bennet (D),2014,Securities & Investment,1470924,161500,1632424
B001267,N00030608,Michael F Bennet (D),2014,Lawyers/Law Firms,1348113,195551,1543664
B001267,N00030608,Michael F Bennet (D),2014,Retired,702514,0,702514
B001267,N00030608,Michael F Bennet (D),2014,Real Estate,533070,98000,631070
B001267,N00030608,Michael F Bennet (D),2014,Lobbyists,392907,19650,412557
B001267,N00030608,Michael F Bennet (D),2014,Misc Finance,343607,19000,362607
B001267,N00030608,Michael F Bennet (D),2014,Education,317805,38100,355905
B001267,N00030608,Michael F Bennet (D),2014,Leadership PACs,250,355262,355512
B001267,N00030608,Michael F Bennet (D),2014,Business Services,332951,17000,349951
B001267,N00030608,Michael F Bennet (D),2014,TV/Movies/Music,288216,35500,323716
R000595,N00030612,Marco Rubio (R),2014,Retired,2918542,0,2918542
R000595,N00030612,Marco Rubio (R),2014,Securities & Investment,1137113,51400,1188513
R000595,N00030612,Marco Rubio (R),2014,Republican/Conservative,1021228,70771,1091999
R000595,N00030612,Marco Rubio (R),2014,Real Estate,783584,40800,824384
R000595,N00030612,Marco Rubio (R),2014,Lawyers/Law Firms,462007,91493,553500
R000595,N00030612,Marco Rubio (R),2014,Misc Finance,545976,2000,547976
R000595,N00030612,Marco Rubio (R),2014,Insurance,310690,194250,504940
R000595,N00030612,Marco Rubio (R),2014,Health Professionals,436639,61500,498139
R000595,N00030612,Marco Rubio (R),2014,Leadership PACs,96494,268766,365260
R000595,N00030612,Marco Rubio (R),2014,General Contractors,337815,20500,358315
S001185,N00030622,Terri A Sewell (D),2014,Lawyers/Law Firms,98957,43500,142457
S001185,N00030622,Terri A Sewell (D),2014,Insurance,11600,129000,140600
S001185,N00030622,Terri A Sewell (D),2014,Securities & Investment,27500,94500,122000
S001185,N00030622,Terri A Sewell (D),2014,Commercial Banks,10750,76250,87000
S001185,N00030622,Terri A Sewell (D),2014,Real Estate,8300,50000,58300
S001185,N00030622,Terri A Sewell (D),2014,Accountants,2900,38952,41852
S001185,N00030622,Terri A Sewell (D),2014,Leadership PACs,0,36000,36000
S001185,N00030622,Terri A Sewell (D),2014,Building Trade Unions,0,35000,35000
S001185,N00030622,Terri A Sewell (D),2014,Building Materials & Equipment,9300,25000,34300
S001185,N00030622,Terri A Sewell (D),2014,Industrial Unions,0,33500,33500
R000593,N00030645,Dennis Ross (R),2014,Insurance,8300,173000,181300
R000593,N00030645,Dennis Ross (R),2014,Real Estate,73958,64250,138208
R000593,N00030645,Dennis Ross (R),2014,Securities & Investment,2850,87500,90350
R000593,N00030645,Dennis Ross (R),2014,Commercial Banks,2250,78250,80500
R000593,N00030645,Dennis Ross (R),2014,Accountants,4850,47500,52350
R000593,N00030645,Dennis Ross (R),2014,Finance/Credit Companies,6700,42000,48700
R000593,N00030645,Dennis Ross (R),2014,Retail Sales,5650,39000,44650
R000593,N00030645,Dennis Ross (R),2014,Food Processing & Sales,17600,15500,33100
R000593,N00030645,Dennis Ross (R),2014,Lawyers/Law Firms,17133,15500,32633
R000593,N00030645,Dennis Ross (R),2014,Oil & Gas,1000,31500,32500
K000378,N00030667,Adam Kinzinger (R),2014,Health Professionals,40100,54000,94100
K000378,N00030667,Adam Kinzinger (R),2014,Electric Utilities,16000,76150,92150
K000378,N00030667,Adam Kinzinger (R),2014,Insurance,22350,64000,86350
K000378,N00030667,Adam Kinzinger (R),2014,Oil & Gas,16100,64500,80600
K000378,N00030667,Adam Kinzinger (R),2014,Pharmaceuticals/Health Products,3000,71500,74500
K000378,N00030667,Adam Kinzinger (R),2014,Leadership PACs,0,72457,72457
K000378,N00030667,Adam Kinzinger (R),2014,Securities & Investment,59472,8000,67472
K000378,N00030667,Adam Kinzinger (R),2014,Retired,60306,0,60306
K000378,N00030667,Adam Kinzinger (R),2014,Telecom Services,5083,53000,58083
K000378,N00030667,Adam Kinzinger (R),2014,Lawyers/Law Firms,33852,21273,55125
H001058,N00030673,Bill Huizenga (R),2014,Insurance,4250,142000,146250
H001058,N00030673,Bill Huizenga (R),2014,Misc Manufacturing & Distributing,97200,11054,108254
H001058,N00030673,Bill Huizenga (R),2014,Securities & Investment,31950,65000,96950
H001058,N00030673,Bill Huizenga (R),2014,Real Estate,28300,60000,88300
H001058,N00030673,Bill Huizenga (R),2014,Commercial Banks,3750,83100,86850
H001058,N00030673,Bill Huizenga (R),2014,Retired,47480,0,47480
H001058,N00030673,Bill Huizenga (R),2014,Accountants,0,40911,40911
H001058,N00030673,Bill Huizenga (R),2014,Finance/Credit Companies,0,40000,40000
H001058,N00030673,Bill Huizenga (R),2014,Leadership PACs,500,38200,38700
H001058,N00030673,Bill Huizenga (R),2014,Retail Sales,21600,13500,35100
L000576,N00030676,Billy Long (R),2014,Health Professionals,27950,57000,84950
L000576,N00030676,Billy Long (R),2014,Automotive,40400,23500,63900
L000576,N00030676,Billy Long (R),2014,Electric Utilities,0,51300,51300
L000576,N00030676,Billy Long (R),2014,Real Estate,39900,9990,49890
L000576,N00030676,Billy Long (R),2014,Retired,45650,0,45650
L000576,N00030676,Billy Long (R),2014,Oil & Gas,6200,38650,44850
L000576,N00030676,Billy Long (R),2014,Misc Finance,42750,2000,44750
L000576,N00030676,Billy Long (R),2014,Misc Manufacturing & Distributing,19100,22056,41156
L000576,N00030676,Billy Long (R),2014,TV/Movies/Music,10300,26270,36570
L000576,N00030676,Billy Long (R),2014,Telecom Services,0,36500,36500
D000617,N00030693,Suzan DelBene (D),2014,Leadership PACs,20700,155354,176054
D000617,N00030693,Suzan DelBene (D),2014,Electronics Mfg & Equip,108600,46635,155235
D000617,N00030693,Suzan DelBene (D),2014,Retired,151900,0,151900
D000617,N00030693,Suzan DelBene (D),2014,Lawyers/Law Firms,49650,23750,73400
D000617,N00030693,Suzan DelBene (D),2014,Retail Sales,19650,46000,65650
D000617,N00030693,Suzan DelBene (D),2014,Public Sector Unions,0,64500,64500
D000617,N00030693,Suzan DelBene (D),2014,Securities & Investment,28725,35000,63725
D000617,N00030693,Suzan DelBene (D),2014,Building Trade Unions,0,57000,57000
D000617,N00030693,Suzan DelBene (D),2014,Business Services,50669,5500,56169
D000617,N00030693,Suzan DelBene (D),2014,Lobbyists,53850,1000,54850
D000623,N00030709,Mark Desaulnier (D),2014,Public Sector Unions,0,53000,53000
D000623,N00030709,Mark Desaulnier (D),2014,Building Trade Unions,0,49600,49600
D000623,N00030709,Mark Desaulnier (D),2014,Lawyers/Law Firms,20800,11000,31800
D000623,N00030709,Mark Desaulnier (D),2014,Industrial Unions,0,31000,31000
D000623,N00030709,Mark Desaulnier (D),2014,Health Professionals,1750,20000,21750
D000623,N00030709,Mark Desaulnier (D),2014,Transportation Unions,0,21500,21500
D000623,N00030709,Mark Desaulnier (D),2014,Retired,19650,0,19650
D000623,N00030709,Mark Desaulnier (D),2014,Leadership PACs,0,19100,19100
D000623,N00030709,Mark Desaulnier (D),2014,Real Estate,7450,10000,17450
D000623,N00030709,Mark Desaulnier (D),2014,Misc Unions,0,16600,16600
B001287,N00030717,Ami Bera (D),2014,Retired,358032,0,358032
B001287,N00030717,Ami Bera (D),2014,Health Professionals,100081,230500,330581
B001287,N00030717,Ami Bera (D),2014,Leadership PACs,21200,268952,290152
B001287,N00030717,Ami Bera (D),2014,Lawyers/Law Firms,129958,18750,148708
B001287,N00030717,Ami Bera (D),2014,Securities & Investment,128269,7500,135769
B001287,N00030717,Ami Bera (D),2014,Education,120151,0,120151
B001287,N00030717,Ami Bera (D),2014,Candidate Committees,2000,117500,119500
B001287,N00030717,Ami Bera (D),2014,Electronics Mfg & Equip,83930,25090,109020
B001287,N00030717,Ami Bera (D),2014,Public Sector Unions,500,106490,106990
B001287,N00030717,Ami Bera (D),2014,Democratic/Liberal,84096,12702,96798
C001083,N00030736,John Carney (D),2014,Securities & Investment,22820,134000,156820
C001083,N00030736,John Carney (D),2014,Insurance,4070,151200,155270
C001083,N00030736,John Carney (D),2014,Lawyers/Law Firms,89385,21750,111135
C001083,N00030736,John Carney (D),2014,Commercial Banks,11850,96250,108100
C001083,N00030736,John Carney (D),2014,Real Estate,15869,52000,67869
C001083,N00030736,John Carney (D),2014,Finance/Credit Companies,7750,51500,59250
C001083,N00030736,John Carney (D),2014,Pharmaceuticals/Health Products,1550,51448,52998
C001083,N00030736,John Carney (D),2014,Accountants,1750,47499,49249
C001083,N00030736,John Carney (D),2014,Business Services,15800,4000,19800
C001083,N00030736,John Carney (D),2014,Defense Aerospace,275,19000,19275
P000602,N00030744,Mike Pompeo (R),2014,Oil & Gas,219450,140000,359450
P000602,N00030744,Mike Pompeo (R),2014,Health Professionals,51650,125500,177150
P000602,N00030744,Mike Pompeo (R),2014,Electric Utilities,16500,87750,104250
P000602,N00030744,Mike Pompeo (R),2014,Air Transport,15500,55500,71000
P000602,N00030744,Mike Pompeo (R),2014,Republican/Conservative,65817,5000,70817
P000602,N00030744,Mike Pompeo (R),2014,Pharmaceuticals/Health Products,7250,63250,70500
P000602,N00030744,Mike Pompeo (R),2014,Telecom Services,3850,61000,64850
P000602,N00030744,Mike Pompeo (R),2014,Insurance,23050,40000,63050
P000602,N00030744,Mike Pompeo (R),2014,Lawyers/Law Firms,43200,19500,62700
P000602,N00030744,Mike Pompeo (R),2014,Retired,61500,0,61500
D000615,N00030752,Jeff Duncan (R),2014,Oil & Gas,3100,46500,49600
D000615,N00030752,Jeff Duncan (R),2014,Hospitals/Nursing Homes,6250,25000,31250
D000615,N00030752,Jeff Duncan (R),2014,Health Professionals,6450,23000,29450
D000615,N00030752,Jeff Duncan (R),2014,Real Estate,11925,7500,19425
D000615,N00030752,Jeff Duncan (R),2014,Retired,18850,0,18850
D000615,N00030752,Jeff Duncan (R),2014,Crop Production & Basic Processing,7505,11000,18505
D000615,N00030752,Jeff Duncan (R),2014,Insurance,2850,14500,17350
D000615,N00030752,Jeff Duncan (R),2014,General Contractors,4100,12500,16600
D000615,N00030752,Jeff Duncan (R),2014,Electric Utilities,2050,14000,16050
D000615,N00030752,Jeff Duncan (R),2014,Securities & Investment,13600,0,13600
R000591,N00030768,Martha Roby (R),2014,Real Estate,44200,21500,65700
R000591,N00030768,Martha Roby (R),2014,Defense Aerospace,500,64000,64500
R000591,N00030768,Martha Roby (R),2014,Health Professionals,23130,26500,49630
R000591,N00030768,Martha Roby (R),2014,Insurance,3250,45100,48350
R000591,N00030768,Martha Roby (R),2014,Retired,44000,0,44000
R000591,N00030768,Martha Roby (R),2014,Crop Production & Basic Processing,750,40000,40750
R000591,N00030768,Martha Roby (R),2014,Leadership PACs,0,38848,38848
R000591,N00030768,Martha Roby (R),2014,Lawyers/Law Firms,10191,20000,30191
R000591,N00030768,Martha Roby (R),2014,Forestry & Forest Products,7600,22000,29600
R000591,N00030768,Martha Roby (R),2014,Securities & Investment,12300,16000,28300
C001087,N00030770,Rick Crawford (R),2014,Crop Production & Basic Processing,51000,77330,128330
C001087,N00030770,Rick Crawford (R),2014,Agricultural Services/Products,1966,48500,50466
C001087,N00030770,Rick Crawford (R),2014,Health Professionals,29702,16500,46202
C001087,N00030770,Rick Crawford (R),2014,Leadership PACs,0,39500,39500
C001087,N00030770,Rick Crawford (R),2014,Retail Sales,9350,18500,27850
C001087,N00030770,Rick Crawford (R),2014,Air Transport,1050,26554,27604
C001087,N00030770,Rick Crawford (R),2014,Securities & Investment,19100,6500,25600
C001087,N00030770,Rick Crawford (R),2014,Poultry & Eggs,7700,16500,24200
C001087,N00030770,Rick Crawford (R),2014,Commercial Banks,4773,18250,23023
C001087,N00030770,Rick Crawford (R),2014,Real Estate,9050,11000,20050
G000565,N00030771,Paul Gosar (R),2014,Health Professionals,75900,69000,144900
G000565,N00030771,Paul Gosar (R),2014,Electric Utilities,7350,21500,28850
G000565,N00030771,Paul Gosar (R),2014,Casinos/Gambling,25000,1000,26000
G000565,N00030771,Paul Gosar (R),2014,Mining,0,14000,14000
G000565,N00030771,Paul Gosar (R),2014,Lawyers/Law Firms,10750,2750,13500
G000565,N00030771,Paul Gosar (R),2014,Leadership PACs,0,13500,13500
G000565,N00030771,Paul Gosar (R),2014,Health Services/HMOs,0,13000,13000
G000565,N00030771,Paul Gosar (R),2014,Oil & Gas,0,12500,12500
G000565,N00030771,Paul Gosar (R),2014,Real Estate,5950,4000,9950
G000565,N00030771,Paul Gosar (R),2014,Retired,9350,0,9350
G000562,N00030780,Cory Gardner (R),2014,Retired,1361896,0,1361896
G000562,N00030780,Cory Gardner (R),2014,Securities & Investment,788945,14000,802945
G000562,N00030780,Cory Gardner (R),2014,Oil & Gas,437249,258700,695949
G000562,N00030780,Cory Gardner (R),2014,Real Estate,479106,28500,507606
G000562,N00030780,Cory Gardner (R),2014,Leadership PACs,0,406194,406194
G000562,N00030780,Cory Gardner (R),2014,Republican/Conservative,302833,61775,364608
G000562,N00030780,Cory Gardner (R),2014,Misc Finance,246436,11100,257536
G000562,N00030780,Cory Gardner (R),2014,Commercial Banks,139906,87500,227406
G000562,N00030780,Cory Gardner (R),2014,Lawyers/Law Firms,204548,13500,218048
G000562,N00030780,Cory Gardner (R),2014,Misc Manufacturing & Distributing,176883,29100,205983
G000560,N00030788,Tom Graves (R),2014,Real Estate,39150,22500,61650
G000560,N00030788,Tom Graves (R),2014,Insurance,15250,38500,53750
G000560,N00030788,Tom Graves (R),2014,Misc Manufacturing & Distributing,23900,19250,43150
G000560,N00030788,Tom Graves (R),2014,Retired,38500,0,38500
G000560,N00030788,Tom Graves (R),2014,Textiles,30200,7000,37200
G000560,N00030788,Tom Graves (R),2014,Health Professionals,17250,16000,33250
G000560,N00030788,Tom Graves (R),2014,Commercial Banks,2850,25500,28350
G000560,N00030788,Tom Graves (R),2014,Crop Production & Basic Processing,6350,16500,22850
G000560,N00030788,Tom Graves (R),2014,Oil & Gas,7200,15000,22200
G000560,N00030788,Tom Graves (R),2014,Air Transport,0,20500,20500
G000560,N00030788,Tom Graves (R),2014,Leadership PACs,0,20500,20500
G000570,N00030801,Frank Guinta (R),2014,Leadership PACs,0,237900,237900
G000570,N00030801,Frank Guinta (R),2014,Retired,70200,0,70200
G000570,N00030801,Frank Guinta (R),2014,Real Estate,56650,11500,68150
G000570,N00030801,Frank Guinta (R),2014,Insurance,36750,30000,66750
G000570,N00030801,Frank Guinta (R),2014,Securities & Investment,51450,5500,56950
G000570,N00030801,Frank Guinta (R),2014,Candidate Committees,0,54500,54500
G000570,N00030801,Frank Guinta (R),2014,Republican/Conservative,11100,29234,40334
G000570,N00030801,Frank Guinta (R),2014,Health Professionals,10050,22500,32550
G000570,N00030801,Frank Guinta (R),2014,Lawyers/Law Firms,28425,1000,29425
G000570,N00030801,Frank Guinta (R),2014,Oil & Gas,10450,18000,28450
F000459,N00030815,Chuck Fleischmann (R),2014,Leadership PACs,0,120499,120499
F000459,N00030815,Chuck Fleischmann (R),2014,General Contractors,68400,25500,93900
F000459,N00030815,Chuck Fleischmann (R),2014,Real Estate,53200,9000,62200
F000459,N00030815,Chuck Fleischmann (R),2014,Health Professionals,35500,23000,58500
F000459,N00030815,Chuck Fleischmann (R),2014,Lawyers/Law Firms,41000,16500,57500
F000459,N00030815,Chuck Fleischmann (R),2014,Hospitals/Nursing Homes,13350,38000,51350
F000459,N00030815,Chuck Fleischmann (R),2014,Insurance,11900,36400,48300
F000459,N00030815,Chuck Fleischmann (R),2014,Pharmaceuticals/Health Products,32200,10500,42700
F000459,N00030815,Chuck Fleischmann (R),2014,Retired,37400,0,37400
F000459,N00030815,Chuck Fleischmann (R),2014,Accountants,22450,12000,34450
B001297,N00030829,Ken Buck (R),2014,Retired,138750,0,138750
B001297,N00030829,Ken Buck (R),2014,Oil & Gas,63650,52800,116450
B001297,N00030829,Ken Buck (R),2014,Leadership PACs,0,66000,66000
B001297,N00030829,Ken Buck (R),2014,Real Estate,57050,5000,62050
B001297,N00030829,Ken Buck (R),2014,General Contractors,41600,7000,48600
B001297,N00030829,Ken Buck (R),2014,Business Services,44425,0,44425
B001297,N00030829,Ken Buck (R),2014,Gun Rights,28800,13058,41858
B001297,N00030829,Ken Buck (R),2014,Automotive,33200,8000,41200
B001297,N00030829,Ken Buck (R),2014,Health Professionals,24430,16000,40430
B001297,N00030829,Ken Buck (R),2014,Misc Finance,35100,2500,37600
P000603,N00030836,Rand Paul (R),2014,Retired,944975,0,944975
P000603,N00030836,Rand Paul (R),2014,Health Professionals,640832,79000,719832
P000603,N00030836,Rand Paul (R),2014,Republican/Conservative,434615,55005,489620
P000603,N00030836,Rand Paul (R),2014,Securities & Investment,432347,10500,442847
P000603,N00030836,Rand Paul (R),2014,Mining,228010,22350,250360
P000603,N00030836,Rand Paul (R),2014,Misc Finance,231650,2000,233650
P000603,N00030836,Rand Paul (R),2014,Lawyers/Law Firms,212405,20550,232955
P000603,N00030836,Rand Paul (R),2014,Real Estate,227452,5000,232452
P000603,N00030836,Rand Paul (R),2014,Leadership PACs,32085,182720,214805
P000603,N00030836,Rand Paul (R),2014,Misc Manufacturing & Distributing,141152,11000,152152
G000559,N00030856,John Garamendi (D),2014,Transportation Unions,250,100000,100250
G000559,N00030856,John Garamendi (D),2014,Lawyers/Law Firms,46100,23500,69600
G000559,N00030856,John Garamendi (D),2014,Sea Transport,7300,57306,64606
G000559,N00030856,John Garamendi (D),2014,Crop Production & Basic Processing,22475,39124,61599
G000559,N00030856,John Garamendi (D),2014,Building Trade Unions,0,61050,61050
G000559,N00030856,John Garamendi (D),2014,Public Sector Unions,270,58100,58370
G000559,N00030856,John Garamendi (D),2014,Insurance,22100,31487,53587
G000559,N00030856,John Garamendi (D),2014,Real Estate,37435,11000,48435
G000559,N00030856,John Garamendi (D),2014,Industrial Unions,0,40000,40000
G000559,N00030856,John Garamendi (D),2014,Defense Aerospace,0,32000,32000
K000382,N00030875,Ann Mclane Kuster (D),2014,Retired,319192,0,319192
K000382,N00030875,Ann Mclane Kuster (D),2014,Leadership PACs,20950,252480,273430
K000382,N00030875,Ann Mclane Kuster (D),2014,Women's Issues,165800,24250,190050
K000382,N00030875,Ann Mclane Kuster (D),2014,Lawyers/Law Firms,150598,16250,166848
K000382,N00030875,Ann Mclane Kuster (D),2014,Securities & Investment,102941,38500,141441
K000382,N00030875,Ann Mclane Kuster (D),2014,Candidate Committees,0,121000,121000
K000382,N00030875,Ann Mclane Kuster (D),2014,Democratic/Liberal,79905,16000,95905
K000382,N00030875,Ann Mclane Kuster (D),2014,Education,82500,0,82500
K000382,N00030875,Ann Mclane Kuster (D),2014,Public Sector Unions,0,80000,80000
K000382,N00030875,Ann Mclane Kuster (D),2014,Environment,55725,16520,72245
G000566,N00030880,Trey Gowdy (R),2014,Securities & Investment,19450,14000,33450
G000566,N00030880,Trey Gowdy (R),2014,Real Estate,14550,17000,31550
G000566,N00030880,Trey Gowdy (R),2014,Insurance,5850,23000,28850
G000566,N00030880,Trey Gowdy (R),2014,Electronics Mfg & Equip,5700,21750,27450
G000566,N00030880,Trey Gowdy (R),2014,Accountants,1750,25000,26750
G000566,N00030880,Trey Gowdy (R),2014,Telecom Services,1000,24000,25000
G000566,N00030880,Trey Gowdy (R),2014,Crop Production & Basic Processing,8600,15500,24100
G000566,N00030880,Trey Gowdy (R),2014,Electric Utilities,2000,21500,23500
G000566,N00030880,Trey Gowdy (R),2014,Lawyers/Law Firms,18250,5000,23250
G000566,N00030880,Trey Gowdy (R),2014,Health Professionals,7950,14000,21950
S001188,N00030891,Marlin Stutzman (R),2014,Insurance,3900,98250,102150
S001188,N00030891,Marlin Stutzman (R),2014,Commercial Banks,14700,80500,95200
S001188,N00030891,Marlin Stutzman (R),2014,Real Estate,23200,52350,75550
S001188,N00030891,Marlin Stutzman (R),2014,Securities & Investment,14950,60000,74950
S001188,N00030891,Marlin Stutzman (R),2014,Retired,57850,0,57850
S001188,N00030891,Marlin Stutzman (R),2014,Leadership PACs,0,53908,53908
S001188,N00030891,Marlin Stutzman (R),2014,Retail Sales,30450,13500,43950
S001188,N00030891,Marlin Stutzman (R),2014,Finance/Credit Companies,250,43000,43250
S001188,N00030891,Marlin Stutzman (R),2014,Health Professionals,17400,23500,40900
S001188,N00030891,Marlin Stutzman (R),2014,Accountants,0,40000,40000
B001274,N00030910,Mo Brooks (R),2014,Defense Aerospace,4500,63500,68000
B001274,N00030910,Mo Brooks (R),2014,Misc Defense,33150,9100,42250
B001274,N00030910,Mo Brooks (R),2014,Health Professionals,20000,19000,39000
B001274,N00030910,Mo Brooks (R),2014,Defense Electronics,2250,33000,35250
B001274,N00030910,Mo Brooks (R),2014,Lawyers/Law Firms,17760,15000,32760
B001274,N00030910,Mo Brooks (R),2014,Retired,26742,0,26742
B001274,N00030910,Mo Brooks (R),2014,Real Estate,17500,8000,25500
B001274,N00030910,Mo Brooks (R),2014,Electronics Mfg & Equip,16500,5200,21700
B001274,N00030910,Mo Brooks (R),2014,Electric Utilities,0,18500,18500
B001274,N00030910,Mo Brooks (R),2014,Insurance,1000,14500,15500
R000585,N00030949,Tom Reed (R),2014,Securities & Investment,191517,91500,283017
R000585,N00030949,Tom Reed (R),2014,Oil & Gas,82250,122000,204250
R000585,N00030949,Tom Reed (R),2014,Leadership PACs,0,193999,193999
R000585,N00030949,Tom Reed (R),2014,Insurance,18246,173000,191246
R000585,N00030949,Tom Reed (R),2014,Health Professionals,11112,128500,139612
R000585,N00030949,Tom Reed (R),2014,Real Estate,48828,56500,105328
R000585,N00030949,Tom Reed (R),2014,"Beer, Wine & Liquor",49750,54021,103771
R000585,N00030949,Tom Reed (R),2014,Lawyers/Law Firms,52775,41150,93925
R000585,N00030949,Tom Reed (R),2014,Lobbyists,90085,3000,93085
R000585,N00030949,Tom Reed (R),2014,Electronics Mfg & Equip,55191,37885,93076
D000616,N00030957,Scott Desjarlais (R),2014,Leadership PACs,0,64750,64750
D000616,N00030957,Scott Desjarlais (R),2014,Health Professionals,50300,2500,52800
D000616,N00030957,Scott Desjarlais (R),2014,Retired,44901,0,44901
D000616,N00030957,Scott Desjarlais (R),2014,Misc Manufacturing & Distributing,20850,500,21350
D000616,N00030957,Scott Desjarlais (R),2014,Lawyers/Law Firms,20840,0,20840
D000616,N00030957,Scott Desjarlais (R),2014,Republican/Conservative,8550,10000,18550
D000616,N00030957,Scott Desjarlais (R),2014,Food Processing & Sales,16100,1500,17600
D000616,N00030957,Scott Desjarlais (R),2014,Pharmaceuticals/Health Products,15600,0,15600
D000616,N00030957,Scott Desjarlais (R),2014,Hospitals/Nursing Homes,10150,5000,15150
D000616,N00030957,Scott Desjarlais (R),2014,Building Materials & Equipment,12500,0,12500
R000589,N00030962,Scott Rigell (R),2014,Leadership PACs,0,108699,108699
R000589,N00030962,Scott Rigell (R),2014,Retired,105769,0,105769
R000589,N00030962,Scott Rigell (R),2014,Real Estate,77450,12000,89450
R000589,N00030962,Scott Rigell (R),2014,Automotive,51361,31000,82361
R000589,N00030962,Scott Rigell (R),2014,Defense Aerospace,0,58000,58000
R000589,N00030962,Scott Rigell (R),2014,Retail Sales,21000,28000,49000
R000589,N00030962,Scott Rigell (R),2014,Oil & Gas,7500,37500,45000
R000589,N00030962,Scott Rigell (R),2014,Health Professionals,17550,27000,44550
R000589,N00030962,Scott Rigell (R),2014,Railroads,22450,20000,42450
R000589,N00030962,Scott Rigell (R),2014,Misc Defense,22700,19000,41700
D000614,N00030967,Sean P Duffy (R),2014,Insurance,23292,161200,184492
D000614,N00030967,Sean P Duffy (R),2014,Securities & Investment,65450,85500,150950
D000614,N00030967,Sean P Duffy (R),2014,Retired,147975,0,147975
D000614,N00030967,Sean P Duffy (R),2014,Commercial Banks,36862,90500,127362
D000614,N00030967,Sean P Duffy (R),2014,Real Estate,34450,77250,111700
D000614,N00030967,Sean P Duffy (R),2014,Leadership PACs,0,98589,98589
D000614,N00030967,Sean P Duffy (R),2014,Misc Manufacturing & Distributing,73350,15054,88404
D000614,N00030967,Sean P Duffy (R),2014,Health Professionals,52206,29300,81506
D000614,N00030967,Sean P Duffy (R),2014,Finance/Credit Companies,16100,43650,59750
D000614,N00030967,Sean P Duffy (R),2014,Accountants,6000,44000,50000
R000587,N00030968,Reid Ribble (R),2014,Retired,130141,0,130141
R000587,N00030968,Reid Ribble (R),2014,Leadership PACs,0,80600,80600
R000587,N00030968,Reid Ribble (R),2014,Health Professionals,41750,32600,74350
R000587,N00030968,Reid Ribble (R),2014,Trucking,33739,33000,66739
R000587,N00030968,Reid Ribble (R),2014,Food Processing & Sales,37678,29000,66678
R000587,N00030968,Reid Ribble (R),2014,Insurance,25600,41000,66600
R000587,N00030968,Reid Ribble (R),2014,Forestry & Forest Products,12500,41000,53500
R000587,N00030968,Reid Ribble (R),2014,Air Transport,0,49000,49000
R000587,N00030968,Reid Ribble (R),2014,Dairy,19700,29000,48700
R000587,N00030968,Reid Ribble (R),2014,Misc Manufacturing & Distributing,25800,19846,45646
A000368,N00030980,Kelly Ayotte (R),2014,Securities & Investment,796364,55000,851364
A000368,N00030980,Kelly Ayotte (R),2014,Retired,476944,0,476944
A000368,N00030980,Kelly Ayotte (R),2014,Lobbyists,385833,9587,395420
A000368,N00030980,Kelly Ayotte (R),2014,Insurance,134816,220000,354816
A000368,N00030980,Kelly Ayotte (R),2014,Leadership PACs,4149,305150,309299
A000368,N00030980,Kelly Ayotte (R),2014,Lawyers/Law Firms,224465,68500,292965
A000368,N00030980,Kelly Ayotte (R),2014,Real Estate,232178,30810,262988
A000368,N00030980,Kelly Ayotte (R),2014,Oil & Gas,102818,107650,210468
A000368,N00030980,Kelly Ayotte (R),2014,Pharmaceuticals/Health Products,53850,143399,197249
A000368,N00030980,Kelly Ayotte (R),2014,Health Professionals,72585,116000,188585
H001053,N00031005,Vicky Hartzler (R),2014,Real Estate,53050,4000,57050
H001053,N00031005,Vicky Hartzler (R),2014,Retired,49000,0,49000
H001053,N00031005,Vicky Hartzler (R),2014,Crop Production & Basic Processing,25050,21000,46050
H001053,N00031005,Vicky Hartzler (R),2014,Agricultural Services/Products,20500,24750,45250
H001053,N00031005,Vicky Hartzler (R),2014,Defense Aerospace,0,45000,45000
H001053,N00031005,Vicky Hartzler (R),2014,Health Professionals,29750,13000,42750
H001053,N00031005,Vicky Hartzler (R),2014,Lawyers/Law Firms,18800,10000,28800
H001053,N00031005,Vicky Hartzler (R),2014,Dairy,10000,15800,25800
H001053,N00031005,Vicky Hartzler (R),2014,Misc Manufacturing & Distributing,14300,11000,25300
H001053,N00031005,Vicky Hartzler (R),2014,Food & Beverage,24350,0,24350
N000186,N00031006,Alan Nunnelee (R),2014,Health Professionals,51900,19500,71400
N000186,N00031006,Alan Nunnelee (R),2014,Oil & Gas,40500,24100,64600
N000186,N00031006,Alan Nunnelee (R),2014,Electric Utilities,0,46500,46500
N000186,N00031006,Alan Nunnelee (R),2014,Commercial Banks,8750,26000,34750
N000186,N00031006,Alan Nunnelee (R),2014,Insurance,8000,26500,34500
N000186,N00031006,Alan Nunnelee (R),2014,Crop Production & Basic Processing,1300,32000,33300
N000186,N00031006,Alan Nunnelee (R),2014,Lawyers/Law Firms,14600,16250,30850
N000186,N00031006,Alan Nunnelee (R),2014,Retired,28850,0,28850
N000186,N00031006,Alan Nunnelee (R),2014,Leadership PACs,0,28500,28500
N000186,N00031006,Alan Nunnelee (R),2014,Lobbyists,25600,2500,28100
O000169,N00031011,Bill Owens (D),2014,Leadership PACs,250,52500,52750
O000169,N00031011,Bill Owens (D),2014,Building Trade Unions,0,34000,34000
O000169,N00031011,Bill Owens (D),2014,Lawyers/Law Firms,21450,9000,30450
O000169,N00031011,Bill Owens (D),2014,Securities & Investment,17100,12000,29100
O000169,N00031011,Bill Owens (D),2014,Retired,27950,0,27950
O000169,N00031011,Bill Owens (D),2014,Public Sector Unions,0,26500,26500
O000169,N00031011,Bill Owens (D),2014,Real Estate,14100,9000,23100
O000169,N00031011,Bill Owens (D),2014,Candidate Committees,0,19000,19000
O000169,N00031011,Bill Owens (D),2014,Health Professionals,1500,17000,18500
O000169,N00031011,Bill Owens (D),2014,Commercial Banks,4600,13500,18100
C001106,N00031064,Ryan Costello (R),2014,Leadership PACs,0,161550,161550
C001106,N00031064,Ryan Costello (R),2014,Lawyers/Law Firms,81716,36999,118715
C001106,N00031064,Ryan Costello (R),2014,Retired,70956,0,70956
C001106,N00031064,Ryan Costello (R),2014,Real Estate,50900,18500,69400
C001106,N00031064,Ryan Costello (R),2014,Pharmaceuticals/Health Products,15550,50350,65900
C001106,N00031064,Ryan Costello (R),2014,Health Professionals,6250,54500,60750
C001106,N00031064,Ryan Costello (R),2014,Securities & Investment,59600,1000,60600
C001106,N00031064,Ryan Costello (R),2014,Insurance,15500,26500,42000
C001106,N00031064,Ryan Costello (R),2014,Republican/Conservative,19750,21500,41250
C001106,N00031064,Ryan Costello (R),2014,Construction Services,31604,7500,39104
D000613,N00031103,Bob Dold (R),2014,Securities & Investment,518290,10500,528790
D000613,N00031103,Bob Dold (R),2014,Leadership PACs,0,299400,299400
D000613,N00031103,Bob Dold (R),2014,Retired,293379,0,293379
D000613,N00031103,Bob Dold (R),2014,Lawyers/Law Firms,249393,1500,250893
D000613,N00031103,Bob Dold (R),2014,Real Estate,120260,14500,134760
D000613,N00031103,Bob Dold (R),2014,Pro-Israel,109070,9250,118320
D000613,N00031103,Bob Dold (R),2014,Pharmaceuticals/Health Products,85750,19500,105250
D000613,N00031103,Bob Dold (R),2014,Business Services,79253,4000,83253
D000613,N00031103,Bob Dold (R),2014,Misc Manufacturing & Distributing,61950,13500,75450
D000613,N00031103,Bob Dold (R),2014,Insurance,42000,32900,74900
H001059,N00031104,Randy Hultgren (R),2014,Securities & Investment,54500,98000,152500
H001059,N00031104,Randy Hultgren (R),2014,Insurance,3950,115500,119450
H001059,N00031104,Randy Hultgren (R),2014,Commercial Banks,9220,74500,83720
H001059,N00031104,Randy Hultgren (R),2014,Real Estate,16907,40000,56907
H001059,N00031104,Randy Hultgren (R),2014,Accountants,250,40000,40250
H001059,N00031104,Randy Hultgren (R),2014,Health Professionals,15600,24500,40100
H001059,N00031104,Randy Hultgren (R),2014,Leadership PACs,0,36788,36788
H001059,N00031104,Randy Hultgren (R),2014,Building Trade Unions,0,36000,36000
H001059,N00031104,Randy Hultgren (R),2014,Electric Utilities,2500,27500,30000
H001059,N00031104,Randy Hultgren (R),2014,Retired,29400,0,29400
R000586,N00031127,Jim Renacci (R),2014,Insurance,19550,131500,151050
R000586,N00031127,Jim Renacci (R),2014,Misc Manufacturing & Distributing,77550,34781,112331
R000586,N00031127,Jim Renacci (R),2014,Real Estate,49960,60500,110460
R000586,N00031127,Jim Renacci (R),2014,Securities & Investment,32450,74000,106450
R000586,N00031127,Jim Renacci (R),2014,Accountants,6800,58999,65799
R000586,N00031127,Jim Renacci (R),2014,Oil & Gas,18949,46000,64949
R000586,N00031127,Jim Renacci (R),2014,Pharmaceuticals/Health Products,8800,55000,63800
R000586,N00031127,Jim Renacci (R),2014,Lawyers/Law Firms,41550,18850,60400
R000586,N00031127,Jim Renacci (R),2014,Hospitals/Nursing Homes,20000,38000,58000
R000586,N00031127,Jim Renacci (R),2014,Commercial Banks,2050,51500,53550
G000563,N00031128,Bob Gibbs (R),2014,Leadership PACs,0,85545,85545
G000563,N00031128,Bob Gibbs (R),2014,Oil & Gas,29400,36500,65900
G000563,N00031128,Bob Gibbs (R),2014,Agricultural Services/Products,3600,59024,62624
G000563,N00031128,Bob Gibbs (R),2014,Crop Production & Basic Processing,2300,50500,52800
G000563,N00031128,Bob Gibbs (R),2014,Misc Manufacturing & Distributing,33550,14000,47550
G000563,N00031128,Bob Gibbs (R),2014,Electric Utilities,4250,31000,35250
G000563,N00031128,Bob Gibbs (R),2014,Railroads,0,33000,33000
G000563,N00031128,Bob Gibbs (R),2014,Building Materials & Equipment,20250,12500,32750
G000563,N00031128,Bob Gibbs (R),2014,Construction Services,1000,31000,32000
G000563,N00031128,Bob Gibbs (R),2014,Sea Transport,4000,27000,31000
L000575,N00031129,James Lankford (R),2014,Oil & Gas,280235,179000,459235
L000575,N00031129,James Lankford (R),2014,Retired,307610,0,307610
L000575,N00031129,James Lankford (R),2014,Health Professionals,153925,46500,200425
L000575,N00031129,James Lankford (R),2014,Leadership PACs,0,150303,150303
L000575,N00031129,James Lankford (R),2014,Real Estate,85403,21500,106903
L000575,N00031129,James Lankford (R),2014,Commercial Banks,73127,31000,104127
L000575,N00031129,James Lankford (R),2014,Lawyers/Law Firms,89600,7250,96850
L000575,N00031129,James Lankford (R),2014,Insurance,42085,53600,95685
L000575,N00031129,James Lankford (R),2014,General Contractors,60130,18500,78630
L000575,N00031129,James Lankford (R),2014,Pro-Israel,47800,28500,76300
M001181,N00031134,Patrick Meehan (R),2014,Lawyers/Law Firms,116599,51000,167599
M001181,N00031134,Patrick Meehan (R),2014,Securities & Investment,68750,34000,102750
M001181,N00031134,Patrick Meehan (R),2014,Insurance,30650,69000,99650
M001181,N00031134,Patrick Meehan (R),2014,Pharmaceuticals/Health Products,11900,84000,95900
M001181,N00031134,Patrick Meehan (R),2014,Real Estate,67550,19500,87050
M001181,N00031134,Patrick Meehan (R),2014,Air Transport,6500,73500,80000
M001181,N00031134,Patrick Meehan (R),2014,Transportation Unions,0,63500,63500
M001181,N00031134,Patrick Meehan (R),2014,Leadership PACs,0,61500,61500
M001181,N00031134,Patrick Meehan (R),2014,Oil & Gas,11300,49250,60550
M001181,N00031134,Patrick Meehan (R),2014,Construction Services,13350,30850,44200
F000458,N00031141,Steve Fincher (R),2014,Crop Production & Basic Processing,182665,53000,235665
F000458,N00031141,Steve Fincher (R),2014,Insurance,20000,102500,122500
F000458,N00031141,Steve Fincher (R),2014,Commercial Banks,33250,76500,109750
F000458,N00031141,Steve Fincher (R),2014,Real Estate,33400,58500,91900
F000458,N00031141,Steve Fincher (R),2014,General Contractors,75400,1000,76400
F000458,N00031141,Steve Fincher (R),2014,Securities & Investment,4050,64000,68050
F000458,N00031141,Steve Fincher (R),2014,Agricultural Services/Products,19700,39000,58700
F000458,N00031141,Steve Fincher (R),2014,Health Professionals,29850,16500,46350
F000458,N00031141,Steve Fincher (R),2014,Food & Beverage,22700,17000,39700
F000458,N00031141,Steve Fincher (R),2014,Retired,37800,0,37800
A000369,N00031177,Mark Amodei (R),2014,Casinos/Gambling,18950,28500,47450
A000369,N00031177,Mark Amodei (R),2014,Retired,31550,0,31550
A000369,N00031177,Mark Amodei (R),2014,Health Professionals,4000,26500,30500
A000369,N00031177,Mark Amodei (R),2014,Lawyers/Law Firms,22750,7000,29750
A000369,N00031177,Mark Amodei (R),2014,Mining,1500,25000,26500
A000369,N00031177,Mark Amodei (R),2014,Real Estate,19550,5000,24550
A000369,N00031177,Mark Amodei (R),2014,Lobbyists,22500,2000,24500
A000369,N00031177,Mark Amodei (R),2014,"Beer, Wine & Liquor",2600,16500,19100
A000369,N00031177,Mark Amodei (R),2014,General Contractors,13750,5000,18750
A000369,N00031177,Mark Amodei (R),2014,Automotive,7950,10000,17950
S001186,N00031204,Steve Southerland (R),2014,Leadership PACs,5450,352648,358098
S001186,N00031204,Steve Southerland (R),2014,Health Professionals,119300,72500,191800
S001186,N00031204,Steve Southerland (R),2014,Retired,142499,0,142499
S001186,N00031204,Steve Southerland (R),2014,Candidate Committees,0,103101,103101
S001186,N00031204,Steve Southerland (R),2014,Oil & Gas,35500,53000,88500
S001186,N00031204,Steve Southerland (R),2014,Insurance,19500,62000,81500
S001186,N00031204,Steve Southerland (R),2014,Crop Production & Basic Processing,40650,38000,78650
S001186,N00031204,Steve Southerland (R),2014,Real Estate,55455,23000,78455
S001186,N00031204,Steve Southerland (R),2014,Air Transport,0,67000,67000
S001186,N00031204,Steve Southerland (R),2014,Securities & Investment,27372,34500,61872
B001275,N00031227,Larry Bucshon (R),2014,Health Professionals,9450,143000,152450
B001275,N00031227,Larry Bucshon (R),2014,Mining,59500,26000,85500
B001275,N00031227,Larry Bucshon (R),2014,Building Materials & Equipment,38950,13000,51950
B001275,N00031227,Larry Bucshon (R),2014,Real Estate,26192,12500,38692
B001275,N00031227,Larry Bucshon (R),2014,Insurance,18900,18000,36900
B001275,N00031227,Larry Bucshon (R),2014,Leadership PACs,0,33678,33678
B001275,N00031227,Larry Bucshon (R),2014,Construction Services,24000,7000,31000
B001275,N00031227,Larry Bucshon (R),2014,Railroads,3500,27000,30500
B001275,N00031227,Larry Bucshon (R),2014,Misc Manufacturing & Distributing,24550,5500,30050
B001275,N00031227,Larry Bucshon (R),2014,Electric Utilities,3500,23250,26750
B001282,N00031233,Andy Barr (R),2014,Mining,151960,64500,216460
B001282,N00031233,Andy Barr (R),2014,Securities & Investment,106650,70500,177150
B001282,N00031233,Andy Barr (R),2014,Insurance,32242,122400,154642
B001282,N00031233,Andy Barr (R),2014,Retired,149420,0,149420
B001282,N00031233,Andy Barr (R),2014,Commercial Banks,41450,103250,144700
B001282,N00031233,Andy Barr (R),2014,Health Professionals,56005,84750,140755
B001282,N00031233,Andy Barr (R),2014,Real Estate,57150,56240,113390
B001282,N00031233,Andy Barr (R),2014,Leadership PACs,0,103058,103058
B001282,N00031233,Andy Barr (R),2014,Lawyers/Law Firms,62236,15250,77486
B001282,N00031233,Andy Barr (R),2014,Crop Production & Basic Processing,49530,5500,55030
H001055,N00031244,Joe Heck (R),2014,Health Professionals,150445,179099,329544
H001055,N00031244,Joe Heck (R),2014,Leadership PACs,0,183944,183944
H001055,N00031244,Joe Heck (R),2014,Casinos/Gambling,115918,49772,165690
H001055,N00031244,Joe Heck (R),2014,Retired,109435,0,109435
H001055,N00031244,Joe Heck (R),2014,Real Estate,55359,31890,87249
H001055,N00031244,Joe Heck (R),2014,Misc Issues,62750,1000,63750
H001055,N00031244,Joe Heck (R),2014,Defense Aerospace,500,54998,55498
H001055,N00031244,Joe Heck (R),2014,Insurance,6067,44500,50567
H001055,N00031244,Joe Heck (R),2014,Lawyers/Law Firms,29210,21000,50210
H001055,N00031244,Joe Heck (R),2014,General Contractors,34200,15500,49700
R000598,N00031253,Keith J Rothfus (R),2014,Securities & Investment,112240,47000,159240
R000598,N00031253,Keith J Rothfus (R),2014,Insurance,46792,89000,135792
R000598,N00031253,Keith J Rothfus (R),2014,Leadership PACs,0,118288,118288
R000598,N00031253,Keith J Rothfus (R),2014,Mining,73054,40500,113554
R000598,N00031253,Keith J Rothfus (R),2014,Retired,104823,0,104823
R000598,N00031253,Keith J Rothfus (R),2014,Commercial Banks,45574,55950,101524
R000598,N00031253,Keith J Rothfus (R),2014,Oil & Gas,40250,35000,75250
R000598,N00031253,Keith J Rothfus (R),2014,Real Estate,37015,32540,69555
R000598,N00031253,Keith J Rothfus (R),2014,Health Professionals,49050,20500,69550
R000598,N00031253,Keith J Rothfus (R),2014,Lawyers/Law Firms,51300,17201,68501
H001060,N00031265,Robert Hurt (R),2014,Insurance,2500,103000,105500
H001060,N00031265,Robert Hurt (R),2014,Securities & Investment,13100,87500,100600
H001060,N00031265,Robert Hurt (R),2014,Commercial Banks,10100,71000,81100
H001060,N00031265,Robert Hurt (R),2014,Retired,77252,0,77252
H001060,N00031265,Robert Hurt (R),2014,Real Estate,23750,51000,74750
H001060,N00031265,Robert Hurt (R),2014,Leadership PACs,0,45352,45352
H001060,N00031265,Robert Hurt (R),2014,Accountants,1250,41499,42749
H001060,N00031265,Robert Hurt (R),2014,Finance/Credit Companies,2000,28500,30500
H001060,N00031265,Robert Hurt (R),2014,Lawyers/Law Firms,18150,11750,29900
H001060,N00031265,Robert Hurt (R),2014,Electric Utilities,0,29000,29000
G000567,N00031297,Tim Griffin (R),2014,Oil & Gas,12450,34000,46450
G000567,N00031297,Tim Griffin (R),2014,Health Professionals,13825,30000,43825
G000567,N00031297,Tim Griffin (R),2014,Securities & Investment,22850,19500,42350
G000567,N00031297,Tim Griffin (R),2014,Commercial Banks,13800,17000,30800
G000567,N00031297,Tim Griffin (R),2014,Leadership PACs,0,25588,25588
G000567,N00031297,Tim Griffin (R),2014,Insurance,2750,22000,24750
G000567,N00031297,Tim Griffin (R),2014,Retail Sales,7600,11500,19100
G000567,N00031297,Tim Griffin (R),2014,Real Estate,5000,13500,18500
G000567,N00031297,Tim Griffin (R),2014,Pharmaceuticals/Health Products,0,18000,18000
G000567,N00031297,Tim Griffin (R),2014,Lobbyists,17900,0,17900
D000610,N00031317,Ted Deutch (D),2014,Lawyers/Law Firms,85300,25333,110633
D000610,N00031317,Ted Deutch (D),2014,Pro-Israel,75170,27700,102870
D000610,N00031317,Ted Deutch (D),2014,Securities & Investment,100110,2500,102610
D000610,N00031317,Ted Deutch (D),2014,Real Estate,53787,12000,65787
D000610,N00031317,Ted Deutch (D),2014,TV/Movies/Music,23600,38000,61600
D000610,N00031317,Ted Deutch (D),2014,Retired,47518,0,47518
D000610,N00031317,Ted Deutch (D),2014,Industrial Unions,0,32000,32000
D000610,N00031317,Ted Deutch (D),2014,Misc Finance,29200,0,29200
D000610,N00031317,Ted Deutch (D),2014,Health Professionals,12000,11500,23500
D000610,N00031317,Ted Deutch (D),2014,Retail Sales,6400,15500,21900
L000573,N00031377,Raul Labrador (R),2014,Retired,38150,0,38150
L000573,N00031377,Raul Labrador (R),2014,Livestock,25550,5000,30550
L000573,N00031377,Raul Labrador (R),2014,Crop Production & Basic Processing,5750,20350,26100
L000573,N00031377,Raul Labrador (R),2014,Electronics Mfg & Equip,12400,6000,18400
L000573,N00031377,Raul Labrador (R),2014,Lawyers/Law Firms,7850,9250,17100
L000573,N00031377,Raul Labrador (R),2014,Misc Manufacturing & Distributing,13900,2000,15900
L000573,N00031377,Raul Labrador (R),2014,Forestry & Forest Products,0,15000,15000
L000573,N00031377,Raul Labrador (R),2014,General Contractors,7700,6000,13700
L000573,N00031377,Raul Labrador (R),2014,Insurance,500,12600,13100
L000573,N00031377,Raul Labrador (R),2014,Misc Finance,12900,0,12900
G000569,N00031401,Michael Grimm (R),2014,Real Estate,161731,71500,233231
G000569,N00031401,Michael Grimm (R),2014,Leadership PACs,0,123000,123000
G000569,N00031401,Michael Grimm (R),2014,Securities & Investment,78700,39000,117700
G000569,N00031401,Michael Grimm (R),2014,Transportation Unions,0,103500,103500
G000569,N00031401,Michael Grimm (R),2014,Insurance,6642,90000,96642
G000569,N00031401,Michael Grimm (R),2014,Building Trade Unions,0,62000,62000
G000569,N00031401,Michael Grimm (R),2014,Accountants,8064,45000,53064
G000569,N00031401,Michael Grimm (R),2014,Commercial Banks,9564,41000,50564
G000569,N00031401,Michael Grimm (R),2014,Lawyers/Law Firms,34325,10900,45225
G000569,N00031401,Michael Grimm (R),2014,Retired,44066,0,44066
M001182,N00031412,Mick Mulvaney (R),2014,Insurance,2250,109500,111750
M001182,N00031412,Mick Mulvaney (R),2014,Securities & Investment,28800,71000,99800
M001182,N00031412,Mick Mulvaney (R),2014,Commercial Banks,4600,86000,90600
M001182,N00031412,Mick Mulvaney (R),2014,Finance/Credit Companies,8750,53500,62250
M001182,N00031412,Mick Mulvaney (R),2014,Real Estate,22400,39260,61660
M001182,N00031412,Mick Mulvaney (R),2014,Retired,58400,0,58400
M001182,N00031412,Mick Mulvaney (R),2014,Accountants,0,49000,49000
M001182,N00031412,Mick Mulvaney (R),2014,Health Professionals,15701,18500,34201
M001182,N00031412,Mick Mulvaney (R),2014,Lawyers/Law Firms,26850,6250,33100
M001182,N00031412,Mick Mulvaney (R),2014,Misc Finance,22450,10500,32950
H001073,N00031417,Will Hurd (R),2014,Leadership PACs,0,152100,152100
H001073,N00031417,Will Hurd (R),2014,Oil & Gas,88373,20500,108873
H001073,N00031417,Will Hurd (R),2014,Retired,69600,0,69600
H001073,N00031417,Will Hurd (R),2014,Misc Finance,66300,0,66300
H001073,N00031417,Will Hurd (R),2014,Real Estate,54768,0,54768
H001073,N00031417,Will Hurd (R),2014,Securities & Investment,47300,0,47300
H001073,N00031417,Will Hurd (R),2014,Candidate Committees,0,34999,34999
H001073,N00031417,Will Hurd (R),2014,General Contractors,27450,7500,34950
H001073,N00031417,Will Hurd (R),2014,Lawyers/Law Firms,32400,1000,33400
H001073,N00031417,Will Hurd (R),2014,Commercial Banks,19400,10350,29750
E000291,N00031513,Renee Ellmers (R),2014,Health Professionals,21600,202450,224050
E000291,N00031513,Renee Ellmers (R),2014,Pharmaceuticals/Health Products,0,150783,150783
E000291,N00031513,Renee Ellmers (R),2014,Leadership PACs,0,89250,89250
E000291,N00031513,Renee Ellmers (R),2014,Insurance,7650,55000,62650
E000291,N00031513,Renee Ellmers (R),2014,Oil & Gas,750,61000,61750
E000291,N00031513,Renee Ellmers (R),2014,Retail Sales,4300,48000,52300
E000291,N00031513,Renee Ellmers (R),2014,Lobbyists,43400,2000,45400
E000291,N00031513,Renee Ellmers (R),2014,Health Services/HMOs,0,45000,45000
E000291,N00031513,Renee Ellmers (R),2014,Electric Utilities,1000,43000,44000
E000291,N00031513,Renee Ellmers (R),2014,Lawyers/Law Firms,12500,31150,43650
B001273,N00031539,Diane Black (R),2014,Health Professionals,10000,112500,122500
B001273,N00031539,Diane Black (R),2014,Insurance,27650,91999,119649
B001273,N00031539,Diane Black (R),2014,Pharmaceuticals/Health Products,2971,88598,91569
B001273,N00031539,Diane Black (R),2014,Oil & Gas,2375,56000,58375
B001273,N00031539,Diane Black (R),2014,Health Services/HMOs,11200,40000,51200
B001273,N00031539,Diane Black (R),2014,Real Estate,2950,39490,42440
B001273,N00031539,Diane Black (R),2014,Special Trade Contractors,38400,3000,41400
B001273,N00031539,Diane Black (R),2014,Retail Sales,1000,34500,35500
B001273,N00031539,Diane Black (R),2014,"Beer, Wine & Liquor",8550,26500,35050
B001273,N00031539,Diane Black (R),2014,Lawyers/Law Firms,24600,10275,34875
F000461,N00031545,Bill Flores (R),2014,Oil & Gas,73539,117000,190539
F000461,N00031545,Bill Flores (R),2014,Health Professionals,15800,89100,104900
F000461,N00031545,Bill Flores (R),2014,Retired,75750,0,75750
F000461,N00031545,Bill Flores (R),2014,Accountants,250,46000,46250
F000461,N00031545,Bill Flores (R),2014,Electric Utilities,10800,32499,43299
F000461,N00031545,Bill Flores (R),2014,Insurance,15840,23500,39340
F000461,N00031545,Bill Flores (R),2014,Lawyers/Law Firms,27600,9500,37100
F000461,N00031545,Bill Flores (R),2014,Misc Energy,31850,0,31850
F000461,N00031545,Bill Flores (R),2014,Air Transport,500,30500,31000
F000461,N00031545,Bill Flores (R),2014,Real Estate,12300,18000,30300
H001064,N00031557,Dennis Heck (D),2014,Securities & Investment,30650,75000,105650
H001064,N00031557,Dennis Heck (D),2014,Retired,92265,0,92265
H001064,N00031557,Dennis Heck (D),2014,Lobbyists,86393,2000,88393
H001064,N00031557,Dennis Heck (D),2014,Real Estate,22250,63000,85250
H001064,N00031557,Dennis Heck (D),2014,Lawyers/Law Firms,53362,19500,72862
H001064,N00031557,Dennis Heck (D),2014,Commercial Banks,4800,60500,65300
H001064,N00031557,Dennis Heck (D),2014,Building Trade Unions,0,58000,58000
H001064,N00031557,Dennis Heck (D),2014,Insurance,2500,55500,58000
H001064,N00031557,Dennis Heck (D),2014,Health Professionals,17401,37500,54901
H001064,N00031557,Dennis Heck (D),2014,Public Sector Unions,500,49000,49500
H001056,N00031559,Jaime Herrera Beutler (R),2014,Retired,126475,0,126475
H001056,N00031559,Jaime Herrera Beutler (R),2014,Leadership PACs,0,102857,102857
H001056,N00031559,Jaime Herrera Beutler (R),2014,Securities & Investment,63550,6500,70050
H001056,N00031559,Jaime Herrera Beutler (R),2014,Real Estate,48750,14000,62750
H001056,N00031559,Jaime Herrera Beutler (R),2014,Forestry & Forest Products,29933,28500,58433
H001056,N00031559,Jaime Herrera Beutler (R),2014,General Contractors,29000,12000,41000
H001056,N00031559,Jaime Herrera Beutler (R),2014,Republican/Conservative,26650,10000,36650
H001056,N00031559,Jaime Herrera Beutler (R),2014,Health Professionals,12500,20000,32500
H001056,N00031559,Jaime Herrera Beutler (R),2014,Defense Aerospace,0,31000,31000
H001056,N00031559,Jaime Herrera Beutler (R),2014,Candidate Committees,0,31000,31000
D000612,N00031593,Jeff Denham (R),2014,Crop Production & Basic Processing,204417,92100,296517
D000612,N00031593,Jeff Denham (R),2014,Leadership PACs,0,208045,208045
D000612,N00031593,Jeff Denham (R),2014,Casinos/Gambling,103300,9500,112800
D000612,N00031593,Jeff Denham (R),2014,Dairy,56962,32133,89095
D000612,N00031593,Jeff Denham (R),2014,Railroads,27050,61000,88050
D000612,N00031593,Jeff Denham (R),2014,Real Estate,56509,31500,88009
D000612,N00031593,Jeff Denham (R),2014,Agricultural Services/Products,19650,59357,79007
D000612,N00031593,Jeff Denham (R),2014,Air Transport,1000,67500,68500
D000612,N00031593,Jeff Denham (R),2014,Oil & Gas,9200,55598,64798
D000612,N00031593,Jeff Denham (R),2014,Securities & Investment,37672,26000,63672
K000376,N00031647,Mike Kelly (R),2014,Insurance,13100,89250,102350
K000376,N00031647,Mike Kelly (R),2014,Oil & Gas,3900,85950,89850
K000376,N00031647,Mike Kelly (R),2014,Health Professionals,17850,54000,71850
K000376,N00031647,Mike Kelly (R),2014,Misc Manufacturing & Distributing,18150,44554,62704
K000376,N00031647,Mike Kelly (R),2014,Pharmaceuticals/Health Products,250,62000,62250
K000376,N00031647,Mike Kelly (R),2014,Retired,60450,0,60450
K000376,N00031647,Mike Kelly (R),2014,Real Estate,9800,43000,52800
K000376,N00031647,Mike Kelly (R),2014,Automotive,25250,24500,49750
K000376,N00031647,Mike Kelly (R),2014,Mining,23650,24500,48150
K000376,N00031647,Mike Kelly (R),2014,Accountants,11400,34500,45900
F000460,N00031672,Blake Farenthold (R),2014,Oil & Gas,41375,50000,91375
F000460,N00031672,Blake Farenthold (R),2014,Retired,52810,0,52810
F000460,N00031672,Blake Farenthold (R),2014,Health Professionals,35698,16500,52198
F000460,N00031672,Blake Farenthold (R),2014,Air Transport,500,50000,50500
F000460,N00031672,Blake Farenthold (R),2014,General Contractors,39700,7500,47200
F000460,N00031672,Blake Farenthold (R),2014,"Beer, Wine & Liquor",24700,13899,38599
F000460,N00031672,Blake Farenthold (R),2014,Automotive,15800,15000,30800
F000460,N00031672,Blake Farenthold (R),2014,Insurance,9700,20500,30200
F000460,N00031672,Blake Farenthold (R),2014,Real Estate,15400,13000,28400
F000460,N00031672,Blake Farenthold (R),2014,Crop Production & Basic Processing,3300,24750,28050
M001180,N00031681,David McKinley (R),2014,Mining,124500,48000,172500
M001180,N00031681,David McKinley (R),2014,Health Professionals,21280,95500,116780
M001180,N00031681,David McKinley (R),2014,Oil & Gas,15850,61500,77350
M001180,N00031681,David McKinley (R),2014,Electric Utilities,1000,71250,72250
M001180,N00031681,David McKinley (R),2014,Special Trade Contractors,48600,11000,59600
M001180,N00031681,David McKinley (R),2014,Lawyers/Law Firms,56250,3000,59250
M001180,N00031681,David McKinley (R),2014,Building Trade Unions,0,49500,49500
M001180,N00031681,David McKinley (R),2014,Transportation Unions,0,47500,47500
M001180,N00031681,David McKinley (R),2014,Pharmaceuticals/Health Products,0,46000,46000
M001180,N00031681,David McKinley (R),2014,Misc Manufacturing & Distributing,31500,2500,34000
B001277,N00031685,Richard Blumenthal (D),2014,Lawyers/Law Firms,674426,66500,740926
B001277,N00031685,Richard Blumenthal (D),2014,Securities & Investment,678897,36100,714997
B001277,N00031685,Richard Blumenthal (D),2014,Retired,585841,0,585841
B001277,N00031685,Richard Blumenthal (D),2014,Real Estate,493005,21000,514005
B001277,N00031685,Richard Blumenthal (D),2014,Health Professionals,139239,131250,270489
B001277,N00031685,Richard Blumenthal (D),2014,Leadership PACs,0,210400,210400
B001277,N00031685,Richard Blumenthal (D),2014,Lobbyists,164100,14000,178100
B001277,N00031685,Richard Blumenthal (D),2014,Education,175950,0,175950
B001277,N00031685,Richard Blumenthal (D),2014,Telecom Services,89750,81250,171000
B001277,N00031685,Richard Blumenthal (D),2014,Misc Finance,149800,1000,150800
H001061,N00031688,John Hoeven (R),2014,Oil & Gas,198389,143998,342387
H001061,N00031688,John Hoeven (R),2014,Retired,240160,0,240160
H001061,N00031688,John Hoeven (R),2014,Leadership PACs,1000,212521,213521
H001061,N00031688,John Hoeven (R),2014,Mining,124881,71875,196756
H001061,N00031688,John Hoeven (R),2014,Insurance,62800,113050,175850
H001061,N00031688,John Hoeven (R),2014,Misc Manufacturing & Distributing,114900,31500,146400
H001061,N00031688,John Hoeven (R),2014,Securities & Investment,126300,16000,142300
H001061,N00031688,John Hoeven (R),2014,Real Estate,96310,32000,128310
H001061,N00031688,John Hoeven (R),2014,Health Professionals,50500,73000,123500
H001061,N00031688,John Hoeven (R),2014,Electric Utilities,40126,79500,119626
L000577,N00031696,Mike Lee (R),2014,Securities & Investment,158462,15500,173962
L000577,N00031696,Mike Lee (R),2014,Retired,162014,0,162014
L000577,N00031696,Mike Lee (R),2014,Lawyers/Law Firms,103402,49850,153252
L000577,N00031696,Mike Lee (R),2014,Business Services,127805,2500,130305
L000577,N00031696,Mike Lee (R),2014,Oil & Gas,63265,47000,110265
L000577,N00031696,Mike Lee (R),2014,Electronics Mfg & Equip,71500,34650,106150
L000577,N00031696,Mike Lee (R),2014,Republican/Conservative,79300,25570,104870
L000577,N00031696,Mike Lee (R),2014,Mining,63995,18250,82245
L000577,N00031696,Mike Lee (R),2014,Lobbyists,77030,3500,80530
L000577,N00031696,Mike Lee (R),2014,Misc Finance,76100,1000,77100
R000592,N00031741,Todd Rokita (R),2014,Lawyers/Law Firms,86925,9250,96175
R000592,N00031741,Todd Rokita (R),2014,Health Professionals,37100,40000,77100
R000592,N00031741,Todd Rokita (R),2014,Mining,43100,10000,53100
R000592,N00031741,Todd Rokita (R),2014,Misc Manufacturing & Distributing,24050,22346,46396
R000592,N00031741,Todd Rokita (R),2014,Real Estate,32748,13500,46248
R000592,N00031741,Todd Rokita (R),2014,Insurance,22400,23500,45900
R000592,N00031741,Todd Rokita (R),2014,Automotive,15750,23500,39250
R000592,N00031741,Todd Rokita (R),2014,Securities & Investment,21650,16000,37650
R000592,N00031741,Todd Rokita (R),2014,Building Materials & Equipment,25950,10500,36450
R000592,N00031741,Todd Rokita (R),2014,Retired,32500,0,32500
M001179,N00031777,Tom Marino (R),2014,Pharmaceuticals/Health Products,1750,53500,55250
M001179,N00031777,Tom Marino (R),2014,Misc Manufacturing & Distributing,46650,6000,52650
M001179,N00031777,Tom Marino (R),2014,Retired,51874,0,51874
M001179,N00031777,Tom Marino (R),2014,Retail Sales,20100,21000,41100
M001179,N00031777,Tom Marino (R),2014,Health Professionals,14500,25500,40000
M001179,N00031777,Tom Marino (R),2014,Insurance,24800,12500,37300
M001179,N00031777,Tom Marino (R),2014,TV/Movies/Music,6750,29000,35750
M001179,N00031777,Tom Marino (R),2014,Real Estate,27150,8000,35150
M001179,N00031777,Tom Marino (R),2014,Automotive,19298,13500,32798
M001179,N00031777,Tom Marino (R),2014,Oil & Gas,500,31750,32250
S001184,N00031782,Tim Scott (R),2014,Securities & Investment,391375,71809,463184
S001184,N00031782,Tim Scott (R),2014,Insurance,134550,203500,338050
S001184,N00031782,Tim Scott (R),2014,Oil & Gas,156401,136100,292501
S001184,N00031782,Tim Scott (R),2014,Real Estate,235865,49740,285605
S001184,N00031782,Tim Scott (R),2014,Lawyers/Law Firms,226816,50100,276916
S001184,N00031782,Tim Scott (R),2014,Retired,238700,0,238700
S001184,N00031782,Tim Scott (R),2014,Health Professionals,116000,114500,230500
S001184,N00031782,Tim Scott (R),2014,Leadership PACs,0,209065,209065
S001184,N00031782,Tim Scott (R),2014,Pharmaceuticals/Health Products,30100,136350,166450
S001184,N00031782,Tim Scott (R),2014,Republican/Conservative,78400,63702,142102
C001088,N00031820,Chris Coons (D),2014,Lawyers/Law Firms,1565340,188390,1753730
C001088,N00031820,Chris Coons (D),2014,Leadership PACs,0,587900,587900
C001088,N00031820,Chris Coons (D),2014,Securities & Investment,394199,88000,482199
C001088,N00031820,Chris Coons (D),2014,Lobbyists,373197,24330,397527
C001088,N00031820,Chris Coons (D),2014,Real Estate,211100,62500,273600
C001088,N00031820,Chris Coons (D),2014,Pharmaceuticals/Health Products,75200,189000,264200
C001088,N00031820,Chris Coons (D),2014,Commercial Banks,103200,122050,225250
C001088,N00031820,Chris Coons (D),2014,Retired,219749,0,219749
C001088,N00031820,Chris Coons (D),2014,Insurance,42477,169000,211477
C001088,N00031820,Chris Coons (D),2014,Health Professionals,131500,78000,209500
B001270,N00031877,Karen Bass (D),2014,TV/Movies/Music,103150,38499,141649
B001270,N00031877,Karen Bass (D),2014,Lawyers/Law Firms,54700,25000,79700
B001270,N00031877,Karen Bass (D),2014,Business Services,38150,2000,40150
B001270,N00031877,Karen Bass (D),2014,Retired,40150,0,40150
B001270,N00031877,Karen Bass (D),2014,Real Estate,31300,8000,39300
B001270,N00031877,Karen Bass (D),2014,Health Professionals,14010,22500,36510
B001270,N00031877,Karen Bass (D),2014,Industrial Unions,0,35000,35000
B001270,N00031877,Karen Bass (D),2014,Public Sector Unions,0,34500,34500
B001270,N00031877,Karen Bass (D),2014,Securities & Investment,24950,8000,32950
B001270,N00031877,Karen Bass (D),2014,Building Trade Unions,0,32500,32500
K000375,N00031933,Bill Keating (D),2014,Lawyers/Law Firms,64445,22250,86695
K000375,N00031933,Bill Keating (D),2014,Leadership PACs,0,77571,77571
K000375,N00031933,Bill Keating (D),2014,Public Sector Unions,0,70500,70500
K000375,N00031933,Bill Keating (D),2014,Building Trade Unions,0,55000,55000
K000375,N00031933,Bill Keating (D),2014,Transportation Unions,0,47500,47500
K000375,N00031933,Bill Keating (D),2014,Industrial Unions,0,45500,45500
K000375,N00031933,Bill Keating (D),2014,Real Estate,32900,10000,42900
K000375,N00031933,Bill Keating (D),2014,Candidate Committees,0,34000,34000
K000375,N00031933,Bill Keating (D),2014,Retired,33485,0,33485
K000375,N00031933,Bill Keating (D),2014,Special Trade Contractors,20350,10000,30350
B001271,N00031934,Dan Benishek (R),2014,Leadership PACs,500,220447,220947
B001271,N00031934,Dan Benishek (R),2014,Health Professionals,58800,144500,203300
B001271,N00031934,Dan Benishek (R),2014,Oil & Gas,42200,59500,101700
B001271,N00031934,Dan Benishek (R),2014,Real Estate,46250,16600,62850
B001271,N00031934,Dan Benishek (R),2014,Casinos/Gambling,60100,0,60100
B001271,N00031934,Dan Benishek (R),2014,Retired,57681,0,57681
B001271,N00031934,Dan Benishek (R),2014,Electric Utilities,10877,46500,57377
B001271,N00031934,Dan Benishek (R),2014,Securities & Investment,45050,11000,56050
B001271,N00031934,Dan Benishek (R),2014,Forestry & Forest Products,1500,48200,49700
B001271,N00031934,Dan Benishek (R),2014,Retail Sales,35050,9000,44050
A000367,N00031938,Justin Amash (R),2014,Republican/Conservative,246515,33500,280015
A000367,N00031938,Justin Amash (R),2014,Misc Manufacturing & Distributing,90765,1000,91765
A000367,N00031938,Justin Amash (R),2014,Retired,83882,0,83882
A000367,N00031938,Justin Amash (R),2014,Securities & Investment,72700,0,72700
A000367,N00031938,Justin Amash (R),2014,Health Professionals,51209,0,51209
A000367,N00031938,Justin Amash (R),2014,Retail Sales,46770,0,46770
A000367,N00031938,Justin Amash (R),2014,Real Estate,43300,2000,45300
A000367,N00031938,Justin Amash (R),2014,Food Processing & Sales,33400,1000,34400
A000367,N00031938,Justin Amash (R),2014,Lawyers/Law Firms,29550,2750,32300
A000367,N00031938,Justin Amash (R),2014,Leadership PACs,0,29400,29400
P000601,N00031958,Steven Palazzo (R),2014,Defense Aerospace,8450,67500,75950
P000601,N00031958,Steven Palazzo (R),2014,Accountants,24800,45999,70799
P000601,N00031958,Steven Palazzo (R),2014,Oil & Gas,23950,44000,67950
P000601,N00031958,Steven Palazzo (R),2014,Leadership PACs,0,43500,43500
P000601,N00031958,Steven Palazzo (R),2014,Misc Defense,5500,32750,38250
P000601,N00031958,Steven Palazzo (R),2014,Defense Electronics,0,31000,31000
P000601,N00031958,Steven Palazzo (R),2014,Lawyers/Law Firms,15350,13500,28850
P000601,N00031958,Steven Palazzo (R),2014,General Contractors,19950,6000,25950
P000601,N00031958,Steven Palazzo (R),2014,Insurance,8250,16000,24250
P000601,N00031958,Steven Palazzo (R),2014,Electric Utilities,0,24000,24000
R000594,N00031988,Jon Runyan (R),2014,Defense Aerospace,300,29000,29300
R000594,N00031988,Jon Runyan (R),2014,Republican/Conservative,10250,10000,20250
R000594,N00031988,Jon Runyan (R),2014,Transportation Unions,0,18000,18000
R000594,N00031988,Jon Runyan (R),2014,Pharmaceuticals/Health Products,900,16500,17400
R000594,N00031988,Jon Runyan (R),2014,Building Trade Unions,0,15300,15300
R000594,N00031988,Jon Runyan (R),2014,Health Professionals,4600,10500,15100
R000594,N00031988,Jon Runyan (R),2014,Securities & Investment,12400,1000,13400
R000594,N00031988,Jon Runyan (R),2014,Misc Defense,4600,8000,12600
R000594,N00031988,Jon Runyan (R),2014,Lawyers/Law Firms,9350,2500,11850
R000594,N00031988,Jon Runyan (R),2014,Crop Production & Basic Processing,0,11500,11500
G000564,N00031998,Chris Gibson (R),2014,Securities & Investment,236258,41000,277258
G000564,N00031998,Chris Gibson (R),2014,Leadership PACs,0,247545,247545
G000564,N00031998,Chris Gibson (R),2014,Retired,143969,0,143969
G000564,N00031998,Chris Gibson (R),2014,Insurance,34373,72500,106873
G000564,N00031998,Chris Gibson (R),2014,Health Professionals,27600,72000,99600
G000564,N00031998,Chris Gibson (R),2014,Lawyers/Law Firms,71337,16599,87936
G000564,N00031998,Chris Gibson (R),2014,Lobbyists,75541,2000,77541
G000564,N00031998,Chris Gibson (R),2014,Crop Production & Basic Processing,39850,36000,75850
G000564,N00031998,Chris Gibson (R),2014,Defense Aerospace,1000,71000,72000
G000564,N00031998,Chris Gibson (R),2014,Real Estate,44334,26000,70334
C001084,N00032019,David Cicilline (D),2014,Lawyers/Law Firms,112000,13000,125000
C001084,N00032019,David Cicilline (D),2014,Retired,107050,0,107050
C001084,N00032019,David Cicilline (D),2014,Real Estate,59700,10500,70200
C001084,N00032019,David Cicilline (D),2014,Securities & Investment,48600,1000,49600
C001084,N00032019,David Cicilline (D),2014,Building Trade Unions,0,45500,45500
C001084,N00032019,David Cicilline (D),2014,TV/Movies/Music,30600,7000,37600
C001084,N00032019,David Cicilline (D),2014,Lobbyists,34250,0,34250
C001084,N00032019,David Cicilline (D),2014,Business Services,30500,2500,33000
C001084,N00032019,David Cicilline (D),2014,Public Sector Unions,1500,29000,30500
C001084,N00032019,David Cicilline (D),2014,Misc Manufacturing & Distributing,18400,12000,30400
N000184,N00032022,Kristi Noem (R),2014,Retired,191850,0,191850
N000184,N00032022,Kristi Noem (R),2014,Crop Production & Basic Processing,60998,51000,111998
N000184,N00032022,Kristi Noem (R),2014,Insurance,10060,71000,81060
N000184,N00032022,Kristi Noem (R),2014,Commercial Banks,50050,28500,78550
N000184,N00032022,Kristi Noem (R),2014,Health Professionals,49400,29000,78400
N000184,N00032022,Kristi Noem (R),2014,Agricultural Services/Products,11550,66000,77550
N000184,N00032022,Kristi Noem (R),2014,Securities & Investment,56250,18000,74250
N000184,N00032022,Kristi Noem (R),2014,Retail Sales,21350,48500,69850
N000184,N00032022,Kristi Noem (R),2014,Real Estate,41300,27000,68300
N000184,N00032022,Kristi Noem (R),2014,Oil & Gas,36050,28500,64550
G000568,N00032029,Morgan Griffith (R),2014,Health Professionals,8200,59000,67200
G000568,N00032029,Morgan Griffith (R),2014,Electric Utilities,5000,57000,62000
G000568,N00032029,Morgan Griffith (R),2014,Oil & Gas,2000,54000,56000
G000568,N00032029,Morgan Griffith (R),2014,Retired,52708,0,52708
G000568,N00032029,Morgan Griffith (R),2014,Telecom Services,1750,37000,38750
G000568,N00032029,Morgan Griffith (R),2014,Mining,8150,29000,37150
G000568,N00032029,Morgan Griffith (R),2014,Lawyers/Law Firms,23850,9753,33603
G000568,N00032029,Morgan Griffith (R),2014,Retail Sales,11593,18000,29593
G000568,N00032029,Morgan Griffith (R),2014,Misc Manufacturing & Distributing,7850,18500,26350
G000568,N00032029,Morgan Griffith (R),2014,Chemical & Related Manufacturing,3800,21500,25300
J000292,N00032088,Bill Johnson (R),2014,Oil & Gas,78316,124000,202316
J000292,N00032088,Bill Johnson (R),2014,Leadership PACs,0,153500,153500
J000292,N00032088,Bill Johnson (R),2014,Mining,94319,36500,130819
J000292,N00032088,Bill Johnson (R),2014,Health Professionals,18912,104500,123412
J000292,N00032088,Bill Johnson (R),2014,Electric Utilities,11327,97500,108827
J000292,N00032088,Bill Johnson (R),2014,Misc Manufacturing & Distributing,79100,13846,92946
J000292,N00032088,Bill Johnson (R),2014,Insurance,16600,48000,64600
J000292,N00032088,Bill Johnson (R),2014,Pharmaceuticals/Health Products,0,40327,40327
J000292,N00032088,Bill Johnson (R),2014,Special Trade Contractors,26963,9000,35963
J000292,N00032088,Bill Johnson (R),2014,Misc Energy,15900,20000,35900
H001071,N00032243,Jody Hice (R),2014,Retired,138521,0,138521
H001071,N00032243,Jody Hice (R),2014,Real Estate,36710,2000,38710
H001071,N00032243,Jody Hice (R),2014,Republican/Conservative,6475,26500,32975
H001071,N00032243,Jody Hice (R),2014,Leadership PACs,0,30000,30000
H001071,N00032243,Jody Hice (R),2014,Health Professionals,27550,0,27550
H001071,N00032243,Jody Hice (R),2014,Lawyers/Law Firms,17450,10000,27450
H001071,N00032243,Jody Hice (R),2014,Retail Sales,21700,2500,24200
H001071,N00032243,Jody Hice (R),2014,Gun Rights,1700,19182,20882
H001071,N00032243,Jody Hice (R),2014,Insurance,17900,2000,19900
H001071,N00032243,Jody Hice (R),2014,Automotive,12350,5000,17350
N000185,N00032441,Richard Nugent (R),2014,Health Professionals,12350,16000,28350
N000185,N00032441,Richard Nugent (R),2014,Electric Utilities,0,19500,19500
N000185,N00032441,Richard Nugent (R),2014,Defense Aerospace,0,19055,19055
N000185,N00032441,Richard Nugent (R),2014,Health Services/HMOs,0,16500,16500
N000185,N00032441,Richard Nugent (R),2014,Oil & Gas,5450,8500,13950
N000185,N00032441,Richard Nugent (R),2014,Leadership PACs,0,13000,13000
N000185,N00032441,Richard Nugent (R),2014,Food Processing & Sales,7700,4000,11700
N000185,N00032441,Richard Nugent (R),2014,Automotive,8400,3000,11400
N000185,N00032441,Richard Nugent (R),2014,Telephone Utilities,250,11000,11250
N000185,N00032441,Richard Nugent (R),2014,Food & Beverage,2500,8000,10500
S001189,N00032457,Austin Scott (R),2014,Crop Production & Basic Processing,20200,53000,73200
S001189,N00032457,Austin Scott (R),2014,Health Professionals,33000,30500,63500
S001189,N00032457,Austin Scott (R),2014,Agricultural Services/Products,5100,55000,60100
S001189,N00032457,Austin Scott (R),2014,Insurance,2800,53500,56300
S001189,N00032457,Austin Scott (R),2014,Defense Aerospace,500,45000,45500
S001189,N00032457,Austin Scott (R),2014,Retail Sales,5750,34000,39750
S001189,N00032457,Austin Scott (R),2014,Retired,37450,0,37450
S001189,N00032457,Austin Scott (R),2014,Real Estate,21550,11890,33440
S001189,N00032457,Austin Scott (R),2014,Food & Beverage,8200,18000,26200
S001189,N00032457,Austin Scott (R),2014,Defense Electronics,0,24500,24500
J000293,N00032546,Ron Johnson (R),2014,Retired,1174896,0,1174896
J000293,N00032546,Ron Johnson (R),2014,Misc Manufacturing & Distributing,337784,43500,381284
J000293,N00032546,Ron Johnson (R),2014,Securities & Investment,333685,31500,365185
J000293,N00032546,Ron Johnson (R),2014,Health Professionals,259101,34325,293426
J000293,N00032546,Ron Johnson (R),2014,Real Estate,225155,35400,260555
J000293,N00032546,Ron Johnson (R),2014,Leadership PACs,0,212609,212609
J000293,N00032546,Ron Johnson (R),2014,Insurance,105850,106650,212500
J000293,N00032546,Ron Johnson (R),2014,Lawyers/Law Firms,142348,22500,164848
J000293,N00032546,Ron Johnson (R),2014,Republican/Conservative,141633,12724,154357
J000293,N00032546,Ron Johnson (R),2014,Oil & Gas,97500,36500,134000
M001183,N00032838,Joe Manchin (D),2014,Lawyers/Law Firms,621903,87400,709303
M001183,N00032838,Joe Manchin (D),2014,Mining,533200,150498,683698
M001183,N00032838,Joe Manchin (D),2014,Electric Utilities,217700,212750,430450
M001183,N00032838,Joe Manchin (D),2014,Leadership PACs,1000,367000,368000
M001183,N00032838,Joe Manchin (D),2014,Health Professionals,194250,105498,299748
M001183,N00032838,Joe Manchin (D),2014,Retired,287000,0,287000
M001183,N00032838,Joe Manchin (D),2014,Pharmaceuticals/Health Products,135400,147750,283150
M001183,N00032838,Joe Manchin (D),2014,Oil & Gas,155150,124000,279150
M001183,N00032838,Joe Manchin (D),2014,Real Estate,194250,51500,245750
M001183,N00032838,Joe Manchin (D),2014,Lobbyists,206219,7220,213439
H001068,N00033030,Jared Huffman (D),2014,Retired,65400,0,65400
H001068,N00033030,Jared Huffman (D),2014,Health Professionals,8650,45250,53900
H001068,N00033030,Jared Huffman (D),2014,Lawyers/Law Firms,28800,17000,45800
H001068,N00033030,Jared Huffman (D),2014,Building Trade Unions,250,43862,44112
H001068,N00033030,Jared Huffman (D),2014,Public Sector Unions,0,41500,41500
H001068,N00033030,Jared Huffman (D),2014,"Beer, Wine & Liquor",28409,12013,40422
H001068,N00033030,Jared Huffman (D),2014,Transportation Unions,0,33600,33600
H001068,N00033030,Jared Huffman (D),2014,Industrial Unions,0,28000,28000
H001068,N00033030,Jared Huffman (D),2014,Environment,12800,9500,22300
H001068,N00033030,Jared Huffman (D),2014,Crop Production & Basic Processing,7648,14000,21648
D000618,N00033054,Steven Daines (R),2014,Retired,575579,0,575579
D000618,N00033054,Steven Daines (R),2014,Securities & Investment,476725,35000,511725
D000618,N00033054,Steven Daines (R),2014,Oil & Gas,242569,167500,410069
D000618,N00033054,Steven Daines (R),2014,Leadership PACs,0,327267,327267
D000618,N00033054,Steven Daines (R),2014,Real Estate,229825,22500,252325
D000618,N00033054,Steven Daines (R),2014,Republican/Conservative,131675,52851,184526
D000618,N00033054,Steven Daines (R),2014,General Contractors,151250,22500,173750
D000618,N00033054,Steven Daines (R),2014,Commercial Banks,69950,86100,156050
D000618,N00033054,Steven Daines (R),2014,Livestock,126425,18500,144925
D000618,N00033054,Steven Daines (R),2014,Mining,81550,59750,141300
C001098,N00033085,Ted Cruz (R),2014,Republican/Conservative,1498270,115331,1613601
C001098,N00033085,Ted Cruz (R),2014,Oil & Gas,833982,181000,1014982
C001098,N00033085,Ted Cruz (R),2014,Lawyers/Law Firms,879995,57249,937244
C001098,N00033085,Ted Cruz (R),2014,Retired,824750,0,824750
C001098,N00033085,Ted Cruz (R),2014,Securities & Investment,751867,24500,776367
C001098,N00033085,Ted Cruz (R),2014,Real Estate,584165,24000,608165
C001098,N00033085,Ted Cruz (R),2014,Misc Finance,486739,3500,490239
C001098,N00033085,Ted Cruz (R),2014,Health Professionals,326121,38000,364121
C001098,N00033085,Ted Cruz (R),2014,Business Services,308022,8000,316022
C001098,N00033085,Ted Cruz (R),2014,Misc Business,295827,10500,306327
M001191,N00033091,Patrick E Murphy (D),2014,Lawyers/Law Firms,295025,34500,329525
M001191,N00033091,Patrick E Murphy (D),2014,Real Estate,263750,61000,324750
M001191,N00033091,Patrick E Murphy (D),2014,Retired,308678,0,308678
M001191,N00033091,Patrick E Murphy (D),2014,Securities & Investment,164400,94880,259280
M001191,N00033091,Patrick E Murphy (D),2014,Leadership PACs,16100,196273,212373
M001191,N00033091,Patrick E Murphy (D),2014,Insurance,64000,105700,169700
M001191,N00033091,Patrick E Murphy (D),2014,General Contractors,115450,4500,119950
M001191,N00033091,Patrick E Murphy (D),2014,Pro-Israel,85925,22000,107925
M001191,N00033091,Patrick E Murphy (D),2014,Misc Finance,95250,11500,106750
M001191,N00033091,Patrick E Murphy (D),2014,Commercial Banks,16050,83500,99550
S001190,N00033101,Brad Schneider (D),2014,Lawyers/Law Firms,329966,39000,368966
S001190,N00033101,Brad Schneider (D),2014,Pro-Israel,335938,30156,366094
S001190,N00033101,Brad Schneider (D),2014,Leadership PACs,28650,227499,256149
S001190,N00033101,Brad Schneider (D),2014,Securities & Investment,207364,21250,228614
S001190,N00033101,Brad Schneider (D),2014,Retired,192184,0,192184
S001190,N00033101,Brad Schneider (D),2014,Real Estate,175560,7000,182560
S001190,N00033101,Brad Schneider (D),2014,Democratic/Liberal,108171,11750,119921
S001190,N00033101,Brad Schneider (D),2014,Candidate Committees,0,101775,101775
S001190,N00033101,Brad Schneider (D),2014,Pharmaceuticals/Health Products,25010,52250,77260
S001190,N00033101,Brad Schneider (D),2014,Public Sector Unions,0,76500,76500
K000384,N00033177,Tim Kaine (D),2014,Lawyers/Law Firms,2077835,99386,2177221
K000384,N00033177,Tim Kaine (D),2014,Retired,1861668,0,1861668
K000384,N00033177,Tim Kaine (D),2014,Securities & Investment,789516,21500,811016
K000384,N00033177,Tim Kaine (D),2014,Real Estate,559394,5000,564394
K000384,N00033177,Tim Kaine (D),2014,Education,526415,0,526415
K000384,N00033177,Tim Kaine (D),2014,Business Services,505624,8900,514524
K000384,N00033177,Tim Kaine (D),2014,Lobbyists,380045,8175,388220
K000384,N00033177,Tim Kaine (D),2014,Women's Issues,371887,3193,375080
K000384,N00033177,Tim Kaine (D),2014,Leadership PACs,0,322500,322500
K000384,N00033177,Tim Kaine (D),2014,Civil Servants/Public Officials,300716,0,300716
E000293,N00033217,Elizabeth Esty (D),2014,Lawyers/Law Firms,226350,27033,253383
E000293,N00033217,Elizabeth Esty (D),2014,Leadership PACs,8800,191636,200436
E000293,N00033217,Elizabeth Esty (D),2014,Retired,171300,0,171300
E000293,N00033217,Elizabeth Esty (D),2014,Securities & Investment,156100,4500,160600
E000293,N00033217,Elizabeth Esty (D),2014,Women's Issues,108810,15000,123810
E000293,N00033217,Elizabeth Esty (D),2014,Health Professionals,31331,61500,92831
E000293,N00033217,Elizabeth Esty (D),2014,Education,84026,0,84026
E000293,N00033217,Elizabeth Esty (D),2014,Business Services,77700,2500,80200
E000293,N00033217,Elizabeth Esty (D),2014,Candidate Committees,0,74226,74226
E000293,N00033217,Elizabeth Esty (D),2014,Transportation Unions,0,68550,68550
L000579,N00033274,Alan Lowenthal (D),2014,Transportation Unions,0,69000,69000
L000579,N00033274,Alan Lowenthal (D),2014,Building Trade Unions,0,64000,64000
L000579,N00033274,Alan Lowenthal (D),2014,Public Sector Unions,0,44600,44600
L000579,N00033274,Alan Lowenthal (D),2014,Health Professionals,5785,34500,40285
L000579,N00033274,Alan Lowenthal (D),2014,Industrial Unions,0,39000,39000
L000579,N00033274,Alan Lowenthal (D),2014,Retired,31570,0,31570
L000579,N00033274,Alan Lowenthal (D),2014,Lawyers/Law Firms,14975,13250,28225
L000579,N00033274,Alan Lowenthal (D),2014,Real Estate,23825,4000,27825
L000579,N00033274,Alan Lowenthal (D),2014,Sea Transport,8600,17500,26100
L000579,N00033274,Alan Lowenthal (D),2014,Casinos/Gambling,17700,0,17700
G000571,N00033281,Tulsi Gabbard (D),2014,Securities & Investment,85057,0,85057
G000571,N00033281,Tulsi Gabbard (D),2014,Health Professionals,60609,6500,67109
G000571,N00033281,Tulsi Gabbard (D),2014,Real Estate,50435,14000,64435
G000571,N00033281,Tulsi Gabbard (D),2014,Lawyers/Law Firms,43207,14500,57707
G000571,N00033281,Tulsi Gabbard (D),2014,Retired,56003,0,56003
G000571,N00033281,Tulsi Gabbard (D),2014,Building Trade Unions,0,48500,48500
G000571,N00033281,Tulsi Gabbard (D),2014,Public Sector Unions,0,43000,43000
G000571,N00033281,Tulsi Gabbard (D),2014,Women's Issues,36050,3107,39157
G000571,N00033281,Tulsi Gabbard (D),2014,Sea Transport,26900,10000,36900
G000571,N00033281,Tulsi Gabbard (D),2014,TV/Movies/Music,34550,2000,36550
C001091,N00033316,Joaquin Castro (D),2014,Lawyers/Law Firms,111500,31500,143000
C001091,N00033316,Joaquin Castro (D),2014,Real Estate,29867,21500,51367
C001091,N00033316,Joaquin Castro (D),2014,Health Professionals,20800,24500,45300
C001091,N00033316,Joaquin Castro (D),2014,Oil & Gas,11500,29000,40500
C001091,N00033316,Joaquin Castro (D),2014,Defense Aerospace,1000,38500,39500
C001091,N00033316,Joaquin Castro (D),2014,Insurance,1250,37500,38750
C001091,N00033316,Joaquin Castro (D),2014,Retail Sales,12500,19000,31500
C001091,N00033316,Joaquin Castro (D),2014,Automotive,3750,26500,30250
C001091,N00033316,Joaquin Castro (D),2014,Securities & Investment,17170,12500,29670
C001091,N00033316,Joaquin Castro (D),2014,Lobbyists,26250,500,26750
C001095,N00033363,Tom Cotton (R),2014,Securities & Investment,1044900,58750,1103650
C001095,N00033363,Tom Cotton (R),2014,Retired,1032476,0,1032476
C001095,N00033363,Tom Cotton (R),2014,Republican/Conservative,817817,80433,898250
C001095,N00033363,Tom Cotton (R),2014,Leadership PACs,22300,416671,438971
C001095,N00033363,Tom Cotton (R),2014,Oil & Gas,348005,84600,432605
C001095,N00033363,Tom Cotton (R),2014,Real Estate,392855,25000,417855
C001095,N00033363,Tom Cotton (R),2014,Lawyers/Law Firms,331422,40365,371787
C001095,N00033363,Tom Cotton (R),2014,Health Professionals,263001,53000,316001
C001095,N00033363,Tom Cotton (R),2014,Commercial Banks,163735,139000,302735
C001095,N00033363,Tom Cotton (R),2014,Misc Finance,269750,7000,276750
V000129,N00033367,David Valadao (R),2014,Crop Production & Basic Processing,297383,99599,396982
V000129,N00033367,David Valadao (R),2014,Leadership PACs,0,244877,244877
V000129,N00033367,David Valadao (R),2014,Dairy,171603,43054,214657
V000129,N00033367,David Valadao (R),2014,Agricultural Services/Products,16400,67410,83810
V000129,N00033367,David Valadao (R),2014,Health Professionals,23850,42600,66450
V000129,N00033367,David Valadao (R),2014,Oil & Gas,10400,49300,59700
V000129,N00033367,David Valadao (R),2014,Livestock,45150,11500,56650
V000129,N00033367,David Valadao (R),2014,Republican/Conservative,13017,42000,55017
V000129,N00033367,David Valadao (R),2014,Insurance,10100,42500,52600
V000129,N00033367,David Valadao (R),2014,Candidate Committees,0,51500,51500
C001097,N00033373,Tony Cardenas (D),2014,Casinos/Gambling,96000,2000,98000
C001097,N00033373,Tony Cardenas (D),2014,Real Estate,48150,11500,59650
C001097,N00033373,Tony Cardenas (D),2014,Democratic/Liberal,46130,10000,56130
C001097,N00033373,Tony Cardenas (D),2014,Health Professionals,22600,18000,40600
C001097,N00033373,Tony Cardenas (D),2014,Public Sector Unions,0,38500,38500
C001097,N00033373,Tony Cardenas (D),2014,Building Trade Unions,0,37500,37500
C001097,N00033373,Tony Cardenas (D),2014,TV/Movies/Music,19000,17833,36833
C001097,N00033373,Tony Cardenas (D),2014,Pharmaceuticals/Health Products,3100,29500,32600
C001097,N00033373,Tony Cardenas (D),2014,Lawyers/Law Firms,20150,7000,27150
C001097,N00033373,Tony Cardenas (D),2014,Accountants,7750,17952,25702
B001286,N00033390,Cheri Bustos (D),2014,Leadership PACs,14100,224543,238643
B001286,N00033390,Cheri Bustos (D),2014,Lawyers/Law Firms,147214,27000,174214
B001286,N00033390,Cheri Bustos (D),2014,Women's Issues,100360,24500,124860
B001286,N00033390,Cheri Bustos (D),2014,Retired,117507,0,117507
B001286,N00033390,Cheri Bustos (D),2014,Candidate Committees,0,85000,85000
B001286,N00033390,Cheri Bustos (D),2014,Pro-Israel,71753,10797,82550
B001286,N00033390,Cheri Bustos (D),2014,Transportation Unions,0,82000,82000
B001286,N00033390,Cheri Bustos (D),2014,Securities & Investment,46922,29000,75922
B001286,N00033390,Cheri Bustos (D),2014,Building Trade Unions,800,73900,74700
B001286,N00033390,Cheri Bustos (D),2014,Air Transport,1550,70498,72048
K000380,N00033395,Dan Kildee (D),2014,Insurance,500,62750,63250
K000380,N00033395,Dan Kildee (D),2014,Health Professionals,43301,13000,56301
K000380,N00033395,Dan Kildee (D),2014,Building Trade Unions,250,52650,52900
K000380,N00033395,Dan Kildee (D),2014,Casinos/Gambling,52500,0,52500
K000380,N00033395,Dan Kildee (D),2014,Lawyers/Law Firms,29810,20000,49810
K000380,N00033395,Dan Kildee (D),2014,Industrial Unions,0,40500,40500
K000380,N00033395,Dan Kildee (D),2014,Real Estate,6900,32750,39650
K000380,N00033395,Dan Kildee (D),2014,Crop Production & Basic Processing,1750,35750,37500
K000380,N00033395,Dan Kildee (D),2014,Public Sector Unions,900,32500,33400
K000380,N00033395,Dan Kildee (D),2014,Finance/Credit Companies,500,30500,31000
H001065,N00033399,George Holding (R),2014,Lawyers/Law Firms,89742,21750,111492
H001065,N00033399,George Holding (R),2014,Health Professionals,66713,26500,93213
H001065,N00033399,George Holding (R),2014,Retired,78550,0,78550
H001065,N00033399,George Holding (R),2014,Real Estate,43800,17000,60800
H001065,N00033399,George Holding (R),2014,Commercial Banks,29480,24500,53980
H001065,N00033399,George Holding (R),2014,Insurance,10950,31600,42550
H001065,N00033399,George Holding (R),2014,Electronics Mfg & Equip,6250,32500,38750
H001065,N00033399,George Holding (R),2014,Automotive,23050,14500,37550
H001065,N00033399,George Holding (R),2014,TV/Movies/Music,6500,31000,37500
H001065,N00033399,George Holding (R),2014,Lobbyists,34650,1000,35650
M001190,N00033410,Markwayne Mullin (R),2014,Oil & Gas,44400,92000,136400
M001190,N00033410,Markwayne Mullin (R),2014,Human Rights,76850,0,76850
M001190,N00033410,Markwayne Mullin (R),2014,Commercial Banks,55224,10500,65724
M001190,N00033410,Markwayne Mullin (R),2014,Leadership PACs,0,61639,61639
M001190,N00033410,Markwayne Mullin (R),2014,Real Estate,30900,15000,45900
M001190,N00033410,Markwayne Mullin (R),2014,Retired,39300,0,39300
M001190,N00033410,Markwayne Mullin (R),2014,Insurance,6750,29500,36250
M001190,N00033410,Markwayne Mullin (R),2014,Air Transport,0,32555,32555
M001190,N00033410,Markwayne Mullin (R),2014,Railroads,0,32000,32000
M001190,N00033410,Markwayne Mullin (R),2014,General Contractors,13500,16500,30000
F000463,N00033443,Deb Fischer (R),2014,Retired,334917,0,334917
F000463,N00033443,Deb Fischer (R),2014,Leadership PACs,200,259482,259682
F000463,N00033443,Deb Fischer (R),2014,Republican/Conservative,148771,45500,194271
F000463,N00033443,Deb Fischer (R),2014,Crop Production & Basic Processing,127860,49552,177412
F000463,N00033443,Deb Fischer (R),2014,Insurance,74250,83500,157750
F000463,N00033443,Deb Fischer (R),2014,Commercial Banks,81250,75500,156750
F000463,N00033443,Deb Fischer (R),2014,Health Professionals,104799,37000,141799
F000463,N00033443,Deb Fischer (R),2014,Securities & Investment,121542,9500,131042
F000463,N00033443,Deb Fischer (R),2014,Agricultural Services/Products,67200,59500,126700
F000463,N00033443,Deb Fischer (R),2014,Oil & Gas,68034,57000,125034
B001278,N00033474,Suzanne Bonamici (D),2014,Lawyers/Law Firms,80600,18500,99100
B001278,N00033474,Suzanne Bonamici (D),2014,Public Sector Unions,0,56750,56750
B001278,N00033474,Suzanne Bonamici (D),2014,Health Professionals,7350,41500,48850
B001278,N00033474,Suzanne Bonamici (D),2014,Retired,46800,0,46800
B001278,N00033474,Suzanne Bonamici (D),2014,Building Trade Unions,0,41500,41500
B001278,N00033474,Suzanne Bonamici (D),2014,Misc Manufacturing & Distributing,8350,25000,33350
B001278,N00033474,Suzanne Bonamici (D),2014,Transportation Unions,0,30500,30500
B001278,N00033474,Suzanne Bonamici (D),2014,Industrial Unions,0,29500,29500
B001278,N00033474,Suzanne Bonamici (D),2014,Electronics Mfg & Equip,7200,17000,24200
B001278,N00033474,Suzanne Bonamici (D),2014,Railroads,8050,15500,23550
B001284,N00033495,Susan Brooks (R),2014,Lawyers/Law Firms,75850,20500,96350
B001284,N00033495,Susan Brooks (R),2014,Securities & Investment,37925,35000,72925
B001284,N00033495,Susan Brooks (R),2014,Real Estate,32250,33200,65450
B001284,N00033495,Susan Brooks (R),2014,Health Professionals,27050,37500,64550
B001284,N00033495,Susan Brooks (R),2014,Leadership PACs,0,63698,63698
B001284,N00033495,Susan Brooks (R),2014,Insurance,10550,44600,55150
B001284,N00033495,Susan Brooks (R),2014,Pharmaceuticals/Health Products,26900,24500,51400
B001284,N00033495,Susan Brooks (R),2014,Retired,47350,0,47350
B001284,N00033495,Susan Brooks (R),2014,Lobbyists,31975,9500,41475
B001284,N00033495,Susan Brooks (R),2014,Retail Sales,8500,30500,39000
S001193,N00033508,Eric Swalwell (D),2014,Lawyers/Law Firms,92138,35797,127935
S001193,N00033508,Eric Swalwell (D),2014,Real Estate,107050,10000,117050
S001193,N00033508,Eric Swalwell (D),2014,Pharmaceuticals/Health Products,8450,71500,79950
S001193,N00033508,Eric Swalwell (D),2014,Health Professionals,43001,36500,79501
S001193,N00033508,Eric Swalwell (D),2014,Electronics Mfg & Equip,46925,29380,76305
S001193,N00033508,Eric Swalwell (D),2014,Retired,56824,0,56824
S001193,N00033508,Eric Swalwell (D),2014,Building Trade Unions,0,55000,55000
S001193,N00033508,Eric Swalwell (D),2014,Public Sector Unions,0,53500,53500
S001193,N00033508,Eric Swalwell (D),2014,"Beer, Wine & Liquor",24856,23764,48620
S001193,N00033508,Eric Swalwell (D),2014,Leadership PACs,0,46000,46000
N000187,N00033509,Gloria McLeod (D),2014,Building Trade Unions,0,12500,12500
N000187,N00033509,Gloria McLeod (D),2014,Public Sector Unions,0,12000,12000
N000187,N00033509,Gloria McLeod (D),2014,Crop Production & Basic Processing,500,9000,9500
N000187,N00033509,Gloria McLeod (D),2014,Health Professionals,300,8000,8300
N000187,N00033509,Gloria McLeod (D),2014,Real Estate,1500,5000,6500
N000187,N00033509,Gloria McLeod (D),2014,Human Rights,250,6000,6250
N000187,N00033509,Gloria McLeod (D),2014,Casinos/Gambling,5500,0,5500
N000187,N00033509,Gloria McLeod (D),2014,Misc Unions,0,5000,5000
N000187,N00033509,Gloria McLeod (D),2014,Recreation/Live Entertainment,4000,0,4000
N000187,N00033509,Gloria McLeod (D),2014,Lobbyists,3750,0,3750
R000599,N00033510,Raul Ruiz (D),2014,Health Professionals,200764,217500,418264
R000599,N00033510,Raul Ruiz (D),2014,Retired,206643,0,206643
R000599,N00033510,Raul Ruiz (D),2014,Leadership PACs,250,192500,192750
R000599,N00033510,Raul Ruiz (D),2014,Lawyers/Law Firms,122071,15250,137321
R000599,N00033510,Raul Ruiz (D),2014,Candidate Committees,0,107599,107599
R000599,N00033510,Raul Ruiz (D),2014,Real Estate,89350,10000,99350
R000599,N00033510,Raul Ruiz (D),2014,Casinos/Gambling,84250,1000,85250
R000599,N00033510,Raul Ruiz (D),2014,Hospitals/Nursing Homes,58810,25500,84310
R000599,N00033510,Raul Ruiz (D),2014,Public Sector Unions,700,83000,83700
R000599,N00033510,Raul Ruiz (D),2014,Securities & Investment,82275,0,82275
C001093,N00033518,Doug Collins (R),2014,Health Professionals,21950,25500,47450
C001093,N00033518,Doug Collins (R),2014,TV/Movies/Music,10000,24000,34000
C001093,N00033518,Doug Collins (R),2014,Insurance,5800,26000,31800
C001093,N00033518,Doug Collins (R),2014,Lawyers/Law Firms,17450,11750,29200
C001093,N00033518,Doug Collins (R),2014,Retail Sales,6850,22000,28850
C001093,N00033518,Doug Collins (R),2014,Retired,27318,0,27318
C001093,N00033518,Doug Collins (R),2014,Leadership PACs,0,24707,24707
C001093,N00033518,Doug Collins (R),2014,Food & Beverage,250,23491,23741
C001093,N00033518,Doug Collins (R),2014,Real Estate,14200,8000,22200
C001093,N00033518,Doug Collins (R),2014,Telecom Services,1500,20000,21500
R000603,N00033527,David Rouzer (R),2014,Crop Production & Basic Processing,167599,53100,220699
R000603,N00033527,David Rouzer (R),2014,Leadership PACs,0,103292,103292
R000603,N00033527,David Rouzer (R),2014,Retired,84035,0,84035
R000603,N00033527,David Rouzer (R),2014,Real Estate,49813,13500,63313
R000603,N00033527,David Rouzer (R),2014,Lawyers/Law Firms,39150,19625,58775
R000603,N00033527,David Rouzer (R),2014,Agricultural Services/Products,10700,41500,52200
R000603,N00033527,David Rouzer (R),2014,Health Professionals,27688,22000,49688
R000603,N00033527,David Rouzer (R),2014,Lobbyists,36670,0,36670
R000603,N00033527,David Rouzer (R),2014,Tobacco,16513,17500,34013
R000603,N00033527,David Rouzer (R),2014,Oil & Gas,7100,22000,29100
B001283,N00033532,James Bridenstine (R),2014,Oil & Gas,29000,38500,67500
B001283,N00033532,James Bridenstine (R),2014,Health Professionals,30950,23000,53950
B001283,N00033532,James Bridenstine (R),2014,Defense Aerospace,1250,40000,41250
B001283,N00033532,James Bridenstine (R),2014,Retired,36350,0,36350
B001283,N00033532,James Bridenstine (R),2014,Republican/Conservative,10750,20738,31488
B001283,N00033532,James Bridenstine (R),2014,Defense Electronics,0,21000,21000
B001283,N00033532,James Bridenstine (R),2014,Leadership PACs,0,18000,18000
B001283,N00033532,James Bridenstine (R),2014,Education,17815,0,17815
B001283,N00033532,James Bridenstine (R),2014,Lawyers/Law Firms,13550,3403,16953
B001283,N00033532,James Bridenstine (R),2014,Misc Defense,6250,10500,16750
O000170,N00033540,Beto O'Rourke (D),2014,Real Estate,30600,6000,36600
O000170,N00033540,Beto O'Rourke (D),2014,Building Trade Unions,0,33500,33500
O000170,N00033540,Beto O'Rourke (D),2014,Commercial Banks,24300,0,24300
O000170,N00033540,Beto O'Rourke (D),2014,"Beer, Wine & Liquor",10200,10000,20200
O000170,N00033540,Beto O'Rourke (D),2014,Oil & Gas,16000,3500,19500
O000170,N00033540,Beto O'Rourke (D),2014,Lawyers/Law Firms,12650,4000,16650
O000170,N00033540,Beto O'Rourke (D),2014,Public Sector Unions,0,13500,13500
O000170,N00033540,Beto O'Rourke (D),2014,Crop Production & Basic Processing,500,13000,13500
O000170,N00033540,Beto O'Rourke (D),2014,Telephone Utilities,10400,3000,13400
O000170,N00033540,Beto O'Rourke (D),2014,Home Builders,11000,2000,13000
G000572,N00033541,Pete Gallego (D),2014,Leadership PACs,0,191100,191100
G000572,N00033541,Pete Gallego (D),2014,Lawyers/Law Firms,154248,27100,181348
G000572,N00033541,Pete Gallego (D),2014,Candidate Committees,0,80966,80966
G000572,N00033541,Pete Gallego (D),2014,"Beer, Wine & Liquor",52600,23000,75600
G000572,N00033541,Pete Gallego (D),2014,Public Sector Unions,0,71000,71000
G000572,N00033541,Pete Gallego (D),2014,Health Professionals,32350,30500,62850
G000572,N00033541,Pete Gallego (D),2014,Building Trade Unions,0,53500,53500
G000572,N00033541,Pete Gallego (D),2014,Securities & Investment,28250,23500,51750
G000572,N00033541,Pete Gallego (D),2014,Democratic/Liberal,29817,20150,49967
G000572,N00033541,Pete Gallego (D),2014,Real Estate,36689,13000,49689
P000607,N00033549,Mark Pocan (D),2014,Building Trade Unions,0,75000,75000
P000607,N00033549,Mark Pocan (D),2014,Public Sector Unions,1700,68000,69700
P000607,N00033549,Mark Pocan (D),2014,Industrial Unions,0,50000,50000
P000607,N00033549,Mark Pocan (D),2014,Insurance,3800,42000,45800
P000607,N00033549,Mark Pocan (D),2014,Lawyers/Law Firms,27310,11478,38788
P000607,N00033549,Mark Pocan (D),2014,Health Professionals,5750,30075,35825
P000607,N00033549,Mark Pocan (D),2014,Transportation Unions,0,30500,30500
P000607,N00033549,Mark Pocan (D),2014,Retired,28770,0,28770
P000607,N00033549,Mark Pocan (D),2014,Misc Unions,0,26500,26500
P000607,N00033549,Mark Pocan (D),2014,Education,17597,3500,21097
P000608,N00033591,Scott Peters (D),2014,Leadership PACs,4100,254363,258463
P000608,N00033591,Scott Peters (D),2014,Retired,256965,0,256965
P000608,N00033591,Scott Peters (D),2014,Lawyers/Law Firms,183325,43750,227075
P000608,N00033591,Scott Peters (D),2014,Real Estate,144950,26500,171450
P000608,N00033591,Scott Peters (D),2014,Candidate Committees,0,117341,117341
P000608,N00033591,Scott Peters (D),2014,Pharmaceuticals/Health Products,12950,100400,113350
P000608,N00033591,Scott Peters (D),2014,Securities & Investment,78050,29500,107550
P000608,N00033591,Scott Peters (D),2014,Health Professionals,38700,67500,106200
P000608,N00033591,Scott Peters (D),2014,Electronics Mfg & Equip,38000,40400,78400
P000608,N00033591,Scott Peters (D),2014,Public Sector Unions,250,73250,73500
B001280,N00033625,Kerry Bentivolio (R),2014,Republican/Conservative,28476,36780,65256
B001280,N00033625,Kerry Bentivolio (R),2014,Retired,37250,0,37250
B001280,N00033625,Kerry Bentivolio (R),2014,Leadership PACs,0,33500,33500
B001280,N00033625,Kerry Bentivolio (R),2014,Real Estate,19550,2000,21550
B001280,N00033625,Kerry Bentivolio (R),2014,Automotive,14450,5000,19450
B001280,N00033625,Kerry Bentivolio (R),2014,Building Materials & Equipment,15200,0,15200
B001280,N00033625,Kerry Bentivolio (R),2014,Misc Finance,15150,0,15150
B001280,N00033625,Kerry Bentivolio (R),2014,Electric Utilities,500,13000,13500
B001280,N00033625,Kerry Bentivolio (R),2014,Candidate Committees,0,12000,12000
B001280,N00033625,Kerry Bentivolio (R),2014,Misc Manufacturing & Distributing,9450,2000,11450
H001067,N00033630,Richard Hudson (R),2014,Insurance,14350,56000,70350
H001067,N00033630,Richard Hudson (R),2014,Crop Production & Basic Processing,16150,48184,64334
H001067,N00033630,Richard Hudson (R),2014,Lawyers/Law Firms,40250,16500,56750
H001067,N00033630,Richard Hudson (R),2014,Securities & Investment,10675,42500,53175
H001067,N00033630,Richard Hudson (R),2014,Oil & Gas,1750,49500,51250
H001067,N00033630,Richard Hudson (R),2014,Commercial Banks,8425,38500,46925
H001067,N00033630,Richard Hudson (R),2014,Accountants,2000,44500,46500
H001067,N00033630,Richard Hudson (R),2014,Health Professionals,1800,43500,45300
H001067,N00033630,Richard Hudson (R),2014,Automotive,34050,10500,44550
H001067,N00033630,Richard Hudson (R),2014,Retail Sales,11068,31500,42568
M001187,N00033631,Mark R Meadows (R),2014,Retired,45815,0,45815
M001187,N00033631,Mark R Meadows (R),2014,Insurance,1500,29500,31000
M001187,N00033631,Mark R Meadows (R),2014,Railroads,0,27000,27000
M001187,N00033631,Mark R Meadows (R),2014,Leadership PACs,0,25180,25180
M001187,N00033631,Mark R Meadows (R),2014,Air Transport,0,23281,23281
M001187,N00033631,Mark R Meadows (R),2014,Real Estate,7600,11500,19100
M001187,N00033631,Mark R Meadows (R),2014,Pro-Israel,16210,800,17010
M001187,N00033631,Mark R Meadows (R),2014,Republican/Conservative,1750,11260,13010
M001187,N00033631,Mark R Meadows (R),2014,Electric Utilities,0,12500,12500
M001187,N00033631,Mark R Meadows (R),2014,Construction Services,250,11500,11750
H001066,N00033638,Steven Horsford (D),2014,Leadership PACs,0,144450,144450
H001066,N00033638,Steven Horsford (D),2014,Lawyers/Law Firms,76268,33453,109721
H001066,N00033638,Steven Horsford (D),2014,Candidate Committees,0,92700,92700
H001066,N00033638,Steven Horsford (D),2014,Casinos/Gambling,44400,35500,79900
H001066,N00033638,Steven Horsford (D),2014,Public Sector Unions,0,76000,76000
H001066,N00033638,Steven Horsford (D),2014,Real Estate,35850,36000,71850
H001066,N00033638,Steven Horsford (D),2014,Insurance,4250,60000,64250
H001066,N00033638,Steven Horsford (D),2014,Securities & Investment,11000,49500,60500
H001066,N00033638,Steven Horsford (D),2014,Building Trade Unions,0,59000,59000
H001066,N00033638,Steven Horsford (D),2014,Retired,58007,0,58007
J000294,N00033640,Hakeem Jeffries (D),2014,Lawyers/Law Firms,126000,24350,150350
J000294,N00033640,Hakeem Jeffries (D),2014,TV/Movies/Music,36550,28750,65300
J000294,N00033640,Hakeem Jeffries (D),2014,Securities & Investment,40500,9500,50000
J000294,N00033640,Hakeem Jeffries (D),2014,Real Estate,43909,6000,49909
J000294,N00033640,Hakeem Jeffries (D),2014,Building Trade Unions,0,43500,43500
J000294,N00033640,Hakeem Jeffries (D),2014,Electronics Mfg & Equip,2750,37090,39840
J000294,N00033640,Hakeem Jeffries (D),2014,Public Sector Unions,0,33100,33100
J000294,N00033640,Hakeem Jeffries (D),2014,Industrial Unions,0,29500,29500
J000294,N00033640,Hakeem Jeffries (D),2014,Misc Unions,0,28000,28000
J000294,N00033640,Hakeem Jeffries (D),2014,Business Services,22500,3500,26000
A000372,N00033720,Richard W Allen (R),2014,Retired,117450,0,117450
A000372,N00033720,Richard W Allen (R),2014,Leadership PACs,0,103000,103000
A000372,N00033720,Richard W Allen (R),2014,Health Professionals,88000,1000,89000
A000372,N00033720,Richard W Allen (R),2014,Real Estate,80675,0,80675
A000372,N00033720,Richard W Allen (R),2014,General Contractors,55250,17500,72750
A000372,N00033720,Richard W Allen (R),2014,Oil & Gas,31750,2500,34250
A000372,N00033720,Richard W Allen (R),2014,Candidate Committees,0,31500,31500
A000372,N00033720,Richard W Allen (R),2014,Lawyers/Law Firms,27950,1000,28950
A000372,N00033720,Richard W Allen (R),2014,Automotive,22700,4500,27200
A000372,N00033720,Richard W Allen (R),2014,Securities & Investment,26950,0,26950
B001294,N00033744,Rod Blum (R),2014,Leadership PACs,0,93700,93700
B001294,N00033744,Rod Blum (R),2014,Retired,71831,0,71831
B001294,N00033744,Rod Blum (R),2014,Real Estate,35637,5000,40637
B001294,N00033744,Rod Blum (R),2014,Republican/Conservative,13320,22000,35320
B001294,N00033744,Rod Blum (R),2014,General Contractors,19350,8000,27350
B001294,N00033744,Rod Blum (R),2014,Trucking,25300,0,25300
B001294,N00033744,Rod Blum (R),2014,Commercial Banks,17849,6000,23849
B001294,N00033744,Rod Blum (R),2014,Crop Production & Basic Processing,20880,2000,22880
B001294,N00033744,Rod Blum (R),2014,Insurance,19050,0,19050
B001294,N00033744,Rod Blum (R),2014,Building Materials & Equipment,19000,0,19000
H001069,N00033782,Heidi Heitkamp (D),2014,Lawyers/Law Firms,576950,67161,644111
H001069,N00033782,Heidi Heitkamp (D),2014,Leadership PACs,0,323918,323918
H001069,N00033782,Heidi Heitkamp (D),2014,Securities & Investment,122349,53500,175849
H001069,N00033782,Heidi Heitkamp (D),2014,Women's Issues,165994,8500,174494
H001069,N00033782,Heidi Heitkamp (D),2014,Oil & Gas,59124,115000,174124
H001069,N00033782,Heidi Heitkamp (D),2014,Lobbyists,155235,3500,158735
H001069,N00033782,Heidi Heitkamp (D),2014,Retired,152066,0,152066
H001069,N00033782,Heidi Heitkamp (D),2014,Crop Production & Basic Processing,84000,31000,115000
H001069,N00033782,Heidi Heitkamp (D),2014,TV/Movies/Music,92667,8500,101167
H001069,N00033782,Heidi Heitkamp (D),2014,Real Estate,78767,19000,97767
M001195,N00033814,Alex Mooney (R),2014,Republican/Conservative,84542,107275,191817
M001195,N00033814,Alex Mooney (R),2014,Leadership PACs,0,172607,172607
M001195,N00033814,Alex Mooney (R),2014,Retired,119163,0,119163
M001195,N00033814,Alex Mooney (R),2014,Mining,70370,34500,104870
M001195,N00033814,Alex Mooney (R),2014,Lawyers/Law Firms,66751,3483,70234
M001195,N00033814,Alex Mooney (R),2014,Business Services,60033,4100,64133
M001195,N00033814,Alex Mooney (R),2014,Candidate Committees,0,61500,61500
M001195,N00033814,Alex Mooney (R),2014,Securities & Investment,58650,0,58650
M001195,N00033814,Alex Mooney (R),2014,Health Professionals,24133,23000,47133
M001195,N00033814,Alex Mooney (R),2014,Real Estate,35608,0,35608
R000597,N00033832,Tom Rice (R),2014,Real Estate,67164,14500,81664
R000597,N00033832,Tom Rice (R),2014,Retired,61900,0,61900
R000597,N00033832,Tom Rice (R),2014,General Contractors,50600,10000,60600
R000597,N00033832,Tom Rice (R),2014,Health Professionals,40600,17000,57600
R000597,N00033832,Tom Rice (R),2014,Accountants,8500,42999,51499
R000597,N00033832,Tom Rice (R),2014,Crop Production & Basic Processing,26150,18000,44150
R000597,N00033832,Tom Rice (R),2014,Electric Utilities,2250,41000,43250
R000597,N00033832,Tom Rice (R),2014,Insurance,12900,28000,40900
R000597,N00033832,Tom Rice (R),2014,Air Transport,0,35555,35555
R000597,N00033832,Tom Rice (R),2014,Hospitals/Nursing Homes,16000,18000,34000
V000131,N00033839,Marc Veasey (D),2014,Lawyers/Law Firms,149538,17250,166788
V000131,N00033839,Marc Veasey (D),2014,Real Estate,54525,23500,78025
V000131,N00033839,Marc Veasey (D),2014,Transportation Unions,0,64600,64600
V000131,N00033839,Marc Veasey (D),2014,Defense Aerospace,0,63499,63499
V000131,N00033839,Marc Veasey (D),2014,Oil & Gas,24000,27000,51000
V000131,N00033839,Marc Veasey (D),2014,Retired,46550,0,46550
V000131,N00033839,Marc Veasey (D),2014,Building Trade Unions,0,44500,44500
V000131,N00033839,Marc Veasey (D),2014,Leadership PACs,0,44068,44068
V000131,N00033839,Marc Veasey (D),2014,Industrial Unions,0,44000,44000
V000131,N00033839,Marc Veasey (D),2014,Securities & Investment,25400,12500,37900
L000584,N00033842,Mia Love (R),2014,Republican/Conservative,289406,27699,317105
L000584,N00033842,Mia Love (R),2014,Retired,221183,0,221183
L000584,N00033842,Mia Love (R),2014,Leadership PACs,0,89500,89500
L000584,N00033842,Mia Love (R),2014,Securities & Investment,77900,2000,79900
L000584,N00033842,Mia Love (R),2014,Real Estate,61895,15500,77395
L000584,N00033842,Mia Love (R),2014,Oil & Gas,19500,36500,56000
L000584,N00033842,Mia Love (R),2014,Health Professionals,27782,13500,41282
L000584,N00033842,Mia Love (R),2014,Business Services,38276,1000,39276
L000584,N00033842,Mia Love (R),2014,Pharmaceuticals/Health Products,25300,12500,37800
L000584,N00033842,Mia Love (R),2014,Misc Manufacturing & Distributing,28900,8000,36900
D000620,N00033897,John K Delaney (D),2014,Securities & Investment,187500,81000,268500
D000620,N00033897,John K Delaney (D),2014,Real Estate,119454,57500,176954
D000620,N00033897,John K Delaney (D),2014,Lawyers/Law Firms,91050,16500,107550
D000620,N00033897,John K Delaney (D),2014,Commercial Banks,39250,61000,100250
D000620,N00033897,John K Delaney (D),2014,Insurance,5250,68000,73250
D000620,N00033897,John K Delaney (D),2014,Misc Finance,60000,13000,73000
D000620,N00033897,John K Delaney (D),2014,Electric Utilities,17000,29500,46500
D000620,N00033897,John K Delaney (D),2014,Accountants,8300,30999,39299
D000620,N00033897,John K Delaney (D),2014,Retired,38050,0,38050
D000620,N00033897,John K Delaney (D),2014,Building Trade Unions,0,36000,36000
B001281,N00033904,Joyce Beatty (D),2014,Insurance,24400,82750,107150
B001281,N00033904,Joyce Beatty (D),2014,Commercial Banks,5050,56500,61550
B001281,N00033904,Joyce Beatty (D),2014,Electric Utilities,7100,47500,54600
B001281,N00033904,Joyce Beatty (D),2014,Lawyers/Law Firms,18950,32500,51450
B001281,N00033904,Joyce Beatty (D),2014,Retail Sales,16500,27500,44000
B001281,N00033904,Joyce Beatty (D),2014,Building Trade Unions,0,40100,40100
B001281,N00033904,Joyce Beatty (D),2014,Real Estate,6500,32000,38500
B001281,N00033904,Joyce Beatty (D),2014,Securities & Investment,4500,31000,35500
B001281,N00033904,Joyce Beatty (D),2014,Pharmaceuticals/Health Products,1000,31750,32750
B001281,N00033904,Joyce Beatty (D),2014,Industrial Unions,0,31000,31000
S001192,N00033932,Chris Stewart (R),2014,Oil & Gas,7850,57500,65350
S001192,N00033932,Chris Stewart (R),2014,Leadership PACs,0,37000,37000
S001192,N00033932,Chris Stewart (R),2014,Pharmaceuticals/Health Products,7700,26500,34200
S001192,N00033932,Chris Stewart (R),2014,Health Professionals,7600,26000,33600
S001192,N00033932,Chris Stewart (R),2014,Lobbyists,32267,0,32267
S001192,N00033932,Chris Stewart (R),2014,Electric Utilities,1500,25500,27000
S001192,N00033932,Chris Stewart (R),2014,Defense Aerospace,0,27000,27000
S001192,N00033932,Chris Stewart (R),2014,Real Estate,21000,4000,25000
S001192,N00033932,Chris Stewart (R),2014,Commercial Banks,10450,14500,24950
S001192,N00033932,Chris Stewart (R),2014,Insurance,2500,20000,22500
B001279,N00033981,Ron Barber (D),2014,Retired,293650,0,293650
B001279,N00033981,Ron Barber (D),2014,Leadership PACs,9550,270864,280414
B001279,N00033981,Ron Barber (D),2014,Candidate Committees,0,170764,170764
B001279,N00033981,Ron Barber (D),2014,Health Professionals,18350,117650,136000
B001279,N00033981,Ron Barber (D),2014,Lawyers/Law Firms,85766,27750,113516
B001279,N00033981,Ron Barber (D),2014,Public Sector Unions,250,90500,90750
B001279,N00033981,Ron Barber (D),2014,Democratic/Liberal,42226,39100,81326
B001279,N00033981,Ron Barber (D),2014,Real Estate,59900,16000,75900
B001279,N00033981,Ron Barber (D),2014,Transportation Unions,0,60500,60500
B001279,N00033981,Ron Barber (D),2014,Business Services,59339,500,59839
M001197,N00033982,Martha McSally (R),2014,Retired,500376,0,500376
M001197,N00033982,Martha McSally (R),2014,Leadership PACs,1000,312261,313261
M001197,N00033982,Martha McSally (R),2014,Securities & Investment,187827,1000,188827
M001197,N00033982,Martha McSally (R),2014,Republican/Conservative,137115,31000,168115
M001197,N00033982,Martha McSally (R),2014,Real Estate,148536,2500,151036
M001197,N00033982,Martha McSally (R),2014,Automotive,76250,22500,98750
M001197,N00033982,Martha McSally (R),2014,Candidate Committees,0,79996,79996
M001197,N00033982,Martha McSally (R),2014,Health Professionals,76383,1500,77883
M001197,N00033982,Martha McSally (R),2014,Misc Finance,65700,0,65700
M001197,N00033982,Martha McSally (R),2014,Lawyers/Law Firms,46582,0,46582
S001191,N00033983,Kyrsten Sinema (D),2014,Lawyers/Law Firms,233565,28750,262315
S001191,N00033983,Kyrsten Sinema (D),2014,Leadership PACs,4700,202300,207000
S001191,N00033983,Kyrsten Sinema (D),2014,Retired,189795,0,189795
S001191,N00033983,Kyrsten Sinema (D),2014,Real Estate,106970,41500,148470
S001191,N00033983,Kyrsten Sinema (D),2014,Insurance,6950,130500,137450
S001191,N00033983,Kyrsten Sinema (D),2014,Democratic/Liberal,111075,15200,126275
S001191,N00033983,Kyrsten Sinema (D),2014,Securities & Investment,48783,74000,122783
S001191,N00033983,Kyrsten Sinema (D),2014,Women's Issues,86749,25500,112249
S001191,N00033983,Kyrsten Sinema (D),2014,Health Professionals,47128,39000,86128
S001191,N00033983,Kyrsten Sinema (D),2014,Candidate Committees,0,85237,85237
L000578,N00033987,Doug LaMalfa (R),2014,Crop Production & Basic Processing,99575,70356,169931
L000578,N00033987,Doug LaMalfa (R),2014,Casinos/Gambling,48300,5000,53300
L000578,N00033987,Doug LaMalfa (R),2014,Oil & Gas,5500,33500,39000
L000578,N00033987,Doug LaMalfa (R),2014,Leadership PACs,0,30500,30500
L000578,N00033987,Doug LaMalfa (R),2014,Agricultural Services/Products,2500,24357,26857
L000578,N00033987,Doug LaMalfa (R),2014,Dairy,4000,18481,22481
L000578,N00033987,Doug LaMalfa (R),2014,Automotive,0,21000,21000
L000578,N00033987,Doug LaMalfa (R),2014,Real Estate,13700,7000,20700
L000578,N00033987,Doug LaMalfa (R),2014,Livestock,6850,10000,16850
L000578,N00033987,Doug LaMalfa (R),2014,Accountants,2250,14500,16750
A000371,N00033997,Pete Aguilar (D),2014,Leadership PACs,4100,141200,145300
A000371,N00033997,Pete Aguilar (D),2014,Lawyers/Law Firms,111269,11250,122519
A000371,N00033997,Pete Aguilar (D),2014,Public Sector Unions,700,84500,85200
A000371,N00033997,Pete Aguilar (D),2014,Real Estate,74496,9000,83496
A000371,N00033997,Pete Aguilar (D),2014,Building Trade Unions,0,73000,73000
A000371,N00033997,Pete Aguilar (D),2014,Retired,65928,0,65928
A000371,N00033997,Pete Aguilar (D),2014,Candidate Committees,0,65500,65500
A000371,N00033997,Pete Aguilar (D),2014,Credit Unions,34050,26000,60050
A000371,N00033997,Pete Aguilar (D),2014,Pro-Israel,54405,5636,60041
A000371,N00033997,Pete Aguilar (D),2014,Democratic/Liberal,35511,13250,48761
R000596,N00034017,Trey Radel (R),2014,Health Professionals,4100,20000,24100
R000596,N00034017,Trey Radel (R),2014,Air Transport,250,21726,21976
R000596,N00034017,Trey Radel (R),2014,Insurance,1000,16000,17000
R000596,N00034017,Trey Radel (R),2014,Food & Beverage,2600,13958,16558
R000596,N00034017,Trey Radel (R),2014,Oil & Gas,10700,5000,15700
R000596,N00034017,Trey Radel (R),2014,Leadership PACs,0,15184,15184
R000596,N00034017,Trey Radel (R),2014,Railroads,0,14500,14500
R000596,N00034017,Trey Radel (R),2014,Pharmaceuticals/Health Products,2500,8000,10500
R000596,N00034017,Trey Radel (R),2014,Retired,10450,0,10450
R000596,N00034017,Trey Radel (R),2014,Retail Sales,1000,8500,9500
M001184,N00034041,Thomas Massie (R),2014,Air Transport,26300,18726,45026
M001184,N00034041,Thomas Massie (R),2014,Lawyers/Law Firms,14950,13500,28450
M001184,N00034041,Thomas Massie (R),2014,Leadership PACs,0,25200,25200
M001184,N00034041,Thomas Massie (R),2014,Railroads,0,25000,25000
M001184,N00034041,Thomas Massie (R),2014,Securities & Investment,23750,0,23750
M001184,N00034041,Thomas Massie (R),2014,Oil & Gas,2000,19500,21500
M001184,N00034041,Thomas Massie (R),2014,Republican/Conservative,10001,9750,19751
M001184,N00034041,Thomas Massie (R),2014,Pharmaceuticals/Health Products,17150,1000,18150
M001184,N00034041,Thomas Massie (R),2014,"Beer, Wine & Liquor",3250,14500,17750
M001184,N00034041,Thomas Massie (R),2014,Gun Rights,6100,11000,17100
K000379,N00034044,Joe Kennedy III (D),2014,Securities & Investment,433314,8000,441314
K000379,N00034044,Joe Kennedy III (D),2014,Lawyers/Law Firms,285799,32650,318449
K000379,N00034044,Joe Kennedy III (D),2014,Real Estate,154800,16000,170800
K000379,N00034044,Joe Kennedy III (D),2014,Lobbyists,100000,2453,102453
K000379,N00034044,Joe Kennedy III (D),2014,Pharmaceuticals/Health Products,20850,63244,84094
K000379,N00034044,Joe Kennedy III (D),2014,Business Services,77250,4000,81250
K000379,N00034044,Joe Kennedy III (D),2014,Misc Finance,67800,0,67800
K000379,N00034044,Joe Kennedy III (D),2014,Electronics Mfg & Equip,33823,24680,58503
K000379,N00034044,Joe Kennedy III (D),2014,Education,55000,0,55000
K000379,N00034044,Joe Kennedy III (D),2014,Retired,54750,0,54750
L000581,N00034068,Brenda Lawrence (D),2014,Real Estate,39150,13500,52650
L000581,N00034068,Brenda Lawrence (D),2014,Women's Issues,33864,11500,45364
L000581,N00034068,Brenda Lawrence (D),2014,Leadership PACs,0,44500,44500
L000581,N00034068,Brenda Lawrence (D),2014,Automotive,24300,12500,36800
L000581,N00034068,Brenda Lawrence (D),2014,Lawyers/Law Firms,17400,13500,30900
L000581,N00034068,Brenda Lawrence (D),2014,Building Trade Unions,0,26250,26250
L000581,N00034068,Brenda Lawrence (D),2014,Public Sector Unions,0,22500,22500
L000581,N00034068,Brenda Lawrence (D),2014,Securities & Investment,18100,0,18100
L000581,N00034068,Brenda Lawrence (D),2014,Candidate Committees,0,17000,17000
L000581,N00034068,Brenda Lawrence (D),2014,Health Professionals,11950,2000,13950
P000605,N00034120,Scott Perry (R),2014,Railroads,250,29500,29750
P000605,N00034120,Scott Perry (R),2014,Oil & Gas,6100,22500,28600
P000605,N00034120,Scott Perry (R),2014,Electric Utilities,0,26500,26500
P000605,N00034120,Scott Perry (R),2014,Insurance,6250,18450,24700
P000605,N00034120,Scott Perry (R),2014,Leadership PACs,0,24000,24000
P000605,N00034120,Scott Perry (R),2014,Real Estate,15650,8000,23650
P000605,N00034120,Scott Perry (R),2014,Air Transport,0,22998,22998
P000605,N00034120,Scott Perry (R),2014,Retired,21300,0,21300
P000605,N00034120,Scott Perry (R),2014,Building Materials & Equipment,3000,18000,21000
P000605,N00034120,Scott Perry (R),2014,Lawyers/Law Firms,7750,10750,18500
C001090,N00034128,Matt Cartwright (D),2014,Lawyers/Law Firms,487740,14000,501740
C001090,N00034128,Matt Cartwright (D),2014,Building Trade Unions,0,65500,65500
C001090,N00034128,Matt Cartwright (D),2014,Public Sector Unions,0,55750,55750
C001090,N00034128,Matt Cartwright (D),2014,Industrial Unions,0,54000,54000
C001090,N00034128,Matt Cartwright (D),2014,Transportation Unions,0,25500,25500
C001090,N00034128,Matt Cartwright (D),2014,Health Professionals,18100,4250,22350
C001090,N00034128,Matt Cartwright (D),2014,Defense Aerospace,0,20000,20000
C001090,N00034128,Matt Cartwright (D),2014,Real Estate,10400,8000,18400
C001090,N00034128,Matt Cartwright (D),2014,Retired,16720,0,16720
C001090,N00034128,Matt Cartwright (D),2014,Insurance,12750,1250,14000
C001094,N00034224,Paul Cook (R),2014,Casinos/Gambling,67400,0,67400
C001094,N00034224,Paul Cook (R),2014,Leadership PACs,0,54700,54700
C001094,N00034224,Paul Cook (R),2014,Defense Aerospace,0,41000,41000
C001094,N00034224,Paul Cook (R),2014,Building Materials & Equipment,15200,25000,40200
C001094,N00034224,Paul Cook (R),2014,Health Professionals,7050,32000,39050
C001094,N00034224,Paul Cook (R),2014,Building Trade Unions,0,37500,37500
C001094,N00034224,Paul Cook (R),2014,Real Estate,26050,6000,32050
C001094,N00034224,Paul Cook (R),2014,Transportation Unions,0,25000,25000
C001094,N00034224,Paul Cook (R),2014,Public Sector Unions,0,24000,24000
C001094,N00034224,Paul Cook (R),2014,Republican/Conservative,0,23500,23500
B001285,N00034254,Julia Brownley (D),2014,Leadership PACs,8600,258588,267188
B001285,N00034254,Julia Brownley (D),2014,Women's Issues,227692,36500,264192
B001285,N00034254,Julia Brownley (D),2014,Retired,243480,0,243480
B001285,N00034254,Julia Brownley (D),2014,Lawyers/Law Firms,136680,15000,151680
B001285,N00034254,Julia Brownley (D),2014,Candidate Committees,0,138500,138500
B001285,N00034254,Julia Brownley (D),2014,Public Sector Unions,0,108800,108800
B001285,N00034254,Julia Brownley (D),2014,Democratic/Liberal,70999,14200,85199
B001285,N00034254,Julia Brownley (D),2014,Environment,55915,20946,76861
B001285,N00034254,Julia Brownley (D),2014,Real Estate,62649,11000,73649
B001285,N00034254,Julia Brownley (D),2014,Transportation Unions,0,68500,68500
M001185,N00034277,Sean Patrick Maloney (D),2014,Lawyers/Law Firms,373298,26250,399548
M001185,N00034277,Sean Patrick Maloney (D),2014,Securities & Investment,303122,89000,392122
M001185,N00034277,Sean Patrick Maloney (D),2014,Leadership PACs,6950,226950,233900
M001185,N00034277,Sean Patrick Maloney (D),2014,Real Estate,181875,40000,221875
M001185,N00034277,Sean Patrick Maloney (D),2014,Retired,161300,0,161300
M001185,N00034277,Sean Patrick Maloney (D),2014,Business Services,96076,500,96576
M001185,N00034277,Sean Patrick Maloney (D),2014,Candidate Committees,0,94500,94500
M001185,N00034277,Sean Patrick Maloney (D),2014,Health Professionals,65997,23500,89497
M001185,N00034277,Sean Patrick Maloney (D),2014,Insurance,35100,52000,87100
M001185,N00034277,Sean Patrick Maloney (D),2014,Transportation Unions,0,81500,81500
V000132,N00034349,Filemon Vela (D),2014,Lawyers/Law Firms,68050,11500,79550
V000132,N00034349,Filemon Vela (D),2014,Construction Services,44014,9000,53014
V000132,N00034349,Filemon Vela (D),2014,Building Trade Unions,0,37500,37500
V000132,N00034349,Filemon Vela (D),2014,Crop Production & Basic Processing,4650,32500,37150
V000132,N00034349,Filemon Vela (D),2014,Industrial Unions,0,32000,32000
V000132,N00034349,Filemon Vela (D),2014,Hospitals/Nursing Homes,5750,22000,27750
V000132,N00034349,Filemon Vela (D),2014,Health Professionals,21143,6500,27643
V000132,N00034349,Filemon Vela (D),2014,Oil & Gas,5000,21500,26500
V000132,N00034349,Filemon Vela (D),2014,"Beer, Wine & Liquor",10200,14500,24700
V000132,N00034349,Filemon Vela (D),2014,Public Sector Unions,0,20000,20000
P000606,N00034416,Robert Pittenger (R),2014,Retired,97500,0,97500
P000606,N00034416,Robert Pittenger (R),2014,Insurance,10700,64500,75200
P000606,N00034416,Robert Pittenger (R),2014,Securities & Investment,32300,39000,71300
P000606,N00034416,Robert Pittenger (R),2014,Real Estate,32350,35000,67350
P000606,N00034416,Robert Pittenger (R),2014,Commercial Banks,6500,59500,66000
P000606,N00034416,Robert Pittenger (R),2014,Lawyers/Law Firms,29950,11125,41075
P000606,N00034416,Robert Pittenger (R),2014,Misc Finance,26200,3000,29200
P000606,N00034416,Robert Pittenger (R),2014,Accountants,3500,24000,27500
P000606,N00034416,Robert Pittenger (R),2014,Retail Sales,13650,12000,25650
P000606,N00034416,Robert Pittenger (R),2014,Leadership PACs,0,24507,24507
K000381,N00034453,Derek Kilmer (D),2014,Retired,121950,0,121950
K000381,N00034453,Derek Kilmer (D),2014,Lawyers/Law Firms,57225,19500,76725
K000381,N00034453,Derek Kilmer (D),2014,Transportation Unions,0,67000,67000
K000381,N00034453,Derek Kilmer (D),2014,Business Services,58600,5500,64100
K000381,N00034453,Derek Kilmer (D),2014,Defense Aerospace,1250,60000,61250
K000381,N00034453,Derek Kilmer (D),2014,Health Professionals,21050,36000,57050
K000381,N00034453,Derek Kilmer (D),2014,Building Trade Unions,0,54500,54500
K000381,N00034453,Derek Kilmer (D),2014,Securities & Investment,39800,12000,51800
K000381,N00034453,Derek Kilmer (D),2014,Public Sector Unions,2600,46000,48600
K000381,N00034453,Derek Kilmer (D),2014,Real Estate,23050,25000,48050
M001188,N00034547,Grace Meng (D),2014,Real Estate,57750,8500,66250
M001188,N00034547,Grace Meng (D),2014,Lawyers/Law Firms,31267,10000,41267
M001188,N00034547,Grace Meng (D),2014,Health Professionals,23000,10000,33000
M001188,N00034547,Grace Meng (D),2014,Retired,31500,0,31500
M001188,N00034547,Grace Meng (D),2014,Building Trade Unions,0,28600,28600
M001188,N00034547,Grace Meng (D),2014,Securities & Investment,22350,6000,28350
M001188,N00034547,Grace Meng (D),2014,Public Sector Unions,0,28000,28000
M001188,N00034547,Grace Meng (D),2014,Misc Business,26115,0,26115
M001188,N00034547,Grace Meng (D),2014,General Contractors,24950,0,24950
M001188,N00034547,Grace Meng (D),2014,Misc Services,22500,0,22500
K000383,N00034580,Angus King (I),2014,Retired,309936,0,309936
K000383,N00034580,Angus King (I),2014,Lawyers/Law Firms,266198,23000,289198
K000383,N00034580,Angus King (I),2014,Securities & Investment,126294,9000,135294
K000383,N00034580,Angus King (I),2014,Health Professionals,47000,48000,95000
K000383,N00034580,Angus King (I),2014,Real Estate,80200,13216,93416
K000383,N00034580,Angus King (I),2014,Education,59183,0,59183
K000383,N00034580,Angus King (I),2014,Insurance,27000,28500,55500
K000383,N00034580,Angus King (I),2014,Business Services,50773,0,50773
K000383,N00034580,Angus King (I),2014,Misc Finance,47050,0,47050
K000383,N00034580,Angus King (I),2014,Pro-Israel,29500,17000,46500
P000611,N00034584,Bruce Poliquin (R),2014,Retired,237100,0,237100
P000611,N00034584,Bruce Poliquin (R),2014,Leadership PACs,0,120600,120600
P000611,N00034584,Bruce Poliquin (R),2014,Securities & Investment,111300,1000,112300
P000611,N00034584,Bruce Poliquin (R),2014,Real Estate,45650,5000,50650
P000611,N00034584,Bruce Poliquin (R),2014,Automotive,28325,8000,36325
P000611,N00034584,Bruce Poliquin (R),2014,Misc Finance,33000,0,33000
P000611,N00034584,Bruce Poliquin (R),2014,Republican/Conservative,18400,13500,31900
P000611,N00034584,Bruce Poliquin (R),2014,Insurance,26250,4000,30250
P000611,N00034584,Bruce Poliquin (R),2014,Candidate Committees,0,27500,27500
P000611,N00034584,Bruce Poliquin (R),2014,Oil & Gas,9100,13000,22100
P000604,N00034639,Donald M Payne Jr (D),2014,Building Trade Unions,3600,32500,36100
P000604,N00034639,Donald M Payne Jr (D),2014,Public Sector Unions,0,28000,28000
P000604,N00034639,Donald M Payne Jr (D),2014,Lawyers/Law Firms,16300,8500,24800
P000604,N00034639,Donald M Payne Jr (D),2014,Insurance,5750,18500,24250
P000604,N00034639,Donald M Payne Jr (D),2014,Transportation Unions,0,23850,23850
P000604,N00034639,Donald M Payne Jr (D),2014,Pharmaceuticals/Health Products,2500,19500,22000
P000604,N00034639,Donald M Payne Jr (D),2014,Electric Utilities,3700,16000,19700
P000604,N00034639,Donald M Payne Jr (D),2014,Lobbyists,14092,1000,15092
P000604,N00034639,Donald M Payne Jr (D),2014,Industrial Unions,0,14750,14750
P000604,N00034639,Donald M Payne Jr (D),2014,Air Transport,0,12500,12500
D000621,N00034746,Ron DeSantis (R),2014,Retired,94325,0,94325
D000621,N00034746,Ron DeSantis (R),2014,Insurance,28450,55200,83650
D000621,N00034746,Ron DeSantis (R),2014,Health Professionals,45500,8000,53500
D000621,N00034746,Ron DeSantis (R),2014,Lawyers/Law Firms,40312,7250,47562
D000621,N00034746,Ron DeSantis (R),2014,Real Estate,36500,5000,41500
D000621,N00034746,Ron DeSantis (R),2014,Recreation/Live Entertainment,27000,7000,34000
D000621,N00034746,Ron DeSantis (R),2014,Telecom Services,0,33500,33500
D000621,N00034746,Ron DeSantis (R),2014,Misc Manufacturing & Distributing,11450,20500,31950
D000621,N00034746,Ron DeSantis (R),2014,Republican/Conservative,10050,20500,30550
D000621,N00034746,Ron DeSantis (R),2014,TV/Movies/Music,3000,27000,30000
D000619,N00034784,Rodney Davis (R),2014,Leadership PACs,0,278986,278986
D000619,N00034784,Rodney Davis (R),2014,Health Professionals,56700,90750,147450
D000619,N00034784,Rodney Davis (R),2014,Insurance,48450,89500,137950
D000619,N00034784,Rodney Davis (R),2014,Agricultural Services/Products,25949,101908,127857
D000619,N00034784,Rodney Davis (R),2014,Securities & Investment,77100,38500,115600
D000619,N00034784,Rodney Davis (R),2014,Mining,64945,37867,102812
D000619,N00034784,Rodney Davis (R),2014,Food & Beverage,39500,60000,99500
D000619,N00034784,Rodney Davis (R),2014,Crop Production & Basic Processing,33450,60500,93950
D000619,N00034784,Rodney Davis (R),2014,Lawyers/Law Firms,55609,31500,87109
D000619,N00034784,Rodney Davis (R),2014,Oil & Gas,21090,59500,80590
E000292,N00034884,William Enyart (D),2014,Lawyers/Law Firms,273294,27000,300294
E000292,N00034884,William Enyart (D),2014,Leadership PACs,0,194250,194250
E000292,N00034884,William Enyart (D),2014,Candidate Committees,0,81000,81000
E000292,N00034884,William Enyart (D),2014,Public Sector Unions,0,75250,75250
E000292,N00034884,William Enyart (D),2014,Building Trade Unions,3750,67250,71000
E000292,N00034884,William Enyart (D),2014,Industrial Unions,0,58000,58000
E000292,N00034884,William Enyart (D),2014,Pro-Israel,43000,12736,55736
E000292,N00034884,William Enyart (D),2014,Defense Aerospace,0,54498,54498
E000292,N00034884,William Enyart (D),2014,Transportation Unions,0,47000,47000
E000292,N00034884,William Enyart (D),2014,Crop Production & Basic Processing,3950,33000,36950
P000610,N00035000,Stacey Plaskett (D),2014,Lawyers/Law Firms,27350,5250,32600
P000610,N00035000,Stacey Plaskett (D),2014,Securities & Investment,30950,0,30950
P000610,N00035000,Stacey Plaskett (D),2014,Leadership PACs,0,28600,28600
P000610,N00035000,Stacey Plaskett (D),2014,Misc Business,24109,0,24109
P000610,N00035000,Stacey Plaskett (D),2014,Business Services,10954,0,10954
P000610,N00035000,Stacey Plaskett (D),2014,Real Estate,8700,2000,10700
P000610,N00035000,Stacey Plaskett (D),2014,Misc Manufacturing & Distributing,9800,0,9800
P000610,N00035000,Stacey Plaskett (D),2014,Candidate Committees,0,9000,9000
P000610,N00035000,Stacey Plaskett (D),2014,Retired,7350,0,7350
P000610,N00035000,Stacey Plaskett (D),2014,"Beer, Wine & Liquor",0,6179,6179
J000295,N00035007,David P Joyce (R),2014,Leadership PACs,0,197077,197077
J000295,N00035007,David P Joyce (R),2014,Misc Manufacturing & Distributing,108915,54500,163415
J000295,N00035007,David P Joyce (R),2014,Real Estate,83796,24000,107796
J000295,N00035007,David P Joyce (R),2014,Transportation Unions,0,102500,102500
J000295,N00035007,David P Joyce (R),2014,Lawyers/Law Firms,74450,23192,97642
J000295,N00035007,David P Joyce (R),2014,Health Professionals,20250,73750,94000
J000295,N00035007,David P Joyce (R),2014,Retired,80950,0,80950
J000295,N00035007,David P Joyce (R),2014,Securities & Investment,71572,4000,75572
J000295,N00035007,David P Joyce (R),2014,Candidate Committees,0,61000,61000
J000295,N00035007,David P Joyce (R),2014,Pharmaceuticals/Health Products,20450,39000,59450
R000605,N00035187,Mike Rounds (R),2014,Retired,318226,0,318226
R000605,N00035187,Mike Rounds (R),2014,Securities & Investment,291308,4500,295808
R000605,N00035187,Mike Rounds (R),2014,Leadership PACs,0,282500,282500
R000605,N00035187,Mike Rounds (R),2014,Commercial Banks,124060,89600,213660
R000605,N00035187,Mike Rounds (R),2014,Oil & Gas,80900,119000,199900
R000605,N00035187,Mike Rounds (R),2014,Real Estate,161400,36500,197900
R000605,N00035187,Mike Rounds (R),2014,Insurance,71800,118750,190550
R000605,N00035187,Mike Rounds (R),2014,Health Professionals,89800,60100,149900
R000605,N00035187,Mike Rounds (R),2014,Lawyers/Law Firms,102660,12000,114660
R000605,N00035187,Mike Rounds (R),2014,Lobbyists,92750,4500,97250
R000605,N00035187,Mike Rounds (R),2014,Retail Sales,55750,41500,97250
K000385,N00035215,Robin Kelly (D),2014,Public Sector Unions,0,58000,58000
K000385,N00035215,Robin Kelly (D),2014,Lawyers/Law Firms,33720,20365,54085
K000385,N00035215,Robin Kelly (D),2014,Building Trade Unions,0,51000,51000
K000385,N00035215,Robin Kelly (D),2014,Securities & Investment,24300,20500,44800
K000385,N00035215,Robin Kelly (D),2014,Human Rights,31350,6250,37600
K000385,N00035215,Robin Kelly (D),2014,Industrial Unions,0,37000,37000
K000385,N00035215,Robin Kelly (D),2014,Health Professionals,10950,26000,36950
K000385,N00035215,Robin Kelly (D),2014,Crop Production & Basic Processing,200,31500,31700
K000385,N00035215,Robin Kelly (D),2014,Real Estate,13772,13500,27272
K000385,N00035215,Robin Kelly (D),2014,Misc Unions,0,25000,25000
B001288,N00035267,Cory Booker (D),2014,Lawyers/Law Firms,2165809,150800,2316609
B001288,N00035267,Cory Booker (D),2014,Securities & Investment,2132520,51500,2184020
B001288,N00035267,Cory Booker (D),2014,Real Estate,1043920,26000,1069920
B001288,N00035267,Cory Booker (D),2014,TV/Movies/Music,699880,20500,720380
B001288,N00035267,Cory Booker (D),2014,Misc Finance,443950,13500,457450
B001288,N00035267,Cory Booker (D),2014,Business Services,449435,5000,454435
B001288,N00035267,Cory Booker (D),2014,Pro-Israel,397599,36527,434126
B001288,N00035267,Cory Booker (D),2014,Insurance,236200,103500,339700
B001288,N00035267,Cory Booker (D),2014,Pharmaceuticals/Health Products,167000,161000,328000
B001288,N00035267,Cory Booker (D),2014,Misc Manufacturing & Distributing,295125,20600,315725
C001101,N00035278,Katherine Clark (D),2014,Lawyers/Law Firms,191795,19750,211545
C001101,N00035278,Katherine Clark (D),2014,Women's Issues,119450,11500,130950
C001101,N00035278,Katherine Clark (D),2014,Retired,121570,0,121570
C001101,N00035278,Katherine Clark (D),2014,Securities & Investment,92139,5000,97139
C001101,N00035278,Katherine Clark (D),2014,Real Estate,73300,11000,84300
C001101,N00035278,Katherine Clark (D),2014,Pharmaceuticals/Health Products,13650,55100,68750
C001101,N00035278,Katherine Clark (D),2014,Business Services,65371,0,65371
C001101,N00035278,Katherine Clark (D),2014,Building Trade Unions,0,62500,62500
C001101,N00035278,Katherine Clark (D),2014,Education,52594,0,52594
C001101,N00035278,Katherine Clark (D),2014,Health Services/HMOs,44300,0,44300
S001195,N00035282,Jason Smith (R),2014,Leadership PACs,0,129516,129516
S001195,N00035282,Jason Smith (R),2014,Crop Production & Basic Processing,71000,35000,106000
S001195,N00035282,Jason Smith (R),2014,Health Professionals,49250,46000,95250
S001195,N00035282,Jason Smith (R),2014,Commercial Banks,42350,20500,62850
S001195,N00035282,Jason Smith (R),2014,Automotive,21900,31000,52900
S001195,N00035282,Jason Smith (R),2014,Lawyers/Law Firms,36350,12000,48350
S001195,N00035282,Jason Smith (R),2014,Real Estate,25750,18500,44250
S001195,N00035282,Jason Smith (R),2014,General Contractors,36750,7000,43750
S001195,N00035282,Jason Smith (R),2014,Mining,11465,26200,37665
S001195,N00035282,Jason Smith (R),2014,Hospitals/Nursing Homes,18750,17000,35750
B001296,N00035307,Brendan Boyle (D),2014,Lawyers/Law Firms,73669,28613,102282
B001296,N00035307,Brendan Boyle (D),2014,Leadership PACs,1000,58100,59100
B001296,N00035307,Brendan Boyle (D),2014,Transportation Unions,0,51000,51000
B001296,N00035307,Brendan Boyle (D),2014,Building Trade Unions,1000,50000,51000
B001296,N00035307,Brendan Boyle (D),2014,Industrial Unions,1000,49875,50875
B001296,N00035307,Brendan Boyle (D),2014,Public Sector Unions,0,47000,47000
B001296,N00035307,Brendan Boyle (D),2014,Health Professionals,5000,34500,39500
B001296,N00035307,Brendan Boyle (D),2014,Real Estate,25650,8500,34150
B001296,N00035307,Brendan Boyle (D),2014,Democratic/Liberal,21279,6750,28029
B001296,N00035307,Brendan Boyle (D),2014,Education,25101,0,25101
C001103,N00035346,Buddy Carter (R),2014,Retail Sales,110400,30000,140400
C001103,N00035346,Buddy Carter (R),2014,Health Professionals,57700,80000,137700
C001103,N00035346,Buddy Carter (R),2014,Leadership PACs,0,57992,57992
C001103,N00035346,Buddy Carter (R),2014,Pharmaceuticals/Health Products,18350,26500,44850
C001103,N00035346,Buddy Carter (R),2014,Retired,43866,0,43866
C001103,N00035346,Buddy Carter (R),2014,Lawyers/Law Firms,30625,7500,38125
C001103,N00035346,Buddy Carter (R),2014,Real Estate,14400,19500,33900
C001103,N00035346,Buddy Carter (R),2014,Oil & Gas,26750,4500,31250
C001103,N00035346,Buddy Carter (R),2014,Automotive,15500,15000,30500
C001103,N00035346,Buddy Carter (R),2014,Commercial Banks,3500,24500,28000
L000583,N00035347,Barry Loudermilk (R),2014,Republican/Conservative,103940,40024,143964
L000583,N00035347,Barry Loudermilk (R),2014,Leadership PACs,0,70500,70500
L000583,N00035347,Barry Loudermilk (R),2014,Retired,54571,0,54571
L000583,N00035347,Barry Loudermilk (R),2014,Health Professionals,17100,28500,45600
L000583,N00035347,Barry Loudermilk (R),2014,Real Estate,33150,11000,44150
L000583,N00035347,Barry Loudermilk (R),2014,Misc Transport,21750,0,21750
L000583,N00035347,Barry Loudermilk (R),2014,Insurance,6085,15500,21585
L000583,N00035347,Barry Loudermilk (R),2014,"Beer, Wine & Liquor",8478,12000,20478
L000583,N00035347,Barry Loudermilk (R),2014,Lawyers/Law Firms,15350,1500,16850
L000583,N00035347,Barry Loudermilk (R),2014,Commercial Banks,5250,11000,16250
B001289,N00035380,Bradley Byrne (R),2014,Leadership PACs,0,157000,157000
B001289,N00035380,Bradley Byrne (R),2014,Lawyers/Law Firms,109250,38000,147250
B001289,N00035380,Bradley Byrne (R),2014,Insurance,32600,69100,101700
B001289,N00035380,Bradley Byrne (R),2014,Retired,95832,0,95832
B001289,N00035380,Bradley Byrne (R),2014,Health Professionals,28250,48500,76750
B001289,N00035380,Bradley Byrne (R),2014,Real Estate,38600,31000,69600
B001289,N00035380,Bradley Byrne (R),2014,Defense Aerospace,2000,47000,49000
B001289,N00035380,Bradley Byrne (R),2014,General Contractors,28400,15000,43400
B001289,N00035380,Bradley Byrne (R),2014,Commercial Banks,5750,34000,39750
B001289,N00035380,Bradley Byrne (R),2014,Electric Utilities,750,39000,39750
C001107,N00035403,Carlos Curbelo (R),2014,Leadership PACs,0,229200,229200
C001107,N00035403,Carlos Curbelo (R),2014,Retired,149380,0,149380
C001107,N00035403,Carlos Curbelo (R),2014,Real Estate,123850,5000,128850
C001107,N00035403,Carlos Curbelo (R),2014,Foreign & Defense Policy,122600,5000,127600
C001107,N00035403,Carlos Curbelo (R),2014,General Contractors,103805,11500,115305
C001107,N00035403,Carlos Curbelo (R),2014,Lawyers/Law Firms,98295,2000,100295
C001107,N00035403,Carlos Curbelo (R),2014,Health Professionals,83541,10500,94041
C001107,N00035403,Carlos Curbelo (R),2014,Pro-Israel,65150,16250,81400
C001107,N00035403,Carlos Curbelo (R),2014,Securities & Investment,65128,0,65128
C001107,N00035403,Carlos Curbelo (R),2014,Candidate Committees,0,61750,61750
B001295,N00035420,Mike Bost (R),2014,Leadership PACs,0,210825,210825
B001295,N00035420,Mike Bost (R),2014,Retired,68180,0,68180
B001295,N00035420,Mike Bost (R),2014,Candidate Committees,0,55500,55500
B001295,N00035420,Mike Bost (R),2014,Health Professionals,34050,20250,54300
B001295,N00035420,Mike Bost (R),2014,Securities & Investment,38600,0,38600
B001295,N00035420,Mike Bost (R),2014,Misc Manufacturing & Distributing,31350,2000,33350
B001295,N00035420,Mike Bost (R),2014,Food & Beverage,17800,9500,27300
B001295,N00035420,Mike Bost (R),2014,Crop Production & Basic Processing,25964,0,25964
B001295,N00035420,Mike Bost (R),2014,Lawyers/Law Firms,24675,500,25175
B001295,N00035420,Mike Bost (R),2014,Insurance,15700,9000,24700
M001196,N00035431,Seth Moulton (D),2014,Democratic/Liberal,1179719,4790,1184509
M001196,N00035431,Seth Moulton (D),2014,Securities & Investment,266750,4500,271250
M001196,N00035431,Seth Moulton (D),2014,Lawyers/Law Firms,94300,18500,112800
M001196,N00035431,Seth Moulton (D),2014,Leadership PACs,1100,94150,95250
M001196,N00035431,Seth Moulton (D),2014,Retired,93897,0,93897
M001196,N00035431,Seth Moulton (D),2014,Education,82578,0,82578
M001196,N00035431,Seth Moulton (D),2014,Misc Finance,62983,2500,65483
M001196,N00035431,Seth Moulton (D),2014,Candidate Committees,0,53600,53600
M001196,N00035431,Seth Moulton (D),2014,Real Estate,51934,0,51934
M001196,N00035431,Seth Moulton (D),2014,Business Services,38007,0,38007
E000294,N00035440,Tom Emmer (R),2014,Retired,194237,0,194237
E000294,N00035440,Tom Emmer (R),2014,Republican/Conservative,110636,23500,134136
E000294,N00035440,Tom Emmer (R),2014,Leadership PACs,0,65500,65500
E000294,N00035440,Tom Emmer (R),2014,Real Estate,40939,5000,45939
E000294,N00035440,Tom Emmer (R),2014,Health Professionals,17600,22000,39600
E000294,N00035440,Tom Emmer (R),2014,Securities & Investment,38600,0,38600
E000294,N00035440,Tom Emmer (R),2014,Oil & Gas,31900,5000,36900
E000294,N00035440,Tom Emmer (R),2014,Lawyers/Law Firms,20650,12000,32650
E000294,N00035440,Tom Emmer (R),2014,Automotive,18550,12500,31050
E000294,N00035440,Tom Emmer (R),2014,Misc Finance,29850,1000,30850
A000370,N00035451,Alma Adams (D),2014,Health Professionals,23900,53500,77400
A000370,N00035451,Alma Adams (D),2014,Women's Issues,50445,25501,75946
A000370,N00035451,Alma Adams (D),2014,Leadership PACs,0,43500,43500
A000370,N00035451,Alma Adams (D),2014,Public Sector Unions,1000,33000,34000
A000370,N00035451,Alma Adams (D),2014,Retired,30725,0,30725
A000370,N00035451,Alma Adams (D),2014,Industrial Unions,0,25000,25000
A000370,N00035451,Alma Adams (D),2014,Education,16150,3000,19150
A000370,N00035451,Alma Adams (D),2014,Lawyers/Law Firms,9186,7500,16686
A000370,N00035451,Alma Adams (D),2014,Building Trade Unions,0,15000,15000
A000370,N00035451,Alma Adams (D),2014,Human Rights,400,10750,11150
E000295,N00035483,Joni Ernst (R),2014,Leadership PACs,2000,354100,356100
E000295,N00035483,Joni Ernst (R),2014,Retired,182537,0,182537
E000295,N00035483,Joni Ernst (R),2014,Republican/Conservative,87041,84900,171941
E000295,N00035483,Joni Ernst (R),2014,Securities & Investment,134020,5000,139020
E000295,N00035483,Joni Ernst (R),2014,Oil & Gas,43900,91500,135400
E000295,N00035483,Joni Ernst (R),2014,Commercial Banks,16850,57000,73850
E000295,N00035483,Joni Ernst (R),2014,Insurance,26515,44500,71015
E000295,N00035483,Joni Ernst (R),2014,Food & Beverage,10200,60100,70300
E000295,N00035483,Joni Ernst (R),2014,Real Estate,49190,15000,64190
E000295,N00035483,Joni Ernst (R),2014,Pro-Israel,24900,34200,59100
T000476,N00035492,Thom Tillis (R),2014,Retired,1262314,0,1262314
T000476,N00035492,Thom Tillis (R),2014,Real Estate,565209,21500,586709
T000476,N00035492,Thom Tillis (R),2014,Securities & Investment,555500,9000,564500
T000476,N00035492,Thom Tillis (R),2014,Lawyers/Law Firms,355359,34750,390109
T000476,N00035492,Thom Tillis (R),2014,Leadership PACs,30600,332575,363175
T000476,N00035492,Thom Tillis (R),2014,Health Professionals,281248,80900,362148
T000476,N00035492,Thom Tillis (R),2014,Oil & Gas,129700,118100,247800
T000476,N00035492,Thom Tillis (R),2014,Republican/Conservative,154184,65450,219634
T000476,N00035492,Thom Tillis (R),2014,Business Services,208944,9000,217944
T000476,N00035492,Thom Tillis (R),2014,Misc Manufacturing & Distributing,148250,42500,190750
P000612,N00035516,David Perdue (R),2014,Retired,1631952,0,1631952
P000612,N00035516,David Perdue (R),2014,Securities & Investment,596932,19000,615932
P000612,N00035516,David Perdue (R),2014,Real Estate,398462,20000,418462
P000612,N00035516,David Perdue (R),2014,Leadership PACs,0,313700,313700
P000612,N00035516,David Perdue (R),2014,Lawyers/Law Firms,241492,40750,282242
P000612,N00035516,David Perdue (R),2014,Insurance,183145,67500,250645
P000612,N00035516,David Perdue (R),2014,Republican/Conservative,163552,37586,201138
P000612,N00035516,David Perdue (R),2014,Health Professionals,171100,27500,198600
P000612,N00035516,David Perdue (R),2014,Misc Finance,197250,0,197250
P000612,N00035516,David Perdue (R),2014,Food & Beverage,129000,56100,185100
S001196,N00035523,Elise Stefanik (R),2014,Securities & Investment,291399,0,291399
S001196,N00035523,Elise Stefanik (R),2014,Leadership PACs,0,178114,178114
S001196,N00035523,Elise Stefanik (R),2014,Retired,60450,0,60450
S001196,N00035523,Elise Stefanik (R),2014,Lobbyists,59783,0,59783
S001196,N00035523,Elise Stefanik (R),2014,Lawyers/Law Firms,51976,1000,52976
S001196,N00035523,Elise Stefanik (R),2014,Misc Finance,47000,1000,48000
S001196,N00035523,Elise Stefanik (R),2014,General Contractors,34700,12650,47350
S001196,N00035523,Elise Stefanik (R),2014,Real Estate,36650,10500,47150
S001196,N00035523,Elise Stefanik (R),2014,Republican/Conservative,21883,19500,41383
S001196,N00035523,Elise Stefanik (R),2014,Candidate Committees,250,40750,41000
J000297,N00035531,Evan Jenkins (R),2014,Health Professionals,162466,66500,228966
J000297,N00035531,Evan Jenkins (R),2014,Mining,158400,30000,188400
J000297,N00035531,Evan Jenkins (R),2014,Leadership PACs,0,178600,178600
J000297,N00035531,Evan Jenkins (R),2014,Retired,89098,0,89098
J000297,N00035531,Evan Jenkins (R),2014,Lawyers/Law Firms,65300,250,65550
J000297,N00035531,Evan Jenkins (R),2014,Oil & Gas,19666,29000,48666
J000297,N00035531,Evan Jenkins (R),2014,Automotive,37450,10000,47450
J000297,N00035531,Evan Jenkins (R),2014,Hospitals/Nursing Homes,40160,6000,46160
J000297,N00035531,Evan Jenkins (R),2014,Special Trade Contractors,38225,0,38225
J000297,N00035531,Evan Jenkins (R),2014,Candidate Committees,1500,34265,35765
T000473,N00035535,Mark Takai (D),2014,Retired,121483,0,121483
T000473,N00035535,Mark Takai (D),2014,Leadership PACs,1000,84750,85750
T000473,N00035535,Mark Takai (D),2014,Lawyers/Law Firms,65525,7700,73225
T000473,N00035535,Mark Takai (D),2014,Sea Transport,44950,27500,72450
T000473,N00035535,Mark Takai (D),2014,Transportation Unions,200,61500,61700
T000473,N00035535,Mark Takai (D),2014,Public Sector Unions,250,58500,58750
T000473,N00035535,Mark Takai (D),2014,Real Estate,46117,9477,55594
T000473,N00035535,Mark Takai (D),2014,Health Professionals,40975,13500,54475
T000473,N00035535,Mark Takai (D),2014,Education,48700,0,48700
T000473,N00035535,Mark Takai (D),2014,Building Trade Unions,3700,40500,44200
S001197,N00035544,Ben Sasse (R),2014,Republican/Conservative,609107,80995,690102
S001197,N00035544,Ben Sasse (R),2014,Retired,357597,0,357597
S001197,N00035544,Ben Sasse (R),2014,Securities & Investment,292688,14500,307188
S001197,N00035544,Ben Sasse (R),2014,Leadership PACs,0,191382,191382
S001197,N00035544,Ben Sasse (R),2014,Oil & Gas,99185,69500,168685
S001197,N00035544,Ben Sasse (R),2014,Insurance,71600,80460,152060
S001197,N00035544,Ben Sasse (R),2014,Real Estate,130638,13000,143638
S001197,N00035544,Ben Sasse (R),2014,Lawyers/Law Firms,106400,36650,143050
S001197,N00035544,Ben Sasse (R),2014,Health Professionals,99988,42600,142588
S001197,N00035544,Ben Sasse (R),2014,Business Services,136950,2600,139550
M001192,N00035593,Vance McAllister (R),2014,Leadership PACs,0,59300,59300
M001192,N00035593,Vance McAllister (R),2014,Crop Production & Basic Processing,18200,17000,35200
M001192,N00035593,Vance McAllister (R),2014,Health Professionals,14350,5000,19350
M001192,N00035593,Vance McAllister (R),2014,Oil & Gas,12400,6000,18400
M001192,N00035593,Vance McAllister (R),2014,General Contractors,14850,0,14850
M001192,N00035593,Vance McAllister (R),2014,Lawyers/Law Firms,8038,6500,14538
M001192,N00035593,Vance McAllister (R),2014,Retired,13949,0,13949
M001192,N00035593,Vance McAllister (R),2014,Food Processing & Sales,10400,0,10400
M001192,N00035593,Vance McAllister (R),2014,Food & Beverage,5500,2000,7500
M001192,N00035593,Vance McAllister (R),2014,Electronics Mfg & Equip,7000,0,7000
T000475,N00035607,Dave Trott (R),2014,Lawyers/Law Firms,201500,8500,210000
T000475,N00035607,Dave Trott (R),2014,Real Estate,87650,11000,98650
T000475,N00035607,Dave Trott (R),2014,Leadership PACs,0,51500,51500
T000475,N00035607,Dave Trott (R),2014,Retired,50950,0,50950
T000475,N00035607,Dave Trott (R),2014,Business Services,46200,2500,48700
T000475,N00035607,Dave Trott (R),2014,Automotive,27200,17000,44200
T000475,N00035607,Dave Trott (R),2014,Securities & Investment,43800,0,43800
T000475,N00035607,Dave Trott (R),2014,Chemical & Related Manufacturing,25800,10000,35800
T000475,N00035607,Dave Trott (R),2014,General Contractors,25550,8500,34050
T000475,N00035607,Dave Trott (R),2014,Health Professionals,7750,19000,26750
H001070,N00035628,Cresent Hardy (R),2014,Casinos/Gambling,27300,17500,44800
H001070,N00035628,Cresent Hardy (R),2014,Leadership PACs,0,35500,35500
H001070,N00035628,Cresent Hardy (R),2014,General Contractors,23450,1000,24450
H001070,N00035628,Cresent Hardy (R),2014,Special Trade Contractors,24386,0,24386
H001070,N00035628,Cresent Hardy (R),2014,Real Estate,23600,0,23600
H001070,N00035628,Cresent Hardy (R),2014,Lawyers/Law Firms,14750,2000,16750
H001070,N00035628,Cresent Hardy (R),2014,Retired,12800,0,12800
H001070,N00035628,Cresent Hardy (R),2014,Health Professionals,6450,6000,12450
H001070,N00035628,Cresent Hardy (R),2014,Recreation/Live Entertainment,10400,0,10400
H001070,N00035628,Cresent Hardy (R),2014,Waste Management,10400,0,10400
G000575,N00035688,Gwen Graham (D),2014,Lawyers/Law Firms,399730,12341,412071
G000575,N00035688,Gwen Graham (D),2014,Retired,337368,0,337368
G000575,N00035688,Gwen Graham (D),2014,Leadership PACs,17100,203163,220263
G000575,N00035688,Gwen Graham (D),2014,Women's Issues,163340,20000,183340
G000575,N00035688,Gwen Graham (D),2014,Real Estate,145663,0,145663
G000575,N00035688,Gwen Graham (D),2014,Education,96776,0,96776
G000575,N00035688,Gwen Graham (D),2014,Democratic/Liberal,48075,20000,68075
G000575,N00035688,Gwen Graham (D),2014,Public Sector Unions,250,66000,66250
G000575,N00035688,Gwen Graham (D),2014,Candidate Committees,0,64500,64500
G000575,N00035688,Gwen Graham (D),2014,Lobbyists,63150,0,63150
P000609,N00035691,Gary Palmer (R),2014,Retired,224252,0,224252
P000609,N00035691,Gary Palmer (R),2014,Republican/Conservative,95704,24000,119704
P000609,N00035691,Gary Palmer (R),2014,General Contractors,104500,5500,110000
P000609,N00035691,Gary Palmer (R),2014,Health Professionals,104250,3500,107750
P000609,N00035691,Gary Palmer (R),2014,Insurance,73000,15000,88000
P000609,N00035691,Gary Palmer (R),2014,Real Estate,75083,12500,87583
P000609,N00035691,Gary Palmer (R),2014,Securities & Investment,60100,0,60100
P000609,N00035691,Gary Palmer (R),2014,Lawyers/Law Firms,44300,12500,56800
P000609,N00035691,Gary Palmer (R),2014,Leadership PACs,0,50000,50000
P000609,N00035691,Gary Palmer (R),2014,Commercial Banks,31350,16000,47350
J000296,N00035717,David Jolly (R),2014,Leadership PACs,0,235950,235950
J000296,N00035717,David Jolly (R),2014,Retired,121441,0,121441
J000296,N00035717,David Jolly (R),2014,Real Estate,100575,12500,113075
J000296,N00035717,David Jolly (R),2014,Candidate Committees,0,93000,93000
J000296,N00035717,David Jolly (R),2014,Securities & Investment,62750,23500,86250
J000296,N00035717,David Jolly (R),2014,Lobbyists,72349,1000,73349
J000296,N00035717,David Jolly (R),2014,Health Professionals,20950,46500,67450
J000296,N00035717,David Jolly (R),2014,Defense Electronics,24525,37000,61525
J000296,N00035717,David Jolly (R),2014,Lawyers/Law Firms,38500,7000,45500
J000296,N00035717,David Jolly (R),2014,Misc Finance,38750,1000,39750
S001198,N00035774,Dan Sullivan (R),2014,Securities & Investment,1069287,0,1069287
S001198,N00035774,Dan Sullivan (R),2014,Retired,688585,0,688585
S001198,N00035774,Dan Sullivan (R),2014,Republican/Conservative,550923,48700,599623
S001198,N00035774,Dan Sullivan (R),2014,Real Estate,417843,5000,422843
S001198,N00035774,Dan Sullivan (R),2014,Oil & Gas,297935,70200,368135
S001198,N00035774,Dan Sullivan (R),2014,Leadership PACs,0,300100,300100
S001198,N00035774,Dan Sullivan (R),2014,Lawyers/Law Firms,248611,250,248861
S001198,N00035774,Dan Sullivan (R),2014,Misc Finance,235084,1000,236084
S001198,N00035774,Dan Sullivan (R),2014,Misc Manufacturing & Distributing,160000,10000,170000
S001198,N00035774,Dan Sullivan (R),2014,Chemical & Related Manufacturing,122575,18500,141075
H001072,N00035792,French Hill (R),2014,Retired,234589,0,234589
H001072,N00035792,French Hill (R),2014,Securities & Investment,212246,13500,225746
H001072,N00035792,French Hill (R),2014,Leadership PACs,0,169146,169146
H001072,N00035792,French Hill (R),2014,Commercial Banks,64264,35000,99264
H001072,N00035792,French Hill (R),2014,Oil & Gas,70850,15500,86350
H001072,N00035792,French Hill (R),2014,Health Professionals,70608,13000,83608
H001072,N00035792,French Hill (R),2014,Real Estate,54338,13500,67838
H001072,N00035792,French Hill (R),2014,Lawyers/Law Firms,64822,3000,67822
H001072,N00035792,French Hill (R),2014,Misc Finance,35100,0,35100
H001072,N00035792,French Hill (R),2014,Accountants,24300,10000,34300
K000387,N00035820,Steve Knight (R),2014,Automotive,27450,0,27450
K000387,N00035820,Steve Knight (R),2014,Real Estate,18775,0,18775
K000387,N00035820,Steve Knight (R),2014,Retired,17417,0,17417
K000387,N00035820,Steve Knight (R),2014,Health Professionals,16866,0,16866
K000387,N00035820,Steve Knight (R),2014,Lawyers/Law Firms,13235,0,13235
K000387,N00035820,Steve Knight (R),2014,Food & Beverage,11850,0,11850
K000387,N00035820,Steve Knight (R),2014,Civil Servants/Public Officials,11658,0,11658
K000387,N00035820,Steve Knight (R),2014,Crop Production & Basic Processing,11200,0,11200
K000387,N00035820,Steve Knight (R),2014,Insurance,10200,0,10200
K000387,N00035820,Steve Knight (R),2014,Gun Rights,2800,6554,9354
L000582,N00035825,Ted Lieu (D),2014,Lawyers/Law Firms,154850,11000,165850
L000582,N00035825,Ted Lieu (D),2014,Retired,128222,0,128222
L000582,N00035825,Ted Lieu (D),2014,Health Professionals,58338,64500,122838
L000582,N00035825,Ted Lieu (D),2014,Real Estate,110400,10000,120400
L000582,N00035825,Ted Lieu (D),2014,Leadership PACs,0,58000,58000
L000582,N00035825,Ted Lieu (D),2014,Public Sector Unions,1000,43500,44500
L000582,N00035825,Ted Lieu (D),2014,Securities & Investment,43396,0,43396
L000582,N00035825,Ted Lieu (D),2014,Misc Manufacturing & Distributing,28400,14500,42900
L000582,N00035825,Ted Lieu (D),2014,Human Rights,14550,23000,37550
L000582,N00035825,Ted Lieu (D),2014,Pharmaceuticals/Health Products,24500,13000,37500
C001102,N00035854,Curt Clawson (R),2014,Retired,173078,0,173078
C001102,N00035854,Curt Clawson (R),2014,Lawyers/Law Firms,55518,0,55518
C001102,N00035854,Curt Clawson (R),2014,Securities & Investment,44100,0,44100
C001102,N00035854,Curt Clawson (R),2014,Republican/Conservative,32746,2750,35496
C001102,N00035854,Curt Clawson (R),2014,Leadership PACs,0,23750,23750
C001102,N00035854,Curt Clawson (R),2014,Misc Manufacturing & Distributing,18750,0,18750
C001102,N00035854,Curt Clawson (R),2014,Real Estate,16493,1000,17493
C001102,N00035854,Curt Clawson (R),2014,Health Professionals,12610,0,12610
C001102,N00035854,Curt Clawson (R),2014,Misc Finance,9600,0,9600
C001102,N00035854,Curt Clawson (R),2014,Automotive,9021,0,9021
R000602,N00035927,Kathleen Rice (D),2014,Lawyers/Law Firms,342086,17500,359586
R000602,N00035927,Kathleen Rice (D),2014,Securities & Investment,322260,12000,334260
R000602,N00035927,Kathleen Rice (D),2014,Real Estate,261457,14500,275957
R000602,N00035927,Kathleen Rice (D),2014,Retired,163002,0,163002
R000602,N00035927,Kathleen Rice (D),2014,Business Services,143226,0,143226
R000602,N00035927,Kathleen Rice (D),2014,Leadership PACs,8050,107250,115300
R000602,N00035927,Kathleen Rice (D),2014,Misc Finance,70600,2500,73100
R000602,N00035927,Kathleen Rice (D),2014,Building Trade Unions,0,67700,67700
R000602,N00035927,Kathleen Rice (D),2014,Public Sector Unions,0,63500,63500
R000602,N00035927,Kathleen Rice (D),2014,Insurance,38050,24000,62050
K000386,N00035934,John Katko (R),2014,Leadership PACs,0,95500,95500
K000386,N00035934,John Katko (R),2014,Retired,63050,0,63050
K000386,N00035934,John Katko (R),2014,Lawyers/Law Firms,49675,0,49675
K000386,N00035934,John Katko (R),2014,Real Estate,35525,2500,38025
K000386,N00035934,John Katko (R),2014,Republican/Conservative,10600,14500,25100
K000386,N00035934,John Katko (R),2014,Automotive,18675,5000,23675
K000386,N00035934,John Katko (R),2014,Securities & Investment,23300,0,23300
K000386,N00035934,John Katko (R),2014,General Contractors,17375,5000,22375
K000386,N00035934,John Katko (R),2014,Candidate Committees,0,20000,20000
K000386,N00035934,John Katko (R),2014,Retail Sales,13650,2500,16150
R000601,N00035972,John Lee Ratcliffe (R),2014,Republican/Conservative,139936,21025,160961
R000601,N00035972,John Lee Ratcliffe (R),2014,Leadership PACs,0,73000,73000
R000601,N00035972,John Lee Ratcliffe (R),2014,Retired,63683,0,63683
R000601,N00035972,John Lee Ratcliffe (R),2014,Oil & Gas,32850,11500,44350
R000601,N00035972,John Lee Ratcliffe (R),2014,Lawyers/Law Firms,38306,2000,40306
R000601,N00035972,John Lee Ratcliffe (R),2014,Misc Business,24600,0,24600
R000601,N00035972,John Lee Ratcliffe (R),2014,Real Estate,15506,8600,24106
R000601,N00035972,John Lee Ratcliffe (R),2014,Securities & Investment,13550,0,13550
R000601,N00035972,John Lee Ratcliffe (R),2014,Commercial Banks,2750,8000,10750
R000601,N00035972,John Lee Ratcliffe (R),2014,Candidate Committees,0,7500,7500
R000601,N00035972,John Lee Ratcliffe (R),2014,Railroads,0,7500,7500
B001290,N00036013,Dave Brat (R),2014,Retired,190807,0,190807
B001290,N00036013,Dave Brat (R),2014,Republican/Conservative,68122,26345,94467
B001290,N00036013,Dave Brat (R),2014,Leadership PACs,0,63600,63600
B001290,N00036013,Dave Brat (R),2014,Real Estate,46300,0,46300
B001290,N00036013,Dave Brat (R),2014,Oil & Gas,15750,8500,24250
B001290,N00036013,Dave Brat (R),2014,Securities & Investment,23880,0,23880
B001290,N00036013,Dave Brat (R),2014,Lawyers/Law Firms,22500,1360,23860
B001290,N00036013,Dave Brat (R),2014,Tobacco,5850,12250,18100
B001290,N00036013,Dave Brat (R),2014,Health Professionals,15400,2500,17900
B001290,N00036013,Dave Brat (R),2014,General Contractors,10756,4000,14756
B001292,N00036018,Don Beyer (D),2014,Lawyers/Law Firms,184353,25500,209853
B001292,N00036018,Don Beyer (D),2014,Retired,196805,0,196805
B001292,N00036018,Don Beyer (D),2014,Real Estate,143450,22000,165450
B001292,N00036018,Don Beyer (D),2014,Automotive,84000,30000,114000
B001292,N00036018,Don Beyer (D),2014,Securities & Investment,58710,5000,63710
B001292,N00036018,Don Beyer (D),2014,Lobbyists,59191,984,60175
B001292,N00036018,Don Beyer (D),2014,Leadership PACs,0,54000,54000
B001292,N00036018,Don Beyer (D),2014,Public Sector Unions,500,51000,51500
B001292,N00036018,Don Beyer (D),2014,Non-Profit Institutions,48350,1250,49600
B001292,N00036018,Don Beyer (D),2014,Business Services,44450,4000,48450
C001105,N00036023,Barbara Comstock (R),2014,Leadership PACs,3900,241350,245250
C001105,N00036023,Barbara Comstock (R),2014,Lawyers/Law Firms,179752,21600,201352
C001105,N00036023,Barbara Comstock (R),2014,Retired,172738,0,172738
C001105,N00036023,Barbara Comstock (R),2014,Lobbyists,166559,4906,171465
C001105,N00036023,Barbara Comstock (R),2014,Business Services,145020,16350,161370
C001105,N00036023,Barbara Comstock (R),2014,Securities & Investment,151549,1000,152549
C001105,N00036023,Barbara Comstock (R),2014,Real Estate,103600,15000,118600
C001105,N00036023,Barbara Comstock (R),2014,Republican/Conservative,60583,41700,102283
C001105,N00036023,Barbara Comstock (R),2014,Oil & Gas,25350,40500,65850
C001105,N00036023,Barbara Comstock (R),2014,Candidate Committees,0,64000,64000
G000574,N00036097,Ruben Gallego (D),2014,Lawyers/Law Firms,69750,6000,75750
G000574,N00036097,Ruben Gallego (D),2014,Real Estate,40025,7500,47525
G000574,N00036097,Ruben Gallego (D),2014,Leadership PACs,0,43500,43500
G000574,N00036097,Ruben Gallego (D),2014,Public Sector Unions,0,34000,34000
G000574,N00036097,Ruben Gallego (D),2014,Lobbyists,26741,0,26741
G000574,N00036097,Ruben Gallego (D),2014,Transportation Unions,0,26000,26000
G000574,N00036097,Ruben Gallego (D),2014,Business Services,23410,0,23410
G000574,N00036097,Ruben Gallego (D),2014,Securities & Investment,22950,0,22950
G000574,N00036097,Ruben Gallego (D),2014,Building Trade Unions,0,22500,22500
G000574,N00036097,Ruben Gallego (D),2014,Retired,21339,0,21339
T000474,N00036107,Norma Torres (D),2014,Building Trade Unions,0,43000,43000
T000474,N00036107,Norma Torres (D),2014,Health Professionals,9900,30500,40400
T000474,N00036107,Norma Torres (D),2014,Leadership PACs,0,33600,33600
T000474,N00036107,Norma Torres (D),2014,Public Sector Unions,0,33500,33500
T000474,N00036107,Norma Torres (D),2014,Casinos/Gambling,23550,0,23550
T000474,N00036107,Norma Torres (D),2014,Misc Unions,0,20500,20500
T000474,N00036107,Norma Torres (D),2014,Real Estate,7100,10000,17100
T000474,N00036107,Norma Torres (D),2014,Women's Issues,3200,11000,14200
T000474,N00036107,Norma Torres (D),2014,Human Rights,500,13000,13500
T000474,N00036107,Norma Torres (D),2014,Candidate Committees,0,13000,13000
G000577,N00036135,Garret Graves (R),2014,Construction Services,108606,17459,126065
G000577,N00036135,Garret Graves (R),2014,Lawyers/Law Firms,84627,29500,114127
G000577,N00036135,Garret Graves (R),2014,Oil & Gas,45385,68600,113985
G000577,N00036135,Garret Graves (R),2014,General Contractors,77300,10000,87300
G000577,N00036135,Garret Graves (R),2014,Retired,77513,0,77513
G000577,N00036135,Garret Graves (R),2014,Leadership PACs,0,67500,67500
G000577,N00036135,Garret Graves (R),2014,Lobbyists,60261,7000,67261
G000577,N00036135,Garret Graves (R),2014,Sea Transport,41900,22200,64100
G000577,N00036135,Garret Graves (R),2014,Insurance,33500,29500,63000
G000577,N00036135,Garret Graves (R),2014,Food & Beverage,52410,6500,58910
D000624,N00036149,Debbie Dingell (D),2014,Retired,91198,0,91198
D000624,N00036149,Debbie Dingell (D),2014,Automotive,43150,44241,87391
D000624,N00036149,Debbie Dingell (D),2014,Lawyers/Law Firms,64134,22108,86242
D000624,N00036149,Debbie Dingell (D),2014,Real Estate,47750,17500,65250
D000624,N00036149,Debbie Dingell (D),2014,Lobbyists,62550,1500,64050
D000624,N00036149,Debbie Dingell (D),2014,Women's Issues,51700,11000,62700
D000624,N00036149,Debbie Dingell (D),2014,Leadership PACs,0,60500,60500
D000624,N00036149,Debbie Dingell (D),2014,Electric Utilities,5500,43498,48998
D000624,N00036149,Debbie Dingell (D),2014,Public Sector Unions,250,42500,42750
D000624,N00036149,Debbie Dingell (D),2014,Education,38850,707,39557
N000188,N00036154,Don Norcross (D),2014,Building Trade Unions,2000,170499,172499
N000188,N00036154,Don Norcross (D),2014,Lawyers/Law Firms,123706,25100,148806
N000188,N00036154,Don Norcross (D),2014,Real Estate,104306,27000,131306
N000188,N00036154,Don Norcross (D),2014,Construction Services,59750,16800,76550
N000188,N00036154,Don Norcross (D),2014,Leadership PACs,1000,66000,67000
N000188,N00036154,Don Norcross (D),2014,Public Sector Unions,0,66000,66000
N000188,N00036154,Don Norcross (D),2014,Industrial Unions,1150,62000,63150
N000188,N00036154,Don Norcross (D),2014,Misc Finance,58000,0,58000
N000188,N00036154,Don Norcross (D),2014,Health Professionals,13350,36000,49350
N000188,N00036154,Don Norcross (D),2014,Transportation Unions,0,42500,42500
M001193,N00036155,Thomas MacArthur (R),2014,Leadership PACs,0,101829,101829
M001193,N00036155,Thomas MacArthur (R),2014,Insurance,19050,10500,29550
M001193,N00036155,Thomas MacArthur (R),2014,Candidate Committees,0,22199,22199
M001193,N00036155,Thomas MacArthur (R),2014,Building Trade Unions,0,21000,21000
M001193,N00036155,Thomas MacArthur (R),2014,Retired,20200,0,20200
M001193,N00036155,Thomas MacArthur (R),2014,Republican/Conservative,5750,11000,16750
M001193,N00036155,Thomas MacArthur (R),2014,Construction Services,16000,0,16000
M001193,N00036155,Thomas MacArthur (R),2014,Lawyers/Law Firms,12000,1000,13000
M001193,N00036155,Thomas MacArthur (R),2014,Securities & Investment,12900,0,12900
M001193,N00036155,Thomas MacArthur (R),2014,Lobbyists,12000,0,12000
R000604,N00036175,Steven Russell (R),2014,Oil & Gas,63500,20750,84250
R000604,N00036175,Steven Russell (R),2014,Leadership PACs,0,73000,73000
R000604,N00036175,Steven Russell (R),2014,Lawyers/Law Firms,46650,10000,56650
R000604,N00036175,Steven Russell (R),2014,Retired,50800,0,50800
R000604,N00036175,Steven Russell (R),2014,Commercial Banks,30400,9600,40000
R000604,N00036175,Steven Russell (R),2014,Republican/Conservative,12650,16500,29150
R000604,N00036175,Steven Russell (R),2014,General Contractors,22850,5500,28350
R000604,N00036175,Steven Russell (R),2014,Real Estate,22950,5000,27950
R000604,N00036175,Steven Russell (R),2014,Civil Servants/Public Officials,27050,0,27050
R000604,N00036175,Steven Russell (R),2014,Misc Business,24201,0,24201
M001194,N00036275,John Moolenaar (R),2014,Leadership PACs,0,101600,101600
M001194,N00036275,John Moolenaar (R),2014,Chemical & Related Manufacturing,69600,10500,80100
M001194,N00036275,John Moolenaar (R),2014,Health Professionals,19024,41000,60024
M001194,N00036275,John Moolenaar (R),2014,Retired,51850,0,51850
M001194,N00036275,John Moolenaar (R),2014,Real Estate,39450,11000,50450
M001194,N00036275,John Moolenaar (R),2014,Health Services/HMOs,30650,4000,34650
M001194,N00036275,John Moolenaar (R),2014,Electric Utilities,0,32500,32500
M001194,N00036275,John Moolenaar (R),2014,Insurance,6800,25000,31800
M001194,N00036275,John Moolenaar (R),2014,Lawyers/Law Firms,21350,6000,27350
M001194,N00036275,John Moolenaar (R),2014,Automotive,4574,22500,27074
N000189,N00036403,Dan Newhouse (R),2014,Crop Production & Basic Processing,177851,17500,195351
N000189,N00036403,Dan Newhouse (R),2014,Retired,69890,0,69890
N000189,N00036403,Dan Newhouse (R),2014,Dairy,27900,9000,36900
N000189,N00036403,Dan Newhouse (R),2014,Agricultural Services/Products,6000,27900,33900
N000189,N00036403,Dan Newhouse (R),2014,Leadership PACs,0,27600,27600
N000189,N00036403,Dan Newhouse (R),2014,"Beer, Wine & Liquor",15450,9500,24950
N000189,N00036403,Dan Newhouse (R),2014,Real Estate,9932,10500,20432
N000189,N00036403,Dan Newhouse (R),2014,Food Processing & Sales,250,20000,20250
N000189,N00036403,Dan Newhouse (R),2014,Health Professionals,7200,12000,19200
N000189,N00036403,Dan Newhouse (R),2014,Lawyers/Law Firms,14950,1000,15950
G000576,N00036409,Glenn S Grothman (R),2014,Leadership PACs,0,122200,122200
G000576,N00036409,Glenn S Grothman (R),2014,Retired,118192,0,118192
G000576,N00036409,Glenn S Grothman (R),2014,Misc Manufacturing & Distributing,23900,9000,32900
G000576,N00036409,Glenn S Grothman (R),2014,Securities & Investment,30650,0,30650
G000576,N00036409,Glenn S Grothman (R),2014,General Contractors,19650,9100,28750
G000576,N00036409,Glenn S Grothman (R),2014,Insurance,12276,15000,27276
G000576,N00036409,Glenn S Grothman (R),2014,Republican/Conservative,8900,15250,24150
G000576,N00036409,Glenn S Grothman (R),2014,Candidate Committees,0,22000,22000
G000576,N00036409,Glenn S Grothman (R),2014,Real Estate,12507,5000,17507
G000576,N00036409,Glenn S Grothman (R),2014,Building Materials & Equipment,9800,6500,16300
B001293,N00036449,Mike Bishop (R),2014,Leadership PACs,0,110600,110600
B001293,N00036449,Mike Bishop (R),2014,Real Estate,68850,19100,87950
B001293,N00036449,Mike Bishop (R),2014,Automotive,26200,36000,62200
B001293,N00036449,Mike Bishop (R),2014,Insurance,4400,41500,45900
B001293,N00036449,Mike Bishop (R),2014,Pro-Israel,31525,14000,45525
B001293,N00036449,Mike Bishop (R),2014,Health Professionals,5450,39000,44450
B001293,N00036449,Mike Bishop (R),2014,Electric Utilities,0,32999,32999
B001293,N00036449,Mike Bishop (R),2014,Misc Manufacturing & Distributing,26300,5000,31300
B001293,N00036449,Mike Bishop (R),2014,Lawyers/Law Firms,22347,8200,30547
B001293,N00036449,Mike Bishop (R),2014,Securities & Investment,29050,0,29050
A000374,N00036633,Ralph Abraham (R),2014,Health Professionals,78950,14000,92950
A000374,N00036633,Ralph Abraham (R),2014,Crop Production & Basic Processing,64350,7000,71350
A000374,N00036633,Ralph Abraham (R),2014,Leadership PACs,0,59000,59000
A000374,N00036633,Ralph Abraham (R),2014,Retired,48455,0,48455
A000374,N00036633,Ralph Abraham (R),2014,Hospitals/Nursing Homes,35950,0,35950
A000374,N00036633,Ralph Abraham (R),2014,Oil & Gas,13253,10500,23753
A000374,N00036633,Ralph Abraham (R),2014,General Contractors,20250,0,20250
A000374,N00036633,Ralph Abraham (R),2014,Misc Business,18650,0,18650
A000374,N00036633,Ralph Abraham (R),2014,Commercial Banks,10450,7000,17450
A000374,N00036633,Ralph Abraham (R),2014,Candidate Committees,0,12000,12000
M000087,N00000078,Carolyn B Maloney (D),2016,Securities & Investment,84950,98500,183450
M000087,N00000078,Carolyn B Maloney (D),2016,Real Estate,126006,52500,178506
M000087,N00000078,Carolyn B Maloney (D),2016,Insurance,2500,101500,104000
M000087,N00000078,Carolyn B Maloney (D),2016,Lawyers/Law Firms,57100,25100,82200
M000087,N00000078,Carolyn B Maloney (D),2016,Retired,75378,0,75378
M000087,N00000078,Carolyn B Maloney (D),2016,Commercial Banks,11900,53500,65400
M000087,N00000078,Carolyn B Maloney (D),2016,Public Sector Unions,0,61750,61750
M000087,N00000078,Carolyn B Maloney (D),2016,Accountants,2700,56500,59200
M000087,N00000078,Carolyn B Maloney (D),2016,Misc Finance,33847,23000,56847
M000087,N00000078,Carolyn B Maloney (D),2016,Building Trade Unions,0,47500,47500
N000015,N00000153,Richard E Neal (D),2016,Insurance,91550,254000,345550
N000015,N00000153,Richard E Neal (D),2016,Securities & Investment,64031,118000,182031
N000015,N00000153,Richard E Neal (D),2016,Pharmaceuticals/Health Products,500,102700,103200
N000015,N00000153,Richard E Neal (D),2016,Health Professionals,2550,77750,80300
N000015,N00000153,Richard E Neal (D),2016,Accountants,21800,55500,77300
N000015,N00000153,Richard E Neal (D),2016,Real Estate,6250,61000,67250
N000015,N00000153,Richard E Neal (D),2016,Lawyers/Law Firms,36000,31070,67070
N000015,N00000153,Richard E Neal (D),2016,Commercial Banks,4250,59000,63250
N000015,N00000153,Richard E Neal (D),2016,Misc Manufacturing & Distributing,4050,44500,48550
N000015,N00000153,Richard E Neal (D),2016,Hospitals/Nursing Homes,8500,27500,36000
M000312,N00000179,James P McGovern (D),2016,Lawyers/Law Firms,37578,20250,57828
M000312,N00000179,James P McGovern (D),2016,Insurance,3850,50500,54350
M000312,N00000179,James P McGovern (D),2016,Building Trade Unions,1450,43500,44950
M000312,N00000179,James P McGovern (D),2016,Railroads,2000,42000,44000
M000312,N00000179,James P McGovern (D),2016,Public Sector Unions,0,34500,34500
M000312,N00000179,James P McGovern (D),2016,Retired,29439,0,29439
M000312,N00000179,James P McGovern (D),2016,Health Professionals,8125,19000,27125
M000312,N00000179,James P McGovern (D),2016,Pharmaceuticals/Health Products,0,25000,25000
M000312,N00000179,James P McGovern (D),2016,Lobbyists,22600,1500,24100
M000312,N00000179,James P McGovern (D),2016,Transportation Unions,0,23500,23500
C001037,N00000267,Michael E Capuano (D),2016,Insurance,2750,88750,91500
C001037,N00000267,Michael E Capuano (D),2016,Real Estate,14850,49500,64350
C001037,N00000267,Michael E Capuano (D),2016,Transportation Unions,0,48500,48500
C001037,N00000267,Michael E Capuano (D),2016,Securities & Investment,9000,35500,44500
C001037,N00000267,Michael E Capuano (D),2016,Railroads,0,42000,42000
C001037,N00000267,Michael E Capuano (D),2016,Pharmaceuticals/Health Products,2000,31500,33500
C001037,N00000267,Michael E Capuano (D),2016,Building Trade Unions,0,32500,32500
C001037,N00000267,Michael E Capuano (D),2016,Lawyers/Law Firms,17500,14750,32250
C001037,N00000267,Michael E Capuano (D),2016,Oil & Gas,27000,2000,29000
C001037,N00000267,Michael E Capuano (D),2016,Air Transport,0,26500,26500
M000133,N00000270,Ed Markey (D),2016,Lawyers/Law Firms,1294933,155763,1450696
M000133,N00000270,Ed Markey (D),2016,Securities & Investment,747558,51000,798558
M000133,N00000270,Ed Markey (D),2016,Real Estate,596346,38500,634846
M000133,N00000270,Ed Markey (D),2016,Lobbyists,399271,9300,408571
M000133,N00000270,Ed Markey (D),2016,Retired,398557,0,398557
M000133,N00000270,Ed Markey (D),2016,Telecom Services,154650,233600,388250
M000133,N00000270,Ed Markey (D),2016,Environment,335582,35949,371531
M000133,N00000270,Ed Markey (D),2016,TV/Movies/Music,323145,41500,364645
M000133,N00000270,Ed Markey (D),2016,Leadership PACs,0,339300,339300
M000133,N00000270,Ed Markey (D),2016,Business Services,284864,7600,292464
R000122,N00000362,Jack Reed (D),2016,Lawyers/Law Firms,365576,92520,458096
R000122,N00000362,Jack Reed (D),2016,Securities & Investment,163250,167000,330250
R000122,N00000362,Jack Reed (D),2016,Leadership PACs,0,260750,260750
R000122,N00000362,Jack Reed (D),2016,Lobbyists,199996,11050,211046
R000122,N00000362,Jack Reed (D),2016,Insurance,55150,139000,194150
R000122,N00000362,Jack Reed (D),2016,Real Estate,101919,66500,168419
R000122,N00000362,Jack Reed (D),2016,Health Professionals,24034,115000,139034
R000122,N00000362,Jack Reed (D),2016,Retired,138632,0,138632
R000122,N00000362,Jack Reed (D),2016,Defense Electronics,54200,75500,129700
R000122,N00000362,Jack Reed (D),2016,Retail Sales,26513,69500,96013
C001035,N00000491,Susan Collins (R),2016,Retired,409300,0,409300
C001035,N00000491,Susan Collins (R),2016,Lawyers/Law Firms,250256,129750,380006
C001035,N00000491,Susan Collins (R),2016,Securities & Investment,296500,65600,362100
C001035,N00000491,Susan Collins (R),2016,Leadership PACs,0,325000,325000
C001035,N00000491,Susan Collins (R),2016,Health Professionals,58150,228300,286450
C001035,N00000491,Susan Collins (R),2016,Lobbyists,275913,10500,286413
C001035,N00000491,Susan Collins (R),2016,Insurance,36000,195500,231500
C001035,N00000491,Susan Collins (R),2016,Real Estate,121125,53000,174125
C001035,N00000491,Susan Collins (R),2016,Misc Manufacturing & Distributing,56900,63500,120400
C001035,N00000491,Susan Collins (R),2016,Business Services,94950,23000,117950
W000800,N00000515,Peter Welch (D),2016,Health Professionals,1534,68000,69534
W000800,N00000515,Peter Welch (D),2016,Telecom Services,5,66500,66505
W000800,N00000515,Peter Welch (D),2016,Misc Issues,53000,0,53000
W000800,N00000515,Peter Welch (D),2016,Public Sector Unions,0,47500,47500
W000800,N00000515,Peter Welch (D),2016,Real Estate,11779,32000,43779
W000800,N00000515,Peter Welch (D),2016,Retail Sales,155,41500,41655
W000800,N00000515,Peter Welch (D),2016,Pharmaceuticals/Health Products,3504,35000,38504
W000800,N00000515,Peter Welch (D),2016,Lawyers/Law Firms,16589,15150,31739
W000800,N00000515,Peter Welch (D),2016,Electric Utilities,608,30500,31108
W000800,N00000515,Peter Welch (D),2016,Retired,30161,0,30161
S000033,N00000528,Bernie Sanders (D),2016,Retired,598249,0,598249
S000033,N00000528,Bernie Sanders (D),2016,Democratic/Liberal,279232,11000,290232
S000033,N00000528,Bernie Sanders (D),2016,Public Sector Unions,800,121000,121800
S000033,N00000528,Bernie Sanders (D),2016,Lawyers/Law Firms,87796,12000,99796
S000033,N00000528,Bernie Sanders (D),2016,Health Professionals,41311,31500,72811
S000033,N00000528,Bernie Sanders (D),2016,Education,67371,0,67371
S000033,N00000528,Bernie Sanders (D),2016,Leadership PACs,0,64000,64000
S000033,N00000528,Bernie Sanders (D),2016,Misc Unions,4000,52000,56000
S000033,N00000528,Bernie Sanders (D),2016,Environment,47540,3007,50547
S000033,N00000528,Bernie Sanders (D),2016,Abortion Policy/Pro-Abortion Rights,31901,10000,41901
L000557,N00000575,John B Larson (D),2016,Insurance,51680,211000,262680
L000557,N00000575,John B Larson (D),2016,Securities & Investment,5600,96000,101600
L000557,N00000575,John B Larson (D),2016,Real Estate,20900,37500,58400
L000557,N00000575,John B Larson (D),2016,Health Professionals,2550,54000,56550
L000557,N00000575,John B Larson (D),2016,Pharmaceuticals/Health Products,500,56000,56500
L000557,N00000575,John B Larson (D),2016,Defense Aerospace,17650,37000,54650
L000557,N00000575,John B Larson (D),2016,Public Sector Unions,0,53000,53000
L000557,N00000575,John B Larson (D),2016,Lawyers/Law Firms,22372,27000,49372
L000557,N00000575,John B Larson (D),2016,Accountants,5250,38500,43750
L000557,N00000575,John B Larson (D),2016,Building Trade Unions,0,42500,42500
D000216,N00000615,Rosa L DeLauro (D),2016,Health Professionals,26893,94000,120893
D000216,N00000615,Rosa L DeLauro (D),2016,Lawyers/Law Firms,56531,22000,78531
D000216,N00000615,Rosa L DeLauro (D),2016,Public Sector Unions,0,76000,76000
D000216,N00000615,Rosa L DeLauro (D),2016,Lobbyists,55054,10263,65317
D000216,N00000615,Rosa L DeLauro (D),2016,Building Trade Unions,0,51500,51500
D000216,N00000615,Rosa L DeLauro (D),2016,Retired,43953,0,43953
D000216,N00000615,Rosa L DeLauro (D),2016,Industrial Unions,0,42000,42000
D000216,N00000615,Rosa L DeLauro (D),2016,Real Estate,26300,12000,38300
D000216,N00000615,Rosa L DeLauro (D),2016,Misc Unions,500,36500,37000
D000216,N00000615,Rosa L DeLauro (D),2016,Education,31390,0,31390
F000372,N00000684,Rodney Frelinghuysen (R),2016,Defense Aerospace,124400,52500,176900
F000372,N00000684,Rodney Frelinghuysen (R),2016,Lobbyists,113593,5764,119357
F000372,N00000684,Rodney Frelinghuysen (R),2016,Pharmaceuticals/Health Products,19300,94000,113300
F000372,N00000684,Rodney Frelinghuysen (R),2016,Retired,109414,0,109414
F000372,N00000684,Rodney Frelinghuysen (R),2016,Real Estate,69000,21000,90000
F000372,N00000684,Rodney Frelinghuysen (R),2016,Securities & Investment,83600,5000,88600
F000372,N00000684,Rodney Frelinghuysen (R),2016,Electric Utilities,2700,72778,75478
F000372,N00000684,Rodney Frelinghuysen (R),2016,Misc Defense,20700,48500,69200
F000372,N00000684,Rodney Frelinghuysen (R),2016,Defense Electronics,2000,62500,64500
F000372,N00000684,Rodney Frelinghuysen (R),2016,Lawyers/Law Firms,23475,34957,58432
M000639,N00000699,Robert Menendez (D),2016,Lawyers/Law Firms,1376465,193049,1569514
M000639,N00000699,Robert Menendez (D),2016,Real Estate,927479,88265,1015744
M000639,N00000699,Robert Menendez (D),2016,Securities & Investment,542801,112700,655501
M000639,N00000699,Robert Menendez (D),2016,Health Professionals,556193,98000,654193
M000639,N00000699,Robert Menendez (D),2016,Retired,533974,0,533974
M000639,N00000699,Robert Menendez (D),2016,Lobbyists,470207,18860,489067
M000639,N00000699,Robert Menendez (D),2016,Pro-Israel,254170,98100,352270
M000639,N00000699,Robert Menendez (D),2016,Leadership PACs,0,346244,346244
M000639,N00000699,Robert Menendez (D),2016,Insurance,188550,144100,332650
M000639,N00000699,Robert Menendez (D),2016,Pharmaceuticals/Health Products,155388,148750,304138
G000548,N00000743,Scott Garrett (R),2016,Securities & Investment,243305,117500,360805
G000548,N00000743,Scott Garrett (R),2016,Retired,244983,0,244983
G000548,N00000743,Scott Garrett (R),2016,Leadership PACs,23315,139500,162815
G000548,N00000743,Scott Garrett (R),2016,Republican/Conservative,78843,43921,122764
G000548,N00000743,Scott Garrett (R),2016,Insurance,22250,87000,109250
G000548,N00000743,Scott Garrett (R),2016,Real Estate,42235,29000,71235
G000548,N00000743,Scott Garrett (R),2016,Commercial Banks,11250,55500,66750
G000548,N00000743,Scott Garrett (R),2016,Lawyers/Law Firms,57435,8450,65885
G000548,N00000743,Scott Garrett (R),2016,Candidate Committees,0,60686,60686
G000548,N00000743,Scott Garrett (R),2016,Misc Finance,38975,15200,54175
P000096,N00000751,Bill Pascrell Jr (D),2016,Lawyers/Law Firms,114350,38750,153100
P000096,N00000751,Bill Pascrell Jr (D),2016,Health Professionals,9200,127500,136700
P000096,N00000751,Bill Pascrell Jr (D),2016,Real Estate,61916,31000,92916
P000096,N00000751,Bill Pascrell Jr (D),2016,Insurance,12250,72000,84250
P000096,N00000751,Bill Pascrell Jr (D),2016,Public Sector Unions,1000,62700,63700
P000096,N00000751,Bill Pascrell Jr (D),2016,Building Trade Unions,0,60400,60400
P000096,N00000751,Bill Pascrell Jr (D),2016,Hospitals/Nursing Homes,17075,40500,57575
P000096,N00000751,Bill Pascrell Jr (D),2016,Lobbyists,51270,1000,52270
P000096,N00000751,Bill Pascrell Jr (D),2016,Pharmaceuticals/Health Products,2900,49000,51900
P000096,N00000751,Bill Pascrell Jr (D),2016,Securities & Investment,14650,34500,49150
P000034,N00000781,Frank Pallone Jr (D),2016,Health Professionals,33000,300150,333150
P000034,N00000781,Frank Pallone Jr (D),2016,Pharmaceuticals/Health Products,36076,235800,271876
P000034,N00000781,Frank Pallone Jr (D),2016,Lawyers/Law Firms,84650,52000,136650
P000034,N00000781,Frank Pallone Jr (D),2016,Lobbyists,101631,4500,106131
P000034,N00000781,Frank Pallone Jr (D),2016,Telecom Services,23700,82000,105700
P000034,N00000781,Frank Pallone Jr (D),2016,Hospitals/Nursing Homes,30600,45500,76100
P000034,N00000781,Frank Pallone Jr (D),2016,Health Services/HMOs,7650,64000,71650
P000034,N00000781,Frank Pallone Jr (D),2016,Real Estate,29350,42000,71350
P000034,N00000781,Frank Pallone Jr (D),2016,TV/Movies/Music,8100,55500,63600
P000034,N00000781,Frank Pallone Jr (D),2016,Chemical & Related Manufacturing,3750,59000,62750
L000554,N00000851,Frank A LoBiondo (R),2016,Transportation Unions,0,150500,150500
L000554,N00000851,Frank A LoBiondo (R),2016,Leadership PACs,0,126852,126852
L000554,N00000851,Frank A LoBiondo (R),2016,Air Transport,3700,89000,92700
L000554,N00000851,Frank A LoBiondo (R),2016,Public Sector Unions,0,67750,67750
L000554,N00000851,Frank A LoBiondo (R),2016,Building Trade Unions,0,64000,64000
L000554,N00000851,Frank A LoBiondo (R),2016,Defense Aerospace,0,51500,51500
L000554,N00000851,Frank A LoBiondo (R),2016,Real Estate,26700,16500,43200
L000554,N00000851,Frank A LoBiondo (R),2016,Defense Electronics,0,43000,43000
L000554,N00000851,Frank A LoBiondo (R),2016,Trucking,10450,28000,38450
L000554,N00000851,Frank A LoBiondo (R),2016,Sea Transport,2850,35250,38100
L000567,N00000898,Leonard Lance (R),2016,Pharmaceuticals/Health Products,22700,154800,177500
L000567,N00000898,Leonard Lance (R),2016,Health Professionals,6275,84500,90775
L000567,N00000898,Leonard Lance (R),2016,Retired,42700,0,42700
L000567,N00000898,Leonard Lance (R),2016,Insurance,8573,31500,40073
L000567,N00000898,Leonard Lance (R),2016,Leadership PACs,0,32500,32500
L000567,N00000898,Leonard Lance (R),2016,Building Trade Unions,0,32000,32000
L000567,N00000898,Leonard Lance (R),2016,Lawyers/Law Firms,22125,7500,29625
L000567,N00000898,Leonard Lance (R),2016,Telecom Services,0,29500,29500
L000567,N00000898,Leonard Lance (R),2016,Electric Utilities,125,28212,28337
L000567,N00000898,Leonard Lance (R),2016,Automotive,500,24000,24500
N000002,N00000939,Jerrold Nadler (D),2016,Lawyers/Law Firms,198400,44150,242550
N000002,N00000939,Jerrold Nadler (D),2016,TV/Movies/Music,43650,61500,105150
N000002,N00000939,Jerrold Nadler (D),2016,Real Estate,93500,6000,99500
N000002,N00000939,Jerrold Nadler (D),2016,Securities & Investment,70700,1000,71700
N000002,N00000939,Jerrold Nadler (D),2016,Printing & Publishing,50047,11798,61845
N000002,N00000939,Jerrold Nadler (D),2016,Transportation Unions,0,55000,55000
N000002,N00000939,Jerrold Nadler (D),2016,Building Trade Unions,0,42500,42500
N000002,N00000939,Jerrold Nadler (D),2016,Misc Unions,0,42350,42350
N000002,N00000939,Jerrold Nadler (D),2016,Public Sector Unions,0,42000,42000
N000002,N00000939,Jerrold Nadler (D),2016,Retired,41825,0,41825
R000053,N00000964,Charles B Rangel (D),2016,Real Estate,23925,0,23925
R000053,N00000964,Charles B Rangel (D),2016,Retired,13970,0,13970
R000053,N00000964,Charles B Rangel (D),2016,Lawyers/Law Firms,11000,2500,13500
R000053,N00000964,Charles B Rangel (D),2016,Building Trade Unions,0,12850,12850
R000053,N00000964,Charles B Rangel (D),2016,Health Professionals,3250,9000,12250
R000053,N00000964,Charles B Rangel (D),2016,Securities & Investment,8060,0,8060
R000053,N00000964,Charles B Rangel (D),2016,Industrial Unions,0,7500,7500
R000053,N00000964,Charles B Rangel (D),2016,Retail Sales,5500,0,5500
R000053,N00000964,Charles B Rangel (D),2016,Education,5125,0,5125
R000053,N00000964,Charles B Rangel (D),2016,Hospitals/Nursing Homes,4725,0,4725
E000179,N00001003,Eliot L Engel (D),2016,Pro-Israel,132950,57200,190150
E000179,N00001003,Eliot L Engel (D),2016,Real Estate,127200,8000,135200
E000179,N00001003,Eliot L Engel (D),2016,Health Professionals,56825,55000,111825
E000179,N00001003,Eliot L Engel (D),2016,Retired,107100,0,107100
E000179,N00001003,Eliot L Engel (D),2016,Lawyers/Law Firms,81886,19000,100886
E000179,N00001003,Eliot L Engel (D),2016,Securities & Investment,74950,6000,80950
E000179,N00001003,Eliot L Engel (D),2016,Pharmaceuticals/Health Products,16700,37500,54200
E000179,N00001003,Eliot L Engel (D),2016,Hospitals/Nursing Homes,30350,7000,37350
E000179,N00001003,Eliot L Engel (D),2016,Education,34800,0,34800
E000179,N00001003,Eliot L Engel (D),2016,Building Trade Unions,0,34000,34000
L000480,N00001024,Nita M Lowey (D),2016,Retired,197319,0,197319
L000480,N00001024,Nita M Lowey (D),2016,Securities & Investment,164700,14000,178700
L000480,N00001024,Nita M Lowey (D),2016,Real Estate,159250,15500,174750
L000480,N00001024,Nita M Lowey (D),2016,Lawyers/Law Firms,84400,23500,107900
L000480,N00001024,Nita M Lowey (D),2016,Pro-Israel,65900,22925,88825
L000480,N00001024,Nita M Lowey (D),2016,Public Sector Unions,0,63500,63500
L000480,N00001024,Nita M Lowey (D),2016,Health Professionals,22385,32000,54385
L000480,N00001024,Nita M Lowey (D),2016,Misc Finance,44850,0,44850
L000480,N00001024,Nita M Lowey (D),2016,Non-Profit Institutions,38900,4000,42900
L000480,N00001024,Nita M Lowey (D),2016,Lobbyists,34700,4550,39250
S000148,N00001093,Charles E Schumer (D),2016,Securities & Investment,2989036,258700,3247736
S000148,N00001093,Charles E Schumer (D),2016,Lawyers/Law Firms,1873035,253551,2126586
S000148,N00001093,Charles E Schumer (D),2016,Real Estate,1767722,90500,1858222
S000148,N00001093,Charles E Schumer (D),2016,Insurance,368650,378000,746650
S000148,N00001093,Charles E Schumer (D),2016,Retired,662311,0,662311
S000148,N00001093,Charles E Schumer (D),2016,Lobbyists,579777,21900,601677
S000148,N00001093,Charles E Schumer (D),2016,Misc Finance,508062,69100,577162
S000148,N00001093,Charles E Schumer (D),2016,TV/Movies/Music,465757,84500,550257
S000148,N00001093,Charles E Schumer (D),2016,Electronics Mfg & Equip,410245,122034,532279
S000148,N00001093,Charles E Schumer (D),2016,Hospitals/Nursing Homes,359478,159200,518678
V000081,N00001102,Nydia M Velazquez (D),2016,Lawyers/Law Firms,35920,10500,46420
V000081,N00001102,Nydia M Velazquez (D),2016,Leadership PACs,0,41500,41500
V000081,N00001102,Nydia M Velazquez (D),2016,Real Estate,14650,26000,40650
V000081,N00001102,Nydia M Velazquez (D),2016,Industrial Unions,0,36500,36500
V000081,N00001102,Nydia M Velazquez (D),2016,Building Trade Unions,0,35500,35500
V000081,N00001102,Nydia M Velazquez (D),2016,Public Sector Unions,0,35000,35000
V000081,N00001102,Nydia M Velazquez (D),2016,Securities & Investment,11800,15000,26800
V000081,N00001102,Nydia M Velazquez (D),2016,Accountants,0,25000,25000
V000081,N00001102,Nydia M Velazquez (D),2016,Insurance,4000,19500,23500
V000081,N00001102,Nydia M Velazquez (D),2016,Transportation Unions,0,21000,21000
C001038,N00001127,Joseph Crowley (D),2016,Real Estate,261278,82000,343278
C001038,N00001127,Joseph Crowley (D),2016,Insurance,56750,231500,288250
C001038,N00001127,Joseph Crowley (D),2016,Securities & Investment,79050,155000,234050
C001038,N00001127,Joseph Crowley (D),2016,Lawyers/Law Firms,133245,52200,185445
C001038,N00001127,Joseph Crowley (D),2016,Misc Issues,120570,0,120570
C001038,N00001127,Joseph Crowley (D),2016,Pharmaceuticals/Health Products,250,107300,107550
C001038,N00001127,Joseph Crowley (D),2016,Hospitals/Nursing Homes,49875,47500,97375
C001038,N00001127,Joseph Crowley (D),2016,Commercial Banks,11850,79500,91350
C001038,N00001127,Joseph Crowley (D),2016,Health Professionals,14950,62500,77450
C001038,N00001127,Joseph Crowley (D),2016,Electric Utilities,3000,66000,69000
M001137,N00001171,Gregory W Meeks (D),2016,Securities & Investment,49950,110000,159950
M001137,N00001171,Gregory W Meeks (D),2016,Insurance,0,114300,114300
M001137,N00001171,Gregory W Meeks (D),2016,Real Estate,10850,57000,67850
M001137,N00001171,Gregory W Meeks (D),2016,Commercial Banks,3000,61000,64000
M001137,N00001171,Gregory W Meeks (D),2016,Accountants,750,46000,46750
M001137,N00001171,Gregory W Meeks (D),2016,Finance/Credit Companies,0,37000,37000
M001137,N00001171,Gregory W Meeks (D),2016,Misc Manufacturing & Distributing,14100,19000,33100
M001137,N00001171,Gregory W Meeks (D),2016,Air Transport,0,30500,30500
M001137,N00001171,Gregory W Meeks (D),2016,Lawyers/Law Firms,8750,17000,25750
M001137,N00001171,Gregory W Meeks (D),2016,Lobbyists,20727,500,21227
K000210,N00001193,Pete King (R),2016,Real Estate,77850,27500,105350
K000210,N00001193,Pete King (R),2016,Securities & Investment,39050,41000,80050
K000210,N00001193,Pete King (R),2016,Retired,70069,0,70069
K000210,N00001193,Pete King (R),2016,Insurance,9250,48500,57750
K000210,N00001193,Pete King (R),2016,Building Trade Unions,0,57200,57200
K000210,N00001193,Pete King (R),2016,Transportation Unions,100,50500,50600
K000210,N00001193,Pete King (R),2016,Republican/Conservative,8400,19000,27400
K000210,N00001193,Pete King (R),2016,Lawyers/Law Firms,19850,6500,26350
K000210,N00001193,Pete King (R),2016,Public Sector Unions,0,25500,25500
K000210,N00001193,Pete King (R),2016,Lobbyists,24100,0,24100
C001092,N00001285,Chris Collins (R),2016,Health Professionals,14570,96500,111070
C001092,N00001285,Chris Collins (R),2016,Pharmaceuticals/Health Products,2905,93400,96305
C001092,N00001285,Chris Collins (R),2016,Oil & Gas,12550,47200,59750
C001092,N00001285,Chris Collins (R),2016,Health Services/HMOs,28300,20500,48800
C001092,N00001285,Chris Collins (R),2016,Telecom Services,0,48000,48000
C001092,N00001285,Chris Collins (R),2016,Electric Utilities,0,37500,37500
C001092,N00001285,Chris Collins (R),2016,Lawyers/Law Firms,21870,9250,31120
C001092,N00001285,Chris Collins (R),2016,Republican/Conservative,3050,25000,28050
C001092,N00001285,Chris Collins (R),2016,TV/Movies/Music,5505,22500,28005
C001092,N00001285,Chris Collins (R),2016,Retired,27230,0,27230
S000480,N00001311,Louise M Slaughter (D),2016,Public Sector Unions,250,66000,66250
S000480,N00001311,Louise M Slaughter (D),2016,Health Professionals,3576,61000,64576
S000480,N00001311,Louise M Slaughter (D),2016,Building Trade Unions,0,57000,57000
S000480,N00001311,Louise M Slaughter (D),2016,Industrial Unions,0,56500,56500
S000480,N00001311,Louise M Slaughter (D),2016,Women's Issues,44304,11000,55304
S000480,N00001311,Louise M Slaughter (D),2016,Lawyers/Law Firms,29028,21000,50028
S000480,N00001311,Louise M Slaughter (D),2016,Real Estate,41340,8000,49340
S000480,N00001311,Louise M Slaughter (D),2016,Transportation Unions,0,49000,49000
S000480,N00001311,Louise M Slaughter (D),2016,Defense Electronics,30525,11000,41525
S000480,N00001311,Louise M Slaughter (D),2016,Retired,40459,0,40459
D000482,N00001373,Mike Doyle (D),2016,Electric Utilities,500,86000,86500
D000482,N00001373,Mike Doyle (D),2016,Industrial Unions,0,61500,61500
D000482,N00001373,Mike Doyle (D),2016,Telecom Services,1750,52000,53750
D000482,N00001373,Mike Doyle (D),2016,Building Trade Unions,0,52500,52500
D000482,N00001373,Mike Doyle (D),2016,Lawyers/Law Firms,16250,23000,39250
D000482,N00001373,Mike Doyle (D),2016,Real Estate,13950,23000,36950
D000482,N00001373,Mike Doyle (D),2016,Oil & Gas,0,32000,32000
D000482,N00001373,Mike Doyle (D),2016,Public Sector Unions,0,31000,31000
D000482,N00001373,Mike Doyle (D),2016,Chemical & Related Manufacturing,0,30500,30500
D000482,N00001373,Mike Doyle (D),2016,Health Professionals,260,24500,24760
T000461,N00001489,Pat Toomey (R),2016,Retired,2885670,0,2885670
T000461,N00001489,Pat Toomey (R),2016,Securities & Investment,1943575,321738,2265313
T000461,N00001489,Pat Toomey (R),2016,Republican/Conservative,1364248,95344,1459592
T000461,N00001489,Pat Toomey (R),2016,Lawyers/Law Firms,968793,254806,1223599
T000461,N00001489,Pat Toomey (R),2016,Real Estate,883033,121100,1004133
T000461,N00001489,Pat Toomey (R),2016,Insurance,462790,474100,936890
T000461,N00001489,Pat Toomey (R),2016,Commercial Banks,432552,301250,733802
T000461,N00001489,Pat Toomey (R),2016,Leadership PACs,0,714491,714491
T000461,N00001489,Pat Toomey (R),2016,Misc Finance,480653,107700,588353
T000461,N00001489,Pat Toomey (R),2016,Oil & Gas,277497,291850,569347
B001227,N00001619,Robert A Brady (D),2016,Lawyers/Law Firms,61300,25500,86800
B001227,N00001619,Robert A Brady (D),2016,Building Trade Unions,0,80500,80500
B001227,N00001619,Robert A Brady (D),2016,Industrial Unions,0,50700,50700
B001227,N00001619,Robert A Brady (D),2016,Telecom Services,24750,15000,39750
B001227,N00001619,Robert A Brady (D),2016,Public Sector Unions,0,38500,38500
B001227,N00001619,Robert A Brady (D),2016,Transportation Unions,0,37000,37000
B001227,N00001619,Robert A Brady (D),2016,General Contractors,33200,0,33200
B001227,N00001619,Robert A Brady (D),2016,Real Estate,24650,8000,32650
B001227,N00001619,Robert A Brady (D),2016,Oil & Gas,20875,6000,26875
B001227,N00001619,Robert A Brady (D),2016,Misc Unions,0,16000,16000
P000373,N00001633,Joe Pitts (R),2016,Health Professionals,0,117500,117500
P000373,N00001633,Joe Pitts (R),2016,Pharmaceuticals/Health Products,1000,75000,76000
P000373,N00001633,Joe Pitts (R),2016,Hospitals/Nursing Homes,0,23000,23000
P000373,N00001633,Joe Pitts (R),2016,Health Services/HMOs,0,19000,19000
P000373,N00001633,Joe Pitts (R),2016,Insurance,1000,15500,16500
P000373,N00001633,Joe Pitts (R),2016,Oil & Gas,0,16000,16000
P000373,N00001633,Joe Pitts (R),2016,Electric Utilities,0,11500,11500
P000373,N00001633,Joe Pitts (R),2016,Lawyers/Law Firms,1700,9500,11200
P000373,N00001633,Joe Pitts (R),2016,Lobbyists,6750,2500,9250
P000373,N00001633,Joe Pitts (R),2016,Automotive,0,7000,7000
N000147,N00001692,Eleanor Holmes Norton (D),2016,Real Estate,56818,11000,67818
N000147,N00001692,Eleanor Holmes Norton (D),2016,Transportation Unions,0,41000,41000
N000147,N00001692,Eleanor Holmes Norton (D),2016,Public Sector Unions,0,37000,37000
N000147,N00001692,Eleanor Holmes Norton (D),2016,Lawyers/Law Firms,14500,14500,29000
N000147,N00001692,Eleanor Holmes Norton (D),2016,Building Trade Unions,0,27500,27500
N000147,N00001692,Eleanor Holmes Norton (D),2016,Industrial Unions,0,15000,15000
N000147,N00001692,Eleanor Holmes Norton (D),2016,General Contractors,10100,4500,14600
N000147,N00001692,Eleanor Holmes Norton (D),2016,Misc Unions,0,12250,12250
N000147,N00001692,Eleanor Holmes Norton (D),2016,Air Transport,0,11500,11500
N000147,N00001692,Eleanor Holmes Norton (D),2016,Railroads,0,11000,11000
F000043,N00001746,Chaka Fattah (D),2016,Leadership PACs,0,21000,21000
F000043,N00001746,Chaka Fattah (D),2016,Public Sector Unions,500,18500,19000
F000043,N00001746,Chaka Fattah (D),2016,Building Trade Unions,0,15000,15000
F000043,N00001746,Chaka Fattah (D),2016,Industrial Unions,0,8500,8500
F000043,N00001746,Chaka Fattah (D),2016,Misc Unions,0,8500,8500
F000043,N00001746,Chaka Fattah (D),2016,Civil Servants/Public Officials,8400,0,8400
F000043,N00001746,Chaka Fattah (D),2016,Securities & Investment,8100,0,8100
F000043,N00001746,Chaka Fattah (D),2016,Real Estate,6500,1000,7500
F000043,N00001746,Chaka Fattah (D),2016,Lawyers/Law Firms,2400,5000,7400
F000043,N00001746,Chaka Fattah (D),2016,"Beer, Wine & Liquor",3600,2500,6100
G000386,N00001758,Chuck Grassley (R),2016,Retired,879737,0,879737
G000386,N00001758,Chuck Grassley (R),2016,Securities & Investment,491157,58000,549157
G000386,N00001758,Chuck Grassley (R),2016,Lawyers/Law Firms,344841,119950,464791
G000386,N00001758,Chuck Grassley (R),2016,Leadership PACs,0,453299,453299
G000386,N00001758,Chuck Grassley (R),2016,Health Professionals,113485,235000,348485
G000386,N00001758,Chuck Grassley (R),2016,Insurance,75725,233100,308825
G000386,N00001758,Chuck Grassley (R),2016,Lobbyists,278276,26487,304763
G000386,N00001758,Chuck Grassley (R),2016,Real Estate,225986,58500,284486
G000386,N00001758,Chuck Grassley (R),2016,Agricultural Services/Products,90450,164619,255069
G000386,N00001758,Chuck Grassley (R),2016,Crop Production & Basic Processing,162802,64000,226802
S000583,N00001811,Lamar Smith (R),2016,Oil & Gas,45200,55500,100700
S000583,N00001811,Lamar Smith (R),2016,Retired,90585,0,90585
S000583,N00001811,Lamar Smith (R),2016,Lawyers/Law Firms,36735,31500,68235
S000583,N00001811,Lamar Smith (R),2016,Real Estate,51450,16500,67950
S000583,N00001811,Lamar Smith (R),2016,Electronics Mfg & Equip,5800,55471,61271
S000583,N00001811,Lamar Smith (R),2016,TV/Movies/Music,11250,46000,57250
S000583,N00001811,Lamar Smith (R),2016,Leadership PACs,0,53000,53000
S000583,N00001811,Lamar Smith (R),2016,Defense Aerospace,1500,41500,43000
S000583,N00001811,Lamar Smith (R),2016,Accountants,2000,38000,40000
S000583,N00001811,Lamar Smith (R),2016,Automotive,13750,25500,39250
S000248,N00001813,Jose E Serrano (D),2016,Public Sector Unions,0,62500,62500
S000248,N00001813,Jose E Serrano (D),2016,Industrial Unions,0,19500,19500
S000248,N00001813,Jose E Serrano (D),2016,Real Estate,7950,10000,17950
S000248,N00001813,Jose E Serrano (D),2016,Transportation Unions,0,15200,15200
S000248,N00001813,Jose E Serrano (D),2016,Hospitals/Nursing Homes,13050,0,13050
S000248,N00001813,Jose E Serrano (D),2016,Lawyers/Law Firms,1500,10750,12250
S000248,N00001813,Jose E Serrano (D),2016,Education,13000,-1000,12000
S000248,N00001813,Jose E Serrano (D),2016,"Beer, Wine & Liquor",2700,8500,11200
S000248,N00001813,Jose E Serrano (D),2016,Human Rights,0,11000,11000
S000248,N00001813,Jose E Serrano (D),2016,Misc Unions,0,11000,11000
S000248,N00001813,Jose E Serrano (D),2016,Building Trade Unions,0,11000,11000
H000874,N00001821,Steny H Hoyer (D),2016,Electric Utilities,24200,197500,221700
H000874,N00001821,Steny H Hoyer (D),2016,Insurance,31000,186750,217750
H000874,N00001821,Steny H Hoyer (D),2016,Securities & Investment,62350,155000,217350
H000874,N00001821,Steny H Hoyer (D),2016,Health Professionals,25100,188500,213600
H000874,N00001821,Steny H Hoyer (D),2016,Lawyers/Law Firms,104612,45500,150112
H000874,N00001821,Steny H Hoyer (D),2016,Pharmaceuticals/Health Products,13000,128500,141500
H000874,N00001821,Steny H Hoyer (D),2016,Real Estate,70036,70000,140036
H000874,N00001821,Steny H Hoyer (D),2016,Public Sector Unions,0,126500,126500
H000874,N00001821,Steny H Hoyer (D),2016,Pro-Israel,77800,21700,99500
H000874,N00001821,Steny H Hoyer (D),2016,Retired,95510,0,95510
M000702,N00001945,Barbara A Mikulski (D),2016,Pharmaceuticals/Health Products,2250,103811,106061
M000702,N00001945,Barbara A Mikulski (D),2016,Defense Electronics,61600,36500,98100
M000702,N00001945,Barbara A Mikulski (D),2016,Health Professionals,-850,79250,78400
M000702,N00001945,Barbara A Mikulski (D),2016,Lobbyists,71086,6626,77712
M000702,N00001945,Barbara A Mikulski (D),2016,Lawyers/Law Firms,12850,41500,54350
M000702,N00001945,Barbara A Mikulski (D),2016,Defense Aerospace,18950,34500,53450
M000702,N00001945,Barbara A Mikulski (D),2016,Misc Defense,8700,35000,43700
M000702,N00001945,Barbara A Mikulski (D),2016,Air Transport,13500,23500,37000
M000702,N00001945,Barbara A Mikulski (D),2016,Transportation Unions,0,30000,30000
M000702,N00001945,Barbara A Mikulski (D),2016,Public Sector Unions,0,27500,27500
C000141,N00001955,Ben Cardin (D),2016,Lawyers/Law Firms,337061,117000,454061
C000141,N00001955,Ben Cardin (D),2016,Securities & Investment,246183,182500,428683
C000141,N00001955,Ben Cardin (D),2016,Health Professionals,127203,268547,395750
C000141,N00001955,Ben Cardin (D),2016,Real Estate,303671,60000,363671
C000141,N00001955,Ben Cardin (D),2016,Insurance,94850,267500,362350
C000141,N00001955,Ben Cardin (D),2016,Lobbyists,223450,10366,233816
C000141,N00001955,Ben Cardin (D),2016,Health Services/HMOs,71716,152109,223825
C000141,N00001955,Ben Cardin (D),2016,Retired,222010,0,222010
C000141,N00001955,Ben Cardin (D),2016,Pro-Israel,159513,59280,218793
C000141,N00001955,Ben Cardin (D),2016,Leadership PACs,0,187000,187000
C000984,N00001971,Elijah E Cummings (D),2016,Public Sector Unions,750,93300,94050
C000984,N00001971,Elijah E Cummings (D),2016,Transportation Unions,0,81700,81700
C000984,N00001971,Elijah E Cummings (D),2016,Lawyers/Law Firms,30850,25500,56350
C000984,N00001971,Elijah E Cummings (D),2016,Real Estate,40100,10000,50100
C000984,N00001971,Elijah E Cummings (D),2016,Health Professionals,20425,26900,47325
C000984,N00001971,Elijah E Cummings (D),2016,Railroads,2500,32000,34500
C000984,N00001971,Elijah E Cummings (D),2016,Oil & Gas,28000,4000,32000
C000984,N00001971,Elijah E Cummings (D),2016,Industrial Unions,0,31000,31000
C000984,N00001971,Elijah E Cummings (D),2016,Sea Transport,1250,29000,30250
C000984,N00001971,Elijah E Cummings (D),2016,Air Transport,0,27500,27500
W000805,N00002097,Mark Warner (D),2016,Securities & Investment,1514027,226600,1740627
W000805,N00002097,Mark Warner (D),2016,Lawyers/Law Firms,1151310,201303,1352613
W000805,N00002097,Mark Warner (D),2016,Retired,1139580,0,1139580
W000805,N00002097,Mark Warner (D),2016,Real Estate,691125,101126,792251
W000805,N00002097,Mark Warner (D),2016,Insurance,262150,337500,599650
W000805,N00002097,Mark Warner (D),2016,Leadership PACs,0,424600,424600
W000805,N00002097,Mark Warner (D),2016,Lobbyists,391688,11100,402788
W000805,N00002097,Mark Warner (D),2016,Business Services,359069,31800,390869
W000805,N00002097,Mark Warner (D),2016,Commercial Banks,197500,166100,363600
W000805,N00002097,Mark Warner (D),2016,Misc Finance,321795,41600,363395
S000185,N00002147,Bobby Scott (D),2016,Public Sector Unions,850,77000,77850
S000185,N00002147,Bobby Scott (D),2016,Industrial Unions,0,56000,56000
S000185,N00002147,Bobby Scott (D),2016,Lawyers/Law Firms,13700,37250,50950
S000185,N00002147,Bobby Scott (D),2016,Transportation Unions,0,37500,37500
S000185,N00002147,Bobby Scott (D),2016,Securities & Investment,12300,18000,30300
S000185,N00002147,Bobby Scott (D),2016,Building Trade Unions,0,27000,27000
S000185,N00002147,Bobby Scott (D),2016,Misc Unions,0,25000,25000
S000185,N00002147,Bobby Scott (D),2016,Insurance,520,23500,24020
S000185,N00002147,Bobby Scott (D),2016,Finance/Credit Companies,500,22000,22500
S000185,N00002147,Bobby Scott (D),2016,Health Professionals,9700,10000,19700
B001135,N00002221,Richard Burr (R),2016,Retired,1028271,0,1028271
B001135,N00002221,Richard Burr (R),2016,Securities & Investment,613599,174000,787599
B001135,N00002221,Richard Burr (R),2016,Lawyers/Law Firms,425758,155995,581753
B001135,N00002221,Richard Burr (R),2016,Insurance,291077,244500,535577
B001135,N00002221,Richard Burr (R),2016,Pharmaceuticals/Health Products,100466,419852,520318
B001135,N00002221,Richard Burr (R),2016,Leadership PACs,0,514160,514160
B001135,N00002221,Richard Burr (R),2016,Real Estate,415629,74500,490129
B001135,N00002221,Richard Burr (R),2016,Health Professionals,206244,242050,448294
B001135,N00002221,Richard Burr (R),2016,Lobbyists,347429,6977,354406
B001135,N00002221,Richard Burr (R),2016,Oil & Gas,94457,202450,296907
P000523,N00002260,David Price (D),2016,Retired,73725,0,73725
P000523,N00002260,David Price (D),2016,Public Sector Unions,0,43000,43000
P000523,N00002260,David Price (D),2016,Education,40825,0,40825
P000523,N00002260,David Price (D),2016,Lawyers/Law Firms,20700,14000,34700
P000523,N00002260,David Price (D),2016,Transportation Unions,0,34500,34500
P000523,N00002260,David Price (D),2016,Defense Electronics,0,34000,34000
P000523,N00002260,David Price (D),2016,Industrial Unions,0,34000,34000
P000523,N00002260,David Price (D),2016,Health Professionals,5800,23500,29300
P000523,N00002260,David Price (D),2016,Railroads,0,26500,26500
P000523,N00002260,David Price (D),2016,Pharmaceuticals/Health Products,500,24000,24500
J000255,N00002299,Walter B Jones Jr (R),2016,Retired,67396,0,67396
J000255,N00002299,Walter B Jones Jr (R),2016,Democratic/Liberal,58025,0,58025
J000255,N00002299,Walter B Jones Jr (R),2016,Real Estate,25490,8500,33990
J000255,N00002299,Walter B Jones Jr (R),2016,Health Professionals,19450,13500,32950
J000255,N00002299,Walter B Jones Jr (R),2016,Lawyers/Law Firms,10750,16500,27250
J000255,N00002299,Walter B Jones Jr (R),2016,Misc Manufacturing & Distributing,21500,0,21500
J000255,N00002299,Walter B Jones Jr (R),2016,Crop Production & Basic Processing,820,17500,18320
J000255,N00002299,Walter B Jones Jr (R),2016,Leadership PACs,0,15200,15200
J000255,N00002299,Walter B Jones Jr (R),2016,Defense Aerospace,100,15000,15100
J000255,N00002299,Walter B Jones Jr (R),2016,Credit Unions,0,15000,15000
J000255,N00002299,Walter B Jones Jr (R),2016,Transportation Unions,0,15000,15000
C000537,N00002408,James E Clyburn (D),2016,Electric Utilities,8350,130500,138850
C000537,N00002408,James E Clyburn (D),2016,Health Professionals,7760,107000,114760
C000537,N00002408,James E Clyburn (D),2016,Insurance,3200,106500,109700
C000537,N00002408,James E Clyburn (D),2016,Lawyers/Law Firms,53160,47500,100660
C000537,N00002408,James E Clyburn (D),2016,Pharmaceuticals/Health Products,3200,81262,84462
C000537,N00002408,James E Clyburn (D),2016,Public Sector Unions,0,81000,81000
C000537,N00002408,James E Clyburn (D),2016,Securities & Investment,4700,74750,79450
C000537,N00002408,James E Clyburn (D),2016,Transportation Unions,0,70340,70340
C000537,N00002408,James E Clyburn (D),2016,Commercial Banks,1250,59000,60250
C000537,N00002408,James E Clyburn (D),2016,Electronics Mfg & Equip,2950,52000,54950
S000051,N00002424,Mark Sanford (R),2016,Real Estate,55400,23000,78400
S000051,N00002424,Mark Sanford (R),2016,Securities & Investment,53200,0,53200
S000051,N00002424,Mark Sanford (R),2016,Retired,44230,0,44230
S000051,N00002424,Mark Sanford (R),2016,Leadership PACs,0,34700,34700
S000051,N00002424,Mark Sanford (R),2016,Air Transport,0,26500,26500
S000051,N00002424,Mark Sanford (R),2016,Railroads,0,25999,25999
S000051,N00002424,Mark Sanford (R),2016,Automotive,12800,12500,25300
S000051,N00002424,Mark Sanford (R),2016,Lawyers/Law Firms,18200,3000,21200
S000051,N00002424,Mark Sanford (R),2016,Health Professionals,16350,2000,18350
S000051,N00002424,Mark Sanford (R),2016,Insurance,6200,10500,16700
L000287,N00002577,John Lewis (D),2016,Health Professionals,7500,64000,71500
L000287,N00002577,John Lewis (D),2016,Insurance,3750,66000,69750
L000287,N00002577,John Lewis (D),2016,Lawyers/Law Firms,33896,30750,64646
L000287,N00002577,John Lewis (D),2016,Real Estate,18350,30000,48350
L000287,N00002577,John Lewis (D),2016,Public Sector Unions,0,47500,47500
L000287,N00002577,John Lewis (D),2016,Retired,45120,0,45120
L000287,N00002577,John Lewis (D),2016,Industrial Unions,0,33500,33500
L000287,N00002577,John Lewis (D),2016,Transportation Unions,0,31500,31500
L000287,N00002577,John Lewis (D),2016,TV/Movies/Music,24300,4000,28300
L000287,N00002577,John Lewis (D),2016,Health Services/HMOs,19325,8000,27325
I000055,N00002593,Johnny Isakson (R),2016,Real Estate,698136,99000,797136
I000055,N00002593,Johnny Isakson (R),2016,Retired,549374,0,549374
I000055,N00002593,Johnny Isakson (R),2016,Lawyers/Law Firms,382360,126520,508880
I000055,N00002593,Johnny Isakson (R),2016,Insurance,230600,261500,492100
I000055,N00002593,Johnny Isakson (R),2016,Leadership PACs,0,401300,401300
I000055,N00002593,Johnny Isakson (R),2016,Securities & Investment,194500,136400,330900
I000055,N00002593,Johnny Isakson (R),2016,Health Professionals,131575,193000,324575
I000055,N00002593,Johnny Isakson (R),2016,Pharmaceuticals/Health Products,45500,255350,300850
I000055,N00002593,Johnny Isakson (R),2016,Retail Sales,189550,86000,275550
I000055,N00002593,Johnny Isakson (R),2016,Lobbyists,223343,5500,228843
B000490,N00002674,Sanford Bishop (D),2016,Crop Production & Basic Processing,15000,51500,66500
B000490,N00002674,Sanford Bishop (D),2016,Lawyers/Law Firms,28584,24750,53334
B000490,N00002674,Sanford Bishop (D),2016,Industrial Unions,0,42000,42000
B000490,N00002674,Sanford Bishop (D),2016,Public Sector Unions,0,39000,39000
B000490,N00002674,Sanford Bishop (D),2016,Agricultural Services/Products,0,33500,33500
B000490,N00002674,Sanford Bishop (D),2016,Health Professionals,5150,27000,32150
B000490,N00002674,Sanford Bishop (D),2016,Insurance,0,32000,32000
B000490,N00002674,Sanford Bishop (D),2016,Defense Aerospace,0,30500,30500
B000490,N00002674,Sanford Bishop (D),2016,Forestry & Forest Products,3334,27000,30334
B000490,N00002674,Sanford Bishop (D),2016,Food & Beverage,10500,18000,28500
B000911,N00002713,Corrine Brown (D),2016,Transportation Unions,0,40500,40500
B000911,N00002713,Corrine Brown (D),2016,Leadership PACs,0,40000,40000
B000911,N00002713,Corrine Brown (D),2016,Trucking,3200,35000,38200
B000911,N00002713,Corrine Brown (D),2016,Railroads,0,33000,33000
B000911,N00002713,Corrine Brown (D),2016,Candidate Committees,0,26500,26500
B000911,N00002713,Corrine Brown (D),2016,Lawyers/Law Firms,6950,16000,22950
B000911,N00002713,Corrine Brown (D),2016,Real Estate,17150,3000,20150
B000911,N00002713,Corrine Brown (D),2016,Industrial Unions,0,20000,20000
B000911,N00002713,Corrine Brown (D),2016,Sea Transport,11100,6000,17100
B000911,N00002713,Corrine Brown (D),2016,Air Transport,0,13000,13000
M000689,N00002793,John L Mica (R),2016,Leadership PACs,0,140100,140100
M000689,N00002793,John L Mica (R),2016,Air Transport,10450,108500,118950
M000689,N00002793,John L Mica (R),2016,Railroads,12652,55000,67652
M000689,N00002793,John L Mica (R),2016,Real Estate,46275,18500,64775
M000689,N00002793,John L Mica (R),2016,Lawyers/Law Firms,42795,19250,62045
M000689,N00002793,John L Mica (R),2016,Insurance,24350,37000,61350
M000689,N00002793,John L Mica (R),2016,Construction Services,20750,34085,54835
M000689,N00002793,John L Mica (R),2016,Health Professionals,36408,17700,54108
M000689,N00002793,John L Mica (R),2016,Retired,36452,0,36452
M000689,N00002793,John L Mica (R),2016,Candidate Committees,2000,34233,36233
R000435,N00002858,Ileana Ros-Lehtinen (R),2016,Pro-Israel,100050,50250,150300
R000435,N00002858,Ileana Ros-Lehtinen (R),2016,Leadership PACs,0,112800,112800
R000435,N00002858,Ileana Ros-Lehtinen (R),2016,Real Estate,77500,8000,85500
R000435,N00002858,Ileana Ros-Lehtinen (R),2016,Lawyers/Law Firms,54748,29500,84248
R000435,N00002858,Ileana Ros-Lehtinen (R),2016,Foreign & Defense Policy,48750,5000,53750
R000435,N00002858,Ileana Ros-Lehtinen (R),2016,Retired,48825,0,48825
R000435,N00002858,Ileana Ros-Lehtinen (R),2016,Transportation Unions,0,38000,38000
R000435,N00002858,Ileana Ros-Lehtinen (R),2016,Health Professionals,20400,16500,36900
R000435,N00002858,Ileana Ros-Lehtinen (R),2016,Misc Manufacturing & Distributing,28200,6000,34200
R000435,N00002858,Ileana Ros-Lehtinen (R),2016,Republican/Conservative,500,31000,31500
H000324,N00002884,Alcee L Hastings (D),2016,Lawyers/Law Firms,63700,13000,76700
H000324,N00002884,Alcee L Hastings (D),2016,Pro-Israel,56050,17200,73250
H000324,N00002884,Alcee L Hastings (D),2016,Finance/Credit Companies,30200,35250,65450
H000324,N00002884,Alcee L Hastings (D),2016,Education,37600,19900,57500
H000324,N00002884,Alcee L Hastings (D),2016,Crop Production & Basic Processing,14250,22500,36750
H000324,N00002884,Alcee L Hastings (D),2016,Industrial Unions,0,35000,35000
H000324,N00002884,Alcee L Hastings (D),2016,Transportation Unions,0,25500,25500
H000324,N00002884,Alcee L Hastings (D),2016,Lobbyists,25150,0,25150
H000324,N00002884,Alcee L Hastings (D),2016,Telephone Utilities,0,24500,24500
H000324,N00002884,Alcee L Hastings (D),2016,Real Estate,16450,8000,24450
F000462,N00002893,Lois J Frankel (D),2016,Real Estate,135150,8000,143150
F000462,N00002893,Lois J Frankel (D),2016,Lawyers/Law Firms,86817,18500,105317
F000462,N00002893,Lois J Frankel (D),2016,Retired,102269,0,102269
F000462,N00002893,Lois J Frankel (D),2016,Securities & Investment,84100,0,84100
F000462,N00002893,Lois J Frankel (D),2016,Pro-Israel,40725,15500,56225
F000462,N00002893,Lois J Frankel (D),2016,Building Trade Unions,0,49000,49000
F000462,N00002893,Lois J Frankel (D),2016,Business Services,38505,10000,48505
F000462,N00002893,Lois J Frankel (D),2016,Public Sector Unions,0,48500,48500
F000462,N00002893,Lois J Frankel (D),2016,Transportation Unions,0,47000,47000
F000462,N00002893,Lois J Frankel (D),2016,Health Professionals,29922,13500,43422
C001111,N00002942,Charlie Crist (D),2016,Lawyers/Law Firms,364656,16500,381156
C001111,N00002942,Charlie Crist (D),2016,Leadership PACs,5500,101600,107100
C001111,N00002942,Charlie Crist (D),2016,Retired,95505,0,95505
C001111,N00002942,Charlie Crist (D),2016,Real Estate,90255,5000,95255
C001111,N00002942,Charlie Crist (D),2016,Building Trade Unions,0,67500,67500
C001111,N00002942,Charlie Crist (D),2016,Health Professionals,47750,6000,53750
C001111,N00002942,Charlie Crist (D),2016,Public Sector Unions,250,49000,49250
C001111,N00002942,Charlie Crist (D),2016,Industrial Unions,0,46500,46500
C001111,N00002942,Charlie Crist (D),2016,Securities & Investment,41000,2500,43500
C001111,N00002942,Charlie Crist (D),2016,Business Services,35318,0,35318
A000055,N00003028,Robert B Aderholt (R),2016,Crop Production & Basic Processing,14053,81500,95553
A000055,N00003028,Robert B Aderholt (R),2016,Agricultural Services/Products,3950,90000,93950
A000055,N00003028,Robert B Aderholt (R),2016,Lawyers/Law Firms,25402,44000,69402
A000055,N00003028,Robert B Aderholt (R),2016,Misc Defense,31200,27177,58377
A000055,N00003028,Robert B Aderholt (R),2016,Defense Electronics,500,56700,57200
A000055,N00003028,Robert B Aderholt (R),2016,Defense Aerospace,3651,45000,48651
A000055,N00003028,Robert B Aderholt (R),2016,Food Processing & Sales,2601,41500,44101
A000055,N00003028,Robert B Aderholt (R),2016,Health Professionals,28904,14932,43836
A000055,N00003028,Robert B Aderholt (R),2016,Building Materials & Equipment,31500,12000,43500
A000055,N00003028,Robert B Aderholt (R),2016,Insurance,1401,35950,37351
S001141,N00003062,Jeff Sessions (R),2016,Defense Aerospace,2000,104000,106000
S001141,N00003062,Jeff Sessions (R),2016,Leadership PACs,0,104000,104000
S001141,N00003062,Jeff Sessions (R),2016,Oil & Gas,3950,88000,91950
S001141,N00003062,Jeff Sessions (R),2016,Lawyers/Law Firms,23305,51198,74503
S001141,N00003062,Jeff Sessions (R),2016,Real Estate,43900,30000,73900
S001141,N00003062,Jeff Sessions (R),2016,Electric Utilities,0,61000,61000
S001141,N00003062,Jeff Sessions (R),2016,Misc Defense,25400,32600,58000
S001141,N00003062,Jeff Sessions (R),2016,Health Professionals,11450,37500,48950
S001141,N00003062,Jeff Sessions (R),2016,Insurance,5750,40500,46250
S001141,N00003062,Jeff Sessions (R),2016,Forestry & Forest Products,12634,29500,42134
B001243,N00003105,Marsha Blackburn (R),2016,Health Professionals,32105,189750,221855
B001243,N00003105,Marsha Blackburn (R),2016,Pharmaceuticals/Health Products,28200,136899,165099
B001243,N00003105,Marsha Blackburn (R),2016,Oil & Gas,14900,71000,85900
B001243,N00003105,Marsha Blackburn (R),2016,Health Services/HMOs,6500,70700,77200
B001243,N00003105,Marsha Blackburn (R),2016,Insurance,8800,67500,76300
B001243,N00003105,Marsha Blackburn (R),2016,Automotive,28600,42500,71100
B001243,N00003105,Marsha Blackburn (R),2016,Retired,67545,0,67545
B001243,N00003105,Marsha Blackburn (R),2016,Hospitals/Nursing Homes,5250,52000,57250
B001243,N00003105,Marsha Blackburn (R),2016,Real Estate,23775,32500,56275
B001243,N00003105,Marsha Blackburn (R),2016,Lawyers/Law Firms,20150,36000,56150
C000754,N00003132,Jim Cooper (D),2016,Lawyers/Law Firms,39300,15500,54800
C000754,N00003132,Jim Cooper (D),2016,Defense Aerospace,0,39500,39500
C000754,N00003132,Jim Cooper (D),2016,Retired,30600,0,30600
C000754,N00003132,Jim Cooper (D),2016,Securities & Investment,13100,15000,28100
C000754,N00003132,Jim Cooper (D),2016,Insurance,2250,22500,24750
C000754,N00003132,Jim Cooper (D),2016,"Beer, Wine & Liquor",6900,16500,23400
C000754,N00003132,Jim Cooper (D),2016,Democratic/Liberal,3125,20000,23125
C000754,N00003132,Jim Cooper (D),2016,Accountants,2000,19000,21000
C000754,N00003132,Jim Cooper (D),2016,Hospitals/Nursing Homes,13980,6500,20480
C000754,N00003132,Jim Cooper (D),2016,Real Estate,15000,4000,19000
D000533,N00003209,John J Duncan Jr (R),2016,Railroads,2250,45500,47750
D000533,N00003209,John J Duncan Jr (R),2016,Lawyers/Law Firms,11450,18000,29450
D000533,N00003209,John J Duncan Jr (R),2016,Misc Transport,0,27631,27631
D000533,N00003209,John J Duncan Jr (R),2016,Building Materials & Equipment,2000,23500,25500
D000533,N00003209,John J Duncan Jr (R),2016,Construction Services,1000,22500,23500
D000533,N00003209,John J Duncan Jr (R),2016,Lobbyists,17500,1500,19000
D000533,N00003209,John J Duncan Jr (R),2016,Air Transport,500,16000,16500
D000533,N00003209,John J Duncan Jr (R),2016,Pharmaceuticals/Health Products,15800,100,15900
D000533,N00003209,John J Duncan Jr (R),2016,Trucking,1500,14000,15500
D000533,N00003209,John J Duncan Jr (R),2016,Transportation Unions,0,13000,13000
C001068,N00003225,Steve Cohen (D),2016,Real Estate,38350,9500,47850
C001068,N00003225,Steve Cohen (D),2016,Transportation Unions,0,45500,45500
C001068,N00003225,Steve Cohen (D),2016,Industrial Unions,0,38500,38500
C001068,N00003225,Steve Cohen (D),2016,Railroads,0,31000,31000
C001068,N00003225,Steve Cohen (D),2016,Lawyers/Law Firms,10170,19750,29920
C001068,N00003225,Steve Cohen (D),2016,Air Transport,3950,25500,29450
C001068,N00003225,Steve Cohen (D),2016,Automotive,3000,23000,26000
C001068,N00003225,Steve Cohen (D),2016,Health Professionals,5750,17500,23250
C001068,N00003225,Steve Cohen (D),2016,Public Sector Unions,0,23000,23000
C001068,N00003225,Steve Cohen (D),2016,Lodging/Tourism,500,20000,20500
W000437,N00003280,Roger Wicker (R),2016,Leadership PACs,0,259500,259500
W000437,N00003280,Roger Wicker (R),2016,Securities & Investment,123675,81571,205246
W000437,N00003280,Roger Wicker (R),2016,Oil & Gas,71816,127000,198816
W000437,N00003280,Roger Wicker (R),2016,Insurance,41500,126750,168250
W000437,N00003280,Roger Wicker (R),2016,Lawyers/Law Firms,79715,86150,165865
W000437,N00003280,Roger Wicker (R),2016,Lobbyists,131628,12000,143628
W000437,N00003280,Roger Wicker (R),2016,Health Professionals,59250,71000,130250
W000437,N00003280,Roger Wicker (R),2016,Telecom Services,28750,96000,124750
W000437,N00003280,Roger Wicker (R),2016,Real Estate,76100,46500,122600
W000437,N00003280,Roger Wicker (R),2016,Sea Transport,17600,60500,78100
T000193,N00003288,Bennie G Thompson (D),2016,Transportation Unions,0,70000,70000
T000193,N00003288,Bennie G Thompson (D),2016,Electric Utilities,0,62000,62000
T000193,N00003288,Bennie G Thompson (D),2016,Lawyers/Law Firms,21400,37000,58400
T000193,N00003288,Bennie G Thompson (D),2016,Industrial Unions,0,54000,54000
T000193,N00003288,Bennie G Thompson (D),2016,Public Sector Unions,0,52000,52000
T000193,N00003288,Bennie G Thompson (D),2016,Railroads,0,37500,37500
T000193,N00003288,Bennie G Thompson (D),2016,Misc Unions,0,36000,36000
T000193,N00003288,Bennie G Thompson (D),2016,Crop Production & Basic Processing,4250,31000,35250
T000193,N00003288,Bennie G Thompson (D),2016,Agricultural Services/Products,0,31000,31000
T000193,N00003288,Bennie G Thompson (D),2016,Building Trade Unions,0,26500,26500
T000193,N00003288,Bennie G Thompson (D),2016,Telecom Services,5000,21500,26500
C000567,N00003328,Thad Cochran (R),2016,Crop Production & Basic Processing,323875,262350,586225
C000567,N00003328,Thad Cochran (R),2016,Leadership PACs,0,496800,496800
C000567,N00003328,Thad Cochran (R),2016,Lawyers/Law Firms,195600,158250,353850
C000567,N00003328,Thad Cochran (R),2016,Oil & Gas,133405,143500,276905
C000567,N00003328,Thad Cochran (R),2016,Lobbyists,254175,7001,261176
C000567,N00003328,Thad Cochran (R),2016,Agricultural Services/Products,26800,226500,253300
C000567,N00003328,Thad Cochran (R),2016,Defense Aerospace,78500,164500,243000
C000567,N00003328,Thad Cochran (R),2016,Retired,201704,0,201704
C000567,N00003328,Thad Cochran (R),2016,Health Professionals,56509,114650,171159
C000567,N00003328,Thad Cochran (R),2016,Insurance,38200,123800,162000
M000355,N00003389,Mitch McConnell (R),2016,Securities & Investment,2146537,265100,2411637
M000355,N00003389,Mitch McConnell (R),2016,Retired,1443585,0,1443585
M000355,N00003389,Mitch McConnell (R),2016,Oil & Gas,790785,395099,1185884
M000355,N00003389,Mitch McConnell (R),2016,Lawyers/Law Firms,754614,293450,1048064
M000355,N00003389,Mitch McConnell (R),2016,Health Professionals,722095,289000,1011095
M000355,N00003389,Mitch McConnell (R),2016,Insurance,637500,369000,1006500
M000355,N00003389,Mitch McConnell (R),2016,Real Estate,888750,88100,976850
M000355,N00003389,Mitch McConnell (R),2016,Lobbyists,686766,28646,715412
M000355,N00003389,Mitch McConnell (R),2016,Misc Finance,604830,53000,657830
M000355,N00003389,Mitch McConnell (R),2016,Pharmaceuticals/Health Products,241900,356673,598573
W000413,N00003467,Ed Whitfield (R),2016,Lobbyists,10250,0,10250
W000413,N00003467,Ed Whitfield (R),2016,Hospitals/Nursing Homes,4700,0,4700
W000413,N00003467,Ed Whitfield (R),2016,Printing & Publishing,1500,0,1500
W000413,N00003467,Ed Whitfield (R),2016,Health Professionals,1400,0,1400
W000413,N00003467,Ed Whitfield (R),2016,Misc Energy,1000,0,1000
W000413,N00003467,Ed Whitfield (R),2016,Crop Production & Basic Processing,750,0,750
W000413,N00003467,Ed Whitfield (R),2016,Telephone Utilities,500,0,500
W000413,N00003467,Ed Whitfield (R),2016,Mining,500,0,500
W000413,N00003467,Ed Whitfield (R),2016,Accountants,500,0,500
W000413,N00003467,Ed Whitfield (R),2016,Oil & Gas,500,0,500
R000395,N00003473,Hal Rogers (R),2016,Air Transport,10000,74500,84500
R000395,N00003473,Hal Rogers (R),2016,Defense Electronics,0,57500,57500
R000395,N00003473,Hal Rogers (R),2016,Defense Aerospace,0,57000,57000
R000395,N00003473,Hal Rogers (R),2016,Health Professionals,9800,46500,56300
R000395,N00003473,Hal Rogers (R),2016,Lawyers/Law Firms,13800,33650,47450
R000395,N00003473,Hal Rogers (R),2016,Electric Utilities,0,46300,46300
R000395,N00003473,Hal Rogers (R),2016,Railroads,6000,39500,45500
R000395,N00003473,Hal Rogers (R),2016,Lobbyists,42850,2500,45350
R000395,N00003473,Hal Rogers (R),2016,Commercial Banks,5000,40000,45000
R000395,N00003473,Hal Rogers (R),2016,Transportation Unions,0,41000,41000
K000009,N00003522,Marcy Kaptur (D),2016,Electric Utilities,0,61500,61500
K000009,N00003522,Marcy Kaptur (D),2016,Industrial Unions,0,60000,60000
K000009,N00003522,Marcy Kaptur (D),2016,Lawyers/Law Firms,25500,22250,47750
K000009,N00003522,Marcy Kaptur (D),2016,Public Sector Unions,101,46500,46601
K000009,N00003522,Marcy Kaptur (D),2016,Transportation Unions,0,44500,44500
K000009,N00003522,Marcy Kaptur (D),2016,Misc Manufacturing & Distributing,9500,26900,36400
K000009,N00003522,Marcy Kaptur (D),2016,Building Trade Unions,0,35200,35200
K000009,N00003522,Marcy Kaptur (D),2016,Defense Aerospace,0,34000,34000
K000009,N00003522,Marcy Kaptur (D),2016,Real Estate,21001,8000,29001
K000009,N00003522,Marcy Kaptur (D),2016,Automotive,500,28499,28999
B000944,N00003535,Sherrod Brown (D),2016,Lawyers/Law Firms,1919513,218623,2138136
B000944,N00003535,Sherrod Brown (D),2016,Retired,1342432,0,1342432
B000944,N00003535,Sherrod Brown (D),2016,Education,678358,1000,679358
B000944,N00003535,Sherrod Brown (D),2016,Real Estate,552106,90000,642106
B000944,N00003535,Sherrod Brown (D),2016,Health Professionals,365472,222300,587772
B000944,N00003535,Sherrod Brown (D),2016,Democratic/Liberal,502243,37565,539808
B000944,N00003535,Sherrod Brown (D),2016,Insurance,211364,308000,519364
B000944,N00003535,Sherrod Brown (D),2016,Lobbyists,437500,21100,458600
B000944,N00003535,Sherrod Brown (D),2016,Securities & Investment,297807,133850,431657
B000944,N00003535,Sherrod Brown (D),2016,Women's Issues,402684,1500,404184
B000589,N00003675,John Boehner (R),2016,Retired,339968,0,339968
B000589,N00003675,John Boehner (R),2016,Securities & Investment,186200,0,186200
B000589,N00003675,John Boehner (R),2016,Real Estate,178650,0,178650
B000589,N00003675,John Boehner (R),2016,Lobbyists,164850,0,164850
B000589,N00003675,John Boehner (R),2016,Insurance,138500,0,138500
B000589,N00003675,John Boehner (R),2016,Lawyers/Law Firms,130450,0,130450
B000589,N00003675,John Boehner (R),2016,Hospitals/Nursing Homes,96600,0,96600
B000589,N00003675,John Boehner (R),2016,Oil & Gas,87650,0,87650
B000589,N00003675,John Boehner (R),2016,Electric Utilities,87600,0,87600
B000589,N00003675,John Boehner (R),2016,Misc Finance,85465,0,85465
P000449,N00003682,Rob Portman (R),2016,Securities & Investment,2321180,227500,2548680
P000449,N00003682,Rob Portman (R),2016,Retired,2530533,0,2530533
P000449,N00003682,Rob Portman (R),2016,Lawyers/Law Firms,1068064,205898,1273962
P000449,N00003682,Rob Portman (R),2016,Real Estate,1064732,105200,1169932
P000449,N00003682,Rob Portman (R),2016,Insurance,591888,463075,1054963
P000449,N00003682,Rob Portman (R),2016,Misc Manufacturing & Distributing,698788,178750,877538
P000449,N00003682,Rob Portman (R),2016,Leadership PACs,15030,685706,700736
P000449,N00003682,Rob Portman (R),2016,Lobbyists,617579,20884,638463
P000449,N00003682,Rob Portman (R),2016,Misc Finance,559542,78000,637542
P000449,N00003682,Rob Portman (R),2016,Oil & Gas,344392,284650,629042
C000266,N00003689,Steve Chabot (R),2016,Insurance,42750,17250,60000
C000266,N00003689,Steve Chabot (R),2016,Retired,48315,0,48315
C000266,N00003689,Steve Chabot (R),2016,Misc Manufacturing & Distributing,35100,13000,48100
C000266,N00003689,Steve Chabot (R),2016,Recreation/Live Entertainment,24650,18500,43150
C000266,N00003689,Steve Chabot (R),2016,Automotive,15550,23500,39050
C000266,N00003689,Steve Chabot (R),2016,Lawyers/Law Firms,23350,15000,38350
C000266,N00003689,Steve Chabot (R),2016,Health Professionals,21950,10500,32450
C000266,N00003689,Steve Chabot (R),2016,Real Estate,20311,8000,28311
C000266,N00003689,Steve Chabot (R),2016,Food Processing & Sales,19900,7000,26900
C000266,N00003689,Steve Chabot (R),2016,Securities & Investment,5900,20500,26400
V000108,N00003813,Pete Visclosky (D),2016,Defense Aerospace,49100,61000,110100
V000108,N00003813,Pete Visclosky (D),2016,Defense Electronics,26800,61000,87800
V000108,N00003813,Pete Visclosky (D),2016,Building Trade Unions,50,64500,64550
V000108,N00003813,Pete Visclosky (D),2016,Electric Utilities,13800,47000,60800
V000108,N00003813,Pete Visclosky (D),2016,Industrial Unions,0,44500,44500
V000108,N00003813,Pete Visclosky (D),2016,Misc Defense,8000,32000,40000
V000108,N00003813,Pete Visclosky (D),2016,Lobbyists,33236,5483,38719
V000108,N00003813,Pete Visclosky (D),2016,Health Professionals,23520,12800,36320
V000108,N00003813,Pete Visclosky (D),2016,Lawyers/Law Firms,10925,23750,34675
V000108,N00003813,Pete Visclosky (D),2016,Misc Manufacturing & Distributing,4500,29500,34000
C000542,N00003845,Dan Coats (R),2016,Lawyers/Law Firms,48800,23350,72150
C000542,N00003845,Dan Coats (R),2016,Leadership PACs,0,65000,65000
C000542,N00003845,Dan Coats (R),2016,Pharmaceuticals/Health Products,11850,43950,55800
C000542,N00003845,Dan Coats (R),2016,Oil & Gas,22000,31750,53750
C000542,N00003845,Dan Coats (R),2016,Insurance,10350,36500,46850
C000542,N00003845,Dan Coats (R),2016,Securities & Investment,41650,3500,45150
C000542,N00003845,Dan Coats (R),2016,Retired,43450,0,43450
C000542,N00003845,Dan Coats (R),2016,Real Estate,29050,8500,37550
C000542,N00003845,Dan Coats (R),2016,Misc Manufacturing & Distributing,9850,24500,34350
C000542,N00003845,Dan Coats (R),2016,Electric Utilities,3750,30000,33750
L000263,N00003950,Sander Levin (D),2016,Insurance,1400,149500,150900
L000263,N00003950,Sander Levin (D),2016,Health Professionals,6550,126500,133050
L000263,N00003950,Sander Levin (D),2016,Public Sector Unions,0,67000,67000
L000263,N00003950,Sander Levin (D),2016,Lawyers/Law Firms,29700,36500,66200
L000263,N00003950,Sander Levin (D),2016,Securities & Investment,8950,44500,53450
L000263,N00003950,Sander Levin (D),2016,Electric Utilities,250,48000,48250
L000263,N00003950,Sander Levin (D),2016,Industrial Unions,0,45500,45500
L000263,N00003950,Sander Levin (D),2016,Transportation Unions,0,45000,45000
L000263,N00003950,Sander Levin (D),2016,Building Trade Unions,0,44500,44500
L000263,N00003950,Sander Levin (D),2016,Real Estate,5250,33000,38250
C000714,N00004029,John Conyers Jr (D),2016,Lawyers/Law Firms,39878,15000,54878
C000714,N00004029,John Conyers Jr (D),2016,TV/Movies/Music,6675,47500,54175
C000714,N00004029,John Conyers Jr (D),2016,Telecom Services,2000,37000,39000
C000714,N00004029,John Conyers Jr (D),2016,Industrial Unions,0,36000,36000
C000714,N00004029,John Conyers Jr (D),2016,Public Sector Unions,0,31500,31500
C000714,N00004029,John Conyers Jr (D),2016,Building Trade Unions,0,30000,30000
C000714,N00004029,John Conyers Jr (D),2016,Health Professionals,1010,19500,20510
C000714,N00004029,John Conyers Jr (D),2016,Retail Sales,33,20000,20033
C000714,N00004029,John Conyers Jr (D),2016,Automotive,1755,14000,15755
C000714,N00004029,John Conyers Jr (D),2016,Misc Unions,0,15500,15500
S000770,N00004118,Debbie Stabenow (D),2016,Lawyers/Law Firms,529434,146606,676040
S000770,N00004118,Debbie Stabenow (D),2016,Securities & Investment,427219,167750,594969
S000770,N00004118,Debbie Stabenow (D),2016,Retired,541365,0,541365
S000770,N00004118,Debbie Stabenow (D),2016,Health Professionals,201786,251710,453496
S000770,N00004118,Debbie Stabenow (D),2016,Crop Production & Basic Processing,133194,243165,376359
S000770,N00004118,Debbie Stabenow (D),2016,Leadership PACs,0,354500,354500
S000770,N00004118,Debbie Stabenow (D),2016,Insurance,137000,215218,352218
S000770,N00004118,Debbie Stabenow (D),2016,Women's Issues,317055,12000,329055
S000770,N00004118,Debbie Stabenow (D),2016,Real Estate,233220,74500,307720
S000770,N00004118,Debbie Stabenow (D),2016,Agricultural Services/Products,42260,264568,306828
U000031,N00004133,Fred Upton (R),2016,Health Professionals,16500,241350,257850
U000031,N00004133,Fred Upton (R),2016,Electric Utilities,31013,208500,239513
U000031,N00004133,Fred Upton (R),2016,Oil & Gas,66750,155500,222250
U000031,N00004133,Fred Upton (R),2016,Pharmaceuticals/Health Products,11450,203250,214700
U000031,N00004133,Fred Upton (R),2016,Retired,132585,0,132585
U000031,N00004133,Fred Upton (R),2016,TV/Movies/Music,53543,63500,117043
U000031,N00004133,Fred Upton (R),2016,Health Services/HMOs,10900,76500,87400
U000031,N00004133,Fred Upton (R),2016,Chemical & Related Manufacturing,3700,77200,80900
U000031,N00004133,Fred Upton (R),2016,Lobbyists,71650,8500,80150
U000031,N00004133,Fred Upton (R),2016,Automotive,14800,57500,72300
S000244,N00004291,F James Sensenbrenner Jr (R),2016,Retired,27525,0,27525
S000244,N00004291,F James Sensenbrenner Jr (R),2016,Lawyers/Law Firms,8500,15750,24250
S000244,N00004291,F James Sensenbrenner Jr (R),2016,Real Estate,14750,7000,21750
S000244,N00004291,F James Sensenbrenner Jr (R),2016,Telecom Services,0,18000,18000
S000244,N00004291,F James Sensenbrenner Jr (R),2016,Insurance,3000,13500,16500
S000244,N00004291,F James Sensenbrenner Jr (R),2016,Telephone Utilities,0,14000,14000
S000244,N00004291,F James Sensenbrenner Jr (R),2016,Oil & Gas,2500,10500,13000
S000244,N00004291,F James Sensenbrenner Jr (R),2016,Misc Finance,12800,0,12800
S000244,N00004291,F James Sensenbrenner Jr (R),2016,Misc Manufacturing & Distributing,7400,5000,12400
S000244,N00004291,F James Sensenbrenner Jr (R),2016,Internet,0,12000,12000
R000570,N00004357,Paul Ryan (R),2016,Retired,4394546,0,4394546
R000570,N00004357,Paul Ryan (R),2016,Securities & Investment,1619472,195500,1814972
R000570,N00004357,Paul Ryan (R),2016,Real Estate,953665,101600,1055265
R000570,N00004357,Paul Ryan (R),2016,Republican/Conservative,722855,5000,727855
R000570,N00004357,Paul Ryan (R),2016,Insurance,411847,296700,708547
R000570,N00004357,Paul Ryan (R),2016,Oil & Gas,494208,187900,682108
R000570,N00004357,Paul Ryan (R),2016,Lawyers/Law Firms,525429,102350,627779
R000570,N00004357,Paul Ryan (R),2016,Health Professionals,273214,220000,493214
R000570,N00004357,Paul Ryan (R),2016,Misc Finance,402700,38000,440700
R000570,N00004357,Paul Ryan (R),2016,Lobbyists,427820,0,427820
B001230,N00004367,Tammy Baldwin (D),2016,Retired,1179590,0,1179590
B001230,N00004367,Tammy Baldwin (D),2016,Women's Issues,882563,36972,919535
B001230,N00004367,Tammy Baldwin (D),2016,Lawyers/Law Firms,699099,45350,744449
B001230,N00004367,Tammy Baldwin (D),2016,Democratic/Liberal,393047,173765,566812
B001230,N00004367,Tammy Baldwin (D),2016,Education,387784,3500,391284
B001230,N00004367,Tammy Baldwin (D),2016,Leadership PACs,8750,348180,356930
B001230,N00004367,Tammy Baldwin (D),2016,Health Professionals,202114,79000,281114
B001230,N00004367,Tammy Baldwin (D),2016,Human Rights,197358,35493,232851
B001230,N00004367,Tammy Baldwin (D),2016,Business Services,210223,4000,214223
B001230,N00004367,Tammy Baldwin (D),2016,TV/Movies/Music,183100,2000,185100
K000188,N00004403,Ron Kind (D),2016,Insurance,17120,237550,254670
K000188,N00004403,Ron Kind (D),2016,Health Professionals,14170,184500,198670
K000188,N00004403,Ron Kind (D),2016,Pharmaceuticals/Health Products,1250,164349,165599
K000188,N00004403,Ron Kind (D),2016,Securities & Investment,12300,103500,115800
K000188,N00004403,Ron Kind (D),2016,Lawyers/Law Firms,22280,57150,79430
K000188,N00004403,Ron Kind (D),2016,Health Services/HMOs,5400,69000,74400
K000188,N00004403,Ron Kind (D),2016,Retail Sales,1065,71000,72065
K000188,N00004403,Ron Kind (D),2016,Misc Manufacturing & Distributing,2500,59500,62000
K000188,N00004403,Ron Kind (D),2016,Real Estate,9785,45000,54785
K000188,N00004403,Ron Kind (D),2016,Lobbyists,44824,7500,52324
K000363,N00004436,John Kline (R),2016,Education,74850,34000,108850
K000363,N00004436,John Kline (R),2016,Securities & Investment,10950,23000,33950
K000363,N00004436,John Kline (R),2016,Insurance,7700,24000,31700
K000363,N00004436,John Kline (R),2016,Casinos/Gambling,25800,0,25800
K000363,N00004436,John Kline (R),2016,Food Processing & Sales,9000,15500,24500
K000363,N00004436,John Kline (R),2016,Lawyers/Law Firms,7750,13000,20750
K000363,N00004436,John Kline (R),2016,Retired,20600,0,20600
K000363,N00004436,John Kline (R),2016,Special Trade Contractors,0,17000,17000
K000363,N00004436,John Kline (R),2016,General Contractors,1250,15500,16750
K000363,N00004436,John Kline (R),2016,Lobbyists,16207,0,16207
P000258,N00004558,Collin Peterson (D),2016,Crop Production & Basic Processing,37825,125000,162825
P000258,N00004558,Collin Peterson (D),2016,Agricultural Services/Products,2000,157800,159800
P000258,N00004558,Collin Peterson (D),2016,Food Processing & Sales,4250,53525,57775
P000258,N00004558,Collin Peterson (D),2016,Dairy,2250,43750,46000
P000258,N00004558,Collin Peterson (D),2016,Lawyers/Law Firms,10550,29143,39693
P000258,N00004558,Collin Peterson (D),2016,Oil & Gas,75,38000,38075
P000258,N00004558,Collin Peterson (D),2016,Accountants,0,36000,36000
P000258,N00004558,Collin Peterson (D),2016,Misc Energy,5250,28100,33350
P000258,N00004558,Collin Peterson (D),2016,Building Trade Unions,0,32500,32500
P000258,N00004558,Collin Peterson (D),2016,Retail Sales,0,28500,28500
T000250,N00004572,John Thune (R),2016,Retired,739596,0,739596
T000250,N00004572,John Thune (R),2016,Securities & Investment,322288,122000,444288
T000250,N00004572,John Thune (R),2016,Insurance,110722,290200,400922
T000250,N00004572,John Thune (R),2016,Lobbyists,370298,9000,379298
T000250,N00004572,John Thune (R),2016,Real Estate,223627,78000,301627
T000250,N00004572,John Thune (R),2016,Leadership PACs,0,287115,287115
T000250,N00004572,John Thune (R),2016,Lawyers/Law Firms,166059,106700,272759
T000250,N00004572,John Thune (R),2016,Air Transport,43690,210000,253690
T000250,N00004572,John Thune (R),2016,Telecom Services,68200,157000,225200
T000250,N00004572,John Thune (R),2016,Health Professionals,75567,141500,217067
C001096,N00004614,Kevin Cramer (R),2016,Oil & Gas,50200,148200,198400
C001096,N00004614,Kevin Cramer (R),2016,Electric Utilities,2700,73600,76300
C001096,N00004614,Kevin Cramer (R),2016,Crop Production & Basic Processing,22900,41500,64400
C001096,N00004614,Kevin Cramer (R),2016,Telecom Services,4500,51000,55500
C001096,N00004614,Kevin Cramer (R),2016,Agricultural Services/Products,2700,48000,50700
C001096,N00004614,Kevin Cramer (R),2016,Health Professionals,2050,43000,45050
C001096,N00004614,Kevin Cramer (R),2016,Telephone Utilities,1000,31000,32000
C001096,N00004614,Kevin Cramer (R),2016,Retired,31275,0,31275
C001096,N00004614,Kevin Cramer (R),2016,Insurance,500,30000,30500
C001096,N00004614,Kevin Cramer (R),2016,Mining,0,30000,30000
R000580,N00004719,Peter Roskam (R),2016,Securities & Investment,148355,136000,284355
R000580,N00004719,Peter Roskam (R),2016,Insurance,33805,232500,266305
R000580,N00004719,Peter Roskam (R),2016,Health Professionals,45985,120678,166663
R000580,N00004719,Peter Roskam (R),2016,Retired,155124,0,155124
R000580,N00004719,Peter Roskam (R),2016,Pharmaceuticals/Health Products,14355,108550,122905
R000580,N00004719,Peter Roskam (R),2016,Real Estate,56800,57500,114300
R000580,N00004719,Peter Roskam (R),2016,Misc Manufacturing & Distributing,52300,43500,95800
R000580,N00004719,Peter Roskam (R),2016,Lawyers/Law Firms,61790,32750,94540
R000580,N00004719,Peter Roskam (R),2016,Accountants,18750,52499,71249
R000580,N00004719,Peter Roskam (R),2016,Misc Finance,37200,33700,70900
S001145,N00004724,Jan Schakowsky (D),2016,Lawyers/Law Firms,149270,25700,174970
S001145,N00004724,Jan Schakowsky (D),2016,Retired,131647,0,131647
S001145,N00004724,Jan Schakowsky (D),2016,Pro-Israel,86014,3500,89514
S001145,N00004724,Jan Schakowsky (D),2016,Health Professionals,4867,73300,78167
S001145,N00004724,Jan Schakowsky (D),2016,Public Sector Unions,0,46500,46500
S001145,N00004724,Jan Schakowsky (D),2016,Industrial Unions,0,46500,46500
S001145,N00004724,Jan Schakowsky (D),2016,Business Services,39093,1000,40093
S001145,N00004724,Jan Schakowsky (D),2016,Misc Unions,0,36250,36250
S001145,N00004724,Jan Schakowsky (D),2016,Education,33939,2000,35939
S001145,N00004724,Jan Schakowsky (D),2016,Civil Servants/Public Officials,30750,0,30750
G000535,N00004874,Luis V Gutierrez (D),2016,Leadership PACs,0,38500,38500
G000535,N00004874,Luis V Gutierrez (D),2016,Accountants,2700,35000,37700
G000535,N00004874,Luis V Gutierrez (D),2016,Misc Unions,0,30000,30000
G000535,N00004874,Luis V Gutierrez (D),2016,Building Trade Unions,0,25000,25000
G000535,N00004874,Luis V Gutierrez (D),2016,Real Estate,12500,8000,20500
G000535,N00004874,Luis V Gutierrez (D),2016,Lawyers/Law Firms,13400,6750,20150
G000535,N00004874,Luis V Gutierrez (D),2016,Human Rights,140,16000,16140
G000535,N00004874,Luis V Gutierrez (D),2016,Transportation Unions,0,16000,16000
G000535,N00004874,Luis V Gutierrez (D),2016,Business Services,15400,0,15400
G000535,N00004874,Luis V Gutierrez (D),2016,Industrial Unions,0,15000,15000
G000535,N00004874,Luis V Gutierrez (D),2016,Telephone Utilities,0,15000,15000
D000096,N00004884,Danny K Davis (D),2016,Public Sector Unions,0,45500,45500
D000096,N00004884,Danny K Davis (D),2016,Pharmaceuticals/Health Products,826,40000,40826
D000096,N00004884,Danny K Davis (D),2016,Insurance,0,39500,39500
D000096,N00004884,Danny K Davis (D),2016,Industrial Unions,0,36000,36000
D000096,N00004884,Danny K Davis (D),2016,"Beer, Wine & Liquor",0,34000,34000
D000096,N00004884,Danny K Davis (D),2016,Building Trade Unions,0,24500,24500
D000096,N00004884,Danny K Davis (D),2016,Health Professionals,500,22500,23000
D000096,N00004884,Danny K Davis (D),2016,Lawyers/Law Firms,6950,15250,22200
D000096,N00004884,Danny K Davis (D),2016,Securities & Investment,0,21000,21000
D000096,N00004884,Danny K Davis (D),2016,Electric Utilities,0,20500,20500
R000515,N00004887,Bobby L Rush (D),2016,Electric Utilities,5400,44500,49900
R000515,N00004887,Bobby L Rush (D),2016,Telecom Services,500,45500,46000
R000515,N00004887,Bobby L Rush (D),2016,Securities & Investment,37800,5000,42800
R000515,N00004887,Bobby L Rush (D),2016,Health Professionals,0,41500,41500
R000515,N00004887,Bobby L Rush (D),2016,Industrial Unions,0,40000,40000
R000515,N00004887,Bobby L Rush (D),2016,Building Trade Unions,0,34500,34500
R000515,N00004887,Bobby L Rush (D),2016,Public Sector Unions,0,30500,30500
R000515,N00004887,Bobby L Rush (D),2016,Lawyers/Law Firms,12100,10000,22100
R000515,N00004887,Bobby L Rush (D),2016,Leadership PACs,0,21500,21500
R000515,N00004887,Bobby L Rush (D),2016,Telephone Utilities,0,20500,20500
S000364,N00004961,John M Shimkus (R),2016,Pharmaceuticals/Health Products,4000,291649,295649
S000364,N00004961,John M Shimkus (R),2016,Health Professionals,24885,233000,257885
S000364,N00004961,John M Shimkus (R),2016,Electric Utilities,31900,214500,246400
S000364,N00004961,John M Shimkus (R),2016,Oil & Gas,7617,172833,180450
S000364,N00004961,John M Shimkus (R),2016,Lobbyists,143235,7000,150235
S000364,N00004961,John M Shimkus (R),2016,Lawyers/Law Firms,37549,79280,116829
S000364,N00004961,John M Shimkus (R),2016,Insurance,7850,97500,105350
S000364,N00004961,John M Shimkus (R),2016,Telecom Services,5400,88000,93400
S000364,N00004961,John M Shimkus (R),2016,Chemical & Related Manufacturing,3000,89900,92900
S000364,N00004961,John M Shimkus (R),2016,Misc Energy,10483,68250,78733
D000563,N00004981,Dick Durbin (D),2016,Lawyers/Law Firms,1279981,110670,1390651
D000563,N00004981,Dick Durbin (D),2016,Retired,389909,0,389909
D000563,N00004981,Dick Durbin (D),2016,Securities & Investment,319675,48240,367915
D000563,N00004981,Dick Durbin (D),2016,Real Estate,269447,40500,309947
D000563,N00004981,Dick Durbin (D),2016,Defense Aerospace,223228,61499,284727
D000563,N00004981,Dick Durbin (D),2016,Health Professionals,106609,149200,255809
D000563,N00004981,Dick Durbin (D),2016,Lobbyists,231002,14500,245502
D000563,N00004981,Dick Durbin (D),2016,Insurance,94201,121000,215201
D000563,N00004981,Dick Durbin (D),2016,Pro-Israel,183040,24650,207690
D000563,N00004981,Dick Durbin (D),2016,Leadership PACs,0,178600,178600
B000575,N00005195,Roy Blunt (R),2016,Securities & Investment,716557,154200,870757
B000575,N00005195,Roy Blunt (R),2016,Retired,815283,0,815283
B000575,N00005195,Roy Blunt (R),2016,Real Estate,612532,91000,703532
B000575,N00005195,Roy Blunt (R),2016,Leadership PACs,16200,643865,660065
B000575,N00005195,Roy Blunt (R),2016,Lawyers/Law Firms,423333,211738,635071
B000575,N00005195,Roy Blunt (R),2016,Lobbyists,531770,7550,539320
B000575,N00005195,Roy Blunt (R),2016,Health Professionals,230500,231000,461500
B000575,N00005195,Roy Blunt (R),2016,Insurance,147257,288100,435357
B000575,N00005195,Roy Blunt (R),2016,Misc Manufacturing & Distributing,279975,102000,381975
B000575,N00005195,Roy Blunt (R),2016,Pharmaceuticals/Health Products,121584,256050,377634
M000934,N00005282,Jerry Moran (R),2016,Leadership PACs,0,368200,368200
M000934,N00005282,Jerry Moran (R),2016,Securities & Investment,126275,148100,274375
M000934,N00005282,Jerry Moran (R),2016,Crop Production & Basic Processing,113605,157352,270957
M000934,N00005282,Jerry Moran (R),2016,Commercial Banks,88449,120000,208449
M000934,N00005282,Jerry Moran (R),2016,Agricultural Services/Products,53100,149500,202600
M000934,N00005282,Jerry Moran (R),2016,Oil & Gas,99052,99000,198052
M000934,N00005282,Jerry Moran (R),2016,Lawyers/Law Firms,99379,87750,187129
M000934,N00005282,Jerry Moran (R),2016,Health Professionals,49687,123500,173187
M000934,N00005282,Jerry Moran (R),2016,Retired,171845,0,171845
M000934,N00005282,Jerry Moran (R),2016,Insurance,36803,132200,169003
R000307,N00005285,Pat Roberts (R),2016,Leadership PACs,15600,471476,487076
R000307,N00005285,Pat Roberts (R),2016,Securities & Investment,237125,172750,409875
R000307,N00005285,Pat Roberts (R),2016,Oil & Gas,184500,204450,388950
R000307,N00005285,Pat Roberts (R),2016,Agricultural Services/Products,34300,287114,321414
R000307,N00005285,Pat Roberts (R),2016,Pharmaceuticals/Health Products,63900,244999,308899
R000307,N00005285,Pat Roberts (R),2016,Health Professionals,65968,229250,295218
R000307,N00005285,Pat Roberts (R),2016,Insurance,70500,211950,282450
R000307,N00005285,Pat Roberts (R),2016,Lawyers/Law Firms,133160,142162,275322
R000307,N00005285,Pat Roberts (R),2016,Retired,266536,0,266536
R000307,N00005285,Pat Roberts (R),2016,Lobbyists,251081,5250,256331
A000373,N00005293,Brad Ashford (D),2016,Leadership PACs,2700,245051,247751
A000373,N00005293,Brad Ashford (D),2016,Lawyers/Law Firms,111470,20750,132220
A000373,N00005293,Brad Ashford (D),2016,Retired,119748,0,119748
A000373,N00005293,Brad Ashford (D),2016,Securities & Investment,67150,30500,97650
A000373,N00005293,Brad Ashford (D),2016,Insurance,18500,77500,96000
A000373,N00005293,Brad Ashford (D),2016,Real Estate,69950,25000,94950
A000373,N00005293,Brad Ashford (D),2016,Health Professionals,39300,51500,90800
A000373,N00005293,Brad Ashford (D),2016,Democratic/Liberal,48145,22552,70697
A000373,N00005293,Brad Ashford (D),2016,Candidate Committees,0,64285,64285
A000373,N00005293,Brad Ashford (D),2016,Agricultural Services/Products,1075,55750,56825
L000491,N00005559,Frank D Lucas (R),2016,Agricultural Services/Products,1000,110400,111400
L000491,N00005559,Frank D Lucas (R),2016,Commercial Banks,32150,64000,96150
L000491,N00005559,Frank D Lucas (R),2016,Securities & Investment,250,89500,89750
L000491,N00005559,Frank D Lucas (R),2016,Crop Production & Basic Processing,20200,65500,85700
L000491,N00005559,Frank D Lucas (R),2016,Insurance,4843,73500,78343
L000491,N00005559,Frank D Lucas (R),2016,Misc Issues,67500,0,67500
L000491,N00005559,Frank D Lucas (R),2016,Oil & Gas,6050,53500,59550
L000491,N00005559,Frank D Lucas (R),2016,Real Estate,17750,40000,57750
L000491,N00005559,Frank D Lucas (R),2016,Accountants,1000,33499,34499
L000491,N00005559,Frank D Lucas (R),2016,Lobbyists,25902,0,25902
I000024,N00005582,James M Inhofe (R),2016,Oil & Gas,210100,268650,478750
I000024,N00005582,James M Inhofe (R),2016,Retired,250475,0,250475
I000024,N00005582,James M Inhofe (R),2016,Leadership PACs,3000,215024,218024
I000024,N00005582,James M Inhofe (R),2016,Lobbyists,128681,9500,138181
I000024,N00005582,James M Inhofe (R),2016,Electric Utilities,5250,127100,132350
I000024,N00005582,James M Inhofe (R),2016,Lawyers/Law Firms,70625,60075,130700
I000024,N00005582,James M Inhofe (R),2016,Defense Aerospace,14000,112000,126000
I000024,N00005582,James M Inhofe (R),2016,Mining,48775,62500,111275
I000024,N00005582,James M Inhofe (R),2016,Real Estate,78435,27500,105935
I000024,N00005582,James M Inhofe (R),2016,Building Materials & Equipment,31400,73250,104650
B000213,N00005656,Joe Barton (R),2016,Oil & Gas,78600,130650,209250
B000213,N00005656,Joe Barton (R),2016,Electric Utilities,8900,86500,95400
B000213,N00005656,Joe Barton (R),2016,Health Professionals,9280,47250,56530
B000213,N00005656,Joe Barton (R),2016,Misc Manufacturing & Distributing,42600,13000,55600
B000213,N00005656,Joe Barton (R),2016,Pharmaceuticals/Health Products,0,40000,40000
B000213,N00005656,Joe Barton (R),2016,Misc Finance,37950,0,37950
B000213,N00005656,Joe Barton (R),2016,Automotive,6600,29000,35600
B000213,N00005656,Joe Barton (R),2016,Retired,33940,0,33940
B000213,N00005656,Joe Barton (R),2016,Telecom Services,0,33500,33500
B000213,N00005656,Joe Barton (R),2016,Lobbyists,31450,2000,33450
S000250,N00005681,Pete Sessions (R),2016,Health Professionals,76850,124250,201100
S000250,N00005681,Pete Sessions (R),2016,Real Estate,103893,45000,148893
S000250,N00005681,Pete Sessions (R),2016,Oil & Gas,59250,68500,127750
S000250,N00005681,Pete Sessions (R),2016,Commercial Banks,21000,106500,127500
S000250,N00005681,Pete Sessions (R),2016,Lawyers/Law Firms,86775,30250,117025
S000250,N00005681,Pete Sessions (R),2016,Securities & Investment,76100,39500,115600
S000250,N00005681,Pete Sessions (R),2016,Misc Finance,56350,20200,76550
S000250,N00005681,Pete Sessions (R),2016,Insurance,6850,63500,70350
S000250,N00005681,Pete Sessions (R),2016,Misc Issues,56000,2152,58152
S000250,N00005681,Pete Sessions (R),2016,Accountants,3250,50000,53250
B001291,N00005736,Brian Babin (R),2016,Health Professionals,115790,84500,200290
B001291,N00005736,Brian Babin (R),2016,Air Transport,8200,52750,60950
B001291,N00005736,Brian Babin (R),2016,Retired,52747,0,52747
B001291,N00005736,Brian Babin (R),2016,Oil & Gas,11700,40700,52400
B001291,N00005736,Brian Babin (R),2016,Construction Services,19357,18000,37357
B001291,N00005736,Brian Babin (R),2016,Railroads,500,34999,35499
B001291,N00005736,Brian Babin (R),2016,Real Estate,22375,11500,33875
B001291,N00005736,Brian Babin (R),2016,Chemical & Related Manufacturing,500,32700,33200
B001291,N00005736,Brian Babin (R),2016,Lawyers/Law Firms,20950,10750,31700
B001291,N00005736,Brian Babin (R),2016,Automotive,7300,23000,30300
J000032,N00005818,Sheila Jackson Lee (D),2016,Health Professionals,39150,1000,40150
J000032,N00005818,Sheila Jackson Lee (D),2016,Industrial Unions,0,30500,30500
J000032,N00005818,Sheila Jackson Lee (D),2016,Hospitals/Nursing Homes,12850,15000,27850
J000032,N00005818,Sheila Jackson Lee (D),2016,Building Trade Unions,0,26500,26500
J000032,N00005818,Sheila Jackson Lee (D),2016,Public Sector Unions,0,26000,26000
J000032,N00005818,Sheila Jackson Lee (D),2016,Transportation Unions,0,24500,24500
J000032,N00005818,Sheila Jackson Lee (D),2016,Lawyers/Law Firms,10650,13250,23900
J000032,N00005818,Sheila Jackson Lee (D),2016,Misc Unions,0,20000,20000
J000032,N00005818,Sheila Jackson Lee (D),2016,Real Estate,8200,9000,17200
J000032,N00005818,Sheila Jackson Lee (D),2016,Retired,16800,0,16800
G000410,N00005870,Gene Green (D),2016,Health Professionals,27100,161000,188100
G000410,N00005870,Gene Green (D),2016,Pharmaceuticals/Health Products,6925,136650,143575
G000410,N00005870,Gene Green (D),2016,Lawyers/Law Firms,70850,39999,110849
G000410,N00005870,Gene Green (D),2016,Oil & Gas,5200,98500,103700
G000410,N00005870,Gene Green (D),2016,Chemical & Related Manufacturing,0,69000,69000
G000410,N00005870,Gene Green (D),2016,Electric Utilities,0,65750,65750
G000410,N00005870,Gene Green (D),2016,Health Services/HMOs,3200,54000,57200
G000410,N00005870,Gene Green (D),2016,Industrial Unions,0,53500,53500
G000410,N00005870,Gene Green (D),2016,Transportation Unions,0,53000,53000
G000410,N00005870,Gene Green (D),2016,Hospitals/Nursing Homes,16800,32152,48952
B000755,N00005883,Kevin Brady (R),2016,Oil & Gas,164150,246600,410750
B000755,N00005883,Kevin Brady (R),2016,Health Professionals,93650,255750,349400
B000755,N00005883,Kevin Brady (R),2016,Insurance,51800,254650,306450
B000755,N00005883,Kevin Brady (R),2016,Pharmaceuticals/Health Products,11700,245850,257550
B000755,N00005883,Kevin Brady (R),2016,Securities & Investment,124300,122000,246300
B000755,N00005883,Kevin Brady (R),2016,Lawyers/Law Firms,84843,125000,209843
B000755,N00005883,Kevin Brady (R),2016,Real Estate,110300,86000,196300
B000755,N00005883,Kevin Brady (R),2016,Hospitals/Nursing Homes,80700,112500,193200
B000755,N00005883,Kevin Brady (R),2016,Lobbyists,156416,3000,159416
B000755,N00005883,Kevin Brady (R),2016,Health Services/HMOs,47300,110000,157300
H000636,N00006008,Ruben Hinojosa (D),2016,Health Professionals,76200,1000,77200
H000636,N00006008,Ruben Hinojosa (D),2016,Lawyers/Law Firms,2600,6000,8600
H000636,N00006008,Ruben Hinojosa (D),2016,Insurance,0,6500,6500
H000636,N00006008,Ruben Hinojosa (D),2016,General Contractors,5200,0,5200
H000636,N00006008,Ruben Hinojosa (D),2016,Building Trade Unions,0,5000,5000
H000636,N00006008,Ruben Hinojosa (D),2016,Misc Manufacturing & Distributing,0,5000,5000
H000636,N00006008,Ruben Hinojosa (D),2016,Hospitals/Nursing Homes,0,5000,5000
H000636,N00006008,Ruben Hinojosa (D),2016,Electronics Mfg & Equip,2700,1000,3700
H000636,N00006008,Ruben Hinojosa (D),2016,Real Estate,2600,1000,3600
H000636,N00006008,Ruben Hinojosa (D),2016,Securities & Investment,2600,0,2600
H000636,N00006008,Ruben Hinojosa (D),2016,Retail Sales,2600,0,2600
D000399,N00006023,Lloyd Doggett (D),2016,Lawyers/Law Firms,125381,21500,146881
D000399,N00006023,Lloyd Doggett (D),2016,Retired,112635,0,112635
D000399,N00006023,Lloyd Doggett (D),2016,Building Trade Unions,0,59000,59000
D000399,N00006023,Lloyd Doggett (D),2016,Health Professionals,10050,38500,48550
D000399,N00006023,Lloyd Doggett (D),2016,Industrial Unions,0,43000,43000
D000399,N00006023,Lloyd Doggett (D),2016,Real Estate,13300,23000,36300
D000399,N00006023,Lloyd Doggett (D),2016,Securities & Investment,32300,0,32300
D000399,N00006023,Lloyd Doggett (D),2016,Transportation Unions,0,32000,32000
D000399,N00006023,Lloyd Doggett (D),2016,Public Sector Unions,0,26000,26000
D000399,N00006023,Lloyd Doggett (D),2016,Misc Finance,16750,1000,17750
T000238,N00006052,Mac Thornberry (R),2016,Defense Aerospace,57450,120000,177450
T000238,N00006052,Mac Thornberry (R),2016,Misc Defense,35400,93500,128900
T000238,N00006052,Mac Thornberry (R),2016,Retired,85082,0,85082
T000238,N00006052,Mac Thornberry (R),2016,Defense Electronics,0,85000,85000
T000238,N00006052,Mac Thornberry (R),2016,Oil & Gas,59150,10000,69150
T000238,N00006052,Mac Thornberry (R),2016,Livestock,51125,17600,68725
T000238,N00006052,Mac Thornberry (R),2016,Real Estate,46450,21000,67450
T000238,N00006052,Mac Thornberry (R),2016,Lawyers/Law Firms,25675,39500,65175
T000238,N00006052,Mac Thornberry (R),2016,Lobbyists,45150,1415,46565
T000238,N00006052,Mac Thornberry (R),2016,Crop Production & Basic Processing,13100,30500,43600
D000197,N00006134,Diana DeGette (D),2016,Pharmaceuticals/Health Products,0,142968,142968
D000197,N00006134,Diana DeGette (D),2016,Democratic/Liberal,136825,0,136825
D000197,N00006134,Diana DeGette (D),2016,Health Professionals,7251,120594,127845
D000197,N00006134,Diana DeGette (D),2016,Lawyers/Law Firms,48425,35875,84300
D000197,N00006134,Diana DeGette (D),2016,Retired,65299,0,65299
D000197,N00006134,Diana DeGette (D),2016,Telecom Services,7900,43900,51800
D000197,N00006134,Diana DeGette (D),2016,Real Estate,37850,10500,48350
D000197,N00006134,Diana DeGette (D),2016,Misc Finance,35400,1000,36400
D000197,N00006134,Diana DeGette (D),2016,Industrial Unions,0,32100,32100
D000197,N00006134,Diana DeGette (D),2016,TV/Movies/Music,10650,18900,29550
B001261,N00006236,John A Barrasso (R),2016,Health Professionals,347293,215350,562643
B001261,N00006236,John A Barrasso (R),2016,Oil & Gas,207566,250900,458466
B001261,N00006236,John A Barrasso (R),2016,Securities & Investment,209000,91571,300571
B001261,N00006236,John A Barrasso (R),2016,Leadership PACs,0,272740,272740
B001261,N00006236,John A Barrasso (R),2016,Lobbyists,246706,7000,253706
B001261,N00006236,John A Barrasso (R),2016,Pharmaceuticals/Health Products,64500,187000,251500
B001261,N00006236,John A Barrasso (R),2016,Mining,161206,80500,241706
B001261,N00006236,John A Barrasso (R),2016,Electric Utilities,19200,210750,229950
B001261,N00006236,John A Barrasso (R),2016,Insurance,41000,135875,176875
B001261,N00006236,John A Barrasso (R),2016,Retired,118799,0,118799
E000285,N00006249,Mike Enzi (R),2016,Leadership PACs,0,300572,300572
E000285,N00006249,Mike Enzi (R),2016,Pharmaceuticals/Health Products,22950,227500,250450
E000285,N00006249,Mike Enzi (R),2016,Oil & Gas,54250,156833,211083
E000285,N00006249,Mike Enzi (R),2016,Health Professionals,29950,180000,209950
E000285,N00006249,Mike Enzi (R),2016,Securities & Investment,90700,102494,193194
E000285,N00006249,Mike Enzi (R),2016,Insurance,28500,146000,174500
E000285,N00006249,Mike Enzi (R),2016,Retail Sales,3850,102000,105850
E000285,N00006249,Mike Enzi (R),2016,Real Estate,34550,58000,92550
E000285,N00006249,Mike Enzi (R),2016,Lobbyists,89892,500,90392
E000285,N00006249,Mike Enzi (R),2016,Health Services/HMOs,31200,52000,83200
S001148,N00006263,Mike Simpson (R),2016,Electric Utilities,7825,111700,119525
S001148,N00006263,Mike Simpson (R),2016,Health Professionals,2925,68000,70925
S001148,N00006263,Mike Simpson (R),2016,Crop Production & Basic Processing,15550,36000,51550
S001148,N00006263,Mike Simpson (R),2016,Construction Services,3625,41250,44875
S001148,N00006263,Mike Simpson (R),2016,Oil & Gas,22100,19200,41300
S001148,N00006263,Mike Simpson (R),2016,General Contractors,1500,37000,38500
S001148,N00006263,Mike Simpson (R),2016,Lobbyists,33800,0,33800
S001148,N00006263,Mike Simpson (R),2016,Dairy,14750,18350,33100
S001148,N00006263,Mike Simpson (R),2016,Defense Aerospace,1625,27000,28625
S001148,N00006263,Mike Simpson (R),2016,Real Estate,2310,24500,26810
C000880,N00006267,Mike Crapo (R),2016,Securities & Investment,538850,332350,871200
C000880,N00006267,Mike Crapo (R),2016,Insurance,81250,405200,486450
C000880,N00006267,Mike Crapo (R),2016,Leadership PACs,0,434600,434600
C000880,N00006267,Mike Crapo (R),2016,Commercial Banks,116450,215800,332250
C000880,N00006267,Mike Crapo (R),2016,Real Estate,138150,124420,262570
C000880,N00006267,Mike Crapo (R),2016,Health Services/HMOs,114500,102250,216750
C000880,N00006267,Mike Crapo (R),2016,Lobbyists,197052,13000,210052
C000880,N00006267,Mike Crapo (R),2016,Finance/Credit Companies,62700,140000,202700
C000880,N00006267,Mike Crapo (R),2016,Lawyers/Law Firms,120104,77600,197704
C000880,N00006267,Mike Crapo (R),2016,Misc Finance,119202,73500,192702
F000448,N00006423,Trent Franks (R),2016,Telecom Services,10800,21500,32300
F000448,N00006423,Trent Franks (R),2016,Defense Electronics,0,26500,26500
F000448,N00006423,Trent Franks (R),2016,Defense Aerospace,0,22500,22500
F000448,N00006423,Trent Franks (R),2016,Leadership PACs,0,20000,20000
F000448,N00006423,Trent Franks (R),2016,Lawyers/Law Firms,11500,5750,17250
F000448,N00006423,Trent Franks (R),2016,Republican/Conservative,2435,11553,13988
F000448,N00006423,Trent Franks (R),2016,Retired,13650,0,13650
F000448,N00006423,Trent Franks (R),2016,Electric Utilities,250,13000,13250
F000448,N00006423,Trent Franks (R),2016,Business Services,13200,0,13200
F000448,N00006423,Trent Franks (R),2016,Construction Services,8000,5000,13000
M000303,N00006424,John McCain (R),2016,Retired,1150564,0,1150564
M000303,N00006424,John McCain (R),2016,Securities & Investment,930350,10000,940350
M000303,N00006424,John McCain (R),2016,Real Estate,635104,62100,697204
M000303,N00006424,John McCain (R),2016,Lawyers/Law Firms,426494,105051,531545
M000303,N00006424,John McCain (R),2016,Leadership PACs,0,455500,455500
M000303,N00006424,John McCain (R),2016,Business Services,275598,16500,292098
M000303,N00006424,John McCain (R),2016,Pro-Israel,207634,55700,263334
M000303,N00006424,John McCain (R),2016,Misc Finance,235885,5500,241385
M000303,N00006424,John McCain (R),2016,Lobbyists,238106,1000,239106
M000303,N00006424,John McCain (R),2016,Insurance,94145,125500,219645
S000018,N00006446,Matt Salmon (R),2016,Misc Manufacturing & Distributing,13550,8000,21550
S000018,N00006446,Matt Salmon (R),2016,Retired,20431,0,20431
S000018,N00006446,Matt Salmon (R),2016,Electronics Mfg & Equip,1000,17210,18210
S000018,N00006446,Matt Salmon (R),2016,Education,8000,9750,17750
S000018,N00006446,Matt Salmon (R),2016,Oil & Gas,8100,8500,16600
S000018,N00006446,Matt Salmon (R),2016,Republican/Conservative,12170,3858,16028
S000018,N00006446,Matt Salmon (R),2016,Insurance,1500,13500,15000
S000018,N00006446,Matt Salmon (R),2016,Lawyers/Law Firms,10651,2000,12651
S000018,N00006446,Matt Salmon (R),2016,Securities & Investment,10800,1000,11800
S000018,N00006446,Matt Salmon (R),2016,Pharmaceuticals/Health Products,1500,8000,9500
S000018,N00006446,Matt Salmon (R),2016,Leadership PACs,0,9500,9500
S001183,N00006460,David Schweikert (R),2016,Real Estate,27650,28000,55650
S001183,N00006460,David Schweikert (R),2016,Retired,46135,0,46135
S001183,N00006460,David Schweikert (R),2016,Insurance,4600,41500,46100
S001183,N00006460,David Schweikert (R),2016,Securities & Investment,7200,31000,38200
S001183,N00006460,David Schweikert (R),2016,Finance/Credit Companies,10100,17500,27600
S001183,N00006460,David Schweikert (R),2016,Commercial Banks,0,24500,24500
S001183,N00006460,David Schweikert (R),2016,Pharmaceuticals/Health Products,0,22250,22250
S001183,N00006460,David Schweikert (R),2016,Lawyers/Law Firms,9550,11250,20800
S001183,N00006460,David Schweikert (R),2016,Accountants,0,17000,17000
S001183,N00006460,David Schweikert (R),2016,Casinos/Gambling,15800,0,15800
U000039,N00006561,Tom Udall (D),2016,Lawyers/Law Firms,586912,89647,676559
U000039,N00006561,Tom Udall (D),2016,Retired,518149,0,518149
U000039,N00006561,Tom Udall (D),2016,Leadership PACs,0,299100,299100
U000039,N00006561,Tom Udall (D),2016,Securities & Investment,240242,35100,275342
U000039,N00006561,Tom Udall (D),2016,Real Estate,185597,22000,207597
U000039,N00006561,Tom Udall (D),2016,Oil & Gas,108063,92000,200063
U000039,N00006561,Tom Udall (D),2016,Lobbyists,183051,9300,192351
U000039,N00006561,Tom Udall (D),2016,Health Professionals,124654,61500,186154
U000039,N00006561,Tom Udall (D),2016,Education,176072,10000,186072
U000039,N00006561,Tom Udall (D),2016,Environment,151353,20543,171896
R000486,N00006671,Lucille Roybal-Allard (D),2016,Real Estate,37410,6000,43410
R000486,N00006671,Lucille Roybal-Allard (D),2016,Public Sector Unions,0,43000,43000
R000486,N00006671,Lucille Roybal-Allard (D),2016,Building Trade Unions,0,32000,32000
R000486,N00006671,Lucille Roybal-Allard (D),2016,Transportation Unions,0,30800,30800
R000486,N00006671,Lucille Roybal-Allard (D),2016,Health Professionals,2000,28000,30000
R000486,N00006671,Lucille Roybal-Allard (D),2016,Lobbyists,27386,0,27386
R000486,N00006671,Lucille Roybal-Allard (D),2016,Hospitals/Nursing Homes,15350,12000,27350
R000486,N00006671,Lucille Roybal-Allard (D),2016,Lawyers/Law Firms,15250,10500,25750
R000486,N00006671,Lucille Roybal-Allard (D),2016,Industrial Unions,0,20000,20000
R000486,N00006671,Lucille Roybal-Allard (D),2016,Construction Services,5750,12500,18250
W000187,N00006690,Maxine Waters (D),2016,Insurance,250,106000,106250
W000187,N00006690,Maxine Waters (D),2016,Real Estate,2001,63500,65501
W000187,N00006690,Maxine Waters (D),2016,Accountants,0,41000,41000
W000187,N00006690,Maxine Waters (D),2016,Democratic/Liberal,36836,250,37086
W000187,N00006690,Maxine Waters (D),2016,Securities & Investment,3000,30500,33500
W000187,N00006690,Maxine Waters (D),2016,Public Sector Unions,0,30500,30500
W000187,N00006690,Maxine Waters (D),2016,Lawyers/Law Firms,11600,14000,25600
W000187,N00006690,Maxine Waters (D),2016,Misc Unions,0,23000,23000
W000187,N00006690,Maxine Waters (D),2016,Industrial Unions,0,20000,20000
W000187,N00006690,Maxine Waters (D),2016,Credit Unions,0,19500,19500
B000711,N00006692,Barbara Boxer (D),2016,TV/Movies/Music,47050,1000,48050
B000711,N00006692,Barbara Boxer (D),2016,Lawyers/Law Firms,37550,2500,40050
B000711,N00006692,Barbara Boxer (D),2016,Retired,23825,0,23825
B000711,N00006692,Barbara Boxer (D),2016,Railroads,0,21000,21000
B000711,N00006692,Barbara Boxer (D),2016,Business Services,20575,0,20575
B000711,N00006692,Barbara Boxer (D),2016,Real Estate,14350,1010,15360
B000711,N00006692,Barbara Boxer (D),2016,Building Materials & Equipment,0,13500,13500
B000711,N00006692,Barbara Boxer (D),2016,Printing & Publishing,10500,0,10500
B000711,N00006692,Barbara Boxer (D),2016,Building Trade Unions,0,10000,10000
B000711,N00006692,Barbara Boxer (D),2016,Electronics Mfg & Equip,7050,2000,9050
T000472,N00006701,Mark A Takano (D),2016,Retired,88566,0,88566
T000472,N00006701,Mark A Takano (D),2016,Lawyers/Law Firms,67725,7750,75475
T000472,N00006701,Mark A Takano (D),2016,Health Professionals,35013,30500,65513
T000472,N00006701,Mark A Takano (D),2016,Public Sector Unions,0,49500,49500
T000472,N00006701,Mark A Takano (D),2016,Industrial Unions,425,46500,46925
T000472,N00006701,Mark A Takano (D),2016,Building Trade Unions,0,39500,39500
T000472,N00006701,Mark A Takano (D),2016,Education,38369,0,38369
T000472,N00006701,Mark A Takano (D),2016,Pro-Israel,31655,2500,34155
T000472,N00006701,Mark A Takano (D),2016,Human Rights,28645,5000,33645
T000472,N00006701,Mark A Takano (D),2016,Real Estate,22505,6000,28505
N000179,N00006789,Grace Napolitano (D),2016,Leadership PACs,0,67000,67000
N000179,N00006789,Grace Napolitano (D),2016,Transportation Unions,0,65500,65500
N000179,N00006789,Grace Napolitano (D),2016,Public Sector Unions,0,53500,53500
N000179,N00006789,Grace Napolitano (D),2016,Industrial Unions,0,40000,40000
N000179,N00006789,Grace Napolitano (D),2016,Candidate Committees,0,39500,39500
N000179,N00006789,Grace Napolitano (D),2016,Air Transport,0,36000,36000
N000179,N00006789,Grace Napolitano (D),2016,Real Estate,17950,9000,26950
N000179,N00006789,Grace Napolitano (D),2016,Lobbyists,22800,2500,25300
N000179,N00006789,Grace Napolitano (D),2016,Lawyers/Law Firms,7000,16750,23750
N000179,N00006789,Grace Napolitano (D),2016,Human Rights,3501,16000,19501
H001063,N00006806,Janice Hahn (D),2016,Candidate Committees,0,1000,1000
M001177,N00006863,Tom McClintock (R),2016,Retired,164259,0,164259
M001177,N00006863,Tom McClintock (R),2016,Real Estate,38250,2750,41000
M001177,N00006863,Tom McClintock (R),2016,Republican/Conservative,36721,844,37565
M001177,N00006863,Tom McClintock (R),2016,Securities & Investment,25645,0,25645
M001177,N00006863,Tom McClintock (R),2016,Gun Rights,17650,2000,19650
M001177,N00006863,Tom McClintock (R),2016,Casinos/Gambling,19100,0,19100
M001177,N00006863,Tom McClintock (R),2016,Food & Beverage,11075,7000,18075
M001177,N00006863,Tom McClintock (R),2016,Oil & Gas,3500,14500,18000
M001177,N00006863,Tom McClintock (R),2016,Forestry & Forest Products,5000,13000,18000
M001177,N00006863,Tom McClintock (R),2016,Lawyers/Law Firms,13675,3500,17175
S000344,N00006897,Brad Sherman (D),2016,Real Estate,80050,52750,132800
S000344,N00006897,Brad Sherman (D),2016,Securities & Investment,58025,65500,123525
S000344,N00006897,Brad Sherman (D),2016,Pro-Israel,73580,20200,93780
S000344,N00006897,Brad Sherman (D),2016,Lawyers/Law Firms,63910,21088,84998
S000344,N00006897,Brad Sherman (D),2016,Insurance,3050,67800,70850
S000344,N00006897,Brad Sherman (D),2016,Retired,64925,0,64925
S000344,N00006897,Brad Sherman (D),2016,Health Professionals,51225,12000,63225
S000344,N00006897,Brad Sherman (D),2016,Accountants,12830,50000,62830
S000344,N00006897,Brad Sherman (D),2016,Building Trade Unions,0,57500,57500
S000344,N00006897,Brad Sherman (D),2016,Misc Finance,38100,13500,51600
I000056,N00007017,Darrell Issa (R),2016,Retired,283582,0,283582
I000056,N00007017,Darrell Issa (R),2016,Republican/Conservative,107695,17250,124945
I000056,N00007017,Darrell Issa (R),2016,Leadership PACs,0,124000,124000
I000056,N00007017,Darrell Issa (R),2016,Real Estate,85511,24200,109711
I000056,N00007017,Darrell Issa (R),2016,Lawyers/Law Firms,80635,23000,103635
I000056,N00007017,Darrell Issa (R),2016,Electronics Mfg & Equip,30850,62000,92850
I000056,N00007017,Darrell Issa (R),2016,Securities & Investment,78200,9000,87200
I000056,N00007017,Darrell Issa (R),2016,Telecom Services,18725,63500,82225
I000056,N00007017,Darrell Issa (R),2016,Automotive,21575,36000,57575
I000056,N00007017,Darrell Issa (R),2016,Internet,15800,40500,56300
V000130,N00007021,Juan Vargas (D),2016,Insurance,2500,151000,153500
V000130,N00007021,Juan Vargas (D),2016,Securities & Investment,34200,62000,96200
V000130,N00007021,Juan Vargas (D),2016,Real Estate,11950,41000,52950
V000130,N00007021,Juan Vargas (D),2016,Commercial Banks,0,50000,50000
V000130,N00007021,Juan Vargas (D),2016,Accountants,2500,43999,46499
V000130,N00007021,Juan Vargas (D),2016,Building Trade Unions,0,37500,37500
V000130,N00007021,Juan Vargas (D),2016,Public Sector Unions,0,30000,30000
V000130,N00007021,Juan Vargas (D),2016,Pro-Israel,14300,15000,29300
V000130,N00007021,Juan Vargas (D),2016,Casinos/Gambling,25300,2000,27300
V000130,N00007021,Juan Vargas (D),2016,Industrial Unions,0,25500,25500
C000059,N00007099,Ken Calvert (R),2016,Casinos/Gambling,88950,0,88950
C000059,N00007099,Ken Calvert (R),2016,Lobbyists,68793,8539,77332
C000059,N00007099,Ken Calvert (R),2016,Real Estate,39716,34250,73966
C000059,N00007099,Ken Calvert (R),2016,Oil & Gas,8900,59000,67900
C000059,N00007099,Ken Calvert (R),2016,Electric Utilities,0,48000,48000
C000059,N00007099,Ken Calvert (R),2016,Defense Aerospace,2500,43000,45500
C000059,N00007099,Ken Calvert (R),2016,Defense Electronics,5000,39500,44500
C000059,N00007099,Ken Calvert (R),2016,Construction Services,18400,24750,43150
C000059,N00007099,Ken Calvert (R),2016,Misc Manufacturing & Distributing,7750,34511,42261
C000059,N00007099,Ken Calvert (R),2016,Crop Production & Basic Processing,17049,23850,40899
R000409,N00007151,Dana Rohrabacher (R),2016,Retired,84675,0,84675
R000409,N00007151,Dana Rohrabacher (R),2016,Real Estate,50320,3000,53320
R000409,N00007151,Dana Rohrabacher (R),2016,Lawyers/Law Firms,28650,0,28650
R000409,N00007151,Dana Rohrabacher (R),2016,Misc Manufacturing & Distributing,22150,0,22150
R000409,N00007151,Dana Rohrabacher (R),2016,Republican/Conservative,15750,5750,21500
R000409,N00007151,Dana Rohrabacher (R),2016,Health Professionals,20047,1000,21047
R000409,N00007151,Dana Rohrabacher (R),2016,Securities & Investment,20250,0,20250
R000409,N00007151,Dana Rohrabacher (R),2016,Pharmaceuticals/Health Products,20150,0,20150
R000409,N00007151,Dana Rohrabacher (R),2016,Electronics Mfg & Equip,12600,3000,15600
R000409,N00007151,Dana Rohrabacher (R),2016,Insurance,12600,2000,14600
C001036,N00007232,Lois Capps (D),2016,Health Professionals,0,9000,9000
C001036,N00007232,Lois Capps (D),2016,Defense Aerospace,0,3500,3500
C001036,N00007232,Lois Capps (D),2016,"Beer, Wine & Liquor",0,2500,2500
C001036,N00007232,Lois Capps (D),2016,Public Sector Unions,0,2000,2000
C001036,N00007232,Lois Capps (D),2016,Real Estate,1000,0,1000
C001036,N00007232,Lois Capps (D),2016,Industrial Unions,0,1000,1000
C001036,N00007232,Lois Capps (D),2016,Leadership PACs,0,1000,1000
C001036,N00007232,Lois Capps (D),2016,Lawyers/Law Firms,0,1000,1000
C001036,N00007232,Lois Capps (D),2016,Pharmaceuticals/Health Products,0,1000,1000
C001036,N00007232,Lois Capps (D),2016,Hospitals/Nursing Homes,0,1000,1000
N000181,N00007248,Devin Nunes (R),2016,Crop Production & Basic Processing,154175,49900,204075
N000181,N00007248,Devin Nunes (R),2016,Insurance,2875,183500,186375
N000181,N00007248,Devin Nunes (R),2016,Health Professionals,33650,115000,148650
N000181,N00007248,Devin Nunes (R),2016,Securities & Investment,43750,72000,115750
N000181,N00007248,Devin Nunes (R),2016,Pharmaceuticals/Health Products,0,111500,111500
N000181,N00007248,Devin Nunes (R),2016,Lobbyists,93239,2000,95239
N000181,N00007248,Devin Nunes (R),2016,Electric Utilities,0,94500,94500
N000181,N00007248,Devin Nunes (R),2016,Real Estate,48150,42500,90650
N000181,N00007248,Devin Nunes (R),2016,Oil & Gas,500,72000,72500
N000181,N00007248,Devin Nunes (R),2016,Agricultural Services/Products,25450,36500,61950
F000030,N00007312,Sam Farr (D),2016,Crop Production & Basic Processing,4500,26200,30700
F000030,N00007312,Sam Farr (D),2016,Health Professionals,2000,14500,16500
F000030,N00007312,Sam Farr (D),2016,Agricultural Services/Products,0,12500,12500
F000030,N00007312,Sam Farr (D),2016,Lodging/Tourism,0,11000,11000
F000030,N00007312,Sam Farr (D),2016,Retired,10851,0,10851
F000030,N00007312,Sam Farr (D),2016,Lawyers/Law Firms,2200,4000,6200
F000030,N00007312,Sam Farr (D),2016,"Beer, Wine & Liquor",5580,500,6080
F000030,N00007312,Sam Farr (D),2016,Air Transport,0,5500,5500
F000030,N00007312,Sam Farr (D),2016,Automotive,1000,4500,5500
F000030,N00007312,Sam Farr (D),2016,Lobbyists,4500,0,4500
E000215,N00007335,Anna Eshoo (D),2016,Pharmaceuticals/Health Products,58170,141790,199960
E000215,N00007335,Anna Eshoo (D),2016,Electronics Mfg & Equip,73075,55512,128587
E000215,N00007335,Anna Eshoo (D),2016,Retired,91875,0,91875
E000215,N00007335,Anna Eshoo (D),2016,Telecom Services,2000,72500,74500
E000215,N00007335,Anna Eshoo (D),2016,Securities & Investment,68900,2500,71400
E000215,N00007335,Anna Eshoo (D),2016,Internet,24750,42200,66950
E000215,N00007335,Anna Eshoo (D),2016,Lawyers/Law Firms,44680,15500,60180
E000215,N00007335,Anna Eshoo (D),2016,Health Professionals,20100,39500,59600
E000215,N00007335,Anna Eshoo (D),2016,Real Estate,23350,14000,37350
E000215,N00007335,Anna Eshoo (D),2016,Telephone Utilities,0,29000,29000
P000197,N00007360,Nancy Pelosi (D),2016,Democratic/Liberal,292208,500,292708
P000197,N00007360,Nancy Pelosi (D),2016,Health Professionals,24961,204000,228961
P000197,N00007360,Nancy Pelosi (D),2016,Retired,181674,0,181674
P000197,N00007360,Nancy Pelosi (D),2016,Women's Issues,166194,5000,171194
P000197,N00007360,Nancy Pelosi (D),2016,Misc Issues,87723,15000,102723
P000197,N00007360,Nancy Pelosi (D),2016,Public Sector Unions,625,101000,101625
P000197,N00007360,Nancy Pelosi (D),2016,Electronics Mfg & Equip,21687,69500,91187
P000197,N00007360,Nancy Pelosi (D),2016,Lawyers/Law Firms,53397,32000,85397
P000197,N00007360,Nancy Pelosi (D),2016,Real Estate,38647,46000,84647
P000197,N00007360,Nancy Pelosi (D),2016,Securities & Investment,47365,34500,81865
F000062,N00007364,Dianne Feinstein (D),2016,Lawyers/Law Firms,374044,134500,508544
F000062,N00007364,Dianne Feinstein (D),2016,Retired,331189,0,331189
F000062,N00007364,Dianne Feinstein (D),2016,Lobbyists,281503,15651,297154
F000062,N00007364,Dianne Feinstein (D),2016,Electric Utilities,199850,96600,296450
F000062,N00007364,Dianne Feinstein (D),2016,Crop Production & Basic Processing,224333,72000,296333
F000062,N00007364,Dianne Feinstein (D),2016,Securities & Investment,234959,28850,263809
F000062,N00007364,Dianne Feinstein (D),2016,Real Estate,220722,33000,253722
F000062,N00007364,Dianne Feinstein (D),2016,TV/Movies/Music,168015,84500,252515
F000062,N00007364,Dianne Feinstein (D),2016,Women's Issues,201449,11000,212449
F000062,N00007364,Dianne Feinstein (D),2016,Electronics Mfg & Equip,75350,105789,181139
T000460,N00007419,Mike Thompson (D),2016,"Beer, Wine & Liquor",207227,38500,245727
T000460,N00007419,Mike Thompson (D),2016,Health Professionals,9540,184861,194401
T000460,N00007419,Mike Thompson (D),2016,Insurance,1500,159000,160500
T000460,N00007419,Mike Thompson (D),2016,Securities & Investment,16923,85500,102423
T000460,N00007419,Mike Thompson (D),2016,Retired,80335,0,80335
T000460,N00007419,Mike Thompson (D),2016,Real Estate,21755,46500,68255
T000460,N00007419,Mike Thompson (D),2016,Pharmaceuticals/Health Products,500,60400,60900
T000460,N00007419,Mike Thompson (D),2016,Health Services/HMOs,4100,56500,60600
T000460,N00007419,Mike Thompson (D),2016,Accountants,2710,52000,54710
T000460,N00007419,Mike Thompson (D),2016,Lawyers/Law Firms,13160,32500,45660
L000397,N00007479,Zoe Lofgren (D),2016,Electronics Mfg & Equip,116150,76300,192450
L000397,N00007479,Zoe Lofgren (D),2016,Lawyers/Law Firms,117658,28900,146558
L000397,N00007479,Zoe Lofgren (D),2016,Retired,117634,0,117634
L000397,N00007479,Zoe Lofgren (D),2016,Internet,53050,57700,110750
L000397,N00007479,Zoe Lofgren (D),2016,Securities & Investment,52650,4000,56650
L000397,N00007479,Zoe Lofgren (D),2016,Accountants,4950,50000,54950
L000397,N00007479,Zoe Lofgren (D),2016,Recreation/Live Entertainment,29100,13500,42600
L000397,N00007479,Zoe Lofgren (D),2016,Lobbyists,29693,2000,31693
L000397,N00007479,Zoe Lofgren (D),2016,Real Estate,22550,8000,30550
L000397,N00007479,Zoe Lofgren (D),2016,Human Rights,22175,4000,26175
R000600,N00007635,Amata Coleman Radewagen (R),2016,Leadership PACs,0,27000,27000
R000600,N00007635,Amata Coleman Radewagen (R),2016,Fisheries & Wildlife,12800,0,12800
R000600,N00007635,Amata Coleman Radewagen (R),2016,Food & Beverage,9600,0,9600
R000600,N00007635,Amata Coleman Radewagen (R),2016,Candidate Committees,0,6500,6500
R000600,N00007635,Amata Coleman Radewagen (R),2016,Women's Issues,0,5000,5000
R000600,N00007635,Amata Coleman Radewagen (R),2016,Retired,2025,0,2025
R000600,N00007635,Amata Coleman Radewagen (R),2016,Misc Business,1900,0,1900
R000600,N00007635,Amata Coleman Radewagen (R),2016,Lawyers/Law Firms,0,1000,1000
R000600,N00007635,Amata Coleman Radewagen (R),2016,Commercial Banks,0,1000,1000
W000791,N00007690,Greg Walden (R),2016,TV/Movies/Music,105969,78200,184169
W000791,N00007690,Greg Walden (R),2016,Pharmaceuticals/Health Products,10650,169250,179900
W000791,N00007690,Greg Walden (R),2016,Health Professionals,19239,147000,166239
W000791,N00007690,Greg Walden (R),2016,Telecom Services,29600,133500,163100
W000791,N00007690,Greg Walden (R),2016,Oil & Gas,2950,146000,148950
W000791,N00007690,Greg Walden (R),2016,Electric Utilities,250,146000,146250
W000791,N00007690,Greg Walden (R),2016,Lobbyists,104870,7500,112370
W000791,N00007690,Greg Walden (R),2016,Health Services/HMOs,24400,85500,109900
W000791,N00007690,Greg Walden (R),2016,Lawyers/Law Firms,55436,52750,108186
W000791,N00007690,Greg Walden (R),2016,Retired,104686,0,104686
W000779,N00007724,Ron Wyden (D),2016,Securities & Investment,781249,172500,953749
W000779,N00007724,Ron Wyden (D),2016,Lawyers/Law Firms,636728,205676,842404
W000779,N00007724,Ron Wyden (D),2016,Insurance,285007,342500,627507
W000779,N00007724,Ron Wyden (D),2016,Real Estate,479796,103840,583636
W000779,N00007724,Ron Wyden (D),2016,Health Professionals,219585,306100,525685
W000779,N00007724,Ron Wyden (D),2016,Hospitals/Nursing Homes,335038,172500,507538
W000779,N00007724,Ron Wyden (D),2016,Pharmaceuticals/Health Products,114325,325950,440275
W000779,N00007724,Ron Wyden (D),2016,Lobbyists,363797,10050,373847
W000779,N00007724,Ron Wyden (D),2016,Health Services/HMOs,169484,192450,361934
W000779,N00007724,Ron Wyden (D),2016,Electric Utilities,47252,259500,306752
B000574,N00007727,Earl Blumenauer (D),2016,Health Professionals,2500,138900,141400
B000574,N00007727,Earl Blumenauer (D),2016,Insurance,10650,86500,97150
B000574,N00007727,Earl Blumenauer (D),2016,Construction Services,18050,67500,85550
B000574,N00007727,Earl Blumenauer (D),2016,Railroads,24375,56000,80375
B000574,N00007727,Earl Blumenauer (D),2016,Misc Manufacturing & Distributing,30700,49000,79700
B000574,N00007727,Earl Blumenauer (D),2016,Real Estate,34650,23500,58150
B000574,N00007727,Earl Blumenauer (D),2016,Lawyers/Law Firms,24892,26500,51392
B000574,N00007727,Earl Blumenauer (D),2016,Health Services/HMOs,9267,34500,43767
B000574,N00007727,Earl Blumenauer (D),2016,Lobbyists,40827,1500,42327
B000574,N00007727,Earl Blumenauer (D),2016,Misc Issues,18250,24000,42250
D000191,N00007781,Peter DeFazio (D),2016,Air Transport,20010,114000,134010
D000191,N00007781,Peter DeFazio (D),2016,Transportation Unions,500,119255,119755
D000191,N00007781,Peter DeFazio (D),2016,Building Materials & Equipment,4502,63500,68002
D000191,N00007781,Peter DeFazio (D),2016,Retired,61728,0,61728
D000191,N00007781,Peter DeFazio (D),2016,Trucking,0,47500,47500
D000191,N00007781,Peter DeFazio (D),2016,Railroads,3000,44000,47000
D000191,N00007781,Peter DeFazio (D),2016,Lobbyists,33380,2000,35380
D000191,N00007781,Peter DeFazio (D),2016,Forestry & Forest Products,17679,17000,34679
D000191,N00007781,Peter DeFazio (D),2016,Public Sector Unions,35,34500,34535
D000191,N00007781,Peter DeFazio (D),2016,"Beer, Wine & Liquor",16800,17700,34500
S000510,N00007833,Adam Smith (D),2016,Defense Aerospace,35900,71500,107400
S000510,N00007833,Adam Smith (D),2016,Misc Defense,5250,58000,63250
S000510,N00007833,Adam Smith (D),2016,Defense Electronics,1000,59500,60500
S000510,N00007833,Adam Smith (D),2016,Lawyers/Law Firms,20350,21250,41600
S000510,N00007833,Adam Smith (D),2016,Real Estate,15950,17500,33450
S000510,N00007833,Adam Smith (D),2016,Electronics Mfg & Equip,7250,25500,32750
S000510,N00007833,Adam Smith (D),2016,Lobbyists,31400,1000,32400
S000510,N00007833,Adam Smith (D),2016,Building Trade Unions,0,27500,27500
S000510,N00007833,Adam Smith (D),2016,Air Transport,3500,22500,26000
S000510,N00007833,Adam Smith (D),2016,Industrial Unions,0,23500,23500
C000127,N00007836,Maria Cantwell (D),2016,Lawyers/Law Firms,704701,10750,715451
C000127,N00007836,Maria Cantwell (D),2016,Retired,705780,0,705780
C000127,N00007836,Maria Cantwell (D),2016,Lobbyists,471190,0,471190
C000127,N00007836,Maria Cantwell (D),2016,Securities & Investment,320564,0,320564
C000127,N00007836,Maria Cantwell (D),2016,Casinos/Gambling,253300,0,253300
C000127,N00007836,Maria Cantwell (D),2016,Real Estate,238363,2500,240863
C000127,N00007836,Maria Cantwell (D),2016,Electronics Mfg & Equip,178477,3500,181977
C000127,N00007836,Maria Cantwell (D),2016,Business Services,164067,0,164067
C000127,N00007836,Maria Cantwell (D),2016,Health Professionals,152611,6750,159361
C000127,N00007836,Maria Cantwell (D),2016,Environment,136106,0,136106
M001111,N00007876,Patty Murray (D),2016,Lawyers/Law Firms,585807,150684,736491
M001111,N00007876,Patty Murray (D),2016,Retired,621397,0,621397
M001111,N00007876,Patty Murray (D),2016,Pharmaceuticals/Health Products,108317,386650,494967
M001111,N00007876,Patty Murray (D),2016,Lobbyists,447227,10769,457996
M001111,N00007876,Patty Murray (D),2016,Women's Issues,392445,25000,417445
M001111,N00007876,Patty Murray (D),2016,Health Professionals,113954,285414,399368
M001111,N00007876,Patty Murray (D),2016,Securities & Investment,276909,90000,366909
M001111,N00007876,Patty Murray (D),2016,Leadership PACs,0,332400,332400
M001111,N00007876,Patty Murray (D),2016,Insurance,65681,242500,308181
M001111,N00007876,Patty Murray (D),2016,Electronics Mfg & Equip,196095,102250,298345
J000174,N00008028,Sam Johnson (R),2016,Insurance,5450,123100,128550
J000174,N00008028,Sam Johnson (R),2016,Leadership PACs,0,95586,95586
J000174,N00008028,Sam Johnson (R),2016,Automotive,20500,32000,52500
J000174,N00008028,Sam Johnson (R),2016,Real Estate,9326,36450,45776
J000174,N00008028,Sam Johnson (R),2016,Commercial Banks,500,37500,38000
J000174,N00008028,Sam Johnson (R),2016,Health Professionals,6300,31250,37550
J000174,N00008028,Sam Johnson (R),2016,Oil & Gas,9200,28150,37350
J000174,N00008028,Sam Johnson (R),2016,Accountants,1000,33500,34500
J000174,N00008028,Sam Johnson (R),2016,Securities & Investment,7650,24500,32150
J000174,N00008028,Sam Johnson (R),2016,Retired,29950,0,29950
L000551,N00008046,Barbara Lee (D),2016,Retired,75745,0,75745
L000551,N00008046,Barbara Lee (D),2016,Democratic/Liberal,70672,950,71622
L000551,N00008046,Barbara Lee (D),2016,Lawyers/Law Firms,54453,15500,69953
L000551,N00008046,Barbara Lee (D),2016,Real Estate,45501,8000,53501
L000551,N00008046,Barbara Lee (D),2016,Health Professionals,30250,20500,50750
L000551,N00008046,Barbara Lee (D),2016,Public Sector Unions,0,49700,49700
L000551,N00008046,Barbara Lee (D),2016,Business Services,47885,0,47885
L000551,N00008046,Barbara Lee (D),2016,Lobbyists,43060,0,43060
L000551,N00008046,Barbara Lee (D),2016,Pharmaceuticals/Health Products,20990,17000,37990
L000551,N00008046,Barbara Lee (D),2016,Building Trade Unions,0,35500,35500
J000126,N00008122,Eddie Bernice Johnson (D),2016,Air Transport,0,45499,45499
J000126,N00008122,Eddie Bernice Johnson (D),2016,Railroads,0,44000,44000
J000126,N00008122,Eddie Bernice Johnson (D),2016,Transportation Unions,0,32000,32000
J000126,N00008122,Eddie Bernice Johnson (D),2016,Health Professionals,5050,20000,25050
J000126,N00008122,Eddie Bernice Johnson (D),2016,Lawyers/Law Firms,6550,17000,23550
J000126,N00008122,Eddie Bernice Johnson (D),2016,Building Trade Unions,0,23500,23500
J000126,N00008122,Eddie Bernice Johnson (D),2016,Hospitals/Nursing Homes,1600,14000,15600
J000126,N00008122,Eddie Bernice Johnson (D),2016,Telephone Utilities,0,14000,14000
J000126,N00008122,Eddie Bernice Johnson (D),2016,Automotive,1000,10000,11000
J000126,N00008122,Eddie Bernice Johnson (D),2016,Public Sector Unions,0,11000,11000
R000487,N00008264,Ed Royce (R),2016,Real Estate,318949,91000,409949
R000487,N00008264,Ed Royce (R),2016,Securities & Investment,194775,161000,355775
R000487,N00008264,Ed Royce (R),2016,Retired,319800,0,319800
R000487,N00008264,Ed Royce (R),2016,Insurance,53350,232700,286050
R000487,N00008264,Ed Royce (R),2016,Pro-Israel,163187,35500,198687
R000487,N00008264,Ed Royce (R),2016,Lawyers/Law Firms,156775,41600,198375
R000487,N00008264,Ed Royce (R),2016,Health Professionals,114586,4300,118886
R000487,N00008264,Ed Royce (R),2016,Commercial Banks,16900,86500,103400
R000487,N00008264,Ed Royce (R),2016,Misc Finance,76350,19500,95850
R000487,N00008264,Ed Royce (R),2016,Misc Manufacturing & Distributing,58165,23500,81665
S000030,N00008274,Loretta Sanchez (D),2016,Lawyers/Law Firms,176227,29500,205727
S000030,N00008274,Loretta Sanchez (D),2016,Retired,164619,0,164619
S000030,N00008274,Loretta Sanchez (D),2016,Health Professionals,101316,17700,119016
S000030,N00008274,Loretta Sanchez (D),2016,Crop Production & Basic Processing,72949,28500,101449
S000030,N00008274,Loretta Sanchez (D),2016,Real Estate,91400,4000,95400
S000030,N00008274,Loretta Sanchez (D),2016,Human Rights,53542,22500,76042
S000030,N00008274,Loretta Sanchez (D),2016,Education,61835,11500,73335
S000030,N00008274,Loretta Sanchez (D),2016,Lobbyists,46050,1500,47550
S000030,N00008274,Loretta Sanchez (D),2016,Democratic/Liberal,42722,2000,44722
S000030,N00008274,Loretta Sanchez (D),2016,Women's Issues,36887,6000,42887
G000377,N00008799,Kay Granger (R),2016,Defense Aerospace,116800,61000,177800
G000377,N00008799,Kay Granger (R),2016,Real Estate,58280,26500,84780
G000377,N00008799,Kay Granger (R),2016,Oil & Gas,59400,16000,75400
G000377,N00008799,Kay Granger (R),2016,Retired,61035,0,61035
G000377,N00008799,Kay Granger (R),2016,Defense Electronics,500,57500,58000
G000377,N00008799,Kay Granger (R),2016,Lobbyists,45850,3661,49511
G000377,N00008799,Kay Granger (R),2016,Air Transport,2250,45000,47250
G000377,N00008799,Kay Granger (R),2016,Misc Manufacturing & Distributing,18000,23000,41000
G000377,N00008799,Kay Granger (R),2016,Lawyers/Law Firms,28394,12000,40394
G000377,N00008799,Kay Granger (R),2016,Misc Defense,0,38000,38000
G000289,N00009154,Bob Goodlatte (R),2016,Lawyers/Law Firms,63258,41500,104758
G000289,N00009154,Bob Goodlatte (R),2016,Retired,95325,0,95325
G000289,N00009154,Bob Goodlatte (R),2016,TV/Movies/Music,15500,72633,88133
G000289,N00009154,Bob Goodlatte (R),2016,Telecom Services,15200,59500,74700
G000289,N00009154,Bob Goodlatte (R),2016,Electronics Mfg & Equip,22800,49500,72300
G000289,N00009154,Bob Goodlatte (R),2016,Securities & Investment,42900,21000,63900
G000289,N00009154,Bob Goodlatte (R),2016,Internet,14750,41000,55750
G000289,N00009154,Bob Goodlatte (R),2016,Lobbyists,54250,1000,55250
G000289,N00009154,Bob Goodlatte (R),2016,Real Estate,35050,18500,53550
G000289,N00009154,Bob Goodlatte (R),2016,Commercial Banks,1000,49000,50000
F000444,N00009573,Jeff Flake (R),2016,Republican/Conservative,1279677,64067,1343744
F000444,N00009573,Jeff Flake (R),2016,Retired,700483,0,700483
F000444,N00009573,Jeff Flake (R),2016,Real Estate,404530,26500,431030
F000444,N00009573,Jeff Flake (R),2016,Securities & Investment,391929,18000,409929
F000444,N00009573,Jeff Flake (R),2016,Leadership PACs,0,371368,371368
F000444,N00009573,Jeff Flake (R),2016,Lawyers/Law Firms,207862,68450,276312
F000444,N00009573,Jeff Flake (R),2016,Misc Finance,234072,4500,238572
F000444,N00009573,Jeff Flake (R),2016,Health Professionals,142567,53500,196067
F000444,N00009573,Jeff Flake (R),2016,Mining,134902,59000,193902
F000444,N00009573,Jeff Flake (R),2016,Oil & Gas,76510,102500,179010
S001150,N00009585,Adam Schiff (D),2016,Lawyers/Law Firms,87850,15500,103350
S001150,N00009585,Adam Schiff (D),2016,Retired,54605,0,54605
S001150,N00009585,Adam Schiff (D),2016,TV/Movies/Music,21800,28000,49800
S001150,N00009585,Adam Schiff (D),2016,Health Professionals,36350,12250,48600
S001150,N00009585,Adam Schiff (D),2016,Real Estate,32950,8000,40950
S001150,N00009585,Adam Schiff (D),2016,Defense Aerospace,2700,33000,35700
S001150,N00009585,Adam Schiff (D),2016,Public Sector Unions,0,34000,34000
S001150,N00009585,Adam Schiff (D),2016,Defense Electronics,0,25000,25000
S001150,N00009585,Adam Schiff (D),2016,Misc Unions,0,22500,22500
S001150,N00009585,Adam Schiff (D),2016,Building Trade Unions,0,22500,22500
D000598,N00009604,Susan A Davis (D),2016,Misc Defense,10900,36500,47400
D000598,N00009604,Susan A Davis (D),2016,Defense Electronics,0,29500,29500
D000598,N00009604,Susan A Davis (D),2016,Defense Aerospace,0,29500,29500
D000598,N00009604,Susan A Davis (D),2016,Real Estate,6750,21000,27750
D000598,N00009604,Susan A Davis (D),2016,Democratic/Liberal,11200,12000,23200
D000598,N00009604,Susan A Davis (D),2016,Electronics Mfg & Equip,3900,17500,21400
D000598,N00009604,Susan A Davis (D),2016,Health Services/HMOs,0,18000,18000
D000598,N00009604,Susan A Davis (D),2016,Public Sector Unions,0,17750,17750
D000598,N00009604,Susan A Davis (D),2016,Retired,17425,0,17425
D000598,N00009604,Susan A Davis (D),2016,Lawyers/Law Firms,5700,10000,15700
V000127,N00009659,David Vitter (R),2016,Oil & Gas,93000,101900,194900
V000127,N00009659,David Vitter (R),2016,Lawyers/Law Firms,64892,71500,136392
V000127,N00009659,David Vitter (R),2016,Leadership PACs,0,99442,99442
V000127,N00009659,David Vitter (R),2016,Mining,57400,38500,95900
V000127,N00009659,David Vitter (R),2016,Retired,90684,0,90684
V000127,N00009659,David Vitter (R),2016,General Contractors,77450,6000,83450
V000127,N00009659,David Vitter (R),2016,Building Materials & Equipment,19350,63500,82850
V000127,N00009659,David Vitter (R),2016,Real Estate,71500,6000,77500
V000127,N00009659,David Vitter (R),2016,Chemical & Related Manufacturing,7000,70100,77100
V000127,N00009659,David Vitter (R),2016,Health Professionals,69750,5500,75250
S001176,N00009660,Steve Scalise (R),2016,Oil & Gas,101600,176500,278100
S001176,N00009660,Steve Scalise (R),2016,Insurance,63100,162800,225900
S001176,N00009660,Steve Scalise (R),2016,Real Estate,132232,72350,204582
S001176,N00009660,Steve Scalise (R),2016,Lobbyists,196822,1249,198071
S001176,N00009660,Steve Scalise (R),2016,Misc Issues,191350,390,191740
S001176,N00009660,Steve Scalise (R),2016,Securities & Investment,80800,105500,186300
S001176,N00009660,Steve Scalise (R),2016,Health Professionals,49225,123000,172225
S001176,N00009660,Steve Scalise (R),2016,Pharmaceuticals/Health Products,37400,122100,159500
S001176,N00009660,Steve Scalise (R),2016,Electric Utilities,27950,125200,153150
S001176,N00009660,Steve Scalise (R),2016,Lawyers/Law Firms,90658,34700,125358
T000462,N00009699,Pat Tiberi (R),2016,Insurance,79160,304400,383560
T000462,N00009699,Pat Tiberi (R),2016,Health Professionals,27085,216100,243185
T000462,N00009699,Pat Tiberi (R),2016,Pharmaceuticals/Health Products,26100,210904,237004
T000462,N00009699,Pat Tiberi (R),2016,Hospitals/Nursing Homes,90750,145950,236700
T000462,N00009699,Pat Tiberi (R),2016,Securities & Investment,75885,143000,218885
T000462,N00009699,Pat Tiberi (R),2016,Real Estate,112990,96500,209490
T000462,N00009699,Pat Tiberi (R),2016,Lobbyists,181203,500,181703
T000462,N00009699,Pat Tiberi (R),2016,Lawyers/Law Firms,96005,70500,166505
T000462,N00009699,Pat Tiberi (R),2016,Electric Utilities,20950,102800,123750
T000462,N00009699,Pat Tiberi (R),2016,Commercial Banks,7475,111600,119075
L000559,N00009724,Jim Langevin (D),2016,Lawyers/Law Firms,57600,19000,76600
L000559,N00009724,Jim Langevin (D),2016,Health Professionals,27550,49000,76550
L000559,N00009724,Jim Langevin (D),2016,Building Trade Unions,0,66800,66800
L000559,N00009724,Jim Langevin (D),2016,Defense Aerospace,11300,46000,57300
L000559,N00009724,Jim Langevin (D),2016,Defense Electronics,14250,41500,55750
L000559,N00009724,Jim Langevin (D),2016,Misc Defense,18850,24000,42850
L000559,N00009724,Jim Langevin (D),2016,Public Sector Unions,1800,34650,36450
L000559,N00009724,Jim Langevin (D),2016,Accountants,15950,17500,33450
L000559,N00009724,Jim Langevin (D),2016,Real Estate,25161,8000,33161
L000559,N00009724,Jim Langevin (D),2016,Transportation Unions,0,31100,31100
C001048,N00009738,John Culberson (R),2016,Oil & Gas,53400,69500,122900
C001048,N00009738,John Culberson (R),2016,Real Estate,84943,20500,105443
C001048,N00009738,John Culberson (R),2016,Retired,86900,0,86900
C001048,N00009738,John Culberson (R),2016,Leadership PACs,0,68500,68500
C001048,N00009738,John Culberson (R),2016,Lawyers/Law Firms,28049,17700,45749
C001048,N00009738,John Culberson (R),2016,Defense Aerospace,2250,42000,44250
C001048,N00009738,John Culberson (R),2016,Construction Services,30325,10500,40825
C001048,N00009738,John Culberson (R),2016,Misc Manufacturing & Distributing,15500,19500,35000
C001048,N00009738,John Culberson (R),2016,Lobbyists,31000,3141,34141
C001048,N00009738,John Culberson (R),2016,Defense Electronics,0,34000,34000
L000560,N00009759,Rick Larsen (D),2016,Air Transport,755,101998,102753
L000560,N00009759,Rick Larsen (D),2016,Transportation Unions,500,61500,62000
L000560,N00009759,Rick Larsen (D),2016,Defense Aerospace,300,57500,57800
L000560,N00009759,Rick Larsen (D),2016,Oil & Gas,0,35500,35500
L000560,N00009759,Rick Larsen (D),2016,Railroads,0,35000,35000
L000560,N00009759,Rick Larsen (D),2016,Defense Electronics,0,32500,32500
L000560,N00009759,Rick Larsen (D),2016,Lawyers/Law Firms,9715,17000,26715
L000560,N00009759,Rick Larsen (D),2016,Insurance,250,23000,23250
L000560,N00009759,Rick Larsen (D),2016,Public Sector Unions,0,22500,22500
L000560,N00009759,Rick Larsen (D),2016,Health Professionals,900,20500,21400
C001047,N00009771,Shelley Moore Capito (R),2016,Securities & Investment,385415,58400,443815
C001047,N00009771,Shelley Moore Capito (R),2016,Retired,412786,0,412786
C001047,N00009771,Shelley Moore Capito (R),2016,Lawyers/Law Firms,293700,48763,342463
C001047,N00009771,Shelley Moore Capito (R),2016,Leadership PACs,0,331100,331100
C001047,N00009771,Shelley Moore Capito (R),2016,Mining,218874,84875,303749
C001047,N00009771,Shelley Moore Capito (R),2016,Oil & Gas,102866,163500,266366
C001047,N00009771,Shelley Moore Capito (R),2016,Insurance,77338,182600,259938
C001047,N00009771,Shelley Moore Capito (R),2016,Commercial Banks,127175,126000,253175
C001047,N00009771,Shelley Moore Capito (R),2016,Health Professionals,117566,107000,224566
C001047,N00009771,Shelley Moore Capito (R),2016,Real Estate,134678,52500,187178
B000287,N00009774,Xavier Becerra (D),2016,Health Professionals,9199,134200,143399
B000287,N00009774,Xavier Becerra (D),2016,Real Estate,75925,50000,125925
B000287,N00009774,Xavier Becerra (D),2016,Securities & Investment,64226,61500,125726
B000287,N00009774,Xavier Becerra (D),2016,Insurance,2500,95500,98000
B000287,N00009774,Xavier Becerra (D),2016,Hospitals/Nursing Homes,34755,61500,96255
B000287,N00009774,Xavier Becerra (D),2016,Lawyers/Law Firms,49907,34100,84007
B000287,N00009774,Xavier Becerra (D),2016,TV/Movies/Music,37525,34900,72425
B000287,N00009774,Xavier Becerra (D),2016,Public Sector Unions,0,70500,70500
B000287,N00009774,Xavier Becerra (D),2016,Casinos/Gambling,64200,0,64200
B000287,N00009774,Xavier Becerra (D),2016,Pharmaceuticals/Health Products,0,49000,49000
M001150,N00009795,Candice S Miller (R),2016,Electric Utilities,0,2000,2000
M001150,N00009795,Candice S Miller (R),2016,Construction Services,0,1000,1000
M001150,N00009795,Candice S Miller (R),2016,Business Services,0,1000,1000
M001150,N00009795,Candice S Miller (R),2016,Defense Aerospace,0,1000,1000
M001150,N00009795,Candice S Miller (R),2016,Railroads,0,1000,1000
M001150,N00009795,Candice S Miller (R),2016,Candidate Committees,0,499,499
S000522,N00009816,Chris Smith (R),2016,Building Trade Unions,0,49000,49000
S000522,N00009816,Chris Smith (R),2016,Pro-Israel,25400,12000,37400
S000522,N00009816,Chris Smith (R),2016,Retired,29730,0,29730
S000522,N00009816,Chris Smith (R),2016,Transportation Unions,0,29000,29000
S000522,N00009816,Chris Smith (R),2016,Abortion Policy/Anti-Abortion,10600,17000,27600
S000522,N00009816,Chris Smith (R),2016,Lawyers/Law Firms,16335,4750,21085
S000522,N00009816,Chris Smith (R),2016,Leadership PACs,0,20500,20500
S000522,N00009816,Chris Smith (R),2016,Lobbyists,12625,6276,18901
S000522,N00009816,Chris Smith (R),2016,Health Professionals,8650,9000,17650
S000522,N00009816,Chris Smith (R),2016,Public Sector Unions,0,17000,17000
M000404,N00009829,Jim McDermott (D),2016,Health Professionals,6200,40000,46200
M000404,N00009829,Jim McDermott (D),2016,Retired,26945,0,26945
M000404,N00009829,Jim McDermott (D),2016,Building Trade Unions,0,15000,15000
M000404,N00009829,Jim McDermott (D),2016,Lawyers/Law Firms,6300,8000,14300
M000404,N00009829,Jim McDermott (D),2016,Industrial Unions,250,9500,9750
M000404,N00009829,Jim McDermott (D),2016,Insurance,0,9500,9500
M000404,N00009829,Jim McDermott (D),2016,Real Estate,2250,7000,9250
M000404,N00009829,Jim McDermott (D),2016,"Beer, Wine & Liquor",1500,7500,9000
M000404,N00009829,Jim McDermott (D),2016,Public Sector Unions,0,9000,9000
M000404,N00009829,Jim McDermott (D),2016,Health Services/HMOs,500,8000,8500
H000338,N00009869,Orrin G Hatch (R),2016,Securities & Investment,1093175,232071,1325246
H000338,N00009869,Orrin G Hatch (R),2016,Pharmaceuticals/Health Products,319170,500827,819997
H000338,N00009869,Orrin G Hatch (R),2016,Lobbyists,611777,14427,626204
H000338,N00009869,Orrin G Hatch (R),2016,Health Professionals,195079,382950,578029
H000338,N00009869,Orrin G Hatch (R),2016,Insurance,160000,412674,572674
H000338,N00009869,Orrin G Hatch (R),2016,Real Estate,412392,117900,530292
H000338,N00009869,Orrin G Hatch (R),2016,Lawyers/Law Firms,283495,238116,521611
H000338,N00009869,Orrin G Hatch (R),2016,Oil & Gas,215050,255900,470950
H000338,N00009869,Orrin G Hatch (R),2016,Leadership PACs,0,432378,432378
H000338,N00009869,Orrin G Hatch (R),2016,Health Services/HMOs,159916,251898,411814
A000360,N00009888,Lamar Alexander (R),2016,Pharmaceuticals/Health Products,32450,308600,341050
A000360,N00009888,Lamar Alexander (R),2016,Leadership PACs,0,307215,307215
A000360,N00009888,Lamar Alexander (R),2016,Securities & Investment,175300,97500,272800
A000360,N00009888,Lamar Alexander (R),2016,Health Professionals,54900,208500,263400
A000360,N00009888,Lamar Alexander (R),2016,Real Estate,213050,37000,250050
A000360,N00009888,Lamar Alexander (R),2016,Retired,231415,0,231415
A000360,N00009888,Lamar Alexander (R),2016,Lawyers/Law Firms,123239,105488,228727
A000360,N00009888,Lamar Alexander (R),2016,Insurance,60350,142000,202350
A000360,N00009888,Lamar Alexander (R),2016,Hospitals/Nursing Homes,85000,116767,201767
A000360,N00009888,Lamar Alexander (R),2016,Oil & Gas,49853,102933,152786
L000174,N00009918,Patrick Leahy (D),2016,Lawyers/Law Firms,494172,105200,599372
L000174,N00009918,Patrick Leahy (D),2016,Leadership PACs,0,331600,331600
L000174,N00009918,Patrick Leahy (D),2016,TV/Movies/Music,182155,93500,275655
L000174,N00009918,Patrick Leahy (D),2016,Lobbyists,204113,8209,212322
L000174,N00009918,Patrick Leahy (D),2016,Securities & Investment,150200,26950,177150
L000174,N00009918,Patrick Leahy (D),2016,Retired,152654,0,152654
L000174,N00009918,Patrick Leahy (D),2016,Electronics Mfg & Equip,53992,74900,128892
L000174,N00009918,Patrick Leahy (D),2016,Telecom Services,67850,58000,125850
L000174,N00009918,Patrick Leahy (D),2016,Defense Aerospace,41100,63250,104350
L000174,N00009918,Patrick Leahy (D),2016,Public Sector Unions,0,81250,81250
S000320,N00009920,Richard C Shelby (R),2016,Securities & Investment,346800,236500,583300
S000320,N00009920,Richard C Shelby (R),2016,Commercial Banks,284071,210600,494671
S000320,N00009920,Richard C Shelby (R),2016,Insurance,103100,256750,359850
S000320,N00009920,Richard C Shelby (R),2016,Lawyers/Law Firms,139000,118250,257250
S000320,N00009920,Richard C Shelby (R),2016,Finance/Credit Companies,90200,121500,211700
S000320,N00009920,Richard C Shelby (R),2016,Real Estate,85650,109000,194650
S000320,N00009920,Richard C Shelby (R),2016,Leadership PACs,0,161000,161000
S000320,N00009920,Richard C Shelby (R),2016,Defense Aerospace,43700,113500,157200
S000320,N00009920,Richard C Shelby (R),2016,Misc Finance,86575,37500,124075
S000320,N00009920,Richard C Shelby (R),2016,Lobbyists,117413,2000,119413
R000146,N00009922,Harry Reid (D),2016,Lawyers/Law Firms,261536,70300,331836
R000146,N00009922,Harry Reid (D),2016,Lobbyists,200568,8422,208990
R000146,N00009922,Harry Reid (D),2016,Hospitals/Nursing Homes,102550,89750,192300
R000146,N00009922,Harry Reid (D),2016,Health Professionals,101100,87000,188100
R000146,N00009922,Harry Reid (D),2016,Pharmaceuticals/Health Products,24800,138000,162800
R000146,N00009922,Harry Reid (D),2016,Securities & Investment,122800,31100,153900
R000146,N00009922,Harry Reid (D),2016,Insurance,50550,78000,128550
R000146,N00009922,Harry Reid (D),2016,Health Services/HMOs,49900,69450,119350
R000146,N00009922,Harry Reid (D),2016,Business Services,80331,22500,102831
R000146,N00009922,Harry Reid (D),2016,Real Estate,76846,23869,100715
N000032,N00009926,Bill Nelson (D),2016,Lawyers/Law Firms,1913872,187153,2101025
N000032,N00009926,Bill Nelson (D),2016,Retired,862348,0,862348
N000032,N00009926,Bill Nelson (D),2016,Real Estate,416050,50500,466550
N000032,N00009926,Bill Nelson (D),2016,Health Professionals,395024,55750,450774
N000032,N00009926,Bill Nelson (D),2016,Securities & Investment,408600,23000,431600
N000032,N00009926,Bill Nelson (D),2016,Lobbyists,390925,25106,416031
N000032,N00009926,Bill Nelson (D),2016,Leadership PACs,0,346500,346500
N000032,N00009926,Bill Nelson (D),2016,Insurance,186758,152388,339146
N000032,N00009926,Bill Nelson (D),2016,Hospitals/Nursing Homes,207930,127382,335312
N000032,N00009926,Bill Nelson (D),2016,Pro-Israel,179200,49250,228450
G000359,N00009975,Lindsey Graham (R),2016,Lawyers/Law Firms,882639,82250,964889
G000359,N00009975,Lindsey Graham (R),2016,Securities & Investment,844678,47982,892660
G000359,N00009975,Lindsey Graham (R),2016,Retired,649413,0,649413
G000359,N00009975,Lindsey Graham (R),2016,Real Estate,530316,31750,562066
G000359,N00009975,Lindsey Graham (R),2016,Leadership PACs,0,309500,309500
G000359,N00009975,Lindsey Graham (R),2016,Pro-Israel,228550,61700,290250
G000359,N00009975,Lindsey Graham (R),2016,Health Professionals,201930,33000,234930
G000359,N00009975,Lindsey Graham (R),2016,Electric Utilities,123784,100000,223784
G000359,N00009975,Lindsey Graham (R),2016,Business Services,207310,8000,215310
G000359,N00009975,Lindsey Graham (R),2016,Lobbyists,196988,9500,206488
L000566,N00012233,Robert E Latta (R),2016,Oil & Gas,16550,64500,81050
L000566,N00012233,Robert E Latta (R),2016,Telecom Services,3250,67500,70750
L000566,N00012233,Robert E Latta (R),2016,Pharmaceuticals/Health Products,3250,57500,60750
L000566,N00012233,Robert E Latta (R),2016,Retired,47179,0,47179
L000566,N00012233,Robert E Latta (R),2016,Electric Utilities,2000,43000,45000
L000566,N00012233,Robert E Latta (R),2016,Health Professionals,6750,27500,34250
L000566,N00012233,Robert E Latta (R),2016,Telephone Utilities,0,32500,32500
L000566,N00012233,Robert E Latta (R),2016,Agricultural Services/Products,6275,19500,25775
L000566,N00012233,Robert E Latta (R),2016,Automotive,200,25500,25700
L000566,N00012233,Robert E Latta (R),2016,TV/Movies/Music,7700,17500,25200
C001049,N00012460,William L Clay Jr (D),2016,Insurance,0,56000,56000
C001049,N00012460,William L Clay Jr (D),2016,Public Sector Unions,0,52000,52000
C001049,N00012460,William L Clay Jr (D),2016,Building Trade Unions,0,49200,49200
C001049,N00012460,William L Clay Jr (D),2016,Industrial Unions,0,45500,45500
C001049,N00012460,William L Clay Jr (D),2016,Lawyers/Law Firms,8500,23248,31748
C001049,N00012460,William L Clay Jr (D),2016,Commercial Banks,0,30400,30400
C001049,N00012460,William L Clay Jr (D),2016,Securities & Investment,2523,27200,29723
C001049,N00012460,William L Clay Jr (D),2016,Real Estate,250,28500,28750
C001049,N00012460,William L Clay Jr (D),2016,Pharmaceuticals/Health Products,0,22500,22500
C001049,N00012460,William L Clay Jr (D),2016,Finance/Credit Companies,0,21500,21500
C000174,N00012508,Tom Carper (D),2016,Insurance,79150,276000,355150
C000174,N00012508,Tom Carper (D),2016,Securities & Investment,131040,207380,338420
C000174,N00012508,Tom Carper (D),2016,Lawyers/Law Firms,159791,118551,278342
C000174,N00012508,Tom Carper (D),2016,Pharmaceuticals/Health Products,30800,189410,220210
C000174,N00012508,Tom Carper (D),2016,Lobbyists,189241,8600,197841
C000174,N00012508,Tom Carper (D),2016,Commercial Banks,78764,109090,187854
C000174,N00012508,Tom Carper (D),2016,Chemical & Related Manufacturing,54775,104040,158815
C000174,N00012508,Tom Carper (D),2016,Health Professionals,19359,119500,138859
C000174,N00012508,Tom Carper (D),2016,Leadership PACs,0,137500,137500
C000174,N00012508,Tom Carper (D),2016,Retired,127603,0,127603
K000360,N00012539,Mark Kirk (R),2016,Retired,1310422,0,1310422
K000360,N00012539,Mark Kirk (R),2016,Securities & Investment,1084356,165500,1249856
K000360,N00012539,Mark Kirk (R),2016,Pro-Israel,552240,75300,627540
K000360,N00012539,Mark Kirk (R),2016,Real Estate,468380,56500,524880
K000360,N00012539,Mark Kirk (R),2016,Leadership PACs,0,482700,482700
K000360,N00012539,Mark Kirk (R),2016,Lawyers/Law Firms,358395,86950,445345
K000360,N00012539,Mark Kirk (R),2016,Health Professionals,190010,238600,428610
K000360,N00012539,Mark Kirk (R),2016,Insurance,104853,244200,349053
K000360,N00012539,Mark Kirk (R),2016,Misc Finance,286180,40500,326680
K000360,N00012539,Mark Kirk (R),2016,Business Services,198755,26500,225255
M001189,N00012546,Luke Messer (R),2016,Insurance,36850,176400,213250
M001189,N00012546,Luke Messer (R),2016,Securities & Investment,13800,115500,129300
M001189,N00012546,Luke Messer (R),2016,Real Estate,34595,78000,112595
M001189,N00012546,Luke Messer (R),2016,Commercial Banks,17100,74200,91300
M001189,N00012546,Luke Messer (R),2016,Retired,66855,0,66855
M001189,N00012546,Luke Messer (R),2016,Misc Manufacturing & Distributing,38900,26500,65400
M001189,N00012546,Luke Messer (R),2016,Lawyers/Law Firms,41185,22750,63935
M001189,N00012546,Luke Messer (R),2016,Lobbyists,52500,2500,55000
M001189,N00012546,Luke Messer (R),2016,Pharmaceuticals/Health Products,10000,44150,54150
M001189,N00012546,Luke Messer (R),2016,Accountants,2750,48500,51250
H001034,N00012611,Mike Honda (D),2016,Retired,244314,0,244314
H001034,N00012611,Mike Honda (D),2016,Human Rights,92575,48400,140975
H001034,N00012611,Mike Honda (D),2016,Lawyers/Law Firms,121535,14250,135785
H001034,N00012611,Mike Honda (D),2016,Leadership PACs,2700,118950,121650
H001034,N00012611,Mike Honda (D),2016,Real Estate,104944,11000,115944
H001034,N00012611,Mike Honda (D),2016,Democratic/Liberal,75113,30606,105719
H001034,N00012611,Mike Honda (D),2016,Electronics Mfg & Equip,59931,38840,98771
H001034,N00012611,Mike Honda (D),2016,Public Sector Unions,550,87250,87800
H001034,N00012611,Mike Honda (D),2016,Health Professionals,52143,28000,80143
H001034,N00012611,Mike Honda (D),2016,Securities & Investment,63450,0,63450
P000588,N00012672,Steve Pearce (R),2016,Oil & Gas,142150,82000,224150
P000588,N00012672,Steve Pearce (R),2016,Retired,112902,0,112902
P000588,N00012672,Steve Pearce (R),2016,Livestock,102526,6000,108526
P000588,N00012672,Steve Pearce (R),2016,Real Estate,53343,21500,74843
P000588,N00012672,Steve Pearce (R),2016,Commercial Banks,27700,19500,47200
P000588,N00012672,Steve Pearce (R),2016,Crop Production & Basic Processing,38350,7500,45850
P000588,N00012672,Steve Pearce (R),2016,Accountants,14100,28000,42100
P000588,N00012672,Steve Pearce (R),2016,Casinos/Gambling,41650,0,41650
P000588,N00012672,Steve Pearce (R),2016,Misc Energy,39464,1000,40464
P000588,N00012672,Steve Pearce (R),2016,Insurance,7900,28000,35900
C001045,N00012739,Ander Crenshaw (R),2016,Misc Issues,87500,0,87500
C001045,N00012739,Ander Crenshaw (R),2016,Insurance,2000,69250,71250
C001045,N00012739,Ander Crenshaw (R),2016,Securities & Investment,4700,60000,64700
C001045,N00012739,Ander Crenshaw (R),2016,Commercial Banks,7250,55500,62750
C001045,N00012739,Ander Crenshaw (R),2016,Lobbyists,49450,3459,52909
C001045,N00012739,Ander Crenshaw (R),2016,Real Estate,17450,29500,46950
C001045,N00012739,Ander Crenshaw (R),2016,Finance/Credit Companies,11200,32000,43200
C001045,N00012739,Ander Crenshaw (R),2016,Telecom Services,0,42125,42125
C001045,N00012739,Ander Crenshaw (R),2016,Misc Defense,10250,27000,37250
C001045,N00012739,Ander Crenshaw (R),2016,Defense Electronics,500,33000,33500
M001143,N00012942,Betty McCollum (D),2016,Casinos/Gambling,114050,2000,116050
M001143,N00012942,Betty McCollum (D),2016,Retired,50477,0,50477
M001143,N00012942,Betty McCollum (D),2016,Lawyers/Law Firms,15375,27165,42540
M001143,N00012942,Betty McCollum (D),2016,Public Sector Unions,2000,38550,40550
M001143,N00012942,Betty McCollum (D),2016,Real Estate,29550,10000,39550
M001143,N00012942,Betty McCollum (D),2016,Health Professionals,10725,28000,38725
M001143,N00012942,Betty McCollum (D),2016,Industrial Unions,0,36500,36500
M001143,N00012942,Betty McCollum (D),2016,Transportation Unions,0,35000,35000
M001143,N00012942,Betty McCollum (D),2016,Crop Production & Basic Processing,2700,28000,30700
M001143,N00012942,Betty McCollum (D),2016,Building Trade Unions,0,29000,29000
G000546,N00013323,Sam Graves (R),2016,Air Transport,10000,104000,114000
G000546,N00013323,Sam Graves (R),2016,Building Materials & Equipment,18900,62750,81650
G000546,N00013323,Sam Graves (R),2016,Trucking,15052,57400,72452
G000546,N00013323,Sam Graves (R),2016,Defense Aerospace,0,54000,54000
G000546,N00013323,Sam Graves (R),2016,Construction Services,1250,51000,52250
G000546,N00013323,Sam Graves (R),2016,Crop Production & Basic Processing,9450,40500,49950
G000546,N00013323,Sam Graves (R),2016,Transportation Unions,0,48500,48500
G000546,N00013323,Sam Graves (R),2016,Public Sector Unions,0,47000,47000
G000546,N00013323,Sam Graves (R),2016,Railroads,0,44000,44000
G000546,N00013323,Sam Graves (R),2016,Automotive,3000,40000,43000
I000057,N00013345,Steve Israel (D),2016,Real Estate,97150,21500,118650
I000057,N00013345,Steve Israel (D),2016,Pharmaceuticals/Health Products,36100,36000,72100
I000057,N00013345,Steve Israel (D),2016,Securities & Investment,44600,21000,65600
I000057,N00013345,Steve Israel (D),2016,Insurance,2500,47000,49500
I000057,N00013345,Steve Israel (D),2016,Lawyers/Law Firms,33452,10000,43452
I000057,N00013345,Steve Israel (D),2016,Misc Manufacturing & Distributing,32250,8500,40750
I000057,N00013345,Steve Israel (D),2016,Retired,39410,0,39410
I000057,N00013345,Steve Israel (D),2016,Business Services,37200,0,37200
I000057,N00013345,Steve Israel (D),2016,Health Professionals,-3200,34500,31300
I000057,N00013345,Steve Israel (D),2016,Accountants,4200,26000,30200
S001154,N00013770,Bill Shuster (R),2016,Air Transport,145400,144499,289899
S001154,N00013770,Bill Shuster (R),2016,Oil & Gas,58600,180812,239412
S001154,N00013770,Bill Shuster (R),2016,Leadership PACs,0,200099,200099
S001154,N00013770,Bill Shuster (R),2016,Railroads,97450,86500,183950
S001154,N00013770,Bill Shuster (R),2016,Construction Services,73500,105000,178500
S001154,N00013770,Bill Shuster (R),2016,Lawyers/Law Firms,72638,103750,176388
S001154,N00013770,Bill Shuster (R),2016,Building Materials & Equipment,63200,84500,147700
S001154,N00013770,Bill Shuster (R),2016,General Contractors,79150,39500,118650
S001154,N00013770,Bill Shuster (R),2016,Electric Utilities,2500,116000,118500
S001154,N00013770,Bill Shuster (R),2016,Sea Transport,33900,79900,113800
F000445,N00013799,Randy Forbes (R),2016,Misc Defense,55400,55700,111100
F000445,N00013799,Randy Forbes (R),2016,Retired,83347,0,83347
F000445,N00013799,Randy Forbes (R),2016,Real Estate,76834,2000,78834
F000445,N00013799,Randy Forbes (R),2016,Defense Aerospace,8145,42500,50645
F000445,N00013799,Randy Forbes (R),2016,Lawyers/Law Firms,37109,9500,46609
F000445,N00013799,Randy Forbes (R),2016,Defense Electronics,13600,33000,46600
F000445,N00013799,Randy Forbes (R),2016,Lobbyists,36050,2162,38212
F000445,N00013799,Randy Forbes (R),2016,Leadership PACs,0,33400,33400
F000445,N00013799,Randy Forbes (R),2016,Health Professionals,25575,7000,32575
F000445,N00013799,Randy Forbes (R),2016,Education,27647,0,27647
P000597,N00013817,Chellie Pingree (D),2016,Retired,56241,0,56241
P000597,N00013817,Chellie Pingree (D),2016,Public Sector Unions,350,31000,31350
P000597,N00013817,Chellie Pingree (D),2016,Building Trade Unions,0,24000,24000
P000597,N00013817,Chellie Pingree (D),2016,Lawyers/Law Firms,16652,6500,23152
P000597,N00013817,Chellie Pingree (D),2016,Securities & Investment,23050,0,23050
P000597,N00013817,Chellie Pingree (D),2016,Construction Services,18775,0,18775
P000597,N00013817,Chellie Pingree (D),2016,Crop Production & Basic Processing,17665,0,17665
P000597,N00013817,Chellie Pingree (D),2016,Business Services,16560,0,16560
P000597,N00013817,Chellie Pingree (D),2016,Industrial Unions,0,15000,15000
P000597,N00013817,Chellie Pingree (D),2016,Real Estate,4350,9000,13350
V000128,N00013820,Chris Van Hollen (D),2016,Lawyers/Law Firms,4275147,73616,4348763
V000128,N00013820,Chris Van Hollen (D),2016,Retired,3403234,0,3403234
V000128,N00013820,Chris Van Hollen (D),2016,Real Estate,1500057,59000,1559057
V000128,N00013820,Chris Van Hollen (D),2016,Education,925684,0,925684
V000128,N00013820,Chris Van Hollen (D),2016,Lobbyists,884392,6430,890822
V000128,N00013820,Chris Van Hollen (D),2016,Securities & Investment,831228,11000,842228
V000128,N00013820,Chris Van Hollen (D),2016,Health Professionals,670659,138250,808909
V000128,N00013820,Chris Van Hollen (D),2016,Civil Servants/Public Officials,757374,0,757374
V000128,N00013820,Chris Van Hollen (D),2016,Business Services,742955,3000,745955
V000128,N00013820,Chris Van Hollen (D),2016,Misc Issues,650297,18054,668351
M001144,N00013846,Jeff Miller (R),2016,Real Estate,54700,5000,59700
M001144,N00013846,Jeff Miller (R),2016,Health Professionals,10150,41000,51150
M001144,N00013846,Jeff Miller (R),2016,Leadership PACs,0,38500,38500
M001144,N00013846,Jeff Miller (R),2016,Defense Electronics,0,33500,33500
M001144,N00013846,Jeff Miller (R),2016,Defense Aerospace,0,33000,33000
M001144,N00013846,Jeff Miller (R),2016,Lawyers/Law Firms,10400,11500,21900
M001144,N00013846,Jeff Miller (R),2016,Lobbyists,20400,1463,21863
M001144,N00013846,Jeff Miller (R),2016,Retired,20150,0,20150
M001144,N00013846,Jeff Miller (R),2016,General Contractors,13500,3500,17000
M001144,N00013846,Jeff Miller (R),2016,Candidate Committees,0,14000,14000
L000562,N00013855,Stephen F Lynch (D),2016,Real Estate,153800,11000,164800
L000562,N00013855,Stephen F Lynch (D),2016,Lawyers/Law Firms,57340,16750,74090
L000562,N00013855,Stephen F Lynch (D),2016,Public Sector Unions,0,59500,59500
L000562,N00013855,Stephen F Lynch (D),2016,Building Trade Unions,1600,56500,58100
L000562,N00013855,Stephen F Lynch (D),2016,Securities & Investment,18900,32500,51400
L000562,N00013855,Stephen F Lynch (D),2016,Insurance,8050,40500,48550
L000562,N00013855,Stephen F Lynch (D),2016,General Contractors,38500,1000,39500
L000562,N00013855,Stephen F Lynch (D),2016,Food & Beverage,36450,0,36450
L000562,N00013855,Stephen F Lynch (D),2016,Special Trade Contractors,15100,15500,30600
L000562,N00013855,Stephen F Lynch (D),2016,Construction Services,28540,1000,29540
B001236,N00013873,John Boozman (R),2016,Health Professionals,216815,113500,330315
B001236,N00013873,John Boozman (R),2016,Leadership PACs,0,316034,316034
B001236,N00013873,John Boozman (R),2016,Retired,288674,0,288674
B001236,N00013873,John Boozman (R),2016,Securities & Investment,202950,66500,269450
B001236,N00013873,John Boozman (R),2016,Commercial Banks,87300,107250,194550
B001236,N00013873,John Boozman (R),2016,Real Estate,131891,53000,184891
B001236,N00013873,John Boozman (R),2016,Oil & Gas,60230,92000,152230
B001236,N00013873,John Boozman (R),2016,Insurance,47700,79000,126700
B001236,N00013873,John Boozman (R),2016,Crop Production & Basic Processing,61250,63937,125187
B001236,N00013873,John Boozman (R),2016,Retail Sales,67165,56375,123540
N000127,N00021207,Rick Nolan (D),2016,Leadership PACs,5400,262000,267400
N000127,N00021207,Rick Nolan (D),2016,Democratic/Liberal,190423,19928,210351
N000127,N00021207,Rick Nolan (D),2016,Retired,198003,0,198003
N000127,N00021207,Rick Nolan (D),2016,Lawyers/Law Firms,72719,39575,112294
N000127,N00021207,Rick Nolan (D),2016,Candidate Committees,0,100461,100461
N000127,N00021207,Rick Nolan (D),2016,Public Sector Unions,593,85000,85593
N000127,N00021207,Rick Nolan (D),2016,Transportation Unions,1,75500,75501
N000127,N00021207,Rick Nolan (D),2016,Building Trade Unions,282,66500,66782
N000127,N00021207,Rick Nolan (D),2016,Real Estate,39334,10000,49334
N000127,N00021207,Rick Nolan (D),2016,Industrial Unions,369,46000,46369
C001077,N00024753,Mike Coffman (R),2016,Retired,451059,0,451059
C001077,N00024753,Mike Coffman (R),2016,Leadership PACs,0,353900,353900
C001077,N00024753,Mike Coffman (R),2016,Real Estate,173293,30000,203293
C001077,N00024753,Mike Coffman (R),2016,Securities & Investment,125100,20500,145600
C001077,N00024753,Mike Coffman (R),2016,Oil & Gas,51394,84500,135894
C001077,N00024753,Mike Coffman (R),2016,Lawyers/Law Firms,76635,14000,90635
C001077,N00024753,Mike Coffman (R),2016,Republican/Conservative,48040,39000,87040
C001077,N00024753,Mike Coffman (R),2016,Health Professionals,30075,47500,77575
C001077,N00024753,Mike Coffman (R),2016,Insurance,3950,72500,76450
C001077,N00024753,Mike Coffman (R),2016,Commercial Banks,51750,18200,69950
R000575,N00024759,Mike D Rogers (R),2016,Defense Aerospace,10700,65500,76200
R000575,N00024759,Mike D Rogers (R),2016,Crop Production & Basic Processing,400,64500,64900
R000575,N00024759,Mike D Rogers (R),2016,Defense Electronics,750,53500,54250
R000575,N00024759,Mike D Rogers (R),2016,Misc Defense,13100,37900,51000
R000575,N00024759,Mike D Rogers (R),2016,Lawyers/Law Firms,12500,36749,49249
R000575,N00024759,Mike D Rogers (R),2016,Health Professionals,26050,22500,48550
R000575,N00024759,Mike D Rogers (R),2016,Agricultural Services/Products,3700,35000,38700
R000575,N00024759,Mike D Rogers (R),2016,Insurance,2500,35400,37900
R000575,N00024759,Mike D Rogers (R),2016,Electric Utilities,6700,29000,35700
R000575,N00024759,Mike D Rogers (R),2016,Commercial Banks,9150,23200,32350
S001181,N00024790,Jeanne Shaheen (D),2016,Women's Issues,759879,34500,794379
S001181,N00024790,Jeanne Shaheen (D),2016,Lawyers/Law Firms,660812,103575,764387
S001181,N00024790,Jeanne Shaheen (D),2016,Retired,623787,0,623787
S001181,N00024790,Jeanne Shaheen (D),2016,Leadership PACs,0,477600,477600
S001181,N00024790,Jeanne Shaheen (D),2016,Securities & Investment,271541,55833,327374
S001181,N00024790,Jeanne Shaheen (D),2016,Real Estate,279614,47040,326654
S001181,N00024790,Jeanne Shaheen (D),2016,Lobbyists,269168,11000,280168
S001181,N00024790,Jeanne Shaheen (D),2016,TV/Movies/Music,205839,24500,230339
S001181,N00024790,Jeanne Shaheen (D),2016,Environment,181328,37485,218813
S001181,N00024790,Jeanne Shaheen (D),2016,Health Professionals,97991,116500,214491
W000795,N00024809,Joe Wilson (R),2016,Defense Aerospace,1000,80500,81500
W000795,N00024809,Joe Wilson (R),2016,Insurance,7150,48000,55150
W000795,N00024809,Joe Wilson (R),2016,Defense Electronics,0,52000,52000
W000795,N00024809,Joe Wilson (R),2016,Lawyers/Law Firms,27525,17000,44525
W000795,N00024809,Joe Wilson (R),2016,Electric Utilities,3000,40200,43200
W000795,N00024809,Joe Wilson (R),2016,Retired,43180,0,43180
W000795,N00024809,Joe Wilson (R),2016,Health Professionals,11050,31500,42550
W000795,N00024809,Joe Wilson (R),2016,Misc Defense,11650,30000,41650
W000795,N00024809,Joe Wilson (R),2016,Real Estate,24650,14000,38650
W000795,N00024809,Joe Wilson (R),2016,Securities & Investment,20300,14000,34300
C001069,N00024842,Joe Courtney (D),2016,Insurance,2150,85000,87150
C001069,N00024842,Joe Courtney (D),2016,Health Professionals,12125,61250,73375
C001069,N00024842,Joe Courtney (D),2016,Defense Aerospace,150,56500,56650
C001069,N00024842,Joe Courtney (D),2016,Building Trade Unions,0,55500,55500
C001069,N00024842,Joe Courtney (D),2016,Public Sector Unions,0,50500,50500
C001069,N00024842,Joe Courtney (D),2016,Lawyers/Law Firms,28575,18000,46575
C001069,N00024842,Joe Courtney (D),2016,Retired,44475,0,44475
C001069,N00024842,Joe Courtney (D),2016,Industrial Unions,0,41000,41000
C001069,N00024842,Joe Courtney (D),2016,Defense Electronics,9850,31000,40850
C001069,N00024842,Joe Courtney (D),2016,Pharmaceuticals/Health Products,8000,28900,36900
C001056,N00024852,John Cornyn (R),2016,Securities & Investment,1006193,181000,1187193
C001056,N00024852,John Cornyn (R),2016,Oil & Gas,807956,293500,1101456
C001056,N00024852,John Cornyn (R),2016,Health Professionals,615200,222949,838149
C001056,N00024852,John Cornyn (R),2016,Lawyers/Law Firms,470857,188050,658907
C001056,N00024852,John Cornyn (R),2016,Real Estate,494249,87000,581249
C001056,N00024852,John Cornyn (R),2016,Retired,562799,0,562799
C001056,N00024852,John Cornyn (R),2016,Insurance,162750,255853,418603
C001056,N00024852,John Cornyn (R),2016,Commercial Banks,229215,124000,353215
C001056,N00024852,John Cornyn (R),2016,Leadership PACs,0,332358,332358
C001056,N00024852,John Cornyn (R),2016,Pharmaceuticals/Health Products,102350,224250,326600
B001245,N00024866,Madeleine Z Bordallo (D),2016,Retail Sales,12800,0,12800
B001245,N00024866,Madeleine Z Bordallo (D),2016,Defense Aerospace,0,12000,12000
B001245,N00024866,Madeleine Z Bordallo (D),2016,Real Estate,5450,3000,8450
B001245,N00024866,Madeleine Z Bordallo (D),2016,Transportation Unions,0,7000,7000
B001245,N00024866,Madeleine Z Bordallo (D),2016,Defense Electronics,1000,6000,7000
B001245,N00024866,Madeleine Z Bordallo (D),2016,Misc Defense,6000,500,6500
B001245,N00024866,Madeleine Z Bordallo (D),2016,Retired,6260,0,6260
B001245,N00024866,Madeleine Z Bordallo (D),2016,Commercial Banks,5350,0,5350
B001245,N00024866,Madeleine Z Bordallo (D),2016,Food Processing & Sales,5050,0,5050
B001245,N00024866,Madeleine Z Bordallo (D),2016,Human Rights,0,5000,5000
B001245,N00024866,Madeleine Z Bordallo (D),2016,Sea Transport,500,4500,5000
S001156,N00024870,Linda Sanchez (D),2016,Insurance,0,120500,120500
S001156,N00024870,Linda Sanchez (D),2016,Pharmaceuticals/Health Products,250,111700,111950
S001156,N00024870,Linda Sanchez (D),2016,Health Professionals,2379,63500,65879
S001156,N00024870,Linda Sanchez (D),2016,Securities & Investment,1000,61500,62500
S001156,N00024870,Linda Sanchez (D),2016,Public Sector Unions,250,58500,58750
S001156,N00024870,Linda Sanchez (D),2016,Health Services/HMOs,12500,43250,55750
S001156,N00024870,Linda Sanchez (D),2016,Real Estate,11925,42500,54425
S001156,N00024870,Linda Sanchez (D),2016,Lawyers/Law Firms,26855,24750,51605
S001156,N00024870,Linda Sanchez (D),2016,Retail Sales,5900,37000,42900
S001156,N00024870,Linda Sanchez (D),2016,Industrial Unions,0,42500,42500
S001157,N00024871,David Scott (D),2016,Insurance,1000,140500,141500
S001157,N00024871,David Scott (D),2016,Securities & Investment,10950,113000,123950
S001157,N00024871,David Scott (D),2016,Commercial Banks,0,112000,112000
S001157,N00024871,David Scott (D),2016,Health Professionals,10500,86500,97000
S001157,N00024871,David Scott (D),2016,Finance/Credit Companies,5000,63000,68000
S001157,N00024871,David Scott (D),2016,Real Estate,23300,37000,60300
S001157,N00024871,David Scott (D),2016,Accountants,750,45500,46250
S001157,N00024871,David Scott (D),2016,Industrial Unions,0,36000,36000
S001157,N00024871,David Scott (D),2016,Crop Production & Basic Processing,0,34000,34000
S001157,N00024871,David Scott (D),2016,Transportation Unions,0,25000,25000
H001036,N00024922,Jeb Hensarling (R),2016,Securities & Investment,113745,185000,298745
H001036,N00024922,Jeb Hensarling (R),2016,Insurance,41700,240000,281700
H001036,N00024922,Jeb Hensarling (R),2016,Commercial Banks,72700,199600,272300
H001036,N00024922,Jeb Hensarling (R),2016,Real Estate,46750,112500,159250
H001036,N00024922,Jeb Hensarling (R),2016,Misc Finance,65850,42000,107850
H001036,N00024922,Jeb Hensarling (R),2016,Retired,93581,0,93581
H001036,N00024922,Jeb Hensarling (R),2016,Finance/Credit Companies,15700,67500,83200
H001036,N00024922,Jeb Hensarling (R),2016,Lawyers/Law Firms,40700,39650,80350
H001036,N00024922,Jeb Hensarling (R),2016,Oil & Gas,15400,44000,59400
H001036,N00024922,Jeb Hensarling (R),2016,Accountants,2300,55000,57300
C001063,N00024978,Henry Cuellar (D),2016,Oil & Gas,20650,131202,151852
C001063,N00024978,Henry Cuellar (D),2016,Lawyers/Law Firms,59841,22450,82291
C001063,N00024978,Henry Cuellar (D),2016,Crop Production & Basic Processing,16600,48000,64600
C001063,N00024978,Henry Cuellar (D),2016,Health Professionals,37097,22500,59597
C001063,N00024978,Henry Cuellar (D),2016,Insurance,2250,53000,55250
C001063,N00024978,Henry Cuellar (D),2016,Retail Sales,21178,27000,48178
C001063,N00024978,Henry Cuellar (D),2016,Real Estate,31200,16500,47700
C001063,N00024978,Henry Cuellar (D),2016,Automotive,11350,31995,43345
C001063,N00024978,Henry Cuellar (D),2016,Construction Services,26300,16000,42300
C001063,N00024978,Henry Cuellar (D),2016,Trucking,6900,27122,34022
M001151,N00024992,Tim Murphy (R),2016,Health Professionals,12640,123500,136140
M001151,N00024992,Tim Murphy (R),2016,Pharmaceuticals/Health Products,1000,94500,95500
M001151,N00024992,Tim Murphy (R),2016,Electric Utilities,5500,70500,76000
M001151,N00024992,Tim Murphy (R),2016,Oil & Gas,7250,49500,56750
M001151,N00024992,Tim Murphy (R),2016,Lawyers/Law Firms,31500,20500,52000
M001151,N00024992,Tim Murphy (R),2016,Real Estate,23750,17000,40750
M001151,N00024992,Tim Murphy (R),2016,Insurance,5250,31500,36750
M001151,N00024992,Tim Murphy (R),2016,Steel Production,8750,26500,35250
M001151,N00024992,Tim Murphy (R),2016,Special Trade Contractors,12950,21000,33950
M001151,N00024992,Tim Murphy (R),2016,Chemical & Related Manufacturing,4500,29000,33500
M001151,N00024992,Tim Murphy (R),2016,Health Services/HMOs,10000,23500,33500
C001051,N00025095,John Carter (R),2016,Defense Electronics,0,55500,55500
C001051,N00025095,John Carter (R),2016,Defense Aerospace,0,54000,54000
C001051,N00025095,John Carter (R),2016,Air Transport,750,47500,48250
C001051,N00025095,John Carter (R),2016,Oil & Gas,31900,11000,42900
C001051,N00025095,John Carter (R),2016,Real Estate,28694,13000,41694
C001051,N00025095,John Carter (R),2016,Misc Defense,6250,35000,41250
C001051,N00025095,John Carter (R),2016,Lawyers/Law Firms,23981,15249,39230
C001051,N00025095,John Carter (R),2016,Lobbyists,38225,0,38225
C001051,N00025095,John Carter (R),2016,Sea Transport,28299,2500,30799
C001051,N00025095,John Carter (R),2016,Automotive,17300,13000,30300
T000463,N00025175,Michael R Turner (R),2016,Defense Aerospace,30000,70500,100500
T000463,N00025175,Michael R Turner (R),2016,Defense Electronics,10800,65300,76100
T000463,N00025175,Michael R Turner (R),2016,Misc Defense,0,51500,51500
T000463,N00025175,Michael R Turner (R),2016,Misc Manufacturing & Distributing,26400,12000,38400
T000463,N00025175,Michael R Turner (R),2016,Retired,33925,0,33925
T000463,N00025175,Michael R Turner (R),2016,Securities & Investment,30378,3500,33878
T000463,N00025175,Michael R Turner (R),2016,Real Estate,14400,15000,29400
T000463,N00025175,Michael R Turner (R),2016,Building Trade Unions,0,29000,29000
T000463,N00025175,Michael R Turner (R),2016,Lobbyists,21750,2000,23750
T000463,N00025175,Michael R Turner (R),2016,Business Services,21900,1000,22900
B001248,N00025219,Michael Burgess (R),2016,Health Professionals,83215,277666,360881
B001248,N00025219,Michael Burgess (R),2016,Pharmaceuticals/Health Products,250,128350,128600
B001248,N00025219,Michael Burgess (R),2016,Health Services/HMOs,11950,65500,77450
B001248,N00025219,Michael Burgess (R),2016,Automotive,1500,46500,48000
B001248,N00025219,Michael Burgess (R),2016,Oil & Gas,8100,35000,43100
B001248,N00025219,Michael Burgess (R),2016,Lawyers/Law Firms,15394,23000,38394
B001248,N00025219,Michael Burgess (R),2016,Insurance,1594,34500,36094
B001248,N00025219,Michael Burgess (R),2016,Lobbyists,34985,500,35485
B001248,N00025219,Michael Burgess (R),2016,Retired,30850,0,30850
B001248,N00025219,Michael Burgess (R),2016,Telecom Services,0,28500,28500
K000362,N00025237,Steven A King (R),2016,Retired,98177,0,98177
K000362,N00025237,Steven A King (R),2016,Republican/Conservative,37654,31935,69589
K000362,N00025237,Steven A King (R),2016,Crop Production & Basic Processing,26577,24500,51077
K000362,N00025237,Steven A King (R),2016,Misc Business,36082,0,36082
K000362,N00025237,Steven A King (R),2016,Agricultural Services/Products,11550,23000,34550
K000362,N00025237,Steven A King (R),2016,Commercial Banks,13650,12000,25650
K000362,N00025237,Steven A King (R),2016,Real Estate,19600,4000,23600
K000362,N00025237,Steven A King (R),2016,Livestock,5400,16000,21400
K000362,N00025237,Steven A King (R),2016,Gun Rights,8390,11000,19390
K000362,N00025237,Steven A King (R),2016,Misc Energy,10850,8250,19100
R000577,N00025280,Tim Ryan (D),2016,Transportation Unions,0,51700,51700
R000577,N00025280,Tim Ryan (D),2016,Industrial Unions,0,50000,50000
R000577,N00025280,Tim Ryan (D),2016,Building Trade Unions,218,47500,47718
R000577,N00025280,Tim Ryan (D),2016,Public Sector Unions,2700,42000,44700
R000577,N00025280,Tim Ryan (D),2016,Misc Manufacturing & Distributing,8600,32000,40600
R000577,N00025280,Tim Ryan (D),2016,Lawyers/Law Firms,27001,12000,39001
R000577,N00025280,Tim Ryan (D),2016,Defense Aerospace,1000,37500,38500
R000577,N00025280,Tim Ryan (D),2016,Automotive,3700,29500,33200
R000577,N00025280,Tim Ryan (D),2016,Chemical & Related Manufacturing,14500,16000,30500
R000577,N00025280,Tim Ryan (D),2016,Real Estate,20500,6000,26500
G000551,N00025284,Raul M Grijalva (D),2016,Public Sector Unions,1,62000,62001
G000551,N00025284,Raul M Grijalva (D),2016,Casinos/Gambling,55400,0,55400
G000551,N00025284,Raul M Grijalva (D),2016,Transportation Unions,0,38500,38500
G000551,N00025284,Raul M Grijalva (D),2016,Misc Unions,0,35250,35250
G000551,N00025284,Raul M Grijalva (D),2016,Lawyers/Law Firms,9314,19050,28364
G000551,N00025284,Raul M Grijalva (D),2016,Industrial Unions,0,26000,26000
G000551,N00025284,Raul M Grijalva (D),2016,Retired,25435,0,25435
G000551,N00025284,Raul M Grijalva (D),2016,Democratic/Liberal,18968,5500,24468
G000551,N00025284,Raul M Grijalva (D),2016,Environment,3875,13453,17328
G000551,N00025284,Raul M Grijalva (D),2016,Crop Production & Basic Processing,3100,12000,15100
B001250,N00025292,Rob Bishop (R),2016,Oil & Gas,11516,139000,150516
B001250,N00025292,Rob Bishop (R),2016,Casinos/Gambling,78700,10000,88700
B001250,N00025292,Rob Bishop (R),2016,Lawyers/Law Firms,24700,38250,62950
B001250,N00025292,Rob Bishop (R),2016,Lobbyists,49099,1000,50099
B001250,N00025292,Rob Bishop (R),2016,Electric Utilities,1750,40000,41750
B001250,N00025292,Rob Bishop (R),2016,Real Estate,17850,20500,38350
B001250,N00025292,Rob Bishop (R),2016,Defense Aerospace,0,33000,33000
B001250,N00025292,Rob Bishop (R),2016,Forestry & Forest Products,8000,21398,29398
B001250,N00025292,Rob Bishop (R),2016,Mining,250,28500,28750
B001250,N00025292,Rob Bishop (R),2016,Retired,26400,0,26400
D000600,N00025337,Mario Diaz-Balart (R),2016,Transportation Unions,0,85125,85125
D000600,N00025337,Mario Diaz-Balart (R),2016,Real Estate,36800,44000,80800
D000600,N00025337,Mario Diaz-Balart (R),2016,Lawyers/Law Firms,40000,39500,79500
D000600,N00025337,Mario Diaz-Balart (R),2016,Air Transport,4200,63000,67200
D000600,N00025337,Mario Diaz-Balart (R),2016,Railroads,2500,41500,44000
D000600,N00025337,Mario Diaz-Balart (R),2016,Lobbyists,43150,0,43150
D000600,N00025337,Mario Diaz-Balart (R),2016,Trucking,3500,38500,42000
D000600,N00025337,Mario Diaz-Balart (R),2016,Automotive,32465,6500,38965
D000600,N00025337,Mario Diaz-Balart (R),2016,Defense Aerospace,0,38500,38500
D000600,N00025337,Mario Diaz-Balart (R),2016,Building Materials & Equipment,0,38000,38000
K000392,N00025445,David Kustoff (R),2016,Lawyers/Law Firms,102550,0,102550
K000392,N00025445,David Kustoff (R),2016,Retired,82075,0,82075
K000392,N00025445,David Kustoff (R),2016,Real Estate,58925,10000,68925
K000392,N00025445,David Kustoff (R),2016,General Contractors,58400,0,58400
K000392,N00025445,David Kustoff (R),2016,Insurance,29050,17200,46250
K000392,N00025445,David Kustoff (R),2016,Leadership PACs,0,37000,37000
K000392,N00025445,David Kustoff (R),2016,Commercial Banks,21050,11500,32550
K000392,N00025445,David Kustoff (R),2016,Automotive,20650,7500,28150
K000392,N00025445,David Kustoff (R),2016,Civil Servants/Public Officials,26800,0,26800
K000392,N00025445,David Kustoff (R),2016,Health Professionals,23050,2500,25550
R000576,N00025482,Dutch Ruppersberger (D),2016,Health Professionals,11100,67500,78600
R000576,N00025482,Dutch Ruppersberger (D),2016,Real Estate,59875,15500,75375
R000576,N00025482,Dutch Ruppersberger (D),2016,Misc Defense,11200,58500,69700
R000576,N00025482,Dutch Ruppersberger (D),2016,Defense Electronics,250,48000,48250
R000576,N00025482,Dutch Ruppersberger (D),2016,Public Sector Unions,0,46500,46500
R000576,N00025482,Dutch Ruppersberger (D),2016,Lawyers/Law Firms,29685,14200,43885
R000576,N00025482,Dutch Ruppersberger (D),2016,Defense Aerospace,5710,35500,41210
R000576,N00025482,Dutch Ruppersberger (D),2016,Industrial Unions,100,34150,34250
R000576,N00025482,Dutch Ruppersberger (D),2016,Telecom Services,5400,27000,32400
R000576,N00025482,Dutch Ruppersberger (D),2016,Accountants,2000,27500,29500
B001269,N00025495,Lou Barletta (R),2016,Railroads,2550,55775,58325
B001269,N00025495,Lou Barletta (R),2016,Construction Services,18519,34000,52519
B001269,N00025495,Lou Barletta (R),2016,Air Transport,1000,48500,49500
B001269,N00025495,Lou Barletta (R),2016,Trucking,15200,33500,48700
B001269,N00025495,Lou Barletta (R),2016,Building Materials & Equipment,12000,33500,45500
B001269,N00025495,Lou Barletta (R),2016,Insurance,3606,40000,43606
B001269,N00025495,Lou Barletta (R),2016,Lawyers/Law Firms,23310,11500,34810
B001269,N00025495,Lou Barletta (R),2016,Oil & Gas,2300,32000,34300
B001269,N00025495,Lou Barletta (R),2016,Transportation Unions,0,33000,33000
B001269,N00025495,Lou Barletta (R),2016,Retired,32745,0,32745
C001053,N00025726,Tom Cole (R),2016,Human Rights,169600,9500,179100
C001053,N00025726,Tom Cole (R),2016,Oil & Gas,28850,80500,109350
C001053,N00025726,Tom Cole (R),2016,Lobbyists,76374,669,77043
C001053,N00025726,Tom Cole (R),2016,Retired,72150,0,72150
C001053,N00025726,Tom Cole (R),2016,Lawyers/Law Firms,34000,33000,67000
C001053,N00025726,Tom Cole (R),2016,Insurance,9200,57700,66900
C001053,N00025726,Tom Cole (R),2016,Health Professionals,4922,61000,65922
C001053,N00025726,Tom Cole (R),2016,Real Estate,31000,22500,53500
C001053,N00025726,Tom Cole (R),2016,Defense Aerospace,0,49000,49000
C001053,N00025726,Tom Cole (R),2016,Commercial Banks,25650,17400,43050
H001050,N00025881,Colleen Hanabusa (D),2016,Retired,81200,0,81200
H001050,N00025881,Colleen Hanabusa (D),2016,Real Estate,49650,12700,62350
H001050,N00025881,Colleen Hanabusa (D),2016,Building Trade Unions,0,45000,45000
H001050,N00025881,Colleen Hanabusa (D),2016,General Contractors,37800,0,37800
H001050,N00025881,Colleen Hanabusa (D),2016,Commercial Banks,21700,8400,30100
H001050,N00025881,Colleen Hanabusa (D),2016,Sea Transport,14700,13500,28200
H001050,N00025881,Colleen Hanabusa (D),2016,Public Sector Unions,0,26500,26500
H001050,N00025881,Colleen Hanabusa (D),2016,Leadership PACs,0,25500,25500
H001050,N00025881,Colleen Hanabusa (D),2016,Industrial Unions,0,24500,24500
H001050,N00025881,Colleen Hanabusa (D),2016,Construction Services,23750,500,24250
C001062,N00026041,Mike Conaway (R),2016,Crop Production & Basic Processing,73970,149000,222970
C001062,N00026041,Mike Conaway (R),2016,Agricultural Services/Products,2700,195610,198310
C001062,N00026041,Mike Conaway (R),2016,Securities & Investment,16200,113000,129200
C001062,N00026041,Mike Conaway (R),2016,Oil & Gas,61591,66833,128424
C001062,N00026041,Mike Conaway (R),2016,Dairy,41200,44750,85950
C001062,N00026041,Mike Conaway (R),2016,Livestock,39450,44000,83450
C001062,N00026041,Mike Conaway (R),2016,Commercial Banks,18400,52000,70400
C001062,N00026041,Mike Conaway (R),2016,Food Processing & Sales,8000,61000,69000
C001062,N00026041,Mike Conaway (R),2016,Accountants,21350,47500,68850
C001062,N00026041,Mike Conaway (R),2016,Lawyers/Law Firms,29350,13200,42550
N000182,N00026043,Randy Neugebauer (R),2016,Commercial Banks,4750,38000,42750
N000182,N00026043,Randy Neugebauer (R),2016,Insurance,250,40000,40250
N000182,N00026043,Randy Neugebauer (R),2016,Securities & Investment,0,38500,38500
N000182,N00026043,Randy Neugebauer (R),2016,Real Estate,4450,20000,24450
N000182,N00026043,Randy Neugebauer (R),2016,Accountants,2700,15500,18200
N000182,N00026043,Randy Neugebauer (R),2016,Livestock,2000,11000,13000
N000182,N00026043,Randy Neugebauer (R),2016,Agricultural Services/Products,0,11500,11500
N000182,N00026043,Randy Neugebauer (R),2016,Misc Finance,1500,9500,11000
N000182,N00026043,Randy Neugebauer (R),2016,Finance/Credit Companies,0,10000,10000
N000182,N00026043,Randy Neugebauer (R),2016,Lobbyists,9000,0,9000
M001153,N00026050,Lisa Murkowski (R),2016,Oil & Gas,429996,379600,809596
M001153,N00026050,Lisa Murkowski (R),2016,Electric Utilities,203612,394500,598112
M001153,N00026050,Lisa Murkowski (R),2016,Leadership PACs,0,438993,438993
M001153,N00026050,Lisa Murkowski (R),2016,Securities & Investment,286353,40500,326853
M001153,N00026050,Lisa Murkowski (R),2016,Lawyers/Law Firms,169251,145700,314951
M001153,N00026050,Lisa Murkowski (R),2016,Lobbyists,193967,7500,201467
M001153,N00026050,Lisa Murkowski (R),2016,Real Estate,161550,32500,194050
M001153,N00026050,Lisa Murkowski (R),2016,Misc Energy,90800,86168,176968
M001153,N00026050,Lisa Murkowski (R),2016,Retired,174735,0,174735
M001153,N00026050,Lisa Murkowski (R),2016,Food & Beverage,76250,87500,163750
W000797,N00026106,Debbie Wasserman Schultz (D),2016,Lawyers/Law Firms,284090,31180,315270
W000797,N00026106,Debbie Wasserman Schultz (D),2016,Retired,197374,0,197374
W000797,N00026106,Debbie Wasserman Schultz (D),2016,Securities & Investment,135775,16000,151775
W000797,N00026106,Debbie Wasserman Schultz (D),2016,Real Estate,134622,16500,151122
W000797,N00026106,Debbie Wasserman Schultz (D),2016,Women's Issues,96304,11690,107994
W000797,N00026106,Debbie Wasserman Schultz (D),2016,Leadership PACs,1000,103000,104000
W000797,N00026106,Debbie Wasserman Schultz (D),2016,Health Professionals,65943,24000,89943
W000797,N00026106,Debbie Wasserman Schultz (D),2016,Pro-Israel,75600,12009,87609
W000797,N00026106,Debbie Wasserman Schultz (D),2016,TV/Movies/Music,57065,28500,85565
W000797,N00026106,Debbie Wasserman Schultz (D),2016,Democratic/Liberal,54492,17500,71992
G000552,N00026148,Louis B Gohmert Jr (R),2016,Retired,110703,0,110703
G000552,N00026148,Louis B Gohmert Jr (R),2016,Health Professionals,29450,250,29700
G000552,N00026148,Louis B Gohmert Jr (R),2016,Oil & Gas,21200,6500,27700
G000552,N00026148,Louis B Gohmert Jr (R),2016,Real Estate,19090,6000,25090
G000552,N00026148,Louis B Gohmert Jr (R),2016,Republican/Conservative,9300,14390,23690
G000552,N00026148,Louis B Gohmert Jr (R),2016,Misc Finance,21750,0,21750
G000552,N00026148,Louis B Gohmert Jr (R),2016,Forestry & Forest Products,8600,12000,20600
G000552,N00026148,Louis B Gohmert Jr (R),2016,Construction Services,14000,0,14000
G000552,N00026148,Louis B Gohmert Jr (R),2016,Insurance,10600,2500,13100
G000552,N00026148,Louis B Gohmert Jr (R),2016,Commercial Banks,10700,500,11200
P000591,N00026160,Tom Price (R),2016,Health Professionals,171177,218693,389870
P000591,N00026160,Tom Price (R),2016,Pharmaceuticals/Health Products,21900,143000,164900
P000591,N00026160,Tom Price (R),2016,Insurance,33300,116250,149550
P000591,N00026160,Tom Price (R),2016,Real Estate,83000,41500,124500
P000591,N00026160,Tom Price (R),2016,Retired,103352,0,103352
P000591,N00026160,Tom Price (R),2016,Health Services/HMOs,15550,64700,80250
P000591,N00026160,Tom Price (R),2016,Securities & Investment,16150,45000,61150
P000591,N00026160,Tom Price (R),2016,Commercial Banks,2250,58500,60750
P000591,N00026160,Tom Price (R),2016,Lawyers/Law Firms,18550,33250,51800
P000591,N00026160,Tom Price (R),2016,Hospitals/Nursing Homes,10750,26000,36750
W000796,N00026163,Lynn A Westmoreland (R),2016,Real Estate,15950,24000,39950
W000796,N00026163,Lynn A Westmoreland (R),2016,Insurance,4825,31762,36587
W000796,N00026163,Lynn A Westmoreland (R),2016,Commercial Banks,5200,24500,29700
W000796,N00026163,Lynn A Westmoreland (R),2016,Crop Production & Basic Processing,7000,11000,18000
W000796,N00026163,Lynn A Westmoreland (R),2016,Leadership PACs,0,17000,17000
W000796,N00026163,Lynn A Westmoreland (R),2016,Finance/Credit Companies,3000,11500,14500
W000796,N00026163,Lynn A Westmoreland (R),2016,Health Professionals,2250,12000,14250
W000796,N00026163,Lynn A Westmoreland (R),2016,Securities & Investment,3700,10000,13700
W000796,N00026163,Lynn A Westmoreland (R),2016,Air Transport,5700,7500,13200
W000796,N00026163,Lynn A Westmoreland (R),2016,Food & Beverage,1350,8500,9850
F000450,N00026166,Virginia Foxx (R),2016,Retired,152745,0,152745
F000450,N00026166,Virginia Foxx (R),2016,Education,99625,28000,127625
F000450,N00026166,Virginia Foxx (R),2016,Lawyers/Law Firms,31800,30750,62550
F000450,N00026166,Virginia Foxx (R),2016,Health Professionals,20229,37100,57329
F000450,N00026166,Virginia Foxx (R),2016,Securities & Investment,28700,27000,55700
F000450,N00026166,Virginia Foxx (R),2016,Food & Beverage,8500,36000,44500
F000450,N00026166,Virginia Foxx (R),2016,Misc Manufacturing & Distributing,32550,11000,43550
F000450,N00026166,Virginia Foxx (R),2016,Retail Sales,8750,32000,40750
F000450,N00026166,Virginia Foxx (R),2016,Insurance,3300,33200,36500
F000450,N00026166,Virginia Foxx (R),2016,Real Estate,26550,9000,35550
D000604,N00026171,Charlie Dent (R),2016,Health Professionals,22150,122000,144150
D000604,N00026171,Charlie Dent (R),2016,Pharmaceuticals/Health Products,9900,127650,137550
D000604,N00026171,Charlie Dent (R),2016,Retired,65175,0,65175
D000604,N00026171,Charlie Dent (R),2016,Lawyers/Law Firms,34300,26750,61050
D000604,N00026171,Charlie Dent (R),2016,Chemical & Related Manufacturing,13500,46500,60000
D000604,N00026171,Charlie Dent (R),2016,Insurance,10500,42300,52800
D000604,N00026171,Charlie Dent (R),2016,Misc Manufacturing & Distributing,18140,31500,49640
D000604,N00026171,Charlie Dent (R),2016,Electric Utilities,3000,43500,46500
D000604,N00026171,Charlie Dent (R),2016,Lobbyists,45150,0,45150
D000604,N00026171,Charlie Dent (R),2016,Building Materials & Equipment,2700,40000,42700
M001159,N00026314,Cathy McMorris Rodgers (R),2016,Securities & Investment,186500,39500,226000
M001159,N00026314,Cathy McMorris Rodgers (R),2016,Health Professionals,41550,150750,192300
M001159,N00026314,Cathy McMorris Rodgers (R),2016,Real Estate,146360,34000,180360
M001159,N00026314,Cathy McMorris Rodgers (R),2016,Insurance,26070,123500,149570
M001159,N00026314,Cathy McMorris Rodgers (R),2016,Retired,148379,0,148379
M001159,N00026314,Cathy McMorris Rodgers (R),2016,Pharmaceuticals/Health Products,29650,108150,137800
M001159,N00026314,Cathy McMorris Rodgers (R),2016,Oil & Gas,17100,96500,113600
M001159,N00026314,Cathy McMorris Rodgers (R),2016,Lawyers/Law Firms,61905,28000,89905
M001159,N00026314,Cathy McMorris Rodgers (R),2016,Food & Beverage,54520,34500,89020
M001159,N00026314,Cathy McMorris Rodgers (R),2016,Forestry & Forest Products,30450,55750,86200
C001059,N00026341,Jim Costa (D),2016,Crop Production & Basic Processing,111000,82100,193100
C001059,N00026341,Jim Costa (D),2016,Oil & Gas,3000,92525,95525
C001059,N00026341,Jim Costa (D),2016,Agricultural Services/Products,2750,80500,83250
C001059,N00026341,Jim Costa (D),2016,Livestock,34999,26700,61699
C001059,N00026341,Jim Costa (D),2016,Real Estate,49000,12500,61500
C001059,N00026341,Jim Costa (D),2016,Misc Issues,53000,2500,55500
C001059,N00026341,Jim Costa (D),2016,Health Professionals,43700,7500,51200
C001059,N00026341,Jim Costa (D),2016,Lawyers/Law Firms,34250,13000,47250
C001059,N00026341,Jim Costa (D),2016,Leadership PACs,0,47250,47250
C001059,N00026341,Jim Costa (D),2016,Electric Utilities,2650,42250,44900
W000798,N00026368,Tim Walberg (R),2016,Leadership PACs,0,271620,271620
W000798,N00026368,Tim Walberg (R),2016,Retired,123555,0,123555
W000798,N00026368,Tim Walberg (R),2016,Automotive,42300,48495,90795
W000798,N00026368,Tim Walberg (R),2016,Misc Manufacturing & Distributing,74200,16000,90200
W000798,N00026368,Tim Walberg (R),2016,Insurance,24214,60500,84714
W000798,N00026368,Tim Walberg (R),2016,Real Estate,52600,27700,80300
W000798,N00026368,Tim Walberg (R),2016,Candidate Committees,2834,58200,61034
W000798,N00026368,Tim Walberg (R),2016,Securities & Investment,48500,12000,60500
W000798,N00026368,Tim Walberg (R),2016,Electric Utilities,23625,35500,59125
W000798,N00026368,Tim Walberg (R),2016,Republican/Conservative,32922,25700,58622
K000389,N00026427,Ro Khanna (D),2016,Securities & Investment,759975,0,759975
K000389,N00026427,Ro Khanna (D),2016,Retired,264801,0,264801
K000389,N00026427,Ro Khanna (D),2016,Electronics Mfg & Equip,238022,0,238022
K000389,N00026427,Ro Khanna (D),2016,Internet,191620,0,191620
K000389,N00026427,Ro Khanna (D),2016,Lawyers/Law Firms,152951,0,152951
K000389,N00026427,Ro Khanna (D),2016,Real Estate,124800,0,124800
K000389,N00026427,Ro Khanna (D),2016,Business Services,90700,0,90700
K000389,N00026427,Ro Khanna (D),2016,Health Professionals,80401,0,80401
K000389,N00026427,Ro Khanna (D),2016,Misc Finance,74000,0,74000
K000389,N00026427,Ro Khanna (D),2016,Education,52100,0,52100
P000592,N00026457,Ted Poe (R),2016,Oil & Gas,23500,44200,67700
P000592,N00026457,Ted Poe (R),2016,Real Estate,39400,10500,49900
P000592,N00026457,Ted Poe (R),2016,Lawyers/Law Firms,27505,19750,47255
P000592,N00026457,Ted Poe (R),2016,Retired,44475,0,44475
P000592,N00026457,Ted Poe (R),2016,Crop Production & Basic Processing,2000,30500,32500
P000592,N00026457,Ted Poe (R),2016,Construction Services,20850,8000,28850
P000592,N00026457,Ted Poe (R),2016,Retail Sales,2750,23500,26250
P000592,N00026457,Ted Poe (R),2016,Misc Manufacturing & Distributing,7400,14000,21400
P000592,N00026457,Ted Poe (R),2016,Automotive,3200,17500,20700
P000592,N00026457,Ted Poe (R),2016,Misc Finance,20050,0,20050
M001157,N00026460,Michael McCaul (R),2016,Oil & Gas,45050,72900,117950
M001157,N00026460,Michael McCaul (R),2016,Real Estate,97791,15000,112791
M001157,N00026460,Michael McCaul (R),2016,Retired,79825,0,79825
M001157,N00026460,Michael McCaul (R),2016,Electronics Mfg & Equip,13700,62500,76200
M001157,N00026460,Michael McCaul (R),2016,Air Transport,32450,38499,70949
M001157,N00026460,Michael McCaul (R),2016,Lawyers/Law Firms,45500,24500,70000
M001157,N00026460,Michael McCaul (R),2016,Securities & Investment,53100,9500,62600
M001157,N00026460,Michael McCaul (R),2016,Misc Finance,56600,3500,60100
M001157,N00026460,Michael McCaul (R),2016,Electric Utilities,2700,48500,51200
M001157,N00026460,Michael McCaul (R),2016,Automotive,26800,18500,45300
D000607,N00026586,Joe Donnelly (D),2016,Lawyers/Law Firms,800739,74594,875333
D000607,N00026586,Joe Donnelly (D),2016,Leadership PACs,2750,387750,390500
D000607,N00026586,Joe Donnelly (D),2016,Securities & Investment,213335,140000,353335
D000607,N00026586,Joe Donnelly (D),2016,Retired,312382,0,312382
D000607,N00026586,Joe Donnelly (D),2016,Pharmaceuticals/Health Products,87312,163571,250883
D000607,N00026586,Joe Donnelly (D),2016,Insurance,30601,210000,240601
D000607,N00026586,Joe Donnelly (D),2016,Lobbyists,191910,35500,227410
D000607,N00026586,Joe Donnelly (D),2016,Real Estate,145869,46000,191869
D000607,N00026586,Joe Donnelly (D),2016,Education,151879,2500,154379
D000607,N00026586,Joe Donnelly (D),2016,Commercial Banks,56731,94250,150981
B001255,N00026595,Charles W Boustany Jr (R),2016,Health Professionals,274914,159200,434114
B001255,N00026595,Charles W Boustany Jr (R),2016,Oil & Gas,218037,192000,410037
B001255,N00026595,Charles W Boustany Jr (R),2016,Insurance,90164,162200,252364
B001255,N00026595,Charles W Boustany Jr (R),2016,Lobbyists,236582,9263,245845
B001255,N00026595,Charles W Boustany Jr (R),2016,Lawyers/Law Firms,156705,60900,217605
B001255,N00026595,Charles W Boustany Jr (R),2016,Retired,183025,0,183025
B001255,N00026595,Charles W Boustany Jr (R),2016,Securities & Investment,98850,74000,172850
B001255,N00026595,Charles W Boustany Jr (R),2016,Crop Production & Basic Processing,112866,44500,157366
B001255,N00026595,Charles W Boustany Jr (R),2016,Leadership PACs,0,144999,144999
B001255,N00026595,Charles W Boustany Jr (R),2016,Hospitals/Nursing Homes,64398,79000,143398
M001156,N00026627,Patrick McHenry (R),2016,Securities & Investment,179600,213150,392750
M001156,N00026627,Patrick McHenry (R),2016,Insurance,69125,281750,350875
M001156,N00026627,Patrick McHenry (R),2016,Commercial Banks,71250,145000,216250
M001156,N00026627,Patrick McHenry (R),2016,Real Estate,92525,100000,192525
M001156,N00026627,Patrick McHenry (R),2016,Lobbyists,125600,2000,127600
M001156,N00026627,Patrick McHenry (R),2016,Lawyers/Law Firms,78250,21800,100050
M001156,N00026627,Patrick McHenry (R),2016,Health Professionals,33800,57000,90800
M001156,N00026627,Patrick McHenry (R),2016,Retail Sales,26800,56500,83300
M001156,N00026627,Patrick McHenry (R),2016,Pharmaceuticals/Health Products,5025,68500,73525
M001156,N00026627,Patrick McHenry (R),2016,Accountants,3850,67000,70850
F000449,N00026631,Jeff Fortenberry (R),2016,Health Professionals,59450,11500,70950
F000449,N00026631,Jeff Fortenberry (R),2016,Insurance,11050,41500,52550
F000449,N00026631,Jeff Fortenberry (R),2016,Real Estate,27450,12000,39450
F000449,N00026631,Jeff Fortenberry (R),2016,Lawyers/Law Firms,17200,13000,30200
F000449,N00026631,Jeff Fortenberry (R),2016,Crop Production & Basic Processing,3250,26500,29750
F000449,N00026631,Jeff Fortenberry (R),2016,Defense Aerospace,0,25000,25000
F000449,N00026631,Jeff Fortenberry (R),2016,Agricultural Services/Products,3450,20500,23950
F000449,N00026631,Jeff Fortenberry (R),2016,Commercial Banks,3250,20500,23750
F000449,N00026631,Jeff Fortenberry (R),2016,Securities & Investment,21300,0,21300
F000449,N00026631,Jeff Fortenberry (R),2016,Republican/Conservative,2000,18500,20500
G000553,N00026686,Al Green (D),2016,Lawyers/Law Firms,82286,13100,95386
G000553,N00026686,Al Green (D),2016,Real Estate,58107,14000,72107
G000553,N00026686,Al Green (D),2016,Industrial Unions,0,40000,40000
G000553,N00026686,Al Green (D),2016,Construction Services,33600,2700,36300
G000553,N00026686,Al Green (D),2016,Building Trade Unions,0,33500,33500
G000553,N00026686,Al Green (D),2016,Education,26950,0,26950
G000553,N00026686,Al Green (D),2016,Transportation Unions,0,25500,25500
G000553,N00026686,Al Green (D),2016,Health Professionals,24800,0,24800
G000553,N00026686,Al Green (D),2016,Public Sector Unions,0,21500,21500
G000553,N00026686,Al Green (D),2016,Oil & Gas,14600,5500,20100
M001158,N00026710,Kenny Marchant (R),2016,Insurance,6100,97800,103900
M001158,N00026710,Kenny Marchant (R),2016,Oil & Gas,23400,65750,89150
M001158,N00026710,Kenny Marchant (R),2016,Real Estate,4750,48500,53250
M001158,N00026710,Kenny Marchant (R),2016,Commercial Banks,2500,47250,49750
M001158,N00026710,Kenny Marchant (R),2016,Securities & Investment,3200,39750,42950
M001158,N00026710,Kenny Marchant (R),2016,Accountants,0,29500,29500
M001158,N00026710,Kenny Marchant (R),2016,Automotive,6150,23000,29150
M001158,N00026710,Kenny Marchant (R),2016,Misc Finance,15500,11000,26500
M001158,N00026710,Kenny Marchant (R),2016,Health Professionals,4500,21750,26250
M001158,N00026710,Kenny Marchant (R),2016,Agricultural Services/Products,5400,17310,22710
C001061,N00026790,Emanuel Cleaver (D),2016,Insurance,0,174000,174000
C001061,N00026790,Emanuel Cleaver (D),2016,Real Estate,45800,49500,95300
C001061,N00026790,Emanuel Cleaver (D),2016,Lawyers/Law Firms,40700,27000,67700
C001061,N00026790,Emanuel Cleaver (D),2016,Securities & Investment,3200,55250,58450
C001061,N00026790,Emanuel Cleaver (D),2016,Industrial Unions,0,52000,52000
C001061,N00026790,Emanuel Cleaver (D),2016,Accountants,0,37500,37500
C001061,N00026790,Emanuel Cleaver (D),2016,Public Sector Unions,0,35000,35000
C001061,N00026790,Emanuel Cleaver (D),2016,Building Trade Unions,0,34000,34000
C001061,N00026790,Emanuel Cleaver (D),2016,Commercial Banks,0,33700,33700
C001061,N00026790,Emanuel Cleaver (D),2016,Misc Unions,1000,32500,33500
K000393,N00026823,John Kennedy (R),2016,Retired,625410,0,625410
K000393,N00026823,John Kennedy (R),2016,Lawyers/Law Firms,440750,33000,473750
K000393,N00026823,John Kennedy (R),2016,Real Estate,386690,10000,396690
K000393,N00026823,John Kennedy (R),2016,Oil & Gas,268900,108200,377100
K000393,N00026823,John Kennedy (R),2016,General Contractors,355150,10000,365150
K000393,N00026823,John Kennedy (R),2016,Health Professionals,286850,14000,300850
K000393,N00026823,John Kennedy (R),2016,Leadership PACs,0,191500,191500
K000393,N00026823,John Kennedy (R),2016,Sea Transport,122100,46700,168800
K000393,N00026823,John Kennedy (R),2016,Insurance,135412,28500,163912
K000393,N00026823,John Kennedy (R),2016,Automotive,142500,18500,161000
R000578,N00026885,Dave Reichert (R),2016,Insurance,7450,120000,127450
R000578,N00026885,Dave Reichert (R),2016,Retired,125550,0,125550
R000578,N00026885,Dave Reichert (R),2016,Securities & Investment,24750,47000,71750
R000578,N00026885,Dave Reichert (R),2016,Real Estate,27525,29000,56525
R000578,N00026885,Dave Reichert (R),2016,Health Professionals,16800,34000,50800
R000578,N00026885,Dave Reichert (R),2016,Forestry & Forest Products,17000,25500,42500
R000578,N00026885,Dave Reichert (R),2016,Building Trade Unions,0,40500,40500
R000578,N00026885,Dave Reichert (R),2016,Misc Manufacturing & Distributing,200,40000,40200
R000578,N00026885,Dave Reichert (R),2016,Accountants,10300,28500,38800
R000578,N00026885,Dave Reichert (R),2016,Pharmaceuticals/Health Products,0,38500,38500
M001160,N00026914,Gwen Moore (D),2016,Insurance,2350,168000,170350
M001160,N00026914,Gwen Moore (D),2016,Securities & Investment,7000,123000,130000
M001160,N00026914,Gwen Moore (D),2016,Casinos/Gambling,66700,0,66700
M001160,N00026914,Gwen Moore (D),2016,Commercial Banks,10650,40750,51400
M001160,N00026914,Gwen Moore (D),2016,Public Sector Unions,0,47000,47000
M001160,N00026914,Gwen Moore (D),2016,Accountants,250,46500,46750
M001160,N00026914,Gwen Moore (D),2016,Real Estate,2600,42000,44600
M001160,N00026914,Gwen Moore (D),2016,Industrial Unions,0,44500,44500
M001160,N00026914,Gwen Moore (D),2016,Finance/Credit Companies,1000,41000,42000
M001160,N00026914,Gwen Moore (D),2016,Building Trade Unions,0,27500,27500
M001166,N00026926,Jerry McNerney (D),2016,Retired,137312,0,137312
M001166,N00026926,Jerry McNerney (D),2016,Lawyers/Law Firms,48990,12201,61191
M001166,N00026926,Jerry McNerney (D),2016,Building Trade Unions,0,58500,58500
M001166,N00026926,Jerry McNerney (D),2016,Health Professionals,19175,31000,50175
M001166,N00026926,Jerry McNerney (D),2016,Environment,45234,2023,47257
M001166,N00026926,Jerry McNerney (D),2016,Electric Utilities,7200,35000,42200
M001166,N00026926,Jerry McNerney (D),2016,Public Sector Unions,0,38000,38000
M001166,N00026926,Jerry McNerney (D),2016,Securities & Investment,36900,0,36900
M001166,N00026926,Jerry McNerney (D),2016,Industrial Unions,0,34500,34500
M001166,N00026926,Jerry McNerney (D),2016,Telecom Services,0,29000,29000
C001067,N00026961,Yvette D Clarke (D),2016,Telecom Services,10000,51000,61000
C001067,N00026961,Yvette D Clarke (D),2016,Health Professionals,8940,35000,43940
C001067,N00026961,Yvette D Clarke (D),2016,Building Trade Unions,0,37500,37500
C001067,N00026961,Yvette D Clarke (D),2016,TV/Movies/Music,4350,28000,32350
C001067,N00026961,Yvette D Clarke (D),2016,Public Sector Unions,0,31000,31000
C001067,N00026961,Yvette D Clarke (D),2016,Misc Unions,0,25500,25500
C001067,N00026961,Yvette D Clarke (D),2016,Industrial Unions,0,25500,25500
C001067,N00026961,Yvette D Clarke (D),2016,Hospitals/Nursing Homes,6110,15500,21610
C001067,N00026961,Yvette D Clarke (D),2016,Lawyers/Law Firms,8350,13000,21350
C001067,N00026961,Yvette D Clarke (D),2016,Electric Utilities,500,20000,20500
B001251,N00027035,G K Butterfield (D),2016,Pharmaceuticals/Health Products,1050,124460,125510
B001251,N00027035,G K Butterfield (D),2016,Health Professionals,20650,77500,98150
B001251,N00027035,G K Butterfield (D),2016,Telecom Services,0,43500,43500
B001251,N00027035,G K Butterfield (D),2016,Insurance,3500,38500,42000
B001251,N00027035,G K Butterfield (D),2016,Industrial Unions,0,41000,41000
B001251,N00027035,G K Butterfield (D),2016,Lawyers/Law Firms,13500,27500,41000
B001251,N00027035,G K Butterfield (D),2016,Public Sector Unions,0,39000,39000
B001251,N00027035,G K Butterfield (D),2016,TV/Movies/Music,8400,27500,35900
B001251,N00027035,G K Butterfield (D),2016,Retail Sales,0,32500,32500
B001251,N00027035,G K Butterfield (D),2016,Food Processing & Sales,4500,27681,32181
H001038,N00027060,Brian M Higgins (D),2016,Lawyers/Law Firms,67352,8250,75602
H001038,N00027060,Brian M Higgins (D),2016,Industrial Unions,0,48000,48000
H001038,N00027060,Brian M Higgins (D),2016,Real Estate,27485,16500,43985
H001038,N00027060,Brian M Higgins (D),2016,Building Trade Unions,0,36000,36000
H001038,N00027060,Brian M Higgins (D),2016,Public Sector Unions,0,33000,33000
H001038,N00027060,Brian M Higgins (D),2016,Transportation Unions,0,28875,28875
H001038,N00027060,Brian M Higgins (D),2016,Hospitals/Nursing Homes,12985,5250,18235
H001038,N00027060,Brian M Higgins (D),2016,Retired,17700,0,17700
H001038,N00027060,Brian M Higgins (D),2016,Misc Unions,0,16700,16700
H001038,N00027060,Brian M Higgins (D),2016,Defense Aerospace,0,16500,16500
F000451,N00027229,Michael G Fitzpatrick (R),2016,Leadership PACs,0,11500,11500
F000451,N00027229,Michael G Fitzpatrick (R),2016,Home Builders,0,5000,5000
F000451,N00027229,Michael G Fitzpatrick (R),2016,Lodging/Tourism,0,3000,3000
F000451,N00027229,Michael G Fitzpatrick (R),2016,Oil & Gas,0,3000,3000
F000451,N00027229,Michael G Fitzpatrick (R),2016,Retail Sales,0,2000,2000
F000451,N00027229,Michael G Fitzpatrick (R),2016,Securities & Investment,0,2000,2000
F000451,N00027229,Michael G Fitzpatrick (R),2016,Electronics Mfg & Equip,0,2000,2000
F000451,N00027229,Michael G Fitzpatrick (R),2016,Lawyers/Law Firms,0,2000,2000
F000451,N00027229,Michael G Fitzpatrick (R),2016,Hospitals/Nursing Homes,0,1000,1000
F000451,N00027229,Michael G Fitzpatrick (R),2016,Candidate Committees,0,750,750
L000563,N00027239,Daniel Lipinski (D),2016,Air Transport,0,76102,76102
L000563,N00027239,Daniel Lipinski (D),2016,Transportation Unions,0,74500,74500
L000563,N00027239,Daniel Lipinski (D),2016,Railroads,1710,54970,56680
L000563,N00027239,Daniel Lipinski (D),2016,Building Materials & Equipment,2000,44500,46500
L000563,N00027239,Daniel Lipinski (D),2016,Building Trade Unions,0,39000,39000
L000563,N00027239,Daniel Lipinski (D),2016,Lawyers/Law Firms,20250,13750,34000
L000563,N00027239,Daniel Lipinski (D),2016,Industrial Unions,0,31500,31500
L000563,N00027239,Daniel Lipinski (D),2016,Construction Services,13350,16250,29600
L000563,N00027239,Daniel Lipinski (D),2016,General Contractors,10851,11500,22351
L000563,N00027239,Daniel Lipinski (D),2016,"Beer, Wine & Liquor",4000,18000,22000
C001071,N00027441,Bob Corker (R),2016,Securities & Investment,780880,180170,961050
C001071,N00027441,Bob Corker (R),2016,Real Estate,525663,85100,610763
C001071,N00027441,Bob Corker (R),2016,Retired,498865,0,498865
C001071,N00027441,Bob Corker (R),2016,Lawyers/Law Firms,363967,106000,469967
C001071,N00027441,Bob Corker (R),2016,Health Professionals,323509,77000,400509
C001071,N00027441,Bob Corker (R),2016,Insurance,178829,201700,380529
C001071,N00027441,Bob Corker (R),2016,Commercial Banks,225431,143800,369231
C001071,N00027441,Bob Corker (R),2016,Misc Finance,339811,23500,363311
C001071,N00027441,Bob Corker (R),2016,Leadership PACs,0,288000,288000
C001071,N00027441,Bob Corker (R),2016,General Contractors,239448,6000,245448
M001163,N00027459,Doris O Matsui (D),2016,Health Professionals,8100,119100,127200
M001163,N00027459,Doris O Matsui (D),2016,Lawyers/Law Firms,41400,50400,91800
M001163,N00027459,Doris O Matsui (D),2016,Pharmaceuticals/Health Products,0,74500,74500
M001163,N00027459,Doris O Matsui (D),2016,Telecom Services,0,73000,73000
M001163,N00027459,Doris O Matsui (D),2016,Real Estate,38010,15000,53010
M001163,N00027459,Doris O Matsui (D),2016,Insurance,0,51000,51000
M001163,N00027459,Doris O Matsui (D),2016,Health Services/HMOs,6000,37000,43000
M001163,N00027459,Doris O Matsui (D),2016,Telephone Utilities,0,38500,38500
M001163,N00027459,Doris O Matsui (D),2016,Public Sector Unions,0,37500,37500
M001163,N00027459,Doris O Matsui (D),2016,Crop Production & Basic Processing,9612,26445,36057
B001257,N00027462,Gus Bilirakis (R),2016,Health Professionals,56474,162500,218974
B001257,N00027462,Gus Bilirakis (R),2016,Pharmaceuticals/Health Products,2350,78500,80850
B001257,N00027462,Gus Bilirakis (R),2016,Real Estate,54531,20000,74531
B001257,N00027462,Gus Bilirakis (R),2016,Retired,66930,0,66930
B001257,N00027462,Gus Bilirakis (R),2016,Health Services/HMOs,700,58100,58800
B001257,N00027462,Gus Bilirakis (R),2016,Lawyers/Law Firms,36461,19750,56211
B001257,N00027462,Gus Bilirakis (R),2016,Telecom Services,0,49500,49500
B001257,N00027462,Gus Bilirakis (R),2016,Insurance,10600,32500,43100
B001257,N00027462,Gus Bilirakis (R),2016,Electric Utilities,0,41000,41000
B001257,N00027462,Gus Bilirakis (R),2016,Lodging/Tourism,850,38500,39350
W000799,N00027467,Tim Walz (D),2016,Retired,144640,0,144640
W000799,N00027467,Tim Walz (D),2016,Lawyers/Law Firms,72383,25750,98133
W000799,N00027467,Tim Walz (D),2016,Building Trade Unions,250,58000,58250
W000799,N00027467,Tim Walz (D),2016,Public Sector Unions,0,56500,56500
W000799,N00027467,Tim Walz (D),2016,Agricultural Services/Products,1100,51750,52850
W000799,N00027467,Tim Walz (D),2016,Leadership PACs,0,48000,48000
W000799,N00027467,Tim Walz (D),2016,Health Professionals,12500,34650,47150
W000799,N00027467,Tim Walz (D),2016,Crop Production & Basic Processing,7400,39000,46400
W000799,N00027467,Tim Walz (D),2016,Real Estate,32379,8500,40879
W000799,N00027467,Tim Walz (D),2016,Industrial Unions,200,38000,38200
K000367,N00027500,Amy Klobuchar (D),2016,Lawyers/Law Firms,624879,144897,769776
K000367,N00027500,Amy Klobuchar (D),2016,Retired,525896,0,525896
K000367,N00027500,Amy Klobuchar (D),2016,Leadership PACs,0,331777,331777
K000367,N00027500,Amy Klobuchar (D),2016,Securities & Investment,266476,32000,298476
K000367,N00027500,Amy Klobuchar (D),2016,Lobbyists,214175,29600,243775
K000367,N00027500,Amy Klobuchar (D),2016,Women's Issues,224147,18094,242241
K000367,N00027500,Amy Klobuchar (D),2016,Pharmaceuticals/Health Products,100125,141150,241275
K000367,N00027500,Amy Klobuchar (D),2016,TV/Movies/Music,155102,57500,212602
K000367,N00027500,Amy Klobuchar (D),2016,Retail Sales,120213,67500,187713
K000367,N00027500,Amy Klobuchar (D),2016,Health Professionals,84230,82000,166230
C001070,N00027503,Bob Casey (D),2016,Lawyers/Law Firms,1738630,207233,1945863
C001070,N00027503,Bob Casey (D),2016,Pharmaceuticals/Health Products,142310,364329,506639
C001070,N00027503,Bob Casey (D),2016,Securities & Investment,334606,163700,498306
C001070,N00027503,Bob Casey (D),2016,Real Estate,361809,59900,421709
C001070,N00027503,Bob Casey (D),2016,Lobbyists,396401,12300,408701
C001070,N00027503,Bob Casey (D),2016,Retired,402087,0,402087
C001070,N00027503,Bob Casey (D),2016,Insurance,156500,222500,379000
C001070,N00027503,Bob Casey (D),2016,Health Professionals,193614,169250,362864
C001070,N00027503,Bob Casey (D),2016,Hospitals/Nursing Homes,233585,123000,356585
C001070,N00027503,Bob Casey (D),2016,Leadership PACs,1000,340364,341364
T000470,N00027509,Scott Tipton (R),2016,Retired,149145,0,149145
T000470,N00027509,Scott Tipton (R),2016,Leadership PACs,0,145600,145600
T000470,N00027509,Scott Tipton (R),2016,Real Estate,86850,46500,133350
T000470,N00027509,Scott Tipton (R),2016,Oil & Gas,24600,90500,115100
T000470,N00027509,Scott Tipton (R),2016,Securities & Investment,45100,66500,111600
T000470,N00027509,Scott Tipton (R),2016,Commercial Banks,35900,59000,94900
T000470,N00027509,Scott Tipton (R),2016,Insurance,9800,68000,77800
T000470,N00027509,Scott Tipton (R),2016,Livestock,47625,12000,59625
T000470,N00027509,Scott Tipton (R),2016,Mining,18250,30000,48250
T000470,N00027509,Scott Tipton (R),2016,Misc Finance,29175,10000,39175
P000593,N00027510,Edwin G Perlmutter (D),2016,Insurance,5520,175500,181020
P000593,N00027510,Edwin G Perlmutter (D),2016,Real Estate,41950,103000,144950
P000593,N00027510,Edwin G Perlmutter (D),2016,Securities & Investment,23877,112500,136377
P000593,N00027510,Edwin G Perlmutter (D),2016,Lawyers/Law Firms,100762,27000,127762
P000593,N00027510,Edwin G Perlmutter (D),2016,Commercial Banks,4100,93000,97100
P000593,N00027510,Edwin G Perlmutter (D),2016,Retired,76910,0,76910
P000593,N00027510,Edwin G Perlmutter (D),2016,Health Professionals,25275,42000,67275
P000593,N00027510,Edwin G Perlmutter (D),2016,Public Sector Unions,0,65000,65000
P000593,N00027510,Edwin G Perlmutter (D),2016,Accountants,1145,60500,61645
P000593,N00027510,Edwin G Perlmutter (D),2016,Finance/Credit Companies,500,60000,60500
C001066,N00027514,Kathy Castor (D),2016,Health Professionals,6325,73000,79325
C001066,N00027514,Kathy Castor (D),2016,Lawyers/Law Firms,45205,18250,63455
C001066,N00027514,Kathy Castor (D),2016,Telecom Services,1000,33000,34000
C001066,N00027514,Kathy Castor (D),2016,Insurance,12000,16500,28500
C001066,N00027514,Kathy Castor (D),2016,Hospitals/Nursing Homes,11900,16500,28400
C001066,N00027514,Kathy Castor (D),2016,Industrial Unions,0,22500,22500
C001066,N00027514,Kathy Castor (D),2016,Building Trade Unions,0,17500,17500
C001066,N00027514,Kathy Castor (D),2016,Real Estate,8050,8000,16050
C001066,N00027514,Kathy Castor (D),2016,Misc Unions,0,16000,16000
C001066,N00027514,Kathy Castor (D),2016,Public Sector Unions,0,15000,15000
H001041,N00027522,Dean Heller (R),2016,Retired,583942,0,583942
H001041,N00027522,Dean Heller (R),2016,Securities & Investment,355265,169700,524965
H001041,N00027522,Dean Heller (R),2016,Leadership PACs,500,490592,491092
H001041,N00027522,Dean Heller (R),2016,Insurance,98705,333800,432505
H001041,N00027522,Dean Heller (R),2016,Casinos/Gambling,308982,106500,415482
H001041,N00027522,Dean Heller (R),2016,Real Estate,325465,54000,379465
H001041,N00027522,Dean Heller (R),2016,Health Professionals,155845,151000,306845
H001041,N00027522,Dean Heller (R),2016,Lobbyists,260614,13714,274328
H001041,N00027522,Dean Heller (R),2016,Oil & Gas,106200,162750,268950
H001041,N00027522,Dean Heller (R),2016,Mining,155275,108825,264100
S001165,N00027523,Albio Sires (D),2016,Building Trade Unions,0,50100,50100
S001165,N00027523,Albio Sires (D),2016,Transportation Unions,0,46500,46500
S001165,N00027523,Albio Sires (D),2016,Lawyers/Law Firms,26250,6500,32750
S001165,N00027523,Albio Sires (D),2016,Real Estate,22800,9000,31800
S001165,N00027523,Albio Sires (D),2016,Education,28300,0,28300
S001165,N00027523,Albio Sires (D),2016,Public Sector Unions,0,26000,26000
S001165,N00027523,Albio Sires (D),2016,Railroads,0,25500,25500
S001165,N00027523,Albio Sires (D),2016,Industrial Unions,0,24500,24500
S001165,N00027523,Albio Sires (D),2016,Lobbyists,18550,3000,21550
S001165,N00027523,Albio Sires (D),2016,Telephone Utilities,0,17000,17000
W000802,N00027533,Sheldon Whitehouse (D),2016,Lawyers/Law Firms,620757,103650,724407
W000802,N00027533,Sheldon Whitehouse (D),2016,Securities & Investment,289191,10500,299691
W000802,N00027533,Sheldon Whitehouse (D),2016,Leadership PACs,0,297680,297680
W000802,N00027533,Sheldon Whitehouse (D),2016,Retired,257773,0,257773
W000802,N00027533,Sheldon Whitehouse (D),2016,Lobbyists,227059,6003,233062
W000802,N00027533,Sheldon Whitehouse (D),2016,TV/Movies/Music,175414,42500,217914
W000802,N00027533,Sheldon Whitehouse (D),2016,Real Estate,153708,27000,180708
W000802,N00027533,Sheldon Whitehouse (D),2016,Pharmaceuticals/Health Products,40613,129500,170113
W000802,N00027533,Sheldon Whitehouse (D),2016,Health Professionals,43667,108060,151727
W000802,N00027533,Sheldon Whitehouse (D),2016,Environment,132482,16250,148732
M001169,N00027566,Christopher S Murphy (D),2016,Retired,1447280,0,1447280
M001169,N00027566,Christopher S Murphy (D),2016,Lawyers/Law Firms,947482,56150,1003632
M001169,N00027566,Christopher S Murphy (D),2016,Securities & Investment,666060,99000,765060
M001169,N00027566,Christopher S Murphy (D),2016,Insurance,131137,280000,411137
M001169,N00027566,Christopher S Murphy (D),2016,Real Estate,319185,62500,381685
M001169,N00027566,Christopher S Murphy (D),2016,Health Professionals,196839,162410,359249
M001169,N00027566,Christopher S Murphy (D),2016,Leadership PACs,15000,295000,310000
M001169,N00027566,Christopher S Murphy (D),2016,Lobbyists,288909,8424,297333
M001169,N00027566,Christopher S Murphy (D),2016,Business Services,269845,15000,284845
M001169,N00027566,Christopher S Murphy (D),2016,Education,279599,0,279599
T000464,N00027605,Jon Tester (D),2016,Lawyers/Law Firms,1218794,182444,1401238
T000464,N00027605,Jon Tester (D),2016,Securities & Investment,584181,314000,898181
T000464,N00027605,Jon Tester (D),2016,Retired,822974,0,822974
T000464,N00027605,Jon Tester (D),2016,Lobbyists,618172,17771,635943
T000464,N00027605,Jon Tester (D),2016,Insurance,106141,374394,480535
T000464,N00027605,Jon Tester (D),2016,Commercial Banks,207118,253778,460896
T000464,N00027605,Jon Tester (D),2016,Leadership PACs,15000,408000,423000
T000464,N00027605,Jon Tester (D),2016,Real Estate,300690,91820,392510
T000464,N00027605,Jon Tester (D),2016,Health Professionals,151804,141900,293704
T000464,N00027605,Jon Tester (D),2016,Environment,253886,17814,271700
S001172,N00027623,Adrian Smith (R),2016,Insurance,8750,109300,118050
S001172,N00027623,Adrian Smith (R),2016,Agricultural Services/Products,1035,72500,73535
S001172,N00027623,Adrian Smith (R),2016,Health Professionals,2950,69200,72150
S001172,N00027623,Adrian Smith (R),2016,Crop Production & Basic Processing,5225,48000,53225
S001172,N00027623,Adrian Smith (R),2016,Real Estate,5700,40500,46200
S001172,N00027623,Adrian Smith (R),2016,Commercial Banks,4225,39000,43225
S001172,N00027623,Adrian Smith (R),2016,Accountants,0,34500,34500
S001172,N00027623,Adrian Smith (R),2016,Lawyers/Law Firms,14900,19500,34400
S001172,N00027623,Adrian Smith (R),2016,Livestock,12000,20000,32000
S001172,N00027623,Adrian Smith (R),2016,Securities & Investment,2900,29000,31900
B001260,N00027626,Vernon Buchanan (R),2016,Hospitals/Nursing Homes,51500,74500,126000
B001260,N00027626,Vernon Buchanan (R),2016,Health Professionals,56715,54500,111215
B001260,N00027626,Vernon Buchanan (R),2016,Retired,110425,0,110425
B001260,N00027626,Vernon Buchanan (R),2016,Misc Issues,86000,8000,94000
B001260,N00027626,Vernon Buchanan (R),2016,Real Estate,65550,27675,93225
B001260,N00027626,Vernon Buchanan (R),2016,Insurance,7400,62000,69400
B001260,N00027626,Vernon Buchanan (R),2016,Pharmaceuticals/Health Products,29400,31000,60400
B001260,N00027626,Vernon Buchanan (R),2016,Health Services/HMOs,0,43000,43000
B001260,N00027626,Vernon Buchanan (R),2016,Sea Transport,23100,18500,41600
B001260,N00027626,Vernon Buchanan (R),2016,Food & Beverage,22800,16500,39300
H001057,N00027649,Tim Huelskamp (R),2016,Republican/Conservative,35319,28930,64249
H001057,N00027649,Tim Huelskamp (R),2016,Misc Manufacturing & Distributing,63600,0,63600
H001057,N00027649,Tim Huelskamp (R),2016,Retired,49826,0,49826
H001057,N00027649,Tim Huelskamp (R),2016,Oil & Gas,32797,13000,45797
H001057,N00027649,Tim Huelskamp (R),2016,Leadership PACs,0,35752,35752
H001057,N00027649,Tim Huelskamp (R),2016,Candidate Committees,0,29200,29200
H001057,N00027649,Tim Huelskamp (R),2016,Securities & Investment,25600,0,25600
H001057,N00027649,Tim Huelskamp (R),2016,Crop Production & Basic Processing,22694,1000,23694
H001057,N00027649,Tim Huelskamp (R),2016,Home Builders,17200,5000,22200
H001057,N00027649,Tim Huelskamp (R),2016,Health Professionals,16350,4500,20850
G000555,N00027658,Kirsten Gillibrand (D),2016,Lawyers/Law Firms,2294052,174700,2468752
G000555,N00027658,Kirsten Gillibrand (D),2016,Securities & Investment,1518237,189500,1707737
G000555,N00027658,Kirsten Gillibrand (D),2016,Real Estate,696158,76500,772658
G000555,N00027658,Kirsten Gillibrand (D),2016,Retired,756913,0,756913
G000555,N00027658,Kirsten Gillibrand (D),2016,Women's Issues,571105,14500,585605
G000555,N00027658,Kirsten Gillibrand (D),2016,TV/Movies/Music,473914,57500,531414
G000555,N00027658,Kirsten Gillibrand (D),2016,Lobbyists,389130,17845,406975
G000555,N00027658,Kirsten Gillibrand (D),2016,Business Services,369108,31000,400108
G000555,N00027658,Kirsten Gillibrand (D),2016,Insurance,173741,213116,386857
G000555,N00027658,Kirsten Gillibrand (D),2016,Misc Finance,338828,10100,348928
M001170,N00027694,Claire McCaskill (D),2016,Lawyers/Law Firms,2172300,143166,2315466
M001170,N00027694,Claire McCaskill (D),2016,Retired,1379145,0,1379145
M001170,N00027694,Claire McCaskill (D),2016,Women's Issues,1172415,26500,1198915
M001170,N00027694,Claire McCaskill (D),2016,Securities & Investment,508864,61000,569864
M001170,N00027694,Claire McCaskill (D),2016,Education,409441,0,409441
M001170,N00027694,Claire McCaskill (D),2016,Real Estate,342327,30500,372827
M001170,N00027694,Claire McCaskill (D),2016,Leadership PACs,0,334500,334500
M001170,N00027694,Claire McCaskill (D),2016,TV/Movies/Music,282519,44750,327269
M001170,N00027694,Claire McCaskill (D),2016,Business Services,299056,24525,323581
M001170,N00027694,Claire McCaskill (D),2016,Health Professionals,258348,44500,302848
L000565,N00027741,David Loebsack (D),2016,Health Professionals,12851,87000,99851
L000565,N00027741,David Loebsack (D),2016,Retired,89110,0,89110
L000565,N00027741,David Loebsack (D),2016,Lawyers/Law Firms,51991,10250,62241
L000565,N00027741,David Loebsack (D),2016,Building Trade Unions,150,57500,57650
L000565,N00027741,David Loebsack (D),2016,Education,52669,1000,53669
L000565,N00027741,David Loebsack (D),2016,Industrial Unions,0,52500,52500
L000565,N00027741,David Loebsack (D),2016,Insurance,975,50500,51475
L000565,N00027741,David Loebsack (D),2016,Securities & Investment,33375,15500,48875
L000565,N00027741,David Loebsack (D),2016,Pharmaceuticals/Health Products,6700,38500,45200
L000565,N00027741,David Loebsack (D),2016,Telecom Services,3200,41500,44700
S001168,N00027751,John Sarbanes (D),2016,Retired,186174,0,186174
S001168,N00027751,John Sarbanes (D),2016,Lawyers/Law Firms,138458,0,138458
S001168,N00027751,John Sarbanes (D),2016,Real Estate,91370,0,91370
S001168,N00027751,John Sarbanes (D),2016,Education,73500,0,73500
S001168,N00027751,John Sarbanes (D),2016,Securities & Investment,67000,0,67000
S001168,N00027751,John Sarbanes (D),2016,Misc Manufacturing & Distributing,29560,0,29560
S001168,N00027751,John Sarbanes (D),2016,Health Professionals,23491,-1000,22491
S001168,N00027751,John Sarbanes (D),2016,Non-Profit Institutions,16750,0,16750
S001168,N00027751,John Sarbanes (D),2016,Misc Finance,12950,0,12950
S001168,N00027751,John Sarbanes (D),2016,Hospitals/Nursing Homes,11950,0,11950
J000288,N00027848,Hank Johnson (D),2016,Industrial Unions,0,39500,39500
J000288,N00027848,Hank Johnson (D),2016,Telecom Services,0,35500,35500
J000288,N00027848,Hank Johnson (D),2016,Building Trade Unions,0,31500,31500
J000288,N00027848,Hank Johnson (D),2016,Public Sector Unions,0,28500,28500
J000288,N00027848,Hank Johnson (D),2016,Lawyers/Law Firms,5750,20250,26000
J000288,N00027848,Hank Johnson (D),2016,Defense Aerospace,0,20500,20500
J000288,N00027848,Hank Johnson (D),2016,Insurance,0,19500,19500
J000288,N00027848,Hank Johnson (D),2016,Transportation Unions,0,19000,19000
J000288,N00027848,Hank Johnson (D),2016,Misc Unions,0,18500,18500
J000288,N00027848,Hank Johnson (D),2016,TV/Movies/Music,0,17500,17500
D000622,N00027860,Tammy Duckworth (D),2016,Women's Issues,1279741,36635,1316376
D000622,N00027860,Tammy Duckworth (D),2016,Lawyers/Law Firms,1205199,25900,1231099
D000622,N00027860,Tammy Duckworth (D),2016,Retired,1208777,0,1208777
D000622,N00027860,Tammy Duckworth (D),2016,Democratic/Liberal,704603,23031,727634
D000622,N00027860,Tammy Duckworth (D),2016,Securities & Investment,450781,11000,461781
D000622,N00027860,Tammy Duckworth (D),2016,Leadership PACs,0,386800,386800
D000622,N00027860,Tammy Duckworth (D),2016,Pro-Israel,301684,20850,322534
D000622,N00027860,Tammy Duckworth (D),2016,Real Estate,309146,13000,322146
D000622,N00027860,Tammy Duckworth (D),2016,Education,302020,7500,309520
D000622,N00027860,Tammy Duckworth (D),2016,Environment,240232,19532,259764
J000289,N00027894,Jim Jordan (R),2016,Republican/Conservative,36930,12848,49778
J000289,N00027894,Jim Jordan (R),2016,Misc Manufacturing & Distributing,22200,18000,40200
J000289,N00027894,Jim Jordan (R),2016,Lawyers/Law Firms,13020,23250,36270
J000289,N00027894,Jim Jordan (R),2016,Electronics Mfg & Equip,0,24500,24500
J000289,N00027894,Jim Jordan (R),2016,Electric Utilities,0,24000,24000
J000289,N00027894,Jim Jordan (R),2016,General Contractors,20500,2500,23000
J000289,N00027894,Jim Jordan (R),2016,Insurance,8500,10500,19000
J000289,N00027894,Jim Jordan (R),2016,Health Professionals,9789,7000,16789
J000289,N00027894,Jim Jordan (R),2016,TV/Movies/Music,0,16000,16000
J000289,N00027894,Jim Jordan (R),2016,Oil & Gas,0,16000,16000
S001170,N00028091,Carol Shea-Porter (D),2016,Retired,136657,0,136657
S001170,N00028091,Carol Shea-Porter (D),2016,Leadership PACs,2700,125000,127700
S001170,N00028091,Carol Shea-Porter (D),2016,Women's Issues,88424,19750,108174
S001170,N00028091,Carol Shea-Porter (D),2016,Democratic/Liberal,93056,9175,102231
S001170,N00028091,Carol Shea-Porter (D),2016,Public Sector Unions,0,63250,63250
S001170,N00028091,Carol Shea-Porter (D),2016,Building Trade Unions,0,58000,58000
S001170,N00028091,Carol Shea-Porter (D),2016,Environment,35513,15027,50540
S001170,N00028091,Carol Shea-Porter (D),2016,Candidate Committees,0,49200,49200
S001170,N00028091,Carol Shea-Porter (D),2016,Industrial Unions,5,48000,48005
S001170,N00028091,Carol Shea-Porter (D),2016,Pro-Israel,41641,2500,44141
L000564,N00028133,Douglas L Lamborn (R),2016,Oil & Gas,5127,61250,66377
L000564,N00028133,Douglas L Lamborn (R),2016,Defense Aerospace,0,52000,52000
L000564,N00028133,Douglas L Lamborn (R),2016,Leadership PACs,0,47200,47200
L000564,N00028133,Douglas L Lamborn (R),2016,Defense Electronics,250,45000,45250
L000564,N00028133,Douglas L Lamborn (R),2016,Mining,0,38000,38000
L000564,N00028133,Douglas L Lamborn (R),2016,Telecom Services,11300,19000,30300
L000564,N00028133,Douglas L Lamborn (R),2016,Pro-Israel,26600,3500,30100
L000564,N00028133,Douglas L Lamborn (R),2016,Health Professionals,3550,18000,21550
L000564,N00028133,Douglas L Lamborn (R),2016,Misc Defense,0,21500,21500
L000564,N00028133,Douglas L Lamborn (R),2016,Lawyers/Law Firms,13000,6250,19250
S001194,N00028138,Brian Schatz (D),2016,Lawyers/Law Firms,900989,128549,1029538
S001194,N00028138,Brian Schatz (D),2016,Real Estate,484496,74500,558996
S001194,N00028138,Brian Schatz (D),2016,Leadership PACs,0,478200,478200
S001194,N00028138,Brian Schatz (D),2016,Securities & Investment,284316,19500,303816
S001194,N00028138,Brian Schatz (D),2016,Environment,235610,52029,287639
S001194,N00028138,Brian Schatz (D),2016,Lobbyists,238840,18600,257440
S001194,N00028138,Brian Schatz (D),2016,Sea Transport,154750,95150,249900
S001194,N00028138,Brian Schatz (D),2016,Misc Finance,207115,0,207115
S001194,N00028138,Brian Schatz (D),2016,Telecom Services,71450,133000,204450
S001194,N00028138,Brian Schatz (D),2016,Retired,202981,0,202981
H001042,N00028139,Mazie K Hirono (D),2016,Lawyers/Law Firms,738901,64750,803651
H001042,N00028139,Mazie K Hirono (D),2016,Women's Issues,310272,29500,339772
H001042,N00028139,Mazie K Hirono (D),2016,Retired,239070,0,239070
H001042,N00028139,Mazie K Hirono (D),2016,Leadership PACs,1000,228000,229000
H001042,N00028139,Mazie K Hirono (D),2016,Real Estate,161599,24500,186099
H001042,N00028139,Mazie K Hirono (D),2016,Lobbyists,175094,6750,181844
H001042,N00028139,Mazie K Hirono (D),2016,Sea Transport,92185,78852,171037
H001042,N00028139,Mazie K Hirono (D),2016,Transportation Unions,1400,136875,138275
H001042,N00028139,Mazie K Hirono (D),2016,Human Rights,87966,33244,121210
H001042,N00028139,Mazie K Hirono (D),2016,Public Sector Unions,300,117000,117300
M001165,N00028152,Kevin McCarthy (R),2016,Securities & Investment,520450,167614,688064
M001165,N00028152,Kevin McCarthy (R),2016,Real Estate,451225,98250,549475
M001165,N00028152,Kevin McCarthy (R),2016,Insurance,143900,287300,431200
M001165,N00028152,Kevin McCarthy (R),2016,Lobbyists,340100,6809,346909
M001165,N00028152,Kevin McCarthy (R),2016,Crop Production & Basic Processing,228300,115450,343750
M001165,N00028152,Kevin McCarthy (R),2016,Oil & Gas,148350,189500,337850
M001165,N00028152,Kevin McCarthy (R),2016,Health Professionals,116235,220500,336735
M001165,N00028152,Kevin McCarthy (R),2016,Pharmaceuticals/Health Products,113500,219500,333000
M001165,N00028152,Kevin McCarthy (R),2016,Lawyers/Law Firms,219317,51900,271217
M001165,N00028152,Kevin McCarthy (R),2016,Retired,224806,0,224806
E000290,N00028249,Donna Edwards (D),2016,Women's Issues,450754,19000,469754
E000290,N00028249,Donna Edwards (D),2016,Democratic/Liberal,140483,8466,148949
E000290,N00028249,Donna Edwards (D),2016,Retired,133129,0,133129
E000290,N00028249,Donna Edwards (D),2016,Lawyers/Law Firms,105639,1000,106639
E000290,N00028249,Donna Edwards (D),2016,Human Rights,63927,31999,95926
E000290,N00028249,Donna Edwards (D),2016,Education,92598,0,92598
E000290,N00028249,Donna Edwards (D),2016,Non-Profit Institutions,85465,0,85465
E000290,N00028249,Donna Edwards (D),2016,Business Services,66447,0,66447
E000290,N00028249,Donna Edwards (D),2016,Real Estate,62775,0,62775
E000290,N00028249,Donna Edwards (D),2016,Securities & Investment,60850,0,60850
E000288,N00028257,Keith Ellison (D),2016,Health Professionals,168212,5000,173212
E000288,N00028257,Keith Ellison (D),2016,Retired,135209,0,135209
E000288,N00028257,Keith Ellison (D),2016,Democratic/Liberal,79135,10000,89135
E000288,N00028257,Keith Ellison (D),2016,Human Rights,58694,12500,71194
E000288,N00028257,Keith Ellison (D),2016,Lawyers/Law Firms,37819,19066,56885
E000288,N00028257,Keith Ellison (D),2016,Public Sector Unions,0,51500,51500
E000288,N00028257,Keith Ellison (D),2016,Securities & Investment,47915,1000,48915
E000288,N00028257,Keith Ellison (D),2016,Industrial Unions,25,42500,42525
E000288,N00028257,Keith Ellison (D),2016,Misc Unions,3330,35250,38580
E000288,N00028257,Keith Ellison (D),2016,Education,38199,0,38199
R000582,N00028463,Phil Roe (R),2016,Health Professionals,58745,0,58745
R000582,N00028463,Phil Roe (R),2016,Retired,26200,0,26200
R000582,N00028463,Phil Roe (R),2016,General Contractors,22350,0,22350
R000582,N00028463,Phil Roe (R),2016,Real Estate,20900,0,20900
R000582,N00028463,Phil Roe (R),2016,Food & Beverage,13500,0,13500
R000582,N00028463,Phil Roe (R),2016,Retail Sales,13200,0,13200
R000582,N00028463,Phil Roe (R),2016,Hospitals/Nursing Homes,11100,0,11100
R000582,N00028463,Phil Roe (R),2016,Chemical & Related Manufacturing,8400,0,8400
R000582,N00028463,Phil Roe (R),2016,Building Materials & Equipment,8000,0,8000
R000582,N00028463,Phil Roe (R),2016,Commercial Banks,6900,0,6900
C001076,N00028958,Jason Chaffetz (R),2016,Pharmaceuticals/Health Products,23350,66000,89350
C001076,N00028958,Jason Chaffetz (R),2016,Lawyers/Law Firms,41700,27250,68950
C001076,N00028958,Jason Chaffetz (R),2016,Internet,42600,26000,68600
C001076,N00028958,Jason Chaffetz (R),2016,Retail Sales,3000,64500,67500
C001076,N00028958,Jason Chaffetz (R),2016,Lobbyists,57400,2041,59441
C001076,N00028958,Jason Chaffetz (R),2016,Real Estate,40600,16000,56600
C001076,N00028958,Jason Chaffetz (R),2016,Securities & Investment,26600,28000,54600
C001076,N00028958,Jason Chaffetz (R),2016,Electronics Mfg & Equip,14550,37000,51550
C001076,N00028958,Jason Chaffetz (R),2016,Misc Manufacturing & Distributing,24400,25500,49900
C001076,N00028958,Jason Chaffetz (R),2016,Oil & Gas,14300,35500,49800
F000457,N00029016,Al Franken (D),2016,Retired,1494688,0,1494688
F000457,N00029016,Al Franken (D),2016,Lawyers/Law Firms,1215563,96188,1311751
F000457,N00029016,Al Franken (D),2016,TV/Movies/Music,606128,20004,626132
F000457,N00029016,Al Franken (D),2016,Securities & Investment,383266,7000,390266
F000457,N00029016,Al Franken (D),2016,Leadership PACs,250,377400,377650
F000457,N00029016,Al Franken (D),2016,Real Estate,313864,15010,328874
F000457,N00029016,Al Franken (D),2016,Health Professionals,172689,73400,246089
F000457,N00029016,Al Franken (D),2016,Printing & Publishing,240628,2000,242628
F000457,N00029016,Al Franken (D),2016,Education,235706,2000,237706
F000457,N00029016,Al Franken (D),2016,Democratic/Liberal,200303,19617,219920
R000583,N00029018,Tom Rooney (R),2016,Defense Aerospace,0,50500,50500
R000583,N00029018,Tom Rooney (R),2016,Crop Production & Basic Processing,11050,28000,39050
R000583,N00029018,Tom Rooney (R),2016,Accountants,0,39000,39000
R000583,N00029018,Tom Rooney (R),2016,Electric Utilities,0,27000,27000
R000583,N00029018,Tom Rooney (R),2016,Food Processing & Sales,6400,17000,23400
R000583,N00029018,Tom Rooney (R),2016,Real Estate,2500,20000,22500
R000583,N00029018,Tom Rooney (R),2016,Lawyers/Law Firms,6950,14500,21450
R000583,N00029018,Tom Rooney (R),2016,Leadership PACs,0,21000,21000
R000583,N00029018,Tom Rooney (R),2016,Lobbyists,19600,0,19600
R000583,N00029018,Tom Rooney (R),2016,Defense Electronics,0,19000,19000
T000465,N00029026,Niki Tsongas (D),2016,Lawyers/Law Firms,69558,14000,83558
T000465,N00029026,Niki Tsongas (D),2016,Retired,68341,0,68341
T000465,N00029026,Niki Tsongas (D),2016,Real Estate,56500,9000,65500
T000465,N00029026,Niki Tsongas (D),2016,Pharmaceuticals/Health Products,7900,40500,48400
T000465,N00029026,Niki Tsongas (D),2016,Defense Aerospace,0,43000,43000
T000465,N00029026,Niki Tsongas (D),2016,Business Services,36308,5000,41308
T000465,N00029026,Niki Tsongas (D),2016,Building Trade Unions,0,41000,41000
T000465,N00029026,Niki Tsongas (D),2016,Women's Issues,34885,5,34890
T000465,N00029026,Niki Tsongas (D),2016,Defense Electronics,1025,28000,29025
T000465,N00029026,Niki Tsongas (D),2016,Public Sector Unions,0,27000,27000
H001047,N00029070,Jim Himes (D),2016,Securities & Investment,203940,174400,378340
H001047,N00029070,Jim Himes (D),2016,Insurance,70750,194000,264750
H001047,N00029070,Jim Himes (D),2016,Retired,159095,0,159095
H001047,N00029070,Jim Himes (D),2016,Commercial Banks,17250,81500,98750
H001047,N00029070,Jim Himes (D),2016,Real Estate,29385,68000,97385
H001047,N00029070,Jim Himes (D),2016,Lawyers/Law Firms,54460,15250,69710
H001047,N00029070,Jim Himes (D),2016,Accountants,1785,57500,59285
H001047,N00029070,Jim Himes (D),2016,Retail Sales,29300,23000,52300
H001047,N00029070,Jim Himes (D),2016,Democratic/Liberal,43041,6500,49541
H001047,N00029070,Jim Himes (D),2016,Pharmaceuticals/Health Products,6400,40500,46900
J000290,N00029077,Lynn Jenkins (R),2016,Health Professionals,27819,149500,177319
J000290,N00029077,Lynn Jenkins (R),2016,Insurance,17100,126500,143600
J000290,N00029077,Lynn Jenkins (R),2016,Securities & Investment,34300,62000,96300
J000290,N00029077,Lynn Jenkins (R),2016,Real Estate,47160,42500,89660
J000290,N00029077,Lynn Jenkins (R),2016,Oil & Gas,46200,42250,88450
J000290,N00029077,Lynn Jenkins (R),2016,Lawyers/Law Firms,42125,35750,77875
J000290,N00029077,Lynn Jenkins (R),2016,Accountants,15200,57500,72700
J000290,N00029077,Lynn Jenkins (R),2016,Railroads,39725,31000,70725
J000290,N00029077,Lynn Jenkins (R),2016,Lobbyists,62725,1000,63725
J000290,N00029077,Lynn Jenkins (R),2016,Pharmaceuticals/Health Products,500,63000,63500
P000598,N00029127,Jared Polis (D),2016,Securities & Investment,110850,2500,113350
P000598,N00029127,Jared Polis (D),2016,Retired,81011,0,81011
P000598,N00029127,Jared Polis (D),2016,Lawyers/Law Firms,61565,-3000,58565
P000598,N00029127,Jared Polis (D),2016,Real Estate,45380,0,45380
P000598,N00029127,Jared Polis (D),2016,Business Services,37660,0,37660
P000598,N00029127,Jared Polis (D),2016,Misc Finance,34700,0,34700
P000598,N00029127,Jared Polis (D),2016,Printing & Publishing,32400,0,32400
P000598,N00029127,Jared Polis (D),2016,Non-Profit Institutions,21850,0,21850
P000598,N00029127,Jared Polis (D),2016,Electronics Mfg & Equip,19650,0,19650
P000598,N00029127,Jared Polis (D),2016,Democratic/Liberal,16200,0,16200
F000454,N00029139,Bill Foster (D),2016,Education,464887,0,464887
F000454,N00029139,Bill Foster (D),2016,Democratic/Liberal,215272,10000,225272
F000454,N00029139,Bill Foster (D),2016,Retired,217553,0,217553
F000454,N00029139,Bill Foster (D),2016,Securities & Investment,91335,111000,202335
F000454,N00029139,Bill Foster (D),2016,Lawyers/Law Firms,154900,26998,181898
F000454,N00029139,Bill Foster (D),2016,Real Estate,63005,58000,121005
F000454,N00029139,Bill Foster (D),2016,Civil Servants/Public Officials,114536,0,114536
F000454,N00029139,Bill Foster (D),2016,Insurance,7900,77700,85600
F000454,N00029139,Bill Foster (D),2016,Pro-Israel,80140,2450,82590
F000454,N00029139,Bill Foster (D),2016,Building Trade Unions,0,63500,63500
H001052,N00029147,Andy Harris (R),2016,Health Professionals,128802,124200,253002
H001052,N00029147,Andy Harris (R),2016,Retired,73347,0,73347
H001052,N00029147,Andy Harris (R),2016,Real Estate,42725,7000,49725
H001052,N00029147,Andy Harris (R),2016,Food & Beverage,23700,12000,35700
H001052,N00029147,Andy Harris (R),2016,Misc Defense,5900,22000,27900
H001052,N00029147,Andy Harris (R),2016,Food Processing & Sales,2750,24500,27250
H001052,N00029147,Andy Harris (R),2016,Lawyers/Law Firms,23532,3000,26532
H001052,N00029147,Andy Harris (R),2016,Education,22650,1000,23650
H001052,N00029147,Andy Harris (R),2016,Tobacco,500,20807,21307
H001052,N00029147,Andy Harris (R),2016,Oil & Gas,1500,19000,20500
P000596,N00029168,Pedro Pierluisi (D),2016,Misc Finance,7800,0,7800
P000596,N00029168,Pedro Pierluisi (D),2016,Pharmaceuticals/Health Products,0,4000,4000
P000596,N00029168,Pedro Pierluisi (D),2016,Lawyers/Law Firms,1000,2750,3750
P000596,N00029168,Pedro Pierluisi (D),2016,Transportation Unions,0,3600,3600
P000596,N00029168,Pedro Pierluisi (D),2016,Misc Energy,0,3000,3000
P000596,N00029168,Pedro Pierluisi (D),2016,Public Sector Unions,0,3000,3000
P000596,N00029168,Pedro Pierluisi (D),2016,Democratic/Liberal,0,2500,2500
P000596,N00029168,Pedro Pierluisi (D),2016,Lobbyists,2500,0,2500
P000596,N00029168,Pedro Pierluisi (D),2016,Telephone Utilities,0,2000,2000
P000596,N00029168,Pedro Pierluisi (D),2016,Misc Manufacturing & Distributing,0,2000,2000
H001048,N00029258,Duncan D Hunter (R),2016,Sea Transport,31100,58750,89850
H001048,N00029258,Duncan D Hunter (R),2016,Misc Defense,9250,66777,76027
H001048,N00029258,Duncan D Hunter (R),2016,Defense Aerospace,1000,67500,68500
H001048,N00029258,Duncan D Hunter (R),2016,Defense Electronics,2000,55750,57750
H001048,N00029258,Duncan D Hunter (R),2016,Lobbyists,44500,3476,47976
H001048,N00029258,Duncan D Hunter (R),2016,Transportation Unions,0,41000,41000
H001048,N00029258,Duncan D Hunter (R),2016,Air Transport,0,40500,40500
H001048,N00029258,Duncan D Hunter (R),2016,Building Materials & Equipment,0,30500,30500
H001048,N00029258,Duncan D Hunter (R),2016,Electric Utilities,20250,10000,30250
H001048,N00029258,Duncan D Hunter (R),2016,Trucking,1500,26500,28000
K000368,N00029260,Ann Kirkpatrick (D),2016,Women's Issues,785280,28092,813372
K000368,N00029260,Ann Kirkpatrick (D),2016,Democratic/Liberal,768933,31605,800538
K000368,N00029260,Ann Kirkpatrick (D),2016,Retired,618705,0,618705
K000368,N00029260,Ann Kirkpatrick (D),2016,Lawyers/Law Firms,433151,15750,448901
K000368,N00029260,Ann Kirkpatrick (D),2016,Education,227028,0,227028
K000368,N00029260,Ann Kirkpatrick (D),2016,Leadership PACs,0,218700,218700
K000368,N00029260,Ann Kirkpatrick (D),2016,Real Estate,145598,1000,146598
K000368,N00029260,Ann Kirkpatrick (D),2016,Securities & Investment,144731,0,144731
K000368,N00029260,Ann Kirkpatrick (D),2016,Health Professionals,104707,27500,132207
K000368,N00029260,Ann Kirkpatrick (D),2016,Business Services,121710,0,121710
S001179,N00029273,Aaron Schock (R),2016,Securities & Investment,10700,8000,18700
S001179,N00029273,Aaron Schock (R),2016,Health Professionals,5300,7000,12300
S001179,N00029273,Aaron Schock (R),2016,Misc Finance,5400,2500,7900
S001179,N00029273,Aaron Schock (R),2016,Real Estate,2700,5000,7700
S001179,N00029273,Aaron Schock (R),2016,Misc Manufacturing & Distributing,3700,2500,6200
S001179,N00029273,Aaron Schock (R),2016,Building Materials & Equipment,500,5000,5500
S001179,N00029273,Aaron Schock (R),2016,Accountants,5200,0,5200
S001179,N00029273,Aaron Schock (R),2016,"Beer, Wine & Liquor",2700,2000,4700
S001179,N00029273,Aaron Schock (R),2016,Transportation Unions,0,4000,4000
S001179,N00029273,Aaron Schock (R),2016,Insurance,0,4000,4000
P000595,N00029277,Gary Peters (D),2016,Lawyers/Law Firms,1044333,74724,1119057
P000595,N00029277,Gary Peters (D),2016,Securities & Investment,473828,143500,617328
P000595,N00029277,Gary Peters (D),2016,Leadership PACs,83700,465850,549550
P000595,N00029277,Gary Peters (D),2016,Retired,540063,0,540063
P000595,N00029277,Gary Peters (D),2016,Real Estate,401056,59500,460556
P000595,N00029277,Gary Peters (D),2016,Environment,428210,30647,458857
P000595,N00029277,Gary Peters (D),2016,Insurance,139700,259290,398990
P000595,N00029277,Gary Peters (D),2016,Health Professionals,309992,46500,356492
P000595,N00029277,Gary Peters (D),2016,Education,285989,2750,288739
P000595,N00029277,Gary Peters (D),2016,Lobbyists,253456,8550,262006
O000168,N00029285,Pete Olson (R),2016,Oil & Gas,54050,158400,212450
O000168,N00029285,Pete Olson (R),2016,Health Professionals,11050,61500,72550
O000168,N00029285,Pete Olson (R),2016,Electric Utilities,0,65250,65250
O000168,N00029285,Pete Olson (R),2016,Automotive,5900,58995,64895
O000168,N00029285,Pete Olson (R),2016,Chemical & Related Manufacturing,500,58500,59000
O000168,N00029285,Pete Olson (R),2016,Lawyers/Law Firms,32300,24600,56900
O000168,N00029285,Pete Olson (R),2016,Telecom Services,1500,51000,52500
O000168,N00029285,Pete Olson (R),2016,Real Estate,35600,15500,51100
O000168,N00029285,Pete Olson (R),2016,Lobbyists,42095,3500,45595
O000168,N00029285,Pete Olson (R),2016,Pharmaceuticals/Health Products,1500,39500,41000
M001176,N00029303,Jeff Merkley (D),2016,Retired,468502,0,468502
M001176,N00029303,Jeff Merkley (D),2016,Lawyers/Law Firms,377105,60400,437505
M001176,N00029303,Jeff Merkley (D),2016,Leadership PACs,1,375600,375601
M001176,N00029303,Jeff Merkley (D),2016,Securities & Investment,186612,23500,210112
M001176,N00029303,Jeff Merkley (D),2016,Health Professionals,105917,87500,193417
M001176,N00029303,Jeff Merkley (D),2016,Real Estate,127942,62000,189942
M001176,N00029303,Jeff Merkley (D),2016,Education,168205,1000,169205
M001176,N00029303,Jeff Merkley (D),2016,Environment,131159,17181,148340
M001176,N00029303,Jeff Merkley (D),2016,Lobbyists,112741,5500,118241
M001176,N00029303,Jeff Merkley (D),2016,Electronics Mfg & Equip,81546,34500,116046
P000594,N00029391,Erik Paulsen (R),2016,Leadership PACs,0,370500,370500
P000594,N00029391,Erik Paulsen (R),2016,Pharmaceuticals/Health Products,86550,249350,335900
P000594,N00029391,Erik Paulsen (R),2016,Insurance,71650,231000,302650
P000594,N00029391,Erik Paulsen (R),2016,Retired,292330,0,292330
P000594,N00029391,Erik Paulsen (R),2016,Health Professionals,57660,186700,244360
P000594,N00029391,Erik Paulsen (R),2016,Securities & Investment,122600,87000,209600
P000594,N00029391,Erik Paulsen (R),2016,Real Estate,66925,66500,133425
P000594,N00029391,Erik Paulsen (R),2016,Lawyers/Law Firms,79075,44000,123075
P000594,N00029391,Erik Paulsen (R),2016,Commercial Banks,38236,78000,116236
P000594,N00029391,Erik Paulsen (R),2016,Misc Manufacturing & Distributing,46550,65500,112050
L000580,N00029400,Michelle Lujan Grisham (D),2016,Lawyers/Law Firms,180227,17750,197977
L000580,N00029400,Michelle Lujan Grisham (D),2016,Health Professionals,33785,122400,156185
L000580,N00029400,Michelle Lujan Grisham (D),2016,Casinos/Gambling,99900,2500,102400
L000580,N00029400,Michelle Lujan Grisham (D),2016,Retired,86935,0,86935
L000580,N00029400,Michelle Lujan Grisham (D),2016,Public Sector Unions,0,74500,74500
L000580,N00029400,Michelle Lujan Grisham (D),2016,Insurance,12360,61500,73860
L000580,N00029400,Michelle Lujan Grisham (D),2016,Lobbyists,41100,0,41100
L000580,N00029400,Michelle Lujan Grisham (D),2016,Industrial Unions,0,38500,38500
L000580,N00029400,Michelle Lujan Grisham (D),2016,Securities & Investment,9450,25000,34450
L000580,N00029400,Michelle Lujan Grisham (D),2016,Building Trade Unions,0,32500,32500
R000584,N00029441,James E Risch (R),2016,Leadership PACs,0,208373,208373
R000584,N00029441,James E Risch (R),2016,Oil & Gas,26100,97750,123850
R000584,N00029441,James E Risch (R),2016,Retired,85266,0,85266
R000584,N00029441,James E Risch (R),2016,Pro-Israel,46860,32200,79060
R000584,N00029441,James E Risch (R),2016,Commercial Banks,21700,56450,78150
R000584,N00029441,James E Risch (R),2016,Insurance,5750,68000,73750
R000584,N00029441,James E Risch (R),2016,Mining,43900,29750,73650
R000584,N00029441,James E Risch (R),2016,Misc Manufacturing & Distributing,40000,27664,67664
R000584,N00029441,James E Risch (R),2016,Real Estate,35011,30000,65011
R000584,N00029441,James E Risch (R),2016,Electric Utilities,3500,61500,65000
W000804,N00029459,Rob Wittman (R),2016,Retired,72635,0,72635
W000804,N00029459,Rob Wittman (R),2016,Misc Defense,28950,41500,70450
W000804,N00029459,Rob Wittman (R),2016,Defense Aerospace,2700,60500,63200
W000804,N00029459,Rob Wittman (R),2016,Defense Electronics,700,58500,59200
W000804,N00029459,Rob Wittman (R),2016,Real Estate,45260,12500,57760
W000804,N00029459,Rob Wittman (R),2016,Transportation Unions,0,34500,34500
W000804,N00029459,Rob Wittman (R),2016,Health Professionals,8625,21500,30125
W000804,N00029459,Rob Wittman (R),2016,Electronics Mfg & Equip,8400,15060,23460
W000804,N00029459,Rob Wittman (R),2016,Food & Beverage,20450,3000,23450
W000804,N00029459,Rob Wittman (R),2016,Business Services,17150,4000,21150
C001072,N00029513,Andre Carson (D),2016,Lawyers/Law Firms,71704,16000,87704
C001072,N00029513,Andre Carson (D),2016,Health Professionals,70327,12000,82327
C001072,N00029513,Andre Carson (D),2016,Air Transport,0,63500,63500
C001072,N00029513,Andre Carson (D),2016,Building Trade Unions,0,62500,62500
C001072,N00029513,Andre Carson (D),2016,Transportation Unions,0,49000,49000
C001072,N00029513,Andre Carson (D),2016,Industrial Unions,0,47000,47000
C001072,N00029513,Andre Carson (D),2016,Real Estate,32299,11200,43499
C001072,N00029513,Andre Carson (D),2016,Pharmaceuticals/Health Products,19151,20000,39151
C001072,N00029513,Andre Carson (D),2016,Public Sector Unions,500,37000,37500
C001072,N00029513,Andre Carson (D),2016,Construction Services,29666,7750,37416
L000570,N00029562,Ben R Lujan (D),2016,Casinos/Gambling,125700,2500,128200
L000570,N00029562,Ben R Lujan (D),2016,Health Professionals,5809,112500,118309
L000570,N00029562,Ben R Lujan (D),2016,Pharmaceuticals/Health Products,0,109100,109100
L000570,N00029562,Ben R Lujan (D),2016,Public Sector Unions,0,80500,80500
L000570,N00029562,Ben R Lujan (D),2016,Telecom Services,1500,78500,80000
L000570,N00029562,Ben R Lujan (D),2016,Electric Utilities,5250,72000,77250
L000570,N00029562,Ben R Lujan (D),2016,Lawyers/Law Firms,51654,25443,77097
L000570,N00029562,Ben R Lujan (D),2016,Misc Issues,58362,4600,62962
L000570,N00029562,Ben R Lujan (D),2016,Real Estate,8400,51500,59900
L000570,N00029562,Ben R Lujan (D),2016,Insurance,3200,51000,54200
S001187,N00029574,Steve Stivers (R),2016,Insurance,49800,256500,306300
S001187,N00029574,Steve Stivers (R),2016,Securities & Investment,124800,139650,264450
S001187,N00029574,Steve Stivers (R),2016,Real Estate,95368,80500,175868
S001187,N00029574,Steve Stivers (R),2016,Commercial Banks,37600,129450,167050
S001187,N00029574,Steve Stivers (R),2016,Health Professionals,9450,135350,144800
S001187,N00029574,Steve Stivers (R),2016,Electric Utilities,41250,62500,103750
S001187,N00029574,Steve Stivers (R),2016,Lawyers/Law Firms,51050,49550,100600
S001187,N00029574,Steve Stivers (R),2016,Finance/Credit Companies,21500,79000,100500
S001187,N00029574,Steve Stivers (R),2016,Misc Finance,60150,34200,94350
S001187,N00029574,Steve Stivers (R),2016,Pharmaceuticals/Health Products,9600,77400,87000
H001045,N00029632,Gregg Harper (R),2016,Health Professionals,19250,76000,95250
H001045,N00029632,Gregg Harper (R),2016,Oil & Gas,21550,38500,60050
H001045,N00029632,Gregg Harper (R),2016,Lawyers/Law Firms,27000,18500,45500
H001045,N00029632,Gregg Harper (R),2016,Electric Utilities,1000,44000,45000
H001045,N00029632,Gregg Harper (R),2016,Commercial Banks,7500,32000,39500
H001045,N00029632,Gregg Harper (R),2016,Defense Aerospace,5000,29000,34000
H001045,N00029632,Gregg Harper (R),2016,Real Estate,18850,10000,28850
H001045,N00029632,Gregg Harper (R),2016,Crop Production & Basic Processing,5100,23000,28100
H001045,N00029632,Gregg Harper (R),2016,Leadership PACs,0,27500,27500
H001045,N00029632,Gregg Harper (R),2016,Lobbyists,25300,0,25300
S001175,N00029649,Jackie Speier (D),2016,Pharmaceuticals/Health Products,27900,40500,68400
S001175,N00029649,Jackie Speier (D),2016,Retired,66263,0,66263
S001175,N00029649,Jackie Speier (D),2016,Health Professionals,12600,42200,54800
S001175,N00029649,Jackie Speier (D),2016,Lawyers/Law Firms,32450,13250,45700
S001175,N00029649,Jackie Speier (D),2016,Securities & Investment,41700,1000,42700
S001175,N00029649,Jackie Speier (D),2016,Retail Sales,1500,38500,40000
S001175,N00029649,Jackie Speier (D),2016,Real Estate,22350,7000,29350
S001175,N00029649,Jackie Speier (D),2016,Building Trade Unions,0,27500,27500
S001175,N00029649,Jackie Speier (D),2016,Insurance,0,22000,22000
S001175,N00029649,Jackie Speier (D),2016,Public Sector Unions,0,20500,20500
P000599,N00029662,Bill Posey (R),2016,Retired,103536,0,103536
P000599,N00029662,Bill Posey (R),2016,Health Professionals,31750,43500,75250
P000599,N00029662,Bill Posey (R),2016,Real Estate,28750,34500,63250
P000599,N00029662,Bill Posey (R),2016,Insurance,3950,50000,53950
P000599,N00029662,Bill Posey (R),2016,Commercial Banks,3450,39000,42450
P000599,N00029662,Bill Posey (R),2016,Defense Electronics,16375,21500,37875
P000599,N00029662,Bill Posey (R),2016,Securities & Investment,19300,18500,37800
P000599,N00029662,Bill Posey (R),2016,Construction Services,27850,4500,32350
P000599,N00029662,Bill Posey (R),2016,Defense Aerospace,0,28000,28000
P000599,N00029662,Bill Posey (R),2016,Retail Sales,16210,2000,18210
G000558,N00029675,Brett Guthrie (R),2016,Health Professionals,14600,240500,255100
G000558,N00029675,Brett Guthrie (R),2016,Pharmaceuticals/Health Products,7850,200772,208622
G000558,N00029675,Brett Guthrie (R),2016,Health Services/HMOs,250,101200,101450
G000558,N00029675,Brett Guthrie (R),2016,Insurance,10000,84000,94000
G000558,N00029675,Brett Guthrie (R),2016,Telecom Services,2000,67250,69250
G000558,N00029675,Brett Guthrie (R),2016,Lobbyists,56489,2000,58489
G000558,N00029675,Brett Guthrie (R),2016,Oil & Gas,1000,56000,57000
G000558,N00029675,Brett Guthrie (R),2016,Electric Utilities,0,44500,44500
G000558,N00029675,Brett Guthrie (R),2016,Retail Sales,6250,38000,44250
G000558,N00029675,Brett Guthrie (R),2016,Building Materials & Equipment,3750,40500,44250
F000456,N00029679,John Fleming (R),2016,Republican/Conservative,402991,22500,425491
F000456,N00029679,John Fleming (R),2016,Health Professionals,194705,36500,231205
F000456,N00029679,John Fleming (R),2016,Retired,187953,0,187953
F000456,N00029679,John Fleming (R),2016,Oil & Gas,148430,9000,157430
F000456,N00029679,John Fleming (R),2016,Real Estate,98450,3000,101450
F000456,N00029679,John Fleming (R),2016,General Contractors,59650,6500,66150
F000456,N00029679,John Fleming (R),2016,Pro-Israel,47750,16500,64250
F000456,N00029679,John Fleming (R),2016,Securities & Investment,62550,0,62550
F000456,N00029679,John Fleming (R),2016,Lawyers/Law Firms,54135,3500,57635
F000456,N00029679,John Fleming (R),2016,Hospitals/Nursing Homes,57066,0,57066
T000467,N00029736,Glenn Thompson (R),2016,Oil & Gas,31100,44200,75300
T000467,N00029736,Glenn Thompson (R),2016,Retired,61105,0,61105
T000467,N00029736,Glenn Thompson (R),2016,Real Estate,47736,8000,55736
T000467,N00029736,Glenn Thompson (R),2016,Lawyers/Law Firms,45150,7050,52200
T000467,N00029736,Glenn Thompson (R),2016,Hospitals/Nursing Homes,29550,16500,46050
T000467,N00029736,Glenn Thompson (R),2016,Electric Utilities,5400,37000,42400
T000467,N00029736,Glenn Thompson (R),2016,Insurance,20970,16250,37220
T000467,N00029736,Glenn Thompson (R),2016,Agricultural Services/Products,250,33000,33250
T000467,N00029736,Glenn Thompson (R),2016,Crop Production & Basic Processing,19425,13500,32925
T000467,N00029736,Glenn Thompson (R),2016,Health Professionals,12805,19500,32305
L000571,N00029788,Cynthia Lummis (R),2016,Mining,0,20500,20500
L000571,N00029788,Cynthia Lummis (R),2016,Oil & Gas,2700,16000,18700
L000571,N00029788,Cynthia Lummis (R),2016,Securities & Investment,5450,0,5450
L000571,N00029788,Cynthia Lummis (R),2016,Railroads,0,5000,5000
L000571,N00029788,Cynthia Lummis (R),2016,Crop Production & Basic Processing,0,5000,5000
L000571,N00029788,Cynthia Lummis (R),2016,Misc Energy,2000,1000,3000
L000571,N00029788,Cynthia Lummis (R),2016,Lawyers/Law Firms,2500,500,3000
L000571,N00029788,Cynthia Lummis (R),2016,Internet,2700,0,2700
L000571,N00029788,Cynthia Lummis (R),2016,"Beer, Wine & Liquor",0,2500,2500
L000571,N00029788,Cynthia Lummis (R),2016,Lobbyists,2000,0,2000
L000571,N00029788,Cynthia Lummis (R),2016,Fisheries & Wildlife,0,2000,2000
L000571,N00029788,Cynthia Lummis (R),2016,Candidate Committees,0,2000,2000
L000571,N00029788,Cynthia Lummis (R),2016,Construction Services,0,2000,2000
H001046,N00029835,Martin Heinrich (D),2016,Lawyers/Law Firms,680727,91975,772702
H001046,N00029835,Martin Heinrich (D),2016,Retired,585142,0,585142
H001046,N00029835,Martin Heinrich (D),2016,Lobbyists,404052,3724,407776
H001046,N00029835,Martin Heinrich (D),2016,Environment,243668,31166,274834
H001046,N00029835,Martin Heinrich (D),2016,Leadership PACs,0,243500,243500
H001046,N00029835,Martin Heinrich (D),2016,Health Professionals,128262,105500,233762
H001046,N00029835,Martin Heinrich (D),2016,Education,172041,6500,178541
H001046,N00029835,Martin Heinrich (D),2016,Casinos/Gambling,162050,13500,175550
H001046,N00029835,Martin Heinrich (D),2016,Democratic/Liberal,134053,31435,165488
H001046,N00029835,Martin Heinrich (D),2016,Pro-Israel,134380,23993,158373
C001078,N00029891,Gerry Connolly (D),2016,Retired,124188,0,124188
C001078,N00029891,Gerry Connolly (D),2016,Electronics Mfg & Equip,32945,83000,115945
C001078,N00029891,Gerry Connolly (D),2016,Public Sector Unions,250,98813,99063
C001078,N00029891,Gerry Connolly (D),2016,Lawyers/Law Firms,69340,26750,96090
C001078,N00029891,Gerry Connolly (D),2016,Real Estate,68044,12000,80044
C001078,N00029891,Gerry Connolly (D),2016,Business Services,56742,8500,65242
C001078,N00029891,Gerry Connolly (D),2016,Lobbyists,58600,500,59100
C001078,N00029891,Gerry Connolly (D),2016,Securities & Investment,12350,39000,51350
C001078,N00029891,Gerry Connolly (D),2016,Democratic/Liberal,38584,11000,49584
C001078,N00029891,Gerry Connolly (D),2016,Misc Defense,2350,47000,49350
G000573,N00029908,Joe Garcia (D),2016,Lawyers/Law Firms,170336,1000,171336
G000573,N00029908,Joe Garcia (D),2016,Leadership PACs,12200,125500,137700
G000573,N00029908,Joe Garcia (D),2016,Real Estate,61085,0,61085
G000573,N00029908,Joe Garcia (D),2016,Retired,56945,0,56945
G000573,N00029908,Joe Garcia (D),2016,Candidate Committees,0,42500,42500
G000573,N00029908,Joe Garcia (D),2016,Democratic/Liberal,30002,11000,41002
G000573,N00029908,Joe Garcia (D),2016,Foreign & Defense Policy,29750,10000,39750
G000573,N00029908,Joe Garcia (D),2016,Securities & Investment,37450,0,37450
G000573,N00029908,Joe Garcia (D),2016,General Contractors,33700,0,33700
G000573,N00029908,Joe Garcia (D),2016,Misc Business,27850,0,27850
L000569,N00030026,Blaine Luetkemeyer (R),2016,Insurance,19708,314750,334458
L000569,N00030026,Blaine Luetkemeyer (R),2016,Commercial Banks,35250,165900,201150
L000569,N00030026,Blaine Luetkemeyer (R),2016,Securities & Investment,35732,130500,166232
L000569,N00030026,Blaine Luetkemeyer (R),2016,Real Estate,25590,94250,119840
L000569,N00030026,Blaine Luetkemeyer (R),2016,Finance/Credit Companies,14000,102000,116000
L000569,N00030026,Blaine Luetkemeyer (R),2016,Accountants,4700,50000,54700
L000569,N00030026,Blaine Luetkemeyer (R),2016,Agricultural Services/Products,22600,28400,51000
L000569,N00030026,Blaine Luetkemeyer (R),2016,Lawyers/Law Firms,23966,27000,50966
L000569,N00030026,Blaine Luetkemeyer (R),2016,Leadership PACs,0,42500,42500
L000569,N00030026,Blaine Luetkemeyer (R),2016,Misc Finance,3800,38000,41800
S001180,N00030071,Kurt Schrader (D),2016,Health Professionals,5020,133500,138520
S001180,N00030071,Kurt Schrader (D),2016,Pharmaceuticals/Health Products,250,129178,129428
S001180,N00030071,Kurt Schrader (D),2016,Forestry & Forest Products,43550,49500,93050
S001180,N00030071,Kurt Schrader (D),2016,Insurance,6400,73500,79900
S001180,N00030071,Kurt Schrader (D),2016,Health Services/HMOs,9550,56500,66050
S001180,N00030071,Kurt Schrader (D),2016,Agricultural Services/Products,15700,45500,61200
S001180,N00030071,Kurt Schrader (D),2016,Lawyers/Law Firms,31826,24500,56326
S001180,N00030071,Kurt Schrader (D),2016,Electric Utilities,500,55000,55500
S001180,N00030071,Kurt Schrader (D),2016,Oil & Gas,1500,53000,54500
S001180,N00030071,Kurt Schrader (D),2016,Misc Manufacturing & Distributing,32563,21000,53563
R000588,N00030184,Cedric Richmond (D),2016,Lawyers/Law Firms,115350,37800,153150
R000588,N00030184,Cedric Richmond (D),2016,Oil & Gas,7400,55000,62400
R000588,N00030184,Cedric Richmond (D),2016,Building Trade Unions,0,61000,61000
R000588,N00030184,Cedric Richmond (D),2016,Electric Utilities,3000,44750,47750
R000588,N00030184,Cedric Richmond (D),2016,Transportation Unions,0,47125,47125
R000588,N00030184,Cedric Richmond (D),2016,Public Sector Unions,0,42000,42000
R000588,N00030184,Cedric Richmond (D),2016,Lobbyists,39637,2000,41637
R000588,N00030184,Cedric Richmond (D),2016,Telecom Services,3250,36500,39750
R000588,N00030184,Cedric Richmond (D),2016,Chemical & Related Manufacturing,0,37000,37000
R000588,N00030184,Cedric Richmond (D),2016,Real Estate,19500,16500,36000
T000468,N00030191,Dina Titus (D),2016,Casinos/Gambling,31200,37500,68700
T000468,N00030191,Dina Titus (D),2016,Lawyers/Law Firms,56250,7500,63750
T000468,N00030191,Dina Titus (D),2016,Transportation Unions,0,52000,52000
T000468,N00030191,Dina Titus (D),2016,Building Trade Unions,0,50000,50000
T000468,N00030191,Dina Titus (D),2016,Real Estate,35750,10500,46250
T000468,N00030191,Dina Titus (D),2016,Retired,44784,0,44784
T000468,N00030191,Dina Titus (D),2016,Industrial Unions,0,38000,38000
T000468,N00030191,Dina Titus (D),2016,Air Transport,5500,27000,32500
T000468,N00030191,Dina Titus (D),2016,Public Sector Unions,0,30500,30500
T000468,N00030191,Dina Titus (D),2016,Railroads,0,23000,23000
T000469,N00030196,Paul Tonko (D),2016,Health Professionals,10163,111000,121163
T000469,N00030196,Paul Tonko (D),2016,Public Sector Unions,0,51000,51000
T000469,N00030196,Paul Tonko (D),2016,Industrial Unions,0,50000,50000
T000469,N00030196,Paul Tonko (D),2016,Telecom Services,0,42500,42500
T000469,N00030196,Paul Tonko (D),2016,Building Trade Unions,0,42500,42500
T000469,N00030196,Paul Tonko (D),2016,Pharmaceuticals/Health Products,105,36000,36105
T000469,N00030196,Paul Tonko (D),2016,Real Estate,22295,10500,32795
T000469,N00030196,Paul Tonko (D),2016,Lawyers/Law Firms,19004,13500,32504
T000469,N00030196,Paul Tonko (D),2016,Transportation Unions,0,30750,30750
T000469,N00030196,Paul Tonko (D),2016,Retired,30705,0,30705
H001051,N00030197,Richard Hanna (R),2016,Air Transport,500,29000,29500
H001051,N00030197,Richard Hanna (R),2016,Securities & Investment,19900,1000,20900
H001051,N00030197,Richard Hanna (R),2016,Transportation Unions,0,17000,17000
H001051,N00030197,Richard Hanna (R),2016,Special Trade Contractors,0,16500,16500
H001051,N00030197,Richard Hanna (R),2016,Health Professionals,1000,15000,16000
H001051,N00030197,Richard Hanna (R),2016,Building Trade Unions,0,15000,15000
H001051,N00030197,Richard Hanna (R),2016,Construction Services,0,14000,14000
H001051,N00030197,Richard Hanna (R),2016,General Contractors,1000,12000,13000
H001051,N00030197,Richard Hanna (R),2016,Building Materials & Equipment,0,10500,10500
H001051,N00030197,Richard Hanna (R),2016,Trucking,0,9500,9500
H001051,N00030197,Richard Hanna (R),2016,Insurance,500,9000,9500
C001075,N00030245,Bill Cassidy (R),2016,Health Professionals,861265,343100,1204365
C001075,N00030245,Bill Cassidy (R),2016,Retired,1145288,0,1145288
C001075,N00030245,Bill Cassidy (R),2016,Securities & Investment,976976,8500,985476
C001075,N00030245,Bill Cassidy (R),2016,Oil & Gas,709170,132000,841170
C001075,N00030245,Bill Cassidy (R),2016,Leadership PACs,0,607794,607794
C001075,N00030245,Bill Cassidy (R),2016,Real Estate,444395,6400,450795
C001075,N00030245,Bill Cassidy (R),2016,Republican/Conservative,197826,104714,302540
C001075,N00030245,Bill Cassidy (R),2016,Lawyers/Law Firms,256485,21500,277985
C001075,N00030245,Bill Cassidy (R),2016,General Contractors,226000,38500,264500
C001075,N00030245,Bill Cassidy (R),2016,Misc Finance,243067,5000,248067
S001177,N00030418,Gregorio Sablan (I),2016,Misc Finance,4400,0,4400
S001177,N00030418,Gregorio Sablan (I),2016,Retired,3200,0,3200
S001177,N00030418,Gregorio Sablan (I),2016,Commercial Banks,2500,0,2500
S001177,N00030418,Gregorio Sablan (I),2016,General Contractors,2400,0,2400
S001177,N00030418,Gregorio Sablan (I),2016,Leadership PACs,0,2000,2000
S001177,N00030418,Gregorio Sablan (I),2016,Lawyers/Law Firms,1700,0,1700
S001177,N00030418,Gregorio Sablan (I),2016,Misc Business,900,0,900
S001177,N00030418,Gregorio Sablan (I),2016,Misc Manufacturing & Distributing,600,0,600
S001177,N00030418,Gregorio Sablan (I),2016,Sea Transport,0,500,500
S001177,N00030418,Gregorio Sablan (I),2016,Education,400,0,400
S001177,N00030418,Gregorio Sablan (I),2016,Accountants,400,0,400
S001177,N00030418,Gregorio Sablan (I),2016,Health Professionals,400,0,400
F000455,N00030490,Marcia L Fudge (D),2016,Public Sector Unions,0,54500,54500
F000455,N00030490,Marcia L Fudge (D),2016,Industrial Unions,5000,42500,47500
F000455,N00030490,Marcia L Fudge (D),2016,Agricultural Services/Products,0,44000,44000
F000455,N00030490,Marcia L Fudge (D),2016,Electric Utilities,0,40500,40500
F000455,N00030490,Marcia L Fudge (D),2016,Building Trade Unions,2000,35000,37000
F000455,N00030490,Marcia L Fudge (D),2016,Lawyers/Law Firms,7531,23000,30531
F000455,N00030490,Marcia L Fudge (D),2016,Insurance,0,27000,27000
F000455,N00030490,Marcia L Fudge (D),2016,Transportation Unions,0,26500,26500
F000455,N00030490,Marcia L Fudge (D),2016,Food Processing & Sales,2000,21500,23500
F000455,N00030490,Marcia L Fudge (D),2016,Food & Beverage,500,23000,23500
Q000023,N00030581,Mike Quigley (D),2016,Lawyers/Law Firms,88225,19000,107225
Q000023,N00030581,Mike Quigley (D),2016,Real Estate,36500,26000,62500
Q000023,N00030581,Mike Quigley (D),2016,Securities & Investment,32615,25500,58115
Q000023,N00030581,Mike Quigley (D),2016,Railroads,0,40000,40000
Q000023,N00030581,Mike Quigley (D),2016,Accountants,3950,34000,37950
Q000023,N00030581,Mike Quigley (D),2016,Pro-Israel,19600,17400,37000
Q000023,N00030581,Mike Quigley (D),2016,Retired,30175,0,30175
Q000023,N00030581,Mike Quigley (D),2016,Lodging/Tourism,1500,25500,27000
Q000023,N00030581,Mike Quigley (D),2016,Insurance,4000,22000,26000
Q000023,N00030581,Mike Quigley (D),2016,Transportation Unions,0,26000,26000
C001080,N00030600,Judy Chu (D),2016,Real Estate,58900,7000,65900
C001080,N00030600,Judy Chu (D),2016,Lawyers/Law Firms,41700,16000,57700
C001080,N00030600,Judy Chu (D),2016,Health Professionals,24100,27000,51100
C001080,N00030600,Judy Chu (D),2016,Public Sector Unions,0,46500,46500
C001080,N00030600,Judy Chu (D),2016,TV/Movies/Music,6800,28200,35000
C001080,N00030600,Judy Chu (D),2016,Building Trade Unions,0,34000,34000
C001080,N00030600,Judy Chu (D),2016,Misc Unions,0,33500,33500
C001080,N00030600,Judy Chu (D),2016,Industrial Unions,0,33000,33000
C001080,N00030600,Judy Chu (D),2016,Retired,31548,0,31548
C001080,N00030600,Judy Chu (D),2016,Telecom Services,10550,16500,27050
B001267,N00030608,Michael F Bennet (D),2016,Securities & Investment,1845499,195450,2040949
B001267,N00030608,Michael F Bennet (D),2016,Lawyers/Law Firms,1695953,228712,1924665
B001267,N00030608,Michael F Bennet (D),2016,Retired,953328,0,953328
B001267,N00030608,Michael F Bennet (D),2016,Real Estate,842592,93900,936492
B001267,N00030608,Michael F Bennet (D),2016,Democratic/Liberal,711776,23030,734806
B001267,N00030608,Michael F Bennet (D),2016,Education,501566,27500,529066
B001267,N00030608,Michael F Bennet (D),2016,Lobbyists,494264,25200,519464
B001267,N00030608,Michael F Bennet (D),2016,Environment,480252,27709,507961
B001267,N00030608,Michael F Bennet (D),2016,Health Professionals,273899,207500,481399
B001267,N00030608,Michael F Bennet (D),2016,TV/Movies/Music,427090,42000,469090
R000595,N00030612,Marco Rubio (R),2016,Retired,4589310,0,4589310
R000595,N00030612,Marco Rubio (R),2016,Securities & Investment,1805068,66930,1871998
R000595,N00030612,Marco Rubio (R),2016,Real Estate,1263784,56500,1320284
R000595,N00030612,Marco Rubio (R),2016,Republican/Conservative,1142429,77293,1219722
R000595,N00030612,Marco Rubio (R),2016,Lawyers/Law Firms,774809,108350,883159
R000595,N00030612,Marco Rubio (R),2016,Misc Finance,596528,21000,617528
R000595,N00030612,Marco Rubio (R),2016,Oil & Gas,329211,196166,525377
R000595,N00030612,Marco Rubio (R),2016,Business Services,424604,20000,444604
R000595,N00030612,Marco Rubio (R),2016,Leadership PACs,0,420041,420041
R000595,N00030612,Marco Rubio (R),2016,Insurance,223391,186950,410341
S001185,N00030622,Terri A Sewell (D),2016,Insurance,6350,178250,184600
S001185,N00030622,Terri A Sewell (D),2016,Securities & Investment,17800,120500,138300
S001185,N00030622,Terri A Sewell (D),2016,Lawyers/Law Firms,68680,44850,113530
S001185,N00030622,Terri A Sewell (D),2016,Commercial Banks,13550,89500,103050
S001185,N00030622,Terri A Sewell (D),2016,Real Estate,14850,58500,73350
S001185,N00030622,Terri A Sewell (D),2016,Accountants,1000,49000,50000
S001185,N00030622,Terri A Sewell (D),2016,Forestry & Forest Products,11113,35700,46813
S001185,N00030622,Terri A Sewell (D),2016,Pharmaceuticals/Health Products,1000,37000,38000
S001185,N00030622,Terri A Sewell (D),2016,Defense Aerospace,0,37500,37500
S001185,N00030622,Terri A Sewell (D),2016,Finance/Credit Companies,0,35000,35000
L000586,N00030642,Al Lawson (D),2016,Lawyers/Law Firms,19768,11000,30768
L000586,N00030642,Al Lawson (D),2016,Retired,22562,0,22562
L000586,N00030642,Al Lawson (D),2016,Industrial Unions,0,21000,21000
L000586,N00030642,Al Lawson (D),2016,Insurance,4950,16000,20950
L000586,N00030642,Al Lawson (D),2016,Real Estate,7150,7500,14650
L000586,N00030642,Al Lawson (D),2016,Securities & Investment,14500,0,14500
L000586,N00030642,Al Lawson (D),2016,Leadership PACs,0,14000,14000
L000586,N00030642,Al Lawson (D),2016,Transportation Unions,0,13000,13000
L000586,N00030642,Al Lawson (D),2016,Health Professionals,6300,4000,10300
L000586,N00030642,Al Lawson (D),2016,"Beer, Wine & Liquor",4250,5000,9250
R000593,N00030645,Dennis Ross (R),2016,Insurance,8375,190262,198637
R000593,N00030645,Dennis Ross (R),2016,Securities & Investment,5500,109000,114500
R000593,N00030645,Dennis Ross (R),2016,Commercial Banks,1000,87000,88000
R000593,N00030645,Dennis Ross (R),2016,Real Estate,7100,64000,71100
R000593,N00030645,Dennis Ross (R),2016,Finance/Credit Companies,10750,47000,57750
R000593,N00030645,Dennis Ross (R),2016,Retail Sales,800,51500,52300
R000593,N00030645,Dennis Ross (R),2016,Accountants,4000,47500,51500
R000593,N00030645,Dennis Ross (R),2016,Food Processing & Sales,28600,14000,42600
R000593,N00030645,Dennis Ross (R),2016,Lawyers/Law Firms,17750,20500,38250
R000593,N00030645,Dennis Ross (R),2016,Health Professionals,10200,28000,38200
K000378,N00030667,Adam Kinzinger (R),2016,Insurance,16600,80000,96600
K000378,N00030667,Adam Kinzinger (R),2016,Health Professionals,29969,63500,93469
K000378,N00030667,Adam Kinzinger (R),2016,Electric Utilities,13900,68000,81900
K000378,N00030667,Adam Kinzinger (R),2016,Telecom Services,500,67000,67500
K000378,N00030667,Adam Kinzinger (R),2016,Pharmaceuticals/Health Products,1000,65600,66600
K000378,N00030667,Adam Kinzinger (R),2016,Oil & Gas,14750,51500,66250
K000378,N00030667,Adam Kinzinger (R),2016,Misc Manufacturing & Distributing,29450,29746,59196
K000378,N00030667,Adam Kinzinger (R),2016,Securities & Investment,49100,6000,55100
K000378,N00030667,Adam Kinzinger (R),2016,Crop Production & Basic Processing,7870,47000,54870
K000378,N00030667,Adam Kinzinger (R),2016,Real Estate,22300,27000,49300
H001058,N00030673,Bill Huizenga (R),2016,Insurance,0,170500,170500
H001058,N00030673,Bill Huizenga (R),2016,Real Estate,75000,70000,145000
H001058,N00030673,Bill Huizenga (R),2016,Securities & Investment,18200,99000,117200
H001058,N00030673,Bill Huizenga (R),2016,Commercial Banks,3000,97500,100500
H001058,N00030673,Bill Huizenga (R),2016,Misc Manufacturing & Distributing,48000,10700,58700
H001058,N00030673,Bill Huizenga (R),2016,Accountants,0,40000,40000
H001058,N00030673,Bill Huizenga (R),2016,Finance/Credit Companies,0,36000,36000
H001058,N00030673,Bill Huizenga (R),2016,Lawyers/Law Firms,7500,24250,31750
H001058,N00030673,Bill Huizenga (R),2016,Retail Sales,21600,10000,31600
H001058,N00030673,Bill Huizenga (R),2016,Retired,28475,0,28475
L000576,N00030676,Billy Long (R),2016,Leadership PACs,0,100200,100200
L000576,N00030676,Billy Long (R),2016,Pharmaceuticals/Health Products,1000,97000,98000
L000576,N00030676,Billy Long (R),2016,Health Professionals,17500,77000,94500
L000576,N00030676,Billy Long (R),2016,Real Estate,34250,25000,59250
L000576,N00030676,Billy Long (R),2016,Electric Utilities,1000,49000,50000
L000576,N00030676,Billy Long (R),2016,Automotive,25550,20500,46050
L000576,N00030676,Billy Long (R),2016,Oil & Gas,0,44500,44500
L000576,N00030676,Billy Long (R),2016,Misc Manufacturing & Distributing,24400,19158,43558
L000576,N00030676,Billy Long (R),2016,Retired,41069,0,41069
L000576,N00030676,Billy Long (R),2016,Telecom Services,250,37500,37750
D000617,N00030693,Suzan DelBene (D),2016,Electronics Mfg & Equip,92788,53784,146572
D000617,N00030693,Suzan DelBene (D),2016,Democratic/Liberal,101999,16000,117999
D000617,N00030693,Suzan DelBene (D),2016,Retired,92648,0,92648
D000617,N00030693,Suzan DelBene (D),2016,Lawyers/Law Firms,42820,21000,63820
D000617,N00030693,Suzan DelBene (D),2016,Retail Sales,11615,50500,62115
D000617,N00030693,Suzan DelBene (D),2016,TV/Movies/Music,17005,37000,54005
D000617,N00030693,Suzan DelBene (D),2016,Agricultural Services/Products,225,47500,47725
D000617,N00030693,Suzan DelBene (D),2016,Pharmaceuticals/Health Products,2750,44236,46986
D000617,N00030693,Suzan DelBene (D),2016,Securities & Investment,17700,28000,45700
D000617,N00030693,Suzan DelBene (D),2016,Casinos/Gambling,41650,0,41650
D000617,N00030693,Suzan DelBene (D),2016,Internet,20150,21500,41650
D000623,N00030709,Mark Desaulnier (D),2016,Public Sector Unions,0,56500,56500
D000623,N00030709,Mark Desaulnier (D),2016,Real Estate,42050,6000,48050
D000623,N00030709,Mark Desaulnier (D),2016,Lawyers/Law Firms,32505,8500,41005
D000623,N00030709,Mark Desaulnier (D),2016,Building Trade Unions,0,40500,40500
D000623,N00030709,Mark Desaulnier (D),2016,Industrial Unions,0,37000,37000
D000623,N00030709,Mark Desaulnier (D),2016,Retired,22385,0,22385
D000623,N00030709,Mark Desaulnier (D),2016,Transportation Unions,0,22125,22125
D000623,N00030709,Mark Desaulnier (D),2016,Home Builders,18930,2000,20930
D000623,N00030709,Mark Desaulnier (D),2016,Democratic/Liberal,19320,250,19570
D000623,N00030709,Mark Desaulnier (D),2016,Crop Production & Basic Processing,1000,17000,18000
B001287,N00030717,Ami Bera (D),2016,Retired,328990,0,328990
B001287,N00030717,Ami Bera (D),2016,Health Professionals,89992,221150,311142
B001287,N00030717,Ami Bera (D),2016,Democratic/Liberal,260635,18648,279283
B001287,N00030717,Ami Bera (D),2016,Leadership PACs,2700,241983,244683
B001287,N00030717,Ami Bera (D),2016,Securities & Investment,154750,9500,164250
B001287,N00030717,Ami Bera (D),2016,Human Rights,100925,48600,149525
B001287,N00030717,Ami Bera (D),2016,Lawyers/Law Firms,125833,17685,143518
B001287,N00030717,Ami Bera (D),2016,Pharmaceuticals/Health Products,24450,93250,117700
B001287,N00030717,Ami Bera (D),2016,Education,116944,0,116944
B001287,N00030717,Ami Bera (D),2016,Real Estate,87894,18500,106394
C001083,N00030736,John Carney (D),2016,Securities & Investment,4250,47500,51750
C001083,N00030736,John Carney (D),2016,Insurance,500,38000,38500
C001083,N00030736,John Carney (D),2016,Commercial Banks,1350,24500,25850
C001083,N00030736,John Carney (D),2016,Accountants,0,18000,18000
C001083,N00030736,John Carney (D),2016,Pharmaceuticals/Health Products,0,17500,17500
C001083,N00030736,John Carney (D),2016,Lawyers/Law Firms,8650,6000,14650
C001083,N00030736,John Carney (D),2016,Finance/Credit Companies,0,13500,13500
C001083,N00030736,John Carney (D),2016,Real Estate,3700,9000,12700
C001083,N00030736,John Carney (D),2016,Lobbyists,7750,0,7750
C001083,N00030736,John Carney (D),2016,Democratic/Liberal,500,5000,5500
P000602,N00030744,Mike Pompeo (R),2016,Oil & Gas,84300,106000,190300
P000602,N00030744,Mike Pompeo (R),2016,Health Professionals,20250,64500,84750
P000602,N00030744,Mike Pompeo (R),2016,Telecom Services,1500,61750,63250
P000602,N00030744,Mike Pompeo (R),2016,Electric Utilities,0,54250,54250
P000602,N00030744,Mike Pompeo (R),2016,Pharmaceuticals/Health Products,0,49600,49600
P000602,N00030744,Mike Pompeo (R),2016,Food Processing & Sales,7200,40750,47950
P000602,N00030744,Mike Pompeo (R),2016,Lobbyists,43850,2500,46350
P000602,N00030744,Mike Pompeo (R),2016,Lawyers/Law Firms,31775,14500,46275
P000602,N00030744,Mike Pompeo (R),2016,Chemical & Related Manufacturing,3000,41500,44500
P000602,N00030744,Mike Pompeo (R),2016,Commercial Banks,28825,14500,43325
D000615,N00030752,Jeff Duncan (R),2016,Oil & Gas,1000,41500,42500
D000615,N00030752,Jeff Duncan (R),2016,Retired,33180,0,33180
D000615,N00030752,Jeff Duncan (R),2016,Pro-Israel,5000,20000,25000
D000615,N00030752,Jeff Duncan (R),2016,Insurance,550,23500,24050
D000615,N00030752,Jeff Duncan (R),2016,Health Professionals,2588,20500,23088
D000615,N00030752,Jeff Duncan (R),2016,Hospitals/Nursing Homes,2650,18600,21250
D000615,N00030752,Jeff Duncan (R),2016,Foreign & Defense Policy,10000,10000,20000
D000615,N00030752,Jeff Duncan (R),2016,Securities & Investment,19212,0,19212
D000615,N00030752,Jeff Duncan (R),2016,Lawyers/Law Firms,5250,13750,19000
D000615,N00030752,Jeff Duncan (R),2016,Electric Utilities,1966,17000,18966
R000591,N00030768,Martha Roby (R),2016,Real Estate,52784,19000,71784
R000591,N00030768,Martha Roby (R),2016,Leadership PACs,0,66717,66717
R000591,N00030768,Martha Roby (R),2016,Lawyers/Law Firms,22317,39500,61817
R000591,N00030768,Martha Roby (R),2016,Crop Production & Basic Processing,6450,49000,55450
R000591,N00030768,Martha Roby (R),2016,Forestry & Forest Products,11891,42500,54391
R000591,N00030768,Martha Roby (R),2016,Retired,50550,0,50550
R000591,N00030768,Martha Roby (R),2016,Defense Aerospace,0,47500,47500
R000591,N00030768,Martha Roby (R),2016,Health Professionals,11050,34300,45350
R000591,N00030768,Martha Roby (R),2016,Insurance,500,38500,39000
R000591,N00030768,Martha Roby (R),2016,Accountants,3200,32000,35200
C001087,N00030770,Rick Crawford (R),2016,Crop Production & Basic Processing,64900,86000,150900
C001087,N00030770,Rick Crawford (R),2016,Agricultural Services/Products,3950,49500,53450
C001087,N00030770,Rick Crawford (R),2016,Health Professionals,17500,21500,39000
C001087,N00030770,Rick Crawford (R),2016,Construction Services,6400,13500,19900
C001087,N00030770,Rick Crawford (R),2016,Retired,19549,0,19549
C001087,N00030770,Rick Crawford (R),2016,Poultry & Eggs,5400,13000,18400
C001087,N00030770,Rick Crawford (R),2016,Air Transport,0,18000,18000
C001087,N00030770,Rick Crawford (R),2016,Commercial Banks,3000,12000,15000
C001087,N00030770,Rick Crawford (R),2016,Real Estate,6700,8000,14700
C001087,N00030770,Rick Crawford (R),2016,Trucking,3000,11500,14500
G000565,N00030771,Paul Gosar (R),2016,Health Professionals,108800,67313,176113
G000565,N00030771,Paul Gosar (R),2016,Leadership PACs,3200,29500,32700
G000565,N00030771,Paul Gosar (R),2016,Electric Utilities,1500,29000,30500
G000565,N00030771,Paul Gosar (R),2016,Retired,26200,0,26200
G000565,N00030771,Paul Gosar (R),2016,Lawyers/Law Firms,20650,3250,23900
G000565,N00030771,Paul Gosar (R),2016,Mining,4250,19500,23750
G000565,N00030771,Paul Gosar (R),2016,Republican/Conservative,17382,6000,23382
G000565,N00030771,Paul Gosar (R),2016,Candidate Committees,0,13500,13500
G000565,N00030771,Paul Gosar (R),2016,Casinos/Gambling,12000,1000,13000
G000565,N00030771,Paul Gosar (R),2016,Air Transport,6900,3500,10400
G000562,N00030780,Cory Gardner (R),2016,Retired,1410171,0,1410171
G000562,N00030780,Cory Gardner (R),2016,Securities & Investment,793145,26000,819145
G000562,N00030780,Cory Gardner (R),2016,Oil & Gas,444199,269700,713899
G000562,N00030780,Cory Gardner (R),2016,Real Estate,498956,30500,529456
G000562,N00030780,Cory Gardner (R),2016,Leadership PACs,0,406194,406194
G000562,N00030780,Cory Gardner (R),2016,Republican/Conservative,309033,64622,373655
G000562,N00030780,Cory Gardner (R),2016,Misc Finance,257211,12100,269311
G000562,N00030780,Cory Gardner (R),2016,Lawyers/Law Firms,225648,20838,246486
G000562,N00030780,Cory Gardner (R),2016,Commercial Banks,151956,87500,239456
G000562,N00030780,Cory Gardner (R),2016,Lobbyists,202150,19602,221752
G000560,N00030788,Tom Graves (R),2016,Commercial Banks,350,77499,77849
G000560,N00030788,Tom Graves (R),2016,Real Estate,33300,35500,68800
G000560,N00030788,Tom Graves (R),2016,Insurance,8150,58000,66150
G000560,N00030788,Tom Graves (R),2016,Lobbyists,50950,500,51450
G000560,N00030788,Tom Graves (R),2016,Textiles,37300,11726,49026
G000560,N00030788,Tom Graves (R),2016,Defense Electronics,7400,38500,45900
G000560,N00030788,Tom Graves (R),2016,Misc Manufacturing & Distributing,19300,25000,44300
G000560,N00030788,Tom Graves (R),2016,Finance/Credit Companies,9900,33500,43400
G000560,N00030788,Tom Graves (R),2016,Accountants,1000,41000,42000
G000560,N00030788,Tom Graves (R),2016,Securities & Investment,5000,33500,38500
G000570,N00030801,Frank Guinta (R),2016,Leadership PACs,0,223300,223300
G000570,N00030801,Frank Guinta (R),2016,Insurance,40450,86500,126950
G000570,N00030801,Frank Guinta (R),2016,Securities & Investment,60575,48500,109075
G000570,N00030801,Frank Guinta (R),2016,Real Estate,51000,28000,79000
G000570,N00030801,Frank Guinta (R),2016,Retired,72450,0,72450
G000570,N00030801,Frank Guinta (R),2016,Candidate Committees,1167,62230,63397
G000570,N00030801,Frank Guinta (R),2016,Commercial Banks,6750,35500,42250
G000570,N00030801,Frank Guinta (R),2016,Republican/Conservative,24250,12000,36250
G000570,N00030801,Frank Guinta (R),2016,Automotive,14250,20000,34250
G000570,N00030801,Frank Guinta (R),2016,Misc Manufacturing & Distributing,31200,1998,33198
F000459,N00030815,Chuck Fleischmann (R),2016,General Contractors,61600,20500,82100
F000459,N00030815,Chuck Fleischmann (R),2016,Health Professionals,40200,29500,69700
F000459,N00030815,Chuck Fleischmann (R),2016,Leadership PACs,0,68200,68200
F000459,N00030815,Chuck Fleischmann (R),2016,Insurance,29300,34500,63800
F000459,N00030815,Chuck Fleischmann (R),2016,Real Estate,52200,10500,62700
F000459,N00030815,Chuck Fleischmann (R),2016,Electric Utilities,10800,39500,50300
F000459,N00030815,Chuck Fleischmann (R),2016,Lawyers/Law Firms,34150,13250,47400
F000459,N00030815,Chuck Fleischmann (R),2016,Pharmaceuticals/Health Products,31000,13000,44000
F000459,N00030815,Chuck Fleischmann (R),2016,Retired,43800,0,43800
F000459,N00030815,Chuck Fleischmann (R),2016,Food Processing & Sales,26800,10700,37500
B001297,N00030829,Kenneth R Buck (R),2016,Retired,64726,0,64726
B001297,N00030829,Kenneth R Buck (R),2016,Oil & Gas,13950,49000,62950
B001297,N00030829,Kenneth R Buck (R),2016,Real Estate,38617,8500,47117
B001297,N00030829,Kenneth R Buck (R),2016,Securities & Investment,34000,0,34000
B001297,N00030829,Kenneth R Buck (R),2016,General Contractors,21000,9000,30000
B001297,N00030829,Kenneth R Buck (R),2016,Automotive,14600,15000,29600
B001297,N00030829,Kenneth R Buck (R),2016,Leadership PACs,0,29500,29500
B001297,N00030829,Kenneth R Buck (R),2016,Crop Production & Basic Processing,12250,16000,28250
B001297,N00030829,Kenneth R Buck (R),2016,"Beer, Wine & Liquor",9400,13000,22400
B001297,N00030829,Kenneth R Buck (R),2016,Telecom Services,8100,10500,18600
P000603,N00030836,Rand Paul (R),2016,Retired,779701,0,779701
P000603,N00030836,Rand Paul (R),2016,Health Professionals,516792,81500,598292
P000603,N00030836,Rand Paul (R),2016,Republican/Conservative,395111,34265,429376
P000603,N00030836,Rand Paul (R),2016,Securities & Investment,372233,19000,391233
P000603,N00030836,Rand Paul (R),2016,Real Estate,225873,17500,243373
P000603,N00030836,Rand Paul (R),2016,Leadership PACs,0,224000,224000
P000603,N00030836,Rand Paul (R),2016,Lawyers/Law Firms,173407,22500,195907
P000603,N00030836,Rand Paul (R),2016,Misc Finance,182717,5200,187917
P000603,N00030836,Rand Paul (R),2016,Mining,122800,15650,138450
P000603,N00030836,Rand Paul (R),2016,Insurance,80136,51500,131636
G000559,N00030856,John Garamendi (D),2016,Transportation Unions,0,96500,96500
G000559,N00030856,John Garamendi (D),2016,Lawyers/Law Firms,36512,30500,67012
G000559,N00030856,John Garamendi (D),2016,Real Estate,45417,15500,60917
G000559,N00030856,John Garamendi (D),2016,Building Trade Unions,0,60800,60800
G000559,N00030856,John Garamendi (D),2016,Crop Production & Basic Processing,33805,25933,59738
G000559,N00030856,John Garamendi (D),2016,Sea Transport,5700,46500,52200
G000559,N00030856,John Garamendi (D),2016,Public Sector Unions,1080,41500,42580
G000559,N00030856,John Garamendi (D),2016,Insurance,16300,25500,41800
G000559,N00030856,John Garamendi (D),2016,Defense Aerospace,0,34500,34500
G000559,N00030856,John Garamendi (D),2016,Industrial Unions,0,29500,29500
K000382,N00030875,Ann Mclane Kuster (D),2016,Retired,337092,0,337092
K000382,N00030875,Ann Mclane Kuster (D),2016,Democratic/Liberal,176771,11500,188271
K000382,N00030875,Ann Mclane Kuster (D),2016,Leadership PACs,0,182253,182253
K000382,N00030875,Ann Mclane Kuster (D),2016,Securities & Investment,97267,57500,154767
K000382,N00030875,Ann Mclane Kuster (D),2016,Women's Issues,119350,11000,130350
K000382,N00030875,Ann Mclane Kuster (D),2016,Lawyers/Law Firms,80296,17500,97796
K000382,N00030875,Ann Mclane Kuster (D),2016,Candidate Committees,0,78300,78300
K000382,N00030875,Ann Mclane Kuster (D),2016,Education,77295,0,77295
K000382,N00030875,Ann Mclane Kuster (D),2016,Health Professionals,19359,56500,75859
K000382,N00030875,Ann Mclane Kuster (D),2016,Public Sector Unions,0,74000,74000
G000566,N00030880,Trey Gowdy (R),2016,Retired,172320,0,172320
G000566,N00030880,Trey Gowdy (R),2016,Republican/Conservative,74361,18622,92983
G000566,N00030880,Trey Gowdy (R),2016,Lawyers/Law Firms,39345,4000,43345
G000566,N00030880,Trey Gowdy (R),2016,Real Estate,21785,15900,37685
G000566,N00030880,Trey Gowdy (R),2016,Accountants,4600,32000,36600
G000566,N00030880,Trey Gowdy (R),2016,Health Professionals,26141,8000,34141
G000566,N00030880,Trey Gowdy (R),2016,Insurance,6450,22000,28450
G000566,N00030880,Trey Gowdy (R),2016,Oil & Gas,10900,15500,26400
G000566,N00030880,Trey Gowdy (R),2016,Securities & Investment,13550,10000,23550
G000566,N00030880,Trey Gowdy (R),2016,Misc Manufacturing & Distributing,6600,16200,22800
B001274,N00030910,Mo Brooks (R),2016,Defense Aerospace,1000,44533,45533
B001274,N00030910,Mo Brooks (R),2016,Misc Defense,19250,15300,34550
B001274,N00030910,Mo Brooks (R),2016,Defense Electronics,4000,27700,31700
B001274,N00030910,Mo Brooks (R),2016,Health Professionals,16850,14000,30850
B001274,N00030910,Mo Brooks (R),2016,Real Estate,17100,10000,27100
B001274,N00030910,Mo Brooks (R),2016,Lawyers/Law Firms,5200,14000,19200
B001274,N00030910,Mo Brooks (R),2016,Retired,18550,0,18550
B001274,N00030910,Mo Brooks (R),2016,Agricultural Services/Products,0,17000,17000
B001274,N00030910,Mo Brooks (R),2016,Insurance,0,16000,16000
B001274,N00030910,Mo Brooks (R),2016,Securities & Investment,15200,0,15200
R000585,N00030949,Tom Reed (R),2016,Insurance,15000,203200,218200
R000585,N00030949,Tom Reed (R),2016,Securities & Investment,98450,77500,175950
R000585,N00030949,Tom Reed (R),2016,Leadership PACs,0,125897,125897
R000585,N00030949,Tom Reed (R),2016,Lawyers/Law Firms,88953,33600,122553
R000585,N00030949,Tom Reed (R),2016,Health Professionals,19070,98000,117070
R000585,N00030949,Tom Reed (R),2016,Oil & Gas,26900,86250,113150
R000585,N00030949,Tom Reed (R),2016,Lobbyists,106376,0,106376
R000585,N00030949,Tom Reed (R),2016,Real Estate,47070,53000,100070
R000585,N00030949,Tom Reed (R),2016,Pharmaceuticals/Health Products,1750,93900,95650
R000585,N00030949,Tom Reed (R),2016,Electronics Mfg & Equip,52500,40000,92500
D000616,N00030957,Scott Desjarlais (R),2016,Leadership PACs,0,52000,52000
D000616,N00030957,Scott Desjarlais (R),2016,Health Professionals,31300,5500,36800
D000616,N00030957,Scott Desjarlais (R),2016,Retired,35284,0,35284
D000616,N00030957,Scott Desjarlais (R),2016,Real Estate,20550,9000,29550
D000616,N00030957,Scott Desjarlais (R),2016,Lawyers/Law Firms,28900,0,28900
D000616,N00030957,Scott Desjarlais (R),2016,Food Processing & Sales,21200,5000,26200
D000616,N00030957,Scott Desjarlais (R),2016,Candidate Committees,0,21000,21000
D000616,N00030957,Scott Desjarlais (R),2016,Misc Manufacturing & Distributing,19700,0,19700
D000616,N00030957,Scott Desjarlais (R),2016,Automotive,3700,15000,18700
D000616,N00030957,Scott Desjarlais (R),2016,Gun Rights,5550,10500,16050
R000589,N00030962,Scott Rigell (R),2016,Retired,62755,0,62755
R000589,N00030962,Scott Rigell (R),2016,Real Estate,45062,2000,47062
R000589,N00030962,Scott Rigell (R),2016,Automotive,27600,5000,32600
R000589,N00030962,Scott Rigell (R),2016,Railroads,8900,20000,28900
R000589,N00030962,Scott Rigell (R),2016,Misc Defense,2950,20000,22950
R000589,N00030962,Scott Rigell (R),2016,Defense Aerospace,0,21000,21000
R000589,N00030962,Scott Rigell (R),2016,Health Professionals,12200,8000,20200
R000589,N00030962,Scott Rigell (R),2016,General Contractors,14810,5000,19810
R000589,N00030962,Scott Rigell (R),2016,Retail Sales,5400,9500,14900
R000589,N00030962,Scott Rigell (R),2016,Civil Servants/Public Officials,14225,0,14225
D000614,N00030967,Sean P Duffy (R),2016,Insurance,14655,223800,238455
D000614,N00030967,Sean P Duffy (R),2016,Securities & Investment,51982,143500,195482
D000614,N00030967,Sean P Duffy (R),2016,Retired,169759,0,169759
D000614,N00030967,Sean P Duffy (R),2016,Commercial Banks,37170,100894,138064
D000614,N00030967,Sean P Duffy (R),2016,Real Estate,42720,77500,120220
D000614,N00030967,Sean P Duffy (R),2016,Finance/Credit Companies,24650,49500,74150
D000614,N00030967,Sean P Duffy (R),2016,Republican/Conservative,42468,15350,57818
D000614,N00030967,Sean P Duffy (R),2016,Accountants,1350,50000,51350
D000614,N00030967,Sean P Duffy (R),2016,Misc Manufacturing & Distributing,39945,11000,50945
D000614,N00030967,Sean P Duffy (R),2016,Lawyers/Law Firms,26895,22750,49645
R000587,N00030968,Reid Ribble (R),2016,Dairy,13900,20750,34650
R000587,N00030968,Reid Ribble (R),2016,Air Transport,0,31000,31000
R000587,N00030968,Reid Ribble (R),2016,Trucking,11700,18000,29700
R000587,N00030968,Reid Ribble (R),2016,Insurance,0,18500,18500
R000587,N00030968,Reid Ribble (R),2016,Oil & Gas,5900,12500,18400
R000587,N00030968,Reid Ribble (R),2016,Retired,17150,0,17150
R000587,N00030968,Reid Ribble (R),2016,Building Materials & Equipment,1500,15500,17000
R000587,N00030968,Reid Ribble (R),2016,Electric Utilities,250,16000,16250
R000587,N00030968,Reid Ribble (R),2016,Securities & Investment,14000,2000,16000
R000587,N00030968,Reid Ribble (R),2016,Misc Manufacturing & Distributing,6400,9500,15900
A000368,N00030980,Kelly Ayotte (R),2016,Retired,1966431,0,1966431
A000368,N00030980,Kelly Ayotte (R),2016,Securities & Investment,1413762,119200,1532962
A000368,N00030980,Kelly Ayotte (R),2016,Real Estate,665006,58000,723006
A000368,N00030980,Kelly Ayotte (R),2016,Lawyers/Law Firms,442888,181224,624112
A000368,N00030980,Kelly Ayotte (R),2016,Leadership PACs,26050,591300,617350
A000368,N00030980,Kelly Ayotte (R),2016,Lobbyists,440693,14587,455280
A000368,N00030980,Kelly Ayotte (R),2016,Insurance,157650,294000,451650
A000368,N00030980,Kelly Ayotte (R),2016,Pro-Israel,366414,61700,428114
A000368,N00030980,Kelly Ayotte (R),2016,Oil & Gas,194756,227000,421756
A000368,N00030980,Kelly Ayotte (R),2016,Misc Finance,364559,45000,409559
H001053,N00031005,Vicky Hartzler (R),2016,Crop Production & Basic Processing,15250,44000,59250
H001053,N00031005,Vicky Hartzler (R),2016,Retired,58844,0,58844
H001053,N00031005,Vicky Hartzler (R),2016,Agricultural Services/Products,5650,45700,51350
H001053,N00031005,Vicky Hartzler (R),2016,Defense Aerospace,0,45000,45000
H001053,N00031005,Vicky Hartzler (R),2016,Health Professionals,25550,13500,39050
H001053,N00031005,Vicky Hartzler (R),2016,Real Estate,28350,6000,34350
H001053,N00031005,Vicky Hartzler (R),2016,Leadership PACs,0,32829,32829
H001053,N00031005,Vicky Hartzler (R),2016,Food & Beverage,20800,10500,31300
H001053,N00031005,Vicky Hartzler (R),2016,Lawyers/Law Firms,21080,8750,29830
H001053,N00031005,Vicky Hartzler (R),2016,Defense Electronics,0,29000,29000
N000186,N00031006,Alan Nunnelee (R),2016,General Contractors,5000,0,5000
N000186,N00031006,Alan Nunnelee (R),2016,Retired,2500,0,2500
N000186,N00031006,Alan Nunnelee (R),2016,Real Estate,1000,0,1000
N000186,N00031006,Alan Nunnelee (R),2016,Oil & Gas,2600,-2500,100
C001106,N00031064,Ryan Costello (R),2016,Leadership PACs,0,227071,227071
C001106,N00031064,Ryan Costello (R),2016,Pharmaceuticals/Health Products,20700,144100,164800
C001106,N00031064,Ryan Costello (R),2016,Lawyers/Law Firms,105550,35733,141283
C001106,N00031064,Ryan Costello (R),2016,Insurance,26940,73700,100640
C001106,N00031064,Ryan Costello (R),2016,Health Professionals,15500,74000,89500
C001106,N00031064,Ryan Costello (R),2016,Securities & Investment,77000,11500,88500
C001106,N00031064,Ryan Costello (R),2016,Retired,78300,0,78300
C001106,N00031064,Ryan Costello (R),2016,Real Estate,43050,30000,73050
C001106,N00031064,Ryan Costello (R),2016,Construction Services,30750,26200,56950
C001106,N00031064,Ryan Costello (R),2016,Air Transport,1600,49000,50600
D000613,N00031103,Bob Dold (R),2016,Securities & Investment,507300,104500,611800
D000613,N00031103,Bob Dold (R),2016,Retired,442912,0,442912
D000613,N00031103,Bob Dold (R),2016,Leadership PACs,0,387500,387500
D000613,N00031103,Bob Dold (R),2016,Insurance,44470,219100,263570
D000613,N00031103,Bob Dold (R),2016,Lawyers/Law Firms,225540,30000,255540
D000613,N00031103,Bob Dold (R),2016,Real Estate,130100,61000,191100
D000613,N00031103,Bob Dold (R),2016,Pharmaceuticals/Health Products,60100,130700,190800
D000613,N00031103,Bob Dold (R),2016,Pro-Israel,123473,26290,149763
D000613,N00031103,Bob Dold (R),2016,Health Professionals,46974,99750,146724
D000613,N00031103,Bob Dold (R),2016,Misc Finance,86721,22000,108721
H001059,N00031104,Randy Hultgren (R),2016,Insurance,1250,144000,145250
H001059,N00031104,Randy Hultgren (R),2016,Securities & Investment,44050,99500,143550
H001059,N00031104,Randy Hultgren (R),2016,Commercial Banks,7200,73000,80200
H001059,N00031104,Randy Hultgren (R),2016,Leadership PACs,0,73500,73500
H001059,N00031104,Randy Hultgren (R),2016,Real Estate,14550,56500,71050
H001059,N00031104,Randy Hultgren (R),2016,Accountants,1000,46500,47500
H001059,N00031104,Randy Hultgren (R),2016,Electric Utilities,9000,21500,30500
H001059,N00031104,Randy Hultgren (R),2016,Misc Manufacturing & Distributing,10950,18000,28950
H001059,N00031104,Randy Hultgren (R),2016,Defense Aerospace,0,28000,28000
H001059,N00031104,Randy Hultgren (R),2016,Finance/Credit Companies,0,28000,28000
R000586,N00031127,Jim Renacci (R),2016,Insurance,23600,141750,165350
R000586,N00031127,Jim Renacci (R),2016,Real Estate,49050,80000,129050
R000586,N00031127,Jim Renacci (R),2016,Securities & Investment,33800,72500,106300
R000586,N00031127,Jim Renacci (R),2016,Misc Manufacturing & Distributing,33750,51000,84750
R000586,N00031127,Jim Renacci (R),2016,Pharmaceuticals/Health Products,6950,67000,73950
R000586,N00031127,Jim Renacci (R),2016,Accountants,4370,67500,71870
R000586,N00031127,Jim Renacci (R),2016,Health Professionals,15150,45500,60650
R000586,N00031127,Jim Renacci (R),2016,Lawyers/Law Firms,39146,20450,59596
R000586,N00031127,Jim Renacci (R),2016,Oil & Gas,4993,48250,53243
R000586,N00031127,Jim Renacci (R),2016,Automotive,8350,44000,52350
G000563,N00031128,Bob Gibbs (R),2016,Agricultural Services/Products,2500,49500,52000
G000563,N00031128,Bob Gibbs (R),2016,Transportation Unions,0,39000,39000
G000563,N00031128,Bob Gibbs (R),2016,Construction Services,500,37000,37500
G000563,N00031128,Bob Gibbs (R),2016,Electric Utilities,1000,34250,35250
G000563,N00031128,Bob Gibbs (R),2016,Oil & Gas,1000,32500,33500
G000563,N00031128,Bob Gibbs (R),2016,Misc Manufacturing & Distributing,20100,13000,33100
G000563,N00031128,Bob Gibbs (R),2016,Leadership PACs,0,31091,31091
G000563,N00031128,Bob Gibbs (R),2016,Air Transport,0,30500,30500
G000563,N00031128,Bob Gibbs (R),2016,Crop Production & Basic Processing,0,30500,30500
G000563,N00031128,Bob Gibbs (R),2016,Railroads,0,29499,29499
L000575,N00031129,James Lankford (R),2016,Oil & Gas,461335,365100,826435
L000575,N00031129,James Lankford (R),2016,Retired,564709,0,564709
L000575,N00031129,James Lankford (R),2016,Leadership PACs,0,357953,357953
L000575,N00031129,James Lankford (R),2016,Health Professionals,198960,90500,289460
L000575,N00031129,James Lankford (R),2016,Commercial Banks,146027,69000,215027
L000575,N00031129,James Lankford (R),2016,Real Estate,165503,35000,200503
L000575,N00031129,James Lankford (R),2016,Insurance,68854,117500,186354
L000575,N00031129,James Lankford (R),2016,Lawyers/Law Firms,136475,15250,151725
L000575,N00031129,James Lankford (R),2016,General Contractors,112655,32000,144655
L000575,N00031129,James Lankford (R),2016,Electric Utilities,17040,104600,121640
M001181,N00031134,Patrick Meehan (R),2016,Insurance,27900,157950,185850
M001181,N00031134,Patrick Meehan (R),2016,Lawyers/Law Firms,128800,48700,177500
M001181,N00031134,Patrick Meehan (R),2016,Pharmaceuticals/Health Products,17410,133700,151110
M001181,N00031134,Patrick Meehan (R),2016,Securities & Investment,79450,60000,139450
M001181,N00031134,Patrick Meehan (R),2016,Health Professionals,13450,72000,85450
M001181,N00031134,Patrick Meehan (R),2016,Oil & Gas,18450,60750,79200
M001181,N00031134,Patrick Meehan (R),2016,Real Estate,38175,37000,75175
M001181,N00031134,Patrick Meehan (R),2016,Leadership PACs,0,61646,61646
M001181,N00031134,Patrick Meehan (R),2016,Accountants,7550,51440,58990
M001181,N00031134,Patrick Meehan (R),2016,Lobbyists,56400,500,56900
F000458,N00031141,Steve Fincher (R),2016,Insurance,0,63000,63000
F000458,N00031141,Steve Fincher (R),2016,Real Estate,1000,42500,43500
F000458,N00031141,Steve Fincher (R),2016,Commercial Banks,0,41000,41000
F000458,N00031141,Steve Fincher (R),2016,Securities & Investment,500,36000,36500
F000458,N00031141,Steve Fincher (R),2016,Leadership PACs,0,23000,23000
F000458,N00031141,Steve Fincher (R),2016,Crop Production & Basic Processing,0,23000,23000
F000458,N00031141,Steve Fincher (R),2016,Agricultural Services/Products,0,22000,22000
F000458,N00031141,Steve Fincher (R),2016,Finance/Credit Companies,500,17500,18000
F000458,N00031141,Steve Fincher (R),2016,Accountants,0,15952,15952
F000458,N00031141,Steve Fincher (R),2016,Defense Aerospace,0,15500,15500
A000369,N00031177,Mark Amodei (R),2016,Retired,58750,0,58750
A000369,N00031177,Mark Amodei (R),2016,Health Professionals,19250,25500,44750
A000369,N00031177,Mark Amodei (R),2016,Casinos/Gambling,24300,16000,40300
A000369,N00031177,Mark Amodei (R),2016,Lawyers/Law Firms,21850,10750,32600
A000369,N00031177,Mark Amodei (R),2016,Real Estate,20450,12000,32450
A000369,N00031177,Mark Amodei (R),2016,Mining,4000,26200,30200
A000369,N00031177,Mark Amodei (R),2016,Defense Aerospace,0,24000,24000
A000369,N00031177,Mark Amodei (R),2016,Lobbyists,18350,3000,21350
A000369,N00031177,Mark Amodei (R),2016,Livestock,7450,12000,19450
A000369,N00031177,Mark Amodei (R),2016,"Beer, Wine & Liquor",0,17850,17850
B001275,N00031227,Larry Bucshon (R),2016,Health Professionals,35225,154125,189350
B001275,N00031227,Larry Bucshon (R),2016,Pharmaceuticals/Health Products,17600,96500,114100
B001275,N00031227,Larry Bucshon (R),2016,Electric Utilities,5200,33499,38699
B001275,N00031227,Larry Bucshon (R),2016,Lobbyists,20839,7500,28339
B001275,N00031227,Larry Bucshon (R),2016,Chemical & Related Manufacturing,18000,8000,26000
B001275,N00031227,Larry Bucshon (R),2016,Health Services/HMOs,3000,22200,25200
B001275,N00031227,Larry Bucshon (R),2016,Leadership PACs,0,25000,25000
B001275,N00031227,Larry Bucshon (R),2016,Mining,13600,8900,22500
B001275,N00031227,Larry Bucshon (R),2016,Telecom Services,0,21000,21000
B001275,N00031227,Larry Bucshon (R),2016,Real Estate,8900,11500,20400
B001282,N00031233,Andy Barr (R),2016,Securities & Investment,84326,105500,189826
B001282,N00031233,Andy Barr (R),2016,Insurance,21150,153360,174510
B001282,N00031233,Andy Barr (R),2016,Commercial Banks,37085,104050,141135
B001282,N00031233,Andy Barr (R),2016,Real Estate,70800,60000,130800
B001282,N00031233,Andy Barr (R),2016,Retired,124753,0,124753
B001282,N00031233,Andy Barr (R),2016,Mining,77450,27000,104450
B001282,N00031233,Andy Barr (R),2016,Health Professionals,30750,70650,101400
B001282,N00031233,Andy Barr (R),2016,Leadership PACs,0,75000,75000
B001282,N00031233,Andy Barr (R),2016,Lawyers/Law Firms,59694,8500,68194
B001282,N00031233,Andy Barr (R),2016,Finance/Credit Companies,8700,54400,63100
H001055,N00031244,Joe Heck (R),2016,Retired,1341855,0,1341855
H001055,N00031244,Joe Heck (R),2016,Securities & Investment,899053,22000,921053
H001055,N00031244,Joe Heck (R),2016,Leadership PACs,0,597952,597952
H001055,N00031244,Joe Heck (R),2016,Health Professionals,352128,245500,597628
H001055,N00031244,Joe Heck (R),2016,Real Estate,557839,35000,592839
H001055,N00031244,Joe Heck (R),2016,Republican/Conservative,412914,76279,489193
H001055,N00031244,Joe Heck (R),2016,Oil & Gas,133515,169666,303181
H001055,N00031244,Joe Heck (R),2016,Casinos/Gambling,235150,52500,287650
H001055,N00031244,Joe Heck (R),2016,Misc Finance,235030,12500,247530
H001055,N00031244,Joe Heck (R),2016,Lawyers/Law Firms,182060,23250,205310
R000598,N00031253,Keith J Rothfus (R),2016,Retired,129283,0,129283
R000598,N00031253,Keith J Rothfus (R),2016,Insurance,25408,95262,120670
R000598,N00031253,Keith J Rothfus (R),2016,Commercial Banks,37415,67450,104865
R000598,N00031253,Keith J Rothfus (R),2016,Securities & Investment,53650,50600,104250
R000598,N00031253,Keith J Rothfus (R),2016,Real Estate,58950,31500,90450
R000598,N00031253,Keith J Rothfus (R),2016,Lawyers/Law Firms,74000,4250,78250
R000598,N00031253,Keith J Rothfus (R),2016,Mining,43650,13700,57350
R000598,N00031253,Keith J Rothfus (R),2016,Automotive,34200,11000,45200
R000598,N00031253,Keith J Rothfus (R),2016,Republican/Conservative,24804,19000,43804
R000598,N00031253,Keith J Rothfus (R),2016,Accountants,5000,38000,43000
T000477,N00031263,Scott W Taylor (R),2016,Retired,77470,0,77470
T000477,N00031263,Scott W Taylor (R),2016,Leadership PACs,0,66700,66700
T000477,N00031263,Scott W Taylor (R),2016,Real Estate,51950,6000,57950
T000477,N00031263,Scott W Taylor (R),2016,Automotive,12850,16000,28850
T000477,N00031263,Scott W Taylor (R),2016,Republican/Conservative,4220,20000,24220
T000477,N00031263,Scott W Taylor (R),2016,General Contractors,17250,4000,21250
T000477,N00031263,Scott W Taylor (R),2016,Misc Defense,11150,9500,20650
T000477,N00031263,Scott W Taylor (R),2016,Business Services,18350,0,18350
T000477,N00031263,Scott W Taylor (R),2016,Insurance,6000,10500,16500
T000477,N00031263,Scott W Taylor (R),2016,Health Professionals,9500,7000,16500
H001060,N00031265,Robert Hurt (R),2016,Securities & Investment,6650,45500,52150
H001060,N00031265,Robert Hurt (R),2016,Insurance,500,50500,51000
H001060,N00031265,Robert Hurt (R),2016,Commercial Banks,2500,44500,47000
H001060,N00031265,Robert Hurt (R),2016,Real Estate,8000,30000,38000
H001060,N00031265,Robert Hurt (R),2016,Accountants,500,20000,20500
H001060,N00031265,Robert Hurt (R),2016,Lobbyists,15750,1000,16750
H001060,N00031265,Robert Hurt (R),2016,Retired,16150,0,16150
H001060,N00031265,Robert Hurt (R),2016,Misc Finance,3000,12000,15000
H001060,N00031265,Robert Hurt (R),2016,Finance/Credit Companies,750,13500,14250
H001060,N00031265,Robert Hurt (R),2016,Electric Utilities,0,13500,13500
D000610,N00031317,Ted Deutch (D),2016,Real Estate,151090,12000,163090
D000610,N00031317,Ted Deutch (D),2016,Lawyers/Law Firms,116910,27000,143910
D000610,N00031317,Ted Deutch (D),2016,Pro-Israel,106900,36700,143600
D000610,N00031317,Ted Deutch (D),2016,Securities & Investment,132900,0,132900
D000610,N00031317,Ted Deutch (D),2016,Retired,72167,0,72167
D000610,N00031317,Ted Deutch (D),2016,TV/Movies/Music,18100,40500,58600
D000610,N00031317,Ted Deutch (D),2016,Misc Finance,37850,0,37850
D000610,N00031317,Ted Deutch (D),2016,Health Professionals,27585,8500,36085
D000610,N00031317,Ted Deutch (D),2016,"Beer, Wine & Liquor",15850,16000,31850
D000610,N00031317,Ted Deutch (D),2016,Industrial Unions,0,30000,30000
L000573,N00031377,Raul Labrador (R),2016,Livestock,17500,5500,23000
L000573,N00031377,Raul Labrador (R),2016,Electronics Mfg & Equip,11615,8000,19615
L000573,N00031377,Raul Labrador (R),2016,Republican/Conservative,10400,8017,18417
L000573,N00031377,Raul Labrador (R),2016,Retired,18360,0,18360
L000573,N00031377,Raul Labrador (R),2016,Lawyers/Law Firms,11644,6500,18144
L000573,N00031377,Raul Labrador (R),2016,Home Builders,10800,7000,17800
L000573,N00031377,Raul Labrador (R),2016,Leadership PACs,0,16900,16900
L000573,N00031377,Raul Labrador (R),2016,Special Trade Contractors,9699,6000,15699
L000573,N00031377,Raul Labrador (R),2016,Oil & Gas,7400,7500,14900
L000573,N00031377,Raul Labrador (R),2016,Commercial Banks,3450,11250,14700
M001182,N00031412,Mick Mulvaney (R),2016,Securities & Investment,35200,77000,112200
M001182,N00031412,Mick Mulvaney (R),2016,Insurance,8064,83500,91564
M001182,N00031412,Mick Mulvaney (R),2016,Retired,81567,0,81567
M001182,N00031412,Mick Mulvaney (R),2016,Commercial Banks,2880,75500,78380
M001182,N00031412,Mick Mulvaney (R),2016,Finance/Credit Companies,2700,51500,54200
M001182,N00031412,Mick Mulvaney (R),2016,Real Estate,13700,40500,54200
M001182,N00031412,Mick Mulvaney (R),2016,Accountants,4880,46500,51380
M001182,N00031412,Mick Mulvaney (R),2016,Lawyers/Law Firms,23960,15500,39460
M001182,N00031412,Mick Mulvaney (R),2016,Electronics Mfg & Equip,32800,2000,34800
M001182,N00031412,Mick Mulvaney (R),2016,Health Professionals,19890,12500,32390
H001073,N00031417,Will Hurd (R),2016,Leadership PACs,0,360819,360819
H001073,N00031417,Will Hurd (R),2016,Oil & Gas,153241,165833,319074
H001073,N00031417,Will Hurd (R),2016,Retired,261657,0,261657
H001073,N00031417,Will Hurd (R),2016,Real Estate,149906,15500,165406
H001073,N00031417,Will Hurd (R),2016,Commercial Banks,85975,49700,135675
H001073,N00031417,Will Hurd (R),2016,Securities & Investment,121050,6500,127550
H001073,N00031417,Will Hurd (R),2016,Lawyers/Law Firms,102844,22250,125094
H001073,N00031417,Will Hurd (R),2016,Insurance,33345,72475,105820
H001073,N00031417,Will Hurd (R),2016,Candidate Committees,0,104703,104703
H001073,N00031417,Will Hurd (R),2016,Livestock,71975,30500,102475
E000291,N00031513,Renee Ellmers (R),2016,Health Professionals,18425,175100,193525
E000291,N00031513,Renee Ellmers (R),2016,Pharmaceuticals/Health Products,1500,148699,150199
E000291,N00031513,Renee Ellmers (R),2016,Health Services/HMOs,500,60000,60500
E000291,N00031513,Renee Ellmers (R),2016,Insurance,3500,50500,54000
E000291,N00031513,Renee Ellmers (R),2016,Electric Utilities,1000,46000,47000
E000291,N00031513,Renee Ellmers (R),2016,Leadership PACs,0,43900,43900
E000291,N00031513,Renee Ellmers (R),2016,Retail Sales,3950,32500,36450
E000291,N00031513,Renee Ellmers (R),2016,Lobbyists,34200,0,34200
E000291,N00031513,Renee Ellmers (R),2016,Oil & Gas,1500,29000,30500
E000291,N00031513,Renee Ellmers (R),2016,Crop Production & Basic Processing,8000,21500,29500
B001273,N00031539,Diane Black (R),2016,Insurance,25550,114750,140300
B001273,N00031539,Diane Black (R),2016,Health Professionals,29760,97500,127260
B001273,N00031539,Diane Black (R),2016,Misc Issues,107250,380,107630
B001273,N00031539,Diane Black (R),2016,Pharmaceuticals/Health Products,0,99839,99839
B001273,N00031539,Diane Black (R),2016,Leadership PACs,0,86826,86826
B001273,N00031539,Diane Black (R),2016,Retired,79450,0,79450
B001273,N00031539,Diane Black (R),2016,Health Services/HMOs,5400,58500,63900
B001273,N00031539,Diane Black (R),2016,Real Estate,19800,38500,58300
B001273,N00031539,Diane Black (R),2016,Accountants,10150,47500,57650
B001273,N00031539,Diane Black (R),2016,Hospitals/Nursing Homes,2100,48200,50300
F000461,N00031545,Bill Flores (R),2016,Oil & Gas,49500,153000,202500
F000461,N00031545,Bill Flores (R),2016,Health Professionals,11300,115500,126800
F000461,N00031545,Bill Flores (R),2016,Insurance,12300,64500,76800
F000461,N00031545,Bill Flores (R),2016,Accountants,12100,57000,69100
F000461,N00031545,Bill Flores (R),2016,Retired,68061,0,68061
F000461,N00031545,Bill Flores (R),2016,Real Estate,35700,23000,58700
F000461,N00031545,Bill Flores (R),2016,Electronics Mfg & Equip,21000,29500,50500
F000461,N00031545,Bill Flores (R),2016,Pharmaceuticals/Health Products,0,48000,48000
F000461,N00031545,Bill Flores (R),2016,Leadership PACs,0,44000,44000
F000461,N00031545,Bill Flores (R),2016,Automotive,10900,32500,43400
H001064,N00031557,Dennis Heck (D),2016,Insurance,1350,88500,89850
H001064,N00031557,Dennis Heck (D),2016,Securities & Investment,11400,76000,87400
H001064,N00031557,Dennis Heck (D),2016,Casinos/Gambling,82050,3500,85550
H001064,N00031557,Dennis Heck (D),2016,Real Estate,19100,57500,76600
H001064,N00031557,Dennis Heck (D),2016,Misc Issues,63100,0,63100
H001064,N00031557,Dennis Heck (D),2016,Commercial Banks,1500,61500,63000
H001064,N00031557,Dennis Heck (D),2016,Lawyers/Law Firms,47714,14750,62464
H001064,N00031557,Dennis Heck (D),2016,Retired,51246,0,51246
H001064,N00031557,Dennis Heck (D),2016,Building Trade Unions,100,50000,50100
H001064,N00031557,Dennis Heck (D),2016,Health Professionals,14300,32000,46300
H001056,N00031559,Jaime Herrera Beutler (R),2016,Retired,147915,0,147915
H001056,N00031559,Jaime Herrera Beutler (R),2016,Forestry & Forest Products,31950,30500,62450
H001056,N00031559,Jaime Herrera Beutler (R),2016,Real Estate,39600,19500,59100
H001056,N00031559,Jaime Herrera Beutler (R),2016,Securities & Investment,53850,3000,56850
H001056,N00031559,Jaime Herrera Beutler (R),2016,Food & Beverage,29950,2500,32450
H001056,N00031559,Jaime Herrera Beutler (R),2016,Defense Aerospace,250,29500,29750
H001056,N00031559,Jaime Herrera Beutler (R),2016,Insurance,700,28000,28700
H001056,N00031559,Jaime Herrera Beutler (R),2016,Republican/Conservative,17710,10000,27710
H001056,N00031559,Jaime Herrera Beutler (R),2016,Leadership PACs,0,25900,25900
H001056,N00031559,Jaime Herrera Beutler (R),2016,Health Professionals,9716,16000,25716
D000612,N00031593,Jeff Denham (R),2016,Leadership PACs,0,355800,355800
D000612,N00031593,Jeff Denham (R),2016,Crop Production & Basic Processing,186390,80750,267140
D000612,N00031593,Jeff Denham (R),2016,Oil & Gas,14600,174399,188999
D000612,N00031593,Jeff Denham (R),2016,Trucking,39350,77700,117050
D000612,N00031593,Jeff Denham (R),2016,Casinos/Gambling,112278,4500,116778
D000612,N00031593,Jeff Denham (R),2016,Railroads,46700,62000,108700
D000612,N00031593,Jeff Denham (R),2016,Insurance,5150,94500,99650
D000612,N00031593,Jeff Denham (R),2016,Air Transport,13450,80000,93450
D000612,N00031593,Jeff Denham (R),2016,Agricultural Services/Products,8250,81206,89456
D000612,N00031593,Jeff Denham (R),2016,Real Estate,35835,39500,75335
K000376,N00031647,Mike Kelly (R),2016,Insurance,13760,123300,137060
K000376,N00031647,Mike Kelly (R),2016,Pharmaceuticals/Health Products,4750,81000,85750
K000376,N00031647,Mike Kelly (R),2016,Oil & Gas,1750,75662,77412
K000376,N00031647,Mike Kelly (R),2016,Health Professionals,13170,60000,73170
K000376,N00031647,Mike Kelly (R),2016,Automotive,28650,44000,72650
K000376,N00031647,Mike Kelly (R),2016,Misc Manufacturing & Distributing,26575,45330,71905
K000376,N00031647,Mike Kelly (R),2016,Accountants,13490,53000,66490
K000376,N00031647,Mike Kelly (R),2016,Real Estate,19966,45500,65466
K000376,N00031647,Mike Kelly (R),2016,Lawyers/Law Firms,31656,27250,58906
K000376,N00031647,Mike Kelly (R),2016,Retired,58356,0,58356
F000460,N00031672,Blake Farenthold (R),2016,Oil & Gas,15450,54500,69950
F000460,N00031672,Blake Farenthold (R),2016,Retired,68766,0,68766
F000460,N00031672,Blake Farenthold (R),2016,General Contractors,46275,4000,50275
F000460,N00031672,Blake Farenthold (R),2016,Health Professionals,34750,8200,42950
F000460,N00031672,Blake Farenthold (R),2016,Air Transport,775,39500,40275
F000460,N00031672,Blake Farenthold (R),2016,Railroads,0,37999,37999
F000460,N00031672,Blake Farenthold (R),2016,Crop Production & Basic Processing,1500,34650,36150
F000460,N00031672,Blake Farenthold (R),2016,Internet,4200,29900,34100
F000460,N00031672,Blake Farenthold (R),2016,Leadership PACs,0,32500,32500
F000460,N00031672,Blake Farenthold (R),2016,Construction Services,17750,14000,31750
M001180,N00031681,David McKinley (R),2016,Oil & Gas,22500,56000,78500
M001180,N00031681,David McKinley (R),2016,Health Professionals,10750,67500,78250
M001180,N00031681,David McKinley (R),2016,Transportation Unions,0,68500,68500
M001180,N00031681,David McKinley (R),2016,Building Trade Unions,0,68000,68000
M001180,N00031681,David McKinley (R),2016,Mining,29700,34000,63700
M001180,N00031681,David McKinley (R),2016,Electric Utilities,0,62000,62000
M001180,N00031681,David McKinley (R),2016,Lawyers/Law Firms,52300,7000,59300
M001180,N00031681,David McKinley (R),2016,Industrial Unions,0,50000,50000
M001180,N00031681,David McKinley (R),2016,Public Sector Unions,0,48500,48500
M001180,N00031681,David McKinley (R),2016,Special Trade Contractors,19800,22000,41800
B001277,N00031685,Richard Blumenthal (D),2016,Lawyers/Law Firms,1147900,138841,1286741
B001277,N00031685,Richard Blumenthal (D),2016,Securities & Investment,818078,68500,886578
B001277,N00031685,Richard Blumenthal (D),2016,Real Estate,424301,33000,457301
B001277,N00031685,Richard Blumenthal (D),2016,Retired,372385,0,372385
B001277,N00031685,Richard Blumenthal (D),2016,Leadership PACs,0,337500,337500
B001277,N00031685,Richard Blumenthal (D),2016,Lobbyists,292052,15550,307602
B001277,N00031685,Richard Blumenthal (D),2016,Health Professionals,124698,143250,267948
B001277,N00031685,Richard Blumenthal (D),2016,Telecom Services,151450,110750,262200
B001277,N00031685,Richard Blumenthal (D),2016,TV/Movies/Music,169113,39000,208113
B001277,N00031685,Richard Blumenthal (D),2016,Insurance,46635,126600,173235
H001061,N00031688,John Hoeven (R),2016,Oil & Gas,152355,203098,355453
H001061,N00031688,John Hoeven (R),2016,Leadership PACs,0,317627,317627
H001061,N00031688,John Hoeven (R),2016,Electric Utilities,20305,111750,132055
H001061,N00031688,John Hoeven (R),2016,Mining,76248,42425,118673
H001061,N00031688,John Hoeven (R),2016,Crop Production & Basic Processing,36845,78500,115345
H001061,N00031688,John Hoeven (R),2016,Insurance,43070,68500,111570
H001061,N00031688,John Hoeven (R),2016,Securities & Investment,83233,27000,110233
H001061,N00031688,John Hoeven (R),2016,Real Estate,79133,26000,105133
H001061,N00031688,John Hoeven (R),2016,Agricultural Services/Products,850,100400,101250
H001061,N00031688,John Hoeven (R),2016,Misc Manufacturing & Distributing,75143,14500,89643
L000577,N00031696,Mike Lee (R),2016,Republican/Conservative,705168,45065,750233
L000577,N00031696,Mike Lee (R),2016,Securities & Investment,355896,15500,371396
L000577,N00031696,Mike Lee (R),2016,Lawyers/Law Firms,283391,79100,362491
L000577,N00031696,Mike Lee (R),2016,Retired,307302,0,307302
L000577,N00031696,Mike Lee (R),2016,Real Estate,289190,11510,300700
L000577,N00031696,Mike Lee (R),2016,Oil & Gas,162620,79500,242120
L000577,N00031696,Mike Lee (R),2016,Pro-Israel,201600,34700,236300
L000577,N00031696,Mike Lee (R),2016,Leadership PACs,0,174594,174594
L000577,N00031696,Mike Lee (R),2016,Misc Finance,147525,16800,164325
L000577,N00031696,Mike Lee (R),2016,Misc Manufacturing & Distributing,131950,20700,152650
R000592,N00031741,Todd Rokita (R),2016,Casinos/Gambling,83725,7500,91225
R000592,N00031741,Todd Rokita (R),2016,Health Professionals,46100,26000,72100
R000592,N00031741,Todd Rokita (R),2016,Air Transport,500,55000,55500
R000592,N00031741,Todd Rokita (R),2016,Lawyers/Law Firms,50589,4500,55089
R000592,N00031741,Todd Rokita (R),2016,Real Estate,42714,10200,52914
R000592,N00031741,Todd Rokita (R),2016,Retired,35350,0,35350
R000592,N00031741,Todd Rokita (R),2016,Leadership PACs,0,35271,35271
R000592,N00031741,Todd Rokita (R),2016,Building Materials & Equipment,12800,21000,33800
R000592,N00031741,Todd Rokita (R),2016,Misc Manufacturing & Distributing,19850,9158,29008
R000592,N00031741,Todd Rokita (R),2016,Securities & Investment,18250,9500,27750
M001179,N00031777,Tom Marino (R),2016,Pharmaceuticals/Health Products,1941,70500,72441
M001179,N00031777,Tom Marino (R),2016,Lawyers/Law Firms,35687,25200,60887
M001179,N00031777,Tom Marino (R),2016,Retired,60626,0,60626
M001179,N00031777,Tom Marino (R),2016,Health Professionals,18945,21500,40445
M001179,N00031777,Tom Marino (R),2016,TV/Movies/Music,3450,31500,34950
M001179,N00031777,Tom Marino (R),2016,Misc Manufacturing & Distributing,30900,4000,34900
M001179,N00031777,Tom Marino (R),2016,Telecom Services,3200,30000,33200
M001179,N00031777,Tom Marino (R),2016,Electric Utilities,0,30200,30200
M001179,N00031777,Tom Marino (R),2016,Insurance,16950,12500,29450
M001179,N00031777,Tom Marino (R),2016,Health Services/HMOs,500,28000,28500
S001184,N00031782,Tim Scott (R),2016,Securities & Investment,805818,248308,1054126
S001184,N00031782,Tim Scott (R),2016,Insurance,262825,501500,764325
S001184,N00031782,Tim Scott (R),2016,Real Estate,430656,138240,568896
S001184,N00031782,Tim Scott (R),2016,Oil & Gas,231976,248300,480276
S001184,N00031782,Tim Scott (R),2016,Lawyers/Law Firms,363703,107850,471553
S001184,N00031782,Tim Scott (R),2016,Leadership PACs,0,461265,461265
S001184,N00031782,Tim Scott (R),2016,Pharmaceuticals/Health Products,78850,347850,426700
S001184,N00031782,Tim Scott (R),2016,Retired,421795,0,421795
S001184,N00031782,Tim Scott (R),2016,Health Professionals,209830,185170,395000
S001184,N00031782,Tim Scott (R),2016,Electric Utilities,105804,208750,314554
C001088,N00031820,Chris Coons (D),2016,Lawyers/Law Firms,973383,152089,1125472
C001088,N00031820,Chris Coons (D),2016,Securities & Investment,323249,89500,412749
C001088,N00031820,Chris Coons (D),2016,Leadership PACs,0,316000,316000
C001088,N00031820,Chris Coons (D),2016,Lobbyists,273797,22330,296127
C001088,N00031820,Chris Coons (D),2016,Pharmaceuticals/Health Products,53800,174000,227800
C001088,N00031820,Chris Coons (D),2016,Commercial Banks,74700,99550,174250
C001088,N00031820,Chris Coons (D),2016,Insurance,29852,141000,170852
C001088,N00031820,Chris Coons (D),2016,Real Estate,111889,46000,157889
C001088,N00031820,Chris Coons (D),2016,TV/Movies/Music,92131,50357,142488
C001088,N00031820,Chris Coons (D),2016,Chemical & Related Manufacturing,61825,77000,138825
B001270,N00031877,Karen Bass (D),2016,TV/Movies/Music,43900,36000,79900
B001270,N00031877,Karen Bass (D),2016,Lawyers/Law Firms,14514,13500,28014
B001270,N00031877,Karen Bass (D),2016,Building Trade Unions,0,26500,26500
B001270,N00031877,Karen Bass (D),2016,Health Professionals,-150,26500,26350
B001270,N00031877,Karen Bass (D),2016,Misc Unions,-250,26500,26250
B001270,N00031877,Karen Bass (D),2016,Public Sector Unions,0,25500,25500
B001270,N00031877,Karen Bass (D),2016,Retired,24641,0,24641
B001270,N00031877,Karen Bass (D),2016,Industrial Unions,0,21000,21000
B001270,N00031877,Karen Bass (D),2016,Business Services,14600,2000,16600
B001270,N00031877,Karen Bass (D),2016,Electric Utilities,0,14500,14500
K000375,N00031933,Bill Keating (D),2016,Lawyers/Law Firms,58882,20750,79632
K000375,N00031933,Bill Keating (D),2016,Building Trade Unions,0,67500,67500
K000375,N00031933,Bill Keating (D),2016,Public Sector Unions,0,53500,53500
K000375,N00031933,Bill Keating (D),2016,Transportation Unions,0,48500,48500
K000375,N00031933,Bill Keating (D),2016,Industrial Unions,0,47000,47000
K000375,N00031933,Bill Keating (D),2016,Misc Issues,44535,1000,45535
K000375,N00031933,Bill Keating (D),2016,Real Estate,30749,13500,44249
K000375,N00031933,Bill Keating (D),2016,Pharmaceuticals/Health Products,5750,33750,39500
K000375,N00031933,Bill Keating (D),2016,Retired,38665,0,38665
K000375,N00031933,Bill Keating (D),2016,Special Trade Contractors,23975,7500,31475
B001271,N00031934,Dan Benishek (R),2016,Health Professionals,12250,66000,78250
B001271,N00031934,Dan Benishek (R),2016,Leadership PACs,0,70000,70000
B001271,N00031934,Dan Benishek (R),2016,Forestry & Forest Products,3600,20000,23600
B001271,N00031934,Dan Benishek (R),2016,Casinos/Gambling,23500,0,23500
B001271,N00031934,Dan Benishek (R),2016,Oil & Gas,5175,14750,19925
B001271,N00031934,Dan Benishek (R),2016,Candidate Committees,2167,16000,18167
B001271,N00031934,Dan Benishek (R),2016,Insurance,250,17000,17250
B001271,N00031934,Dan Benishek (R),2016,Crop Production & Basic Processing,0,15000,15000
B001271,N00031934,Dan Benishek (R),2016,Automotive,9500,4500,14000
B001271,N00031934,Dan Benishek (R),2016,Agricultural Services/Products,0,13000,13000
A000367,N00031938,Justin Amash (R),2016,Misc Manufacturing & Distributing,56250,1000,57250
A000367,N00031938,Justin Amash (R),2016,Securities & Investment,56875,0,56875
A000367,N00031938,Justin Amash (R),2016,Republican/Conservative,31465,5450,36915
A000367,N00031938,Justin Amash (R),2016,Retail Sales,35005,0,35005
A000367,N00031938,Justin Amash (R),2016,Retired,31980,0,31980
A000367,N00031938,Justin Amash (R),2016,Food Processing & Sales,31500,0,31500
A000367,N00031938,Justin Amash (R),2016,Real Estate,26100,2000,28100
A000367,N00031938,Justin Amash (R),2016,Health Professionals,22586,0,22586
A000367,N00031938,Justin Amash (R),2016,Automotive,20200,0,20200
A000367,N00031938,Justin Amash (R),2016,Crop Production & Basic Processing,11700,0,11700
P000601,N00031958,Steven Palazzo (R),2016,Defense Aerospace,6000,59500,65500
P000601,N00031958,Steven Palazzo (R),2016,Accountants,6600,50000,56600
P000601,N00031958,Steven Palazzo (R),2016,Leadership PACs,0,52200,52200
P000601,N00031958,Steven Palazzo (R),2016,Oil & Gas,16200,31000,47200
P000601,N00031958,Steven Palazzo (R),2016,Misc Defense,13950,33000,46950
P000601,N00031958,Steven Palazzo (R),2016,Defense Electronics,0,32500,32500
P000601,N00031958,Steven Palazzo (R),2016,Crop Production & Basic Processing,1250,31000,32250
P000601,N00031958,Steven Palazzo (R),2016,Electric Utilities,500,30000,30500
P000601,N00031958,Steven Palazzo (R),2016,Lobbyists,24200,0,24200
P000601,N00031958,Steven Palazzo (R),2016,Lawyers/Law Firms,5000,16750,21750
G000564,N00031998,Chris Gibson (R),2016,Building Trade Unions,0,5000,5000
G000564,N00031998,Chris Gibson (R),2016,Health Professionals,0,2500,2500
G000564,N00031998,Chris Gibson (R),2016,Leadership PACs,0,2000,2000
C001084,N00032019,David Cicilline (D),2016,Retired,138932,0,138932
C001084,N00032019,David Cicilline (D),2016,Lawyers/Law Firms,97581,22000,119581
C001084,N00032019,David Cicilline (D),2016,Real Estate,69550,10500,80050
C001084,N00032019,David Cicilline (D),2016,Building Trade Unions,0,68500,68500
C001084,N00032019,David Cicilline (D),2016,Securities & Investment,56900,5000,61900
C001084,N00032019,David Cicilline (D),2016,TV/Movies/Music,33480,17500,50980
C001084,N00032019,David Cicilline (D),2016,Health Professionals,22293,20000,42293
C001084,N00032019,David Cicilline (D),2016,Public Sector Unions,600,36500,37100
C001084,N00032019,David Cicilline (D),2016,Transportation Unions,0,34500,34500
C001084,N00032019,David Cicilline (D),2016,Industrial Unions,0,32000,32000
N000184,N00032022,Kristi Noem (R),2016,Retired,171987,0,171987
N000184,N00032022,Kristi Noem (R),2016,Insurance,20950,137500,158450
N000184,N00032022,Kristi Noem (R),2016,Health Professionals,44824,83000,127824
N000184,N00032022,Kristi Noem (R),2016,Securities & Investment,65600,52000,117600
N000184,N00032022,Kristi Noem (R),2016,Real Estate,32535,50500,83035
N000184,N00032022,Kristi Noem (R),2016,Crop Production & Basic Processing,39851,39000,78851
N000184,N00032022,Kristi Noem (R),2016,Commercial Banks,39300,38500,77800
N000184,N00032022,Kristi Noem (R),2016,Retail Sales,21800,54000,75800
N000184,N00032022,Kristi Noem (R),2016,Oil & Gas,33400,42250,75650
N000184,N00032022,Kristi Noem (R),2016,Agricultural Services/Products,6750,53500,60250
G000568,N00032029,Morgan Griffith (R),2016,Health Professionals,8200,87500,95700
G000568,N00032029,Morgan Griffith (R),2016,Electric Utilities,1500,51000,52500
G000568,N00032029,Morgan Griffith (R),2016,Retired,47080,0,47080
G000568,N00032029,Morgan Griffith (R),2016,Oil & Gas,1250,37068,38318
G000568,N00032029,Morgan Griffith (R),2016,Telecom Services,900,32500,33400
G000568,N00032029,Morgan Griffith (R),2016,Lawyers/Law Firms,19700,13000,32700
G000568,N00032029,Morgan Griffith (R),2016,Retail Sales,19100,12500,31600
G000568,N00032029,Morgan Griffith (R),2016,Mining,6100,22000,28100
G000568,N00032029,Morgan Griffith (R),2016,Pharmaceuticals/Health Products,1000,19000,20000
G000568,N00032029,Morgan Griffith (R),2016,Chemical & Related Manufacturing,0,18500,18500
J000292,N00032088,Bill Johnson (R),2016,Oil & Gas,14950,113000,127950
J000292,N00032088,Bill Johnson (R),2016,Health Professionals,15400,104500,119900
J000292,N00032088,Bill Johnson (R),2016,Electric Utilities,2750,98500,101250
J000292,N00032088,Bill Johnson (R),2016,Misc Manufacturing & Distributing,60850,19908,80758
J000292,N00032088,Bill Johnson (R),2016,Pharmaceuticals/Health Products,1500,65350,66850
J000292,N00032088,Bill Johnson (R),2016,Leadership PACs,0,51600,51600
J000292,N00032088,Bill Johnson (R),2016,Telecom Services,0,46500,46500
J000292,N00032088,Bill Johnson (R),2016,Insurance,12258,32000,44258
J000292,N00032088,Bill Johnson (R),2016,Automotive,12650,29500,42150
J000292,N00032088,Bill Johnson (R),2016,Building Trade Unions,500,38000,38500
H001071,N00032243,Jody B Hice (R),2016,Retired,32863,0,32863
H001071,N00032243,Jody B Hice (R),2016,Real Estate,16150,6000,22150
H001071,N00032243,Jody B Hice (R),2016,Retail Sales,5950,12000,17950
H001071,N00032243,Jody B Hice (R),2016,Commercial Banks,3300,12500,15800
H001071,N00032243,Jody B Hice (R),2016,Food & Beverage,5400,10000,15400
H001071,N00032243,Jody B Hice (R),2016,Insurance,1750,12000,13750
H001071,N00032243,Jody B Hice (R),2016,Air Transport,5400,8200,13600
H001071,N00032243,Jody B Hice (R),2016,Leadership PACs,0,13500,13500
H001071,N00032243,Jody B Hice (R),2016,Railroads,7900,5500,13400
H001071,N00032243,Jody B Hice (R),2016,Business Services,13300,0,13300
N000185,N00032441,Richard Nugent (R),2016,Crop Production & Basic Processing,1000,9000,10000
N000185,N00032441,Richard Nugent (R),2016,Defense Electronics,0,4500,4500
N000185,N00032441,Richard Nugent (R),2016,Defense Aerospace,0,3000,3000
N000185,N00032441,Richard Nugent (R),2016,Electric Utilities,0,3000,3000
N000185,N00032441,Richard Nugent (R),2016,Health Services/HMOs,0,2500,2500
N000185,N00032441,Richard Nugent (R),2016,Telephone Utilities,0,2500,2500
N000185,N00032441,Richard Nugent (R),2016,Food Processing & Sales,0,2500,2500
N000185,N00032441,Richard Nugent (R),2016,Casinos/Gambling,0,2500,2500
N000185,N00032441,Richard Nugent (R),2016,Commercial Banks,0,2000,2000
N000185,N00032441,Richard Nugent (R),2016,Retired,1750,0,1750
S001189,N00032457,Austin Scott (R),2016,Agricultural Services/Products,625,69500,70125
S001189,N00032457,Austin Scott (R),2016,Crop Production & Basic Processing,10500,58000,68500
S001189,N00032457,Austin Scott (R),2016,Health Professionals,21650,42500,64150
S001189,N00032457,Austin Scott (R),2016,Insurance,1500,47500,49000
S001189,N00032457,Austin Scott (R),2016,Leadership PACs,0,45000,45000
S001189,N00032457,Austin Scott (R),2016,Securities & Investment,11000,33000,44000
S001189,N00032457,Austin Scott (R),2016,Commercial Banks,1500,39000,40500
S001189,N00032457,Austin Scott (R),2016,Defense Electronics,1000,34000,35000
S001189,N00032457,Austin Scott (R),2016,Defense Aerospace,0,34000,34000
S001189,N00032457,Austin Scott (R),2016,Forestry & Forest Products,2500,27000,29500
J000293,N00032546,Ron Johnson (R),2016,Retired,5470034,0,5470034
J000293,N00032546,Ron Johnson (R),2016,Securities & Investment,1188271,69500,1257771
J000293,N00032546,Ron Johnson (R),2016,Republican/Conservative,1203606,37500,1241106
J000293,N00032546,Ron Johnson (R),2016,Real Estate,845815,42500,888315
J000293,N00032546,Ron Johnson (R),2016,Lawyers/Law Firms,456819,74950,531769
J000293,N00032546,Ron Johnson (R),2016,Leadership PACs,0,508550,508550
J000293,N00032546,Ron Johnson (R),2016,Misc Manufacturing & Distributing,456043,48500,504543
J000293,N00032546,Ron Johnson (R),2016,Health Professionals,400164,55000,455164
J000293,N00032546,Ron Johnson (R),2016,Oil & Gas,287509,142450,429959
J000293,N00032546,Ron Johnson (R),2016,Misc Finance,398379,21500,419879
M001183,N00032838,Joe Manchin (D),2016,Mining,257350,86500,343850
M001183,N00032838,Joe Manchin (D),2016,Lawyers/Law Firms,259000,76750,335750
M001183,N00032838,Joe Manchin (D),2016,Electric Utilities,122500,146750,269250
M001183,N00032838,Joe Manchin (D),2016,Leadership PACs,0,221500,221500
M001183,N00032838,Joe Manchin (D),2016,Lobbyists,171518,16220,187738
M001183,N00032838,Joe Manchin (D),2016,Oil & Gas,68300,114500,182800
M001183,N00032838,Joe Manchin (D),2016,Pharmaceuticals/Health Products,61300,118250,179550
M001183,N00032838,Joe Manchin (D),2016,Insurance,30100,145500,175600
M001183,N00032838,Joe Manchin (D),2016,Securities & Investment,91100,73000,164100
M001183,N00032838,Joe Manchin (D),2016,Real Estate,85001,47500,132501
H001068,N00033030,Jared Huffman (D),2016,Retired,109704,0,109704
H001068,N00033030,Jared Huffman (D),2016,Transportation Unions,0,67500,67500
H001068,N00033030,Jared Huffman (D),2016,Lawyers/Law Firms,36185,18000,54185
H001068,N00033030,Jared Huffman (D),2016,Health Professionals,17940,30780,48720
H001068,N00033030,Jared Huffman (D),2016,Public Sector Unions,25,35460,35485
H001068,N00033030,Jared Huffman (D),2016,Real Estate,22822,6000,28822
H001068,N00033030,Jared Huffman (D),2016,"Beer, Wine & Liquor",13539,13932,27471
H001068,N00033030,Jared Huffman (D),2016,Environment,15750,11099,26849
H001068,N00033030,Jared Huffman (D),2016,Building Trade Unions,0,24268,24268
H001068,N00033030,Jared Huffman (D),2016,Casinos/Gambling,23200,0,23200
D000618,N00033054,Steven Daines (R),2016,Retired,611804,0,611804
D000618,N00033054,Steven Daines (R),2016,Securities & Investment,494300,36500,530800
D000618,N00033054,Steven Daines (R),2016,Oil & Gas,247756,182500,430256
D000618,N00033054,Steven Daines (R),2016,Leadership PACs,0,329249,329249
D000618,N00033054,Steven Daines (R),2016,Real Estate,244075,24500,268575
D000618,N00033054,Steven Daines (R),2016,General Contractors,167450,22500,189950
D000618,N00033054,Steven Daines (R),2016,Republican/Conservative,131675,52851,184526
D000618,N00033054,Steven Daines (R),2016,Commercial Banks,86850,90600,177450
D000618,N00033054,Steven Daines (R),2016,Mining,92350,62350,154700
D000618,N00033054,Steven Daines (R),2016,Livestock,133575,18500,152075
C001098,N00033085,Ted Cruz (R),2016,Retired,2075197,0,2075197
C001098,N00033085,Ted Cruz (R),2016,Republican/Conservative,1926677,115405,2042082
C001098,N00033085,Ted Cruz (R),2016,Oil & Gas,1228068,181000,1409068
C001098,N00033085,Ted Cruz (R),2016,Lawyers/Law Firms,1223012,57249,1280261
C001098,N00033085,Ted Cruz (R),2016,Securities & Investment,1189587,24500,1214087
C001098,N00033085,Ted Cruz (R),2016,Real Estate,983455,24000,1007455
C001098,N00033085,Ted Cruz (R),2016,Misc Finance,667229,3500,670729
C001098,N00033085,Ted Cruz (R),2016,Health Professionals,560642,38000,598642
C001098,N00033085,Ted Cruz (R),2016,Misc Business,457888,10500,468388
C001098,N00033085,Ted Cruz (R),2016,Business Services,451719,8000,459719
M001191,N00033091,Patrick Murphy (D),2016,Lawyers/Law Firms,1373609,49150,1422759
M001191,N00033091,Patrick Murphy (D),2016,Retired,1193930,0,1193930
M001191,N00033091,Patrick Murphy (D),2016,Real Estate,820345,62000,882345
M001191,N00033091,Patrick Murphy (D),2016,Securities & Investment,634311,89000,723311
M001191,N00033091,Patrick Murphy (D),2016,Democratic/Liberal,526731,15711,542442
M001191,N00033091,Patrick Murphy (D),2016,Leadership PACs,600,485800,486400
M001191,N00033091,Patrick Murphy (D),2016,Lobbyists,344905,3000,347905
M001191,N00033091,Patrick Murphy (D),2016,Health Professionals,251255,56500,307755
M001191,N00033091,Patrick Murphy (D),2016,Insurance,158299,140700,298999
M001191,N00033091,Patrick Murphy (D),2016,Business Services,274124,3500,277624
S001190,N00033101,Brad Schneider (D),2016,Democratic/Liberal,402878,26800,429678
S001190,N00033101,Brad Schneider (D),2016,Lawyers/Law Firms,321152,11500,332652
S001190,N00033101,Brad Schneider (D),2016,Pro-Israel,293466,25283,318749
S001190,N00033101,Brad Schneider (D),2016,Leadership PACs,11200,299100,310300
S001190,N00033101,Brad Schneider (D),2016,Retired,230064,0,230064
S001190,N00033101,Brad Schneider (D),2016,Securities & Investment,203233,6500,209733
S001190,N00033101,Brad Schneider (D),2016,Real Estate,161981,2500,164481
S001190,N00033101,Brad Schneider (D),2016,Education,128990,1000,129990
S001190,N00033101,Brad Schneider (D),2016,Candidate Committees,0,85930,85930
S001190,N00033101,Brad Schneider (D),2016,Business Services,75703,0,75703
K000384,N00033177,Tim Kaine (D),2016,Lawyers/Law Firms,2672073,142136,2814209
K000384,N00033177,Tim Kaine (D),2016,Retired,2132205,0,2132205
K000384,N00033177,Tim Kaine (D),2016,Securities & Investment,1158896,33500,1192396
K000384,N00033177,Tim Kaine (D),2016,Real Estate,700830,8500,709330
K000384,N00033177,Tim Kaine (D),2016,Business Services,645206,14900,660106
K000384,N00033177,Tim Kaine (D),2016,Education,614929,0,614929
K000384,N00033177,Tim Kaine (D),2016,Lobbyists,472895,16175,489070
K000384,N00033177,Tim Kaine (D),2016,TV/Movies/Music,384744,3500,388244
K000384,N00033177,Tim Kaine (D),2016,Misc Finance,370848,6500,377348
K000384,N00033177,Tim Kaine (D),2016,Women's Issues,371887,3193,375080
E000293,N00033217,Elizabeth Esty (D),2016,Retired,168404,0,168404
E000293,N00033217,Elizabeth Esty (D),2016,Lawyers/Law Firms,145930,17000,162930
E000293,N00033217,Elizabeth Esty (D),2016,Securities & Investment,96250,3000,99250
E000293,N00033217,Elizabeth Esty (D),2016,Women's Issues,72489,5000,77489
E000293,N00033217,Elizabeth Esty (D),2016,Democratic/Liberal,51765,13200,64965
E000293,N00033217,Elizabeth Esty (D),2016,Health Professionals,22194,42000,64194
E000293,N00033217,Elizabeth Esty (D),2016,Leadership PACs,0,60609,60609
E000293,N00033217,Elizabeth Esty (D),2016,Transportation Unions,0,59000,59000
E000293,N00033217,Elizabeth Esty (D),2016,Education,53769,0,53769
E000293,N00033217,Elizabeth Esty (D),2016,Air Transport,260,48500,48760
K000391,N00033240,Raja Krishnamoorthi (D),2016,Health Professionals,322618,85000,407618
K000391,N00033240,Raja Krishnamoorthi (D),2016,Lawyers/Law Firms,234273,6000,240273
K000391,N00033240,Raja Krishnamoorthi (D),2016,Securities & Investment,139611,0,139611
K000391,N00033240,Raja Krishnamoorthi (D),2016,Retired,134204,0,134204
K000391,N00033240,Raja Krishnamoorthi (D),2016,Education,103844,0,103844
K000391,N00033240,Raja Krishnamoorthi (D),2016,Hospitals/Nursing Homes,73985,5000,78985
K000391,N00033240,Raja Krishnamoorthi (D),2016,Human Rights,35794,29150,64944
K000391,N00033240,Raja Krishnamoorthi (D),2016,Electronics Mfg & Equip,60133,1000,61133
K000391,N00033240,Raja Krishnamoorthi (D),2016,Real Estate,53620,5000,58620
K000391,N00033240,Raja Krishnamoorthi (D),2016,Insurance,35608,22500,58108
L000579,N00033274,Alan Lowenthal (D),2016,Transportation Unions,0,61375,61375
L000579,N00033274,Alan Lowenthal (D),2016,Building Trade Unions,0,49200,49200
L000579,N00033274,Alan Lowenthal (D),2016,Public Sector Unions,0,46500,46500
L000579,N00033274,Alan Lowenthal (D),2016,Health Professionals,8650,29600,38250
L000579,N00033274,Alan Lowenthal (D),2016,Lawyers/Law Firms,19900,14750,34650
L000579,N00033274,Alan Lowenthal (D),2016,Retired,32985,0,32985
L000579,N00033274,Alan Lowenthal (D),2016,Industrial Unions,0,32000,32000
L000579,N00033274,Alan Lowenthal (D),2016,Electric Utilities,0,23500,23500
L000579,N00033274,Alan Lowenthal (D),2016,Real Estate,19400,4000,23400
L000579,N00033274,Alan Lowenthal (D),2016,Crop Production & Basic Processing,0,19700,19700
G000571,N00033281,Tulsi Gabbard (D),2016,Health Professionals,81522,16000,97522
G000571,N00033281,Tulsi Gabbard (D),2016,Retired,65476,0,65476
G000571,N00033281,Tulsi Gabbard (D),2016,Democratic/Liberal,55916,5000,60916
G000571,N00033281,Tulsi Gabbard (D),2016,Real Estate,45145,12700,57845
G000571,N00033281,Tulsi Gabbard (D),2016,Lawyers/Law Firms,36515,9000,45515
G000571,N00033281,Tulsi Gabbard (D),2016,Building Trade Unions,0,43500,43500
G000571,N00033281,Tulsi Gabbard (D),2016,Human Rights,37330,6000,43330
G000571,N00033281,Tulsi Gabbard (D),2016,Sea Transport,20935,21000,41935
G000571,N00033281,Tulsi Gabbard (D),2016,Securities & Investment,41062,0,41062
G000571,N00033281,Tulsi Gabbard (D),2016,Electronics Mfg & Equip,35904,5000,40904
C001091,N00033316,Joaquin Castro (D),2016,Lawyers/Law Firms,93730,33082,126812
C001091,N00033316,Joaquin Castro (D),2016,Real Estate,27800,26000,53800
C001091,N00033316,Joaquin Castro (D),2016,Building Trade Unions,0,40000,40000
C001091,N00033316,Joaquin Castro (D),2016,Hospitals/Nursing Homes,15785,23500,39285
C001091,N00033316,Joaquin Castro (D),2016,Public Sector Unions,0,37000,37000
C001091,N00033316,Joaquin Castro (D),2016,Insurance,2250,34250,36500
C001091,N00033316,Joaquin Castro (D),2016,Defense Aerospace,0,36000,36000
C001091,N00033316,Joaquin Castro (D),2016,Retail Sales,10650,23000,33650
C001091,N00033316,Joaquin Castro (D),2016,Industrial Unions,0,31000,31000
C001091,N00033316,Joaquin Castro (D),2016,Accountants,1500,26500,28000
C001095,N00033363,Tom Cotton (R),2016,Securities & Investment,1143450,87750,1231200
C001095,N00033363,Tom Cotton (R),2016,Retired,1131789,0,1131789
C001095,N00033363,Tom Cotton (R),2016,Republican/Conservative,861377,83883,945260
C001095,N00033363,Tom Cotton (R),2016,Real Estate,446930,27500,474430
C001095,N00033363,Tom Cotton (R),2016,Leadership PACs,22300,440171,462471
C001095,N00033363,Tom Cotton (R),2016,Oil & Gas,368005,86100,454105
C001095,N00033363,Tom Cotton (R),2016,Lawyers/Law Firms,367822,50865,418687
C001095,N00033363,Tom Cotton (R),2016,Health Professionals,330476,60000,390476
C001095,N00033363,Tom Cotton (R),2016,Commercial Banks,185885,156750,342635
C001095,N00033363,Tom Cotton (R),2016,Misc Finance,288800,12500,301300
V000129,N00033367,David Valadao (R),2016,Crop Production & Basic Processing,346790,98118,444908
V000129,N00033367,David Valadao (R),2016,Leadership PACs,0,300100,300100
V000129,N00033367,David Valadao (R),2016,Dairy,163683,40000,203683
V000129,N00033367,David Valadao (R),2016,Livestock,75000,12000,87000
V000129,N00033367,David Valadao (R),2016,Agricultural Services/Products,7900,72500,80400
V000129,N00033367,David Valadao (R),2016,Insurance,4650,74000,78650
V000129,N00033367,David Valadao (R),2016,Pharmaceuticals/Health Products,3500,66000,69500
V000129,N00033367,David Valadao (R),2016,"Beer, Wine & Liquor",31400,34000,65400
V000129,N00033367,David Valadao (R),2016,Casinos/Gambling,49200,13500,62700
V000129,N00033367,David Valadao (R),2016,Retired,56343,0,56343
C001097,N00033373,Tony Cardenas (D),2016,Pharmaceuticals/Health Products,22452,114750,137202
C001097,N00033373,Tony Cardenas (D),2016,Health Professionals,33482,45600,79082
C001097,N00033373,Tony Cardenas (D),2016,Real Estate,48900,21500,70400
C001097,N00033373,Tony Cardenas (D),2016,Insurance,2750,67500,70250
C001097,N00033373,Tony Cardenas (D),2016,Casinos/Gambling,64400,0,64400
C001097,N00033373,Tony Cardenas (D),2016,TV/Movies/Music,32260,30000,62260
C001097,N00033373,Tony Cardenas (D),2016,Securities & Investment,31950,28500,60450
C001097,N00033373,Tony Cardenas (D),2016,Lawyers/Law Firms,36300,14000,50300
C001097,N00033373,Tony Cardenas (D),2016,Health Services/HMOs,5550,38000,43550
C001097,N00033373,Tony Cardenas (D),2016,Electric Utilities,7750,35500,43250
B001286,N00033390,Cheri Bustos (D),2016,Democratic/Liberal,189601,16850,206451
B001286,N00033390,Cheri Bustos (D),2016,Leadership PACs,1000,177850,178850
B001286,N00033390,Cheri Bustos (D),2016,Lawyers/Law Firms,147806,15750,163556
B001286,N00033390,Cheri Bustos (D),2016,Retired,121702,0,121702
B001286,N00033390,Cheri Bustos (D),2016,Women's Issues,93837,10000,103837
B001286,N00033390,Cheri Bustos (D),2016,Securities & Investment,38831,39000,77831
B001286,N00033390,Cheri Bustos (D),2016,Education,69041,5000,74041
B001286,N00033390,Cheri Bustos (D),2016,Insurance,15544,58000,73544
B001286,N00033390,Cheri Bustos (D),2016,Transportation Unions,65,70500,70565
B001286,N00033390,Cheri Bustos (D),2016,Real Estate,47760,22000,69760
K000380,N00033395,Dan Kildee (D),2016,Casinos/Gambling,78428,0,78428
K000380,N00033395,Dan Kildee (D),2016,Health Professionals,52392,17500,69892
K000380,N00033395,Dan Kildee (D),2016,Insurance,1000,67000,68000
K000380,N00033395,Dan Kildee (D),2016,Real Estate,17705,49000,66705
K000380,N00033395,Dan Kildee (D),2016,Building Trade Unions,0,48500,48500
K000380,N00033395,Dan Kildee (D),2016,Industrial Unions,250,47000,47250
K000380,N00033395,Dan Kildee (D),2016,Lawyers/Law Firms,21755,23625,45380
K000380,N00033395,Dan Kildee (D),2016,Securities & Investment,3100,32500,35600
K000380,N00033395,Dan Kildee (D),2016,Public Sector Unions,870,32000,32870
K000380,N00033395,Dan Kildee (D),2016,Finance/Credit Companies,0,31500,31500
H001065,N00033399,George Holding (R),2016,Insurance,29550,186300,215850
H001065,N00033399,George Holding (R),2016,Lawyers/Law Firms,136950,35750,172700
H001065,N00033399,George Holding (R),2016,Leadership PACs,0,160203,160203
H001065,N00033399,George Holding (R),2016,Real Estate,88570,56500,145070
H001065,N00033399,George Holding (R),2016,Lobbyists,135355,2500,137855
H001065,N00033399,George Holding (R),2016,Health Professionals,60051,69500,129551
H001065,N00033399,George Holding (R),2016,Securities & Investment,49850,65500,115350
H001065,N00033399,George Holding (R),2016,Pharmaceuticals/Health Products,5000,99500,104500
H001065,N00033399,George Holding (R),2016,Commercial Banks,40250,61500,101750
H001065,N00033399,George Holding (R),2016,Electronics Mfg & Equip,50300,37500,87800
M001190,N00033410,Markwayne Mullin (R),2016,Oil & Gas,59350,145100,204450
M001190,N00033410,Markwayne Mullin (R),2016,Leadership PACs,0,94000,94000
M001190,N00033410,Markwayne Mullin (R),2016,Human Rights,69000,0,69000
M001190,N00033410,Markwayne Mullin (R),2016,Health Professionals,15110,47000,62110
M001190,N00033410,Markwayne Mullin (R),2016,Insurance,12400,43000,55400
M001190,N00033410,Markwayne Mullin (R),2016,Pharmaceuticals/Health Products,2250,53000,55250
M001190,N00033410,Markwayne Mullin (R),2016,Electric Utilities,0,55000,55000
M001190,N00033410,Markwayne Mullin (R),2016,Automotive,14500,38000,52500
M001190,N00033410,Markwayne Mullin (R),2016,Real Estate,25700,20500,46200
M001190,N00033410,Markwayne Mullin (R),2016,Commercial Banks,33010,8000,41010
F000463,N00033443,Deb Fischer (R),2016,Leadership PACs,200,407182,407382
F000463,N00033443,Deb Fischer (R),2016,Retired,358387,0,358387
F000463,N00033443,Deb Fischer (R),2016,Insurance,83000,129000,212000
F000463,N00033443,Deb Fischer (R),2016,Crop Production & Basic Processing,134360,72552,206912
F000463,N00033443,Deb Fischer (R),2016,Republican/Conservative,153071,46500,199571
F000463,N00033443,Deb Fischer (R),2016,Agricultural Services/Products,76525,100500,177025
F000463,N00033443,Deb Fischer (R),2016,Lawyers/Law Firms,96186,76250,172436
F000463,N00033443,Deb Fischer (R),2016,Commercial Banks,89000,81170,170170
F000463,N00033443,Deb Fischer (R),2016,Oil & Gas,68234,90400,158634
F000463,N00033443,Deb Fischer (R),2016,Health Professionals,109199,44500,153699
D000627,N00033449,Val Demings (D),2016,Women's Issues,71992,8100,80092
D000627,N00033449,Val Demings (D),2016,Lawyers/Law Firms,68411,0,68411
D000627,N00033449,Val Demings (D),2016,Leadership PACs,4000,45014,49014
D000627,N00033449,Val Demings (D),2016,Retired,48338,0,48338
D000627,N00033449,Val Demings (D),2016,Public Sector Unions,0,44000,44000
D000627,N00033449,Val Demings (D),2016,Real Estate,30975,2000,32975
D000627,N00033449,Val Demings (D),2016,Education,30856,0,30856
D000627,N00033449,Val Demings (D),2016,Pro-Israel,29560,0,29560
D000627,N00033449,Val Demings (D),2016,Securities & Investment,27600,0,27600
D000627,N00033449,Val Demings (D),2016,Health Professionals,23945,2000,25945
B001278,N00033474,Suzanne Bonamici (D),2016,Lawyers/Law Firms,61645,17000,78645
B001278,N00033474,Suzanne Bonamici (D),2016,Misc Manufacturing & Distributing,20200,35000,55200
B001278,N00033474,Suzanne Bonamici (D),2016,Health Professionals,7934,40000,47934
B001278,N00033474,Suzanne Bonamici (D),2016,Insurance,0,37500,37500
B001278,N00033474,Suzanne Bonamici (D),2016,Retired,32436,0,32436
B001278,N00033474,Suzanne Bonamici (D),2016,Electronics Mfg & Equip,7650,24000,31650
B001278,N00033474,Suzanne Bonamici (D),2016,Crop Production & Basic Processing,2795,23500,26295
B001278,N00033474,Suzanne Bonamici (D),2016,Public Sector Unions,0,25500,25500
B001278,N00033474,Suzanne Bonamici (D),2016,Lobbyists,25435,0,25435
B001278,N00033474,Suzanne Bonamici (D),2016,Real Estate,13969,9000,22969
B001284,N00033495,Susan Brooks (R),2016,Pharmaceuticals/Health Products,23000,119500,142500
B001284,N00033495,Susan Brooks (R),2016,Health Professionals,29128,76500,105628
B001284,N00033495,Susan Brooks (R),2016,Securities & Investment,66500,18500,85000
B001284,N00033495,Susan Brooks (R),2016,Lawyers/Law Firms,58390,13500,71890
B001284,N00033495,Susan Brooks (R),2016,Real Estate,36550,29900,66450
B001284,N00033495,Susan Brooks (R),2016,Retired,55850,0,55850
B001284,N00033495,Susan Brooks (R),2016,Lobbyists,46564,8000,54564
B001284,N00033495,Susan Brooks (R),2016,Automotive,15100,32000,47100
B001284,N00033495,Susan Brooks (R),2016,Insurance,14500,31500,46000
B001284,N00033495,Susan Brooks (R),2016,Accountants,11250,34500,45750
S001193,N00033508,Eric Swalwell (D),2016,Real Estate,119084,16000,135084
S001193,N00033508,Eric Swalwell (D),2016,Health Professionals,49347,59500,108847
S001193,N00033508,Eric Swalwell (D),2016,Retired,83598,0,83598
S001193,N00033508,Eric Swalwell (D),2016,Pharmaceuticals/Health Products,11375,72000,83375
S001193,N00033508,Eric Swalwell (D),2016,Lawyers/Law Firms,61143,19750,80893
S001193,N00033508,Eric Swalwell (D),2016,Electronics Mfg & Equip,33160,45500,78660
S001193,N00033508,Eric Swalwell (D),2016,Securities & Investment,36955,11500,48455
S001193,N00033508,Eric Swalwell (D),2016,Building Trade Unions,0,47500,47500
S001193,N00033508,Eric Swalwell (D),2016,Insurance,21975,25000,46975
S001193,N00033508,Eric Swalwell (D),2016,Human Rights,34344,10650,44994
R000599,N00033510,Raul Ruiz (D),2016,Health Professionals,125943,227600,353543
R000599,N00033510,Raul Ruiz (D),2016,Leadership PACs,0,180500,180500
R000599,N00033510,Raul Ruiz (D),2016,Human Rights,135808,20850,156658
R000599,N00033510,Raul Ruiz (D),2016,Democratic/Liberal,138024,6500,144524
R000599,N00033510,Raul Ruiz (D),2016,Retired,144415,0,144415
R000599,N00033510,Raul Ruiz (D),2016,Lawyers/Law Firms,104499,17500,121999
R000599,N00033510,Raul Ruiz (D),2016,Casinos/Gambling,108165,4500,112665
R000599,N00033510,Raul Ruiz (D),2016,Real Estate,76805,8500,85305
R000599,N00033510,Raul Ruiz (D),2016,Hospitals/Nursing Homes,45366,24500,69866
R000599,N00033510,Raul Ruiz (D),2016,Pharmaceuticals/Health Products,8350,59012,67362
C001093,N00033518,Doug Collins (R),2016,Leadership PACs,0,109500,109500
C001093,N00033518,Doug Collins (R),2016,Health Professionals,22450,42500,64950
C001093,N00033518,Doug Collins (R),2016,TV/Movies/Music,11900,45200,57100
C001093,N00033518,Doug Collins (R),2016,Lawyers/Law Firms,30325,25000,55325
C001093,N00033518,Doug Collins (R),2016,Retail Sales,24238,28000,52238
C001093,N00033518,Doug Collins (R),2016,Telecom Services,3100,38000,41100
C001093,N00033518,Doug Collins (R),2016,Lobbyists,39078,1000,40078
C001093,N00033518,Doug Collins (R),2016,Electronics Mfg & Equip,6950,31000,37950
C001093,N00033518,Doug Collins (R),2016,Candidate Committees,250,32500,32750
C001093,N00033518,Doug Collins (R),2016,Insurance,4500,25500,30000
R000603,N00033527,David Rouzer (R),2016,Crop Production & Basic Processing,109221,76750,185971
R000603,N00033527,David Rouzer (R),2016,Agricultural Services/Products,4250,78200,82450
R000603,N00033527,David Rouzer (R),2016,Real Estate,42968,19000,61968
R000603,N00033527,David Rouzer (R),2016,Leadership PACs,1429,52471,53900
R000603,N00033527,David Rouzer (R),2016,Retired,50103,0,50103
R000603,N00033527,David Rouzer (R),2016,Lawyers/Law Firms,38584,11250,49834
R000603,N00033527,David Rouzer (R),2016,Health Professionals,12900,29000,41900
R000603,N00033527,David Rouzer (R),2016,Trucking,12300,21500,33800
R000603,N00033527,David Rouzer (R),2016,Air Transport,1000,30500,31500
R000603,N00033527,David Rouzer (R),2016,Livestock,2469,29000,31469
K000390,N00033530,Ruben Kihuen (D),2016,Lawyers/Law Firms,189626,11500,201126
K000390,N00033530,Ruben Kihuen (D),2016,Leadership PACs,2800,122100,124900
K000390,N00033530,Ruben Kihuen (D),2016,Health Professionals,98152,10500,108652
K000390,N00033530,Ruben Kihuen (D),2016,Human Rights,58392,24662,83054
K000390,N00033530,Ruben Kihuen (D),2016,Democratic/Liberal,59942,10545,70487
K000390,N00033530,Ruben Kihuen (D),2016,Building Trade Unions,1000,67000,68000
K000390,N00033530,Ruben Kihuen (D),2016,Public Sector Unions,251,66000,66251
K000390,N00033530,Ruben Kihuen (D),2016,Casinos/Gambling,39902,18000,57902
K000390,N00033530,Ruben Kihuen (D),2016,Environment,42634,13831,56465
K000390,N00033530,Ruben Kihuen (D),2016,Candidate Committees,0,54575,54575
B001283,N00033532,James Bridenstine (R),2016,Retired,84015,0,84015
B001283,N00033532,James Bridenstine (R),2016,Health Professionals,53900,19500,73400
B001283,N00033532,James Bridenstine (R),2016,Republican/Conservative,24540,29685,54225
B001283,N00033532,James Bridenstine (R),2016,Defense Aerospace,1500,43500,45000
B001283,N00033532,James Bridenstine (R),2016,Oil & Gas,12250,26500,38750
B001283,N00033532,James Bridenstine (R),2016,Defense Electronics,0,34000,34000
B001283,N00033532,James Bridenstine (R),2016,Telecom Services,4250,19000,23250
B001283,N00033532,James Bridenstine (R),2016,Lawyers/Law Firms,15500,4000,19500
B001283,N00033532,James Bridenstine (R),2016,Misc Finance,18800,0,18800
B001283,N00033532,James Bridenstine (R),2016,Automotive,13150,5000,18150
O000170,N00033540,Beto O'Rourke (D),2016,Real Estate,58705,0,58705
O000170,N00033540,Beto O'Rourke (D),2016,Commercial Banks,53270,1500,54770
O000170,N00033540,Beto O'Rourke (D),2016,Retired,36699,0,36699
O000170,N00033540,Beto O'Rourke (D),2016,Misc Finance,29400,0,29400
O000170,N00033540,Beto O'Rourke (D),2016,Hospitals/Nursing Homes,28615,0,28615
O000170,N00033540,Beto O'Rourke (D),2016,Lawyers/Law Firms,25140,0,25140
O000170,N00033540,Beto O'Rourke (D),2016,Telephone Utilities,21600,0,21600
O000170,N00033540,Beto O'Rourke (D),2016,Pro-Israel,17400,0,17400
O000170,N00033540,Beto O'Rourke (D),2016,Automotive,14845,0,14845
O000170,N00033540,Beto O'Rourke (D),2016,Building Materials & Equipment,13500,0,13500
G000572,N00033541,Pete Gallego (D),2016,Lawyers/Law Firms,288084,11000,299084
G000572,N00033541,Pete Gallego (D),2016,Leadership PACs,12900,206800,219700
G000572,N00033541,Pete Gallego (D),2016,Democratic/Liberal,94895,26256,121151
G000572,N00033541,Pete Gallego (D),2016,Candidate Committees,1000,68700,69700
G000572,N00033541,Pete Gallego (D),2016,Education,55357,0,55357
G000572,N00033541,Pete Gallego (D),2016,Securities & Investment,54571,0,54571
G000572,N00033541,Pete Gallego (D),2016,Public Sector Unions,0,48000,48000
G000572,N00033541,Pete Gallego (D),2016,Building Trade Unions,0,46500,46500
G000572,N00033541,Pete Gallego (D),2016,Retired,42790,0,42790
G000572,N00033541,Pete Gallego (D),2016,Human Rights,15877,26000,41877
P000607,N00033549,Mark Pocan (D),2016,Insurance,3105,81950,85055
P000607,N00033549,Mark Pocan (D),2016,Public Sector Unions,200,66000,66200
P000607,N00033549,Mark Pocan (D),2016,Building Trade Unions,0,60500,60500
P000607,N00033549,Mark Pocan (D),2016,Industrial Unions,0,57000,57000
P000607,N00033549,Mark Pocan (D),2016,Health Professionals,8315,47500,55815
P000607,N00033549,Mark Pocan (D),2016,Retired,38967,0,38967
P000607,N00033549,Mark Pocan (D),2016,Transportation Unions,0,37500,37500
P000607,N00033549,Mark Pocan (D),2016,Misc Unions,0,36250,36250
P000607,N00033549,Mark Pocan (D),2016,Securities & Investment,13251,22500,35751
P000607,N00033549,Mark Pocan (D),2016,Lawyers/Law Firms,17985,15379,33364
P000608,N00033591,Scott Peters (D),2016,Democratic/Liberal,191758,12500,204258
P000608,N00033591,Scott Peters (D),2016,Leadership PACs,0,189938,189938
P000608,N00033591,Scott Peters (D),2016,Pharmaceuticals/Health Products,10103,178950,189053
P000608,N00033591,Scott Peters (D),2016,Lawyers/Law Firms,145360,41750,187110
P000608,N00033591,Scott Peters (D),2016,Real Estate,110661,48500,159161
P000608,N00033591,Scott Peters (D),2016,Retired,144941,0,144941
P000608,N00033591,Scott Peters (D),2016,Health Professionals,30188,68650,98838
P000608,N00033591,Scott Peters (D),2016,Securities & Investment,42075,55000,97075
P000608,N00033591,Scott Peters (D),2016,Electronics Mfg & Equip,25660,53960,79620
P000608,N00033591,Scott Peters (D),2016,Defense Aerospace,1815,73500,75315
B001280,N00033625,Kerry Bentivolio (I),2016,Misc Business,20400,0,20400
B001280,N00033625,Kerry Bentivolio (I),2016,Health Professionals,8100,0,8100
B001280,N00033625,Kerry Bentivolio (I),2016,Hospitals/Nursing Homes,4436,0,4436
B001280,N00033625,Kerry Bentivolio (I),2016,Electronics Mfg & Equip,2700,0,2700
B001280,N00033625,Kerry Bentivolio (I),2016,Lodging/Tourism,2700,0,2700
B001280,N00033625,Kerry Bentivolio (I),2016,Republican/Conservative,0,1234,1234
H001067,N00033630,Richard Hudson (R),2016,Leadership PACs,0,119700,119700
H001067,N00033630,Richard Hudson (R),2016,Health Professionals,8550,95350,103900
H001067,N00033630,Richard Hudson (R),2016,Oil & Gas,8200,87700,95900
H001067,N00033630,Richard Hudson (R),2016,Pharmaceuticals/Health Products,2000,82250,84250
H001067,N00033630,Richard Hudson (R),2016,Insurance,9600,68500,78100
H001067,N00033630,Richard Hudson (R),2016,Securities & Investment,35900,38500,74400
H001067,N00033630,Richard Hudson (R),2016,Automotive,34915,34500,69415
H001067,N00033630,Richard Hudson (R),2016,Accountants,2000,65000,67000
H001067,N00033630,Richard Hudson (R),2016,Lawyers/Law Firms,46507,19250,65757
H001067,N00033630,Richard Hudson (R),2016,Real Estate,27950,36000,63950
M001187,N00033631,Mark R Meadows (R),2016,Retired,44454,0,44454
M001187,N00033631,Mark R Meadows (R),2016,Leadership PACs,32700,8000,40700
M001187,N00033631,Mark R Meadows (R),2016,Health Professionals,16630,15000,31630
M001187,N00033631,Mark R Meadows (R),2016,Republican/Conservative,9825,16893,26718
M001187,N00033631,Mark R Meadows (R),2016,Pro-Israel,17760,8500,26260
M001187,N00033631,Mark R Meadows (R),2016,Railroads,0,21500,21500
M001187,N00033631,Mark R Meadows (R),2016,Real Estate,5650,14000,19650
M001187,N00033631,Mark R Meadows (R),2016,Air Transport,0,16500,16500
M001187,N00033631,Mark R Meadows (R),2016,Insurance,500,14500,15000
M001187,N00033631,Mark R Meadows (R),2016,Misc Manufacturing & Distributing,2625,12000,14625
J000294,N00033640,Hakeem Jeffries (D),2016,Lawyers/Law Firms,108980,34000,142980
J000294,N00033640,Hakeem Jeffries (D),2016,Real Estate,87850,11500,99350
J000294,N00033640,Hakeem Jeffries (D),2016,Securities & Investment,69461,26500,95961
J000294,N00033640,Hakeem Jeffries (D),2016,TV/Movies/Music,38950,36250,75200
J000294,N00033640,Hakeem Jeffries (D),2016,Electronics Mfg & Equip,7500,49400,56900
J000294,N00033640,Hakeem Jeffries (D),2016,Building Trade Unions,0,43000,43000
J000294,N00033640,Hakeem Jeffries (D),2016,Industrial Unions,0,43000,43000
J000294,N00033640,Hakeem Jeffries (D),2016,Public Sector Unions,0,40500,40500
J000294,N00033640,Hakeem Jeffries (D),2016,Transportation Unions,0,35000,35000
J000294,N00033640,Hakeem Jeffries (D),2016,Printing & Publishing,22700,9900,32600
A000372,N00033720,Richard W Allen (R),2016,Retired,97700,0,97700
A000372,N00033720,Richard W Allen (R),2016,Health Professionals,46450,21000,67450
A000372,N00033720,Richard W Allen (R),2016,Crop Production & Basic Processing,18022,45000,63022
A000372,N00033720,Richard W Allen (R),2016,Real Estate,47425,11500,58925
A000372,N00033720,Richard W Allen (R),2016,Securities & Investment,17650,28000,45650
A000372,N00033720,Richard W Allen (R),2016,Leadership PACs,1429,38900,40329
A000372,N00033720,Richard W Allen (R),2016,General Contractors,21000,17500,38500
A000372,N00033720,Richard W Allen (R),2016,Insurance,5350,24500,29850
A000372,N00033720,Richard W Allen (R),2016,Food & Beverage,6850,22500,29350
A000372,N00033720,Richard W Allen (R),2016,Agricultural Services/Products,4250,21500,25750
B001294,N00033744,Rod Blum (R),2016,Leadership PACs,20625,150750,171375
B001294,N00033744,Rod Blum (R),2016,Republican/Conservative,124183,28000,152183
B001294,N00033744,Rod Blum (R),2016,Retired,143969,0,143969
B001294,N00033744,Rod Blum (R),2016,Insurance,27100,35000,62100
B001294,N00033744,Rod Blum (R),2016,Candidate Committees,500,55900,56400
B001294,N00033744,Rod Blum (R),2016,Commercial Banks,19225,22300,41525
B001294,N00033744,Rod Blum (R),2016,Crop Production & Basic Processing,21000,17000,38000
B001294,N00033744,Rod Blum (R),2016,Trucking,33150,1000,34150
B001294,N00033744,Rod Blum (R),2016,Securities & Investment,27720,4000,31720
B001294,N00033744,Rod Blum (R),2016,Real Estate,21800,9000,30800
H001069,N00033782,Heidi Heitkamp (D),2016,Lawyers/Law Firms,598185,100661,698846
H001069,N00033782,Heidi Heitkamp (D),2016,Leadership PACs,0,358918,358918
H001069,N00033782,Heidi Heitkamp (D),2016,Securities & Investment,148999,137000,285999
H001069,N00033782,Heidi Heitkamp (D),2016,Oil & Gas,83679,177200,260879
H001069,N00033782,Heidi Heitkamp (D),2016,Insurance,30171,195688,225859
H001069,N00033782,Heidi Heitkamp (D),2016,Lobbyists,214761,5000,219761
H001069,N00033782,Heidi Heitkamp (D),2016,Women's Issues,165994,8500,174494
H001069,N00033782,Heidi Heitkamp (D),2016,Retired,155381,0,155381
H001069,N00033782,Heidi Heitkamp (D),2016,Commercial Banks,24800,110000,134800
H001069,N00033782,Heidi Heitkamp (D),2016,Electric Utilities,28150,94000,122150
M001195,N00033814,Alex Mooney (R),2016,Leadership PACs,0,123600,123600
M001195,N00033814,Alex Mooney (R),2016,Retired,88982,0,88982
M001195,N00033814,Alex Mooney (R),2016,Republican/Conservative,49753,32695,82448
M001195,N00033814,Alex Mooney (R),2016,Health Professionals,29858,28500,58358
M001195,N00033814,Alex Mooney (R),2016,Lawyers/Law Firms,52194,2750,54944
M001195,N00033814,Alex Mooney (R),2016,Real Estate,32444,13500,45944
M001195,N00033814,Alex Mooney (R),2016,Hospitals/Nursing Homes,33525,2000,35525
M001195,N00033814,Alex Mooney (R),2016,Mining,16700,17826,34526
M001195,N00033814,Alex Mooney (R),2016,Candidate Committees,0,32500,32500
M001195,N00033814,Alex Mooney (R),2016,Oil & Gas,8700,22000,30700
R000597,N00033832,Tom Rice (R),2016,Insurance,3250,72500,75750
R000597,N00033832,Tom Rice (R),2016,Real Estate,36500,36000,72500
R000597,N00033832,Tom Rice (R),2016,Building Materials & Equipment,47150,17000,64150
R000597,N00033832,Tom Rice (R),2016,Health Professionals,22500,33500,56000
R000597,N00033832,Tom Rice (R),2016,Accountants,11500,42500,54000
R000597,N00033832,Tom Rice (R),2016,Electric Utilities,500,47500,48000
R000597,N00033832,Tom Rice (R),2016,Retired,46700,0,46700
R000597,N00033832,Tom Rice (R),2016,General Contractors,23650,19500,43150
R000597,N00033832,Tom Rice (R),2016,Air Transport,0,42500,42500
R000597,N00033832,Tom Rice (R),2016,Lawyers/Law Firms,26750,10500,37250
V000131,N00033839,Marc Veasey (D),2016,Lawyers/Law Firms,148665,13500,162165
V000131,N00033839,Marc Veasey (D),2016,Real Estate,52930,24500,77430
V000131,N00033839,Marc Veasey (D),2016,Oil & Gas,28800,40500,69300
V000131,N00033839,Marc Veasey (D),2016,Transportation Unions,0,62000,62000
V000131,N00033839,Marc Veasey (D),2016,Defense Aerospace,1250,53500,54750
V000131,N00033839,Marc Veasey (D),2016,Retired,47600,0,47600
V000131,N00033839,Marc Veasey (D),2016,Industrial Unions,250,43000,43250
V000131,N00033839,Marc Veasey (D),2016,Misc Unions,0,40000,40000
V000131,N00033839,Marc Veasey (D),2016,Health Professionals,26000,13500,39500
V000131,N00033839,Marc Veasey (D),2016,Automotive,17800,18000,35800
L000584,N00033842,Mia Love (R),2016,Republican/Conservative,460001,23111,483112
L000584,N00033842,Mia Love (R),2016,Retired,466750,0,466750
L000584,N00033842,Mia Love (R),2016,Securities & Investment,129997,70000,199997
L000584,N00033842,Mia Love (R),2016,Leadership PACs,1000,176512,177512
L000584,N00033842,Mia Love (R),2016,Real Estate,71602,58000,129602
L000584,N00033842,Mia Love (R),2016,Insurance,9370,106500,115870
L000584,N00033842,Mia Love (R),2016,Commercial Banks,30091,74800,104891
L000584,N00033842,Mia Love (R),2016,Oil & Gas,26336,41000,67336
L000584,N00033842,Mia Love (R),2016,Gun Rights,51900,10000,61900
L000584,N00033842,Mia Love (R),2016,Accountants,10826,47047,57873
D000620,N00033897,John K Delaney (D),2016,Securities & Investment,96250,96000,192250
D000620,N00033897,John K Delaney (D),2016,Real Estate,117375,53000,170375
D000620,N00033897,John K Delaney (D),2016,Lawyers/Law Firms,107725,20500,128225
D000620,N00033897,John K Delaney (D),2016,Commercial Banks,42400,54500,96900
D000620,N00033897,John K Delaney (D),2016,Insurance,7750,74000,81750
D000620,N00033897,John K Delaney (D),2016,Misc Finance,50450,5000,55450
D000620,N00033897,John K Delaney (D),2016,Business Services,47700,0,47700
D000620,N00033897,John K Delaney (D),2016,Retired,46575,0,46575
D000620,N00033897,John K Delaney (D),2016,Accountants,5900,35500,41400
D000620,N00033897,John K Delaney (D),2016,Finance/Credit Companies,16100,18500,34600
B001281,N00033904,Joyce Beatty (D),2016,Insurance,33650,146500,180150
B001281,N00033904,Joyce Beatty (D),2016,Securities & Investment,3000,68100,71100
B001281,N00033904,Joyce Beatty (D),2016,Commercial Banks,11300,56300,67600
B001281,N00033904,Joyce Beatty (D),2016,Lawyers/Law Firms,23052,28750,51802
B001281,N00033904,Joyce Beatty (D),2016,Real Estate,8050,39000,47050
B001281,N00033904,Joyce Beatty (D),2016,Electric Utilities,500,44000,44500
B001281,N00033904,Joyce Beatty (D),2016,Industrial Unions,0,41500,41500
B001281,N00033904,Joyce Beatty (D),2016,Building Trade Unions,0,37500,37500
B001281,N00033904,Joyce Beatty (D),2016,Retail Sales,13900,23000,36900
B001281,N00033904,Joyce Beatty (D),2016,Pharmaceuticals/Health Products,1000,32000,33000
S001192,N00033932,Chris Stewart (R),2016,Oil & Gas,30300,62200,92500
S001192,N00033932,Chris Stewart (R),2016,Lobbyists,47220,0,47220
S001192,N00033932,Chris Stewart (R),2016,Retired,42069,0,42069
S001192,N00033932,Chris Stewart (R),2016,Pharmaceuticals/Health Products,10300,30000,40300
S001192,N00033932,Chris Stewart (R),2016,Defense Electronics,0,32000,32000
S001192,N00033932,Chris Stewart (R),2016,Commercial Banks,11350,19500,30850
S001192,N00033932,Chris Stewart (R),2016,Defense Aerospace,200,30000,30200
S001192,N00033932,Chris Stewart (R),2016,Health Professionals,1000,28000,29000
S001192,N00033932,Chris Stewart (R),2016,Real Estate,17250,7000,24250
S001192,N00033932,Chris Stewart (R),2016,Trucking,13350,8500,21850
M001197,N00033982,Martha McSally (R),2016,Retired,909215,0,909215
M001197,N00033982,Martha McSally (R),2016,Republican/Conservative,573535,36000,609535
M001197,N00033982,Martha McSally (R),2016,Leadership PACs,1000,362050,363050
M001197,N00033982,Martha McSally (R),2016,Real Estate,209108,19000,228108
M001197,N00033982,Martha McSally (R),2016,Securities & Investment,222938,2500,225438
M001197,N00033982,Martha McSally (R),2016,Insurance,31516,102000,133516
M001197,N00033982,Martha McSally (R),2016,Automotive,106290,21000,127290
M001197,N00033982,Martha McSally (R),2016,Health Professionals,78631,30500,109131
M001197,N00033982,Martha McSally (R),2016,Lawyers/Law Firms,78520,8250,86770
M001197,N00033982,Martha McSally (R),2016,Misc Finance,82227,2000,84227
S001191,N00033983,Kyrsten Sinema (D),2016,Lawyers/Law Firms,224110,43500,267610
S001191,N00033983,Kyrsten Sinema (D),2016,Securities & Investment,115600,148500,264100
S001191,N00033983,Kyrsten Sinema (D),2016,Insurance,14533,202500,217033
S001191,N00033983,Kyrsten Sinema (D),2016,Real Estate,128431,58050,186481
S001191,N00033983,Kyrsten Sinema (D),2016,Democratic/Liberal,153704,31000,184704
S001191,N00033983,Kyrsten Sinema (D),2016,Leadership PACs,16200,149150,165350
S001191,N00033983,Kyrsten Sinema (D),2016,Retired,147221,0,147221
S001191,N00033983,Kyrsten Sinema (D),2016,Health Professionals,49886,82500,132386
S001191,N00033983,Kyrsten Sinema (D),2016,Finance/Credit Companies,12410,94000,106410
S001191,N00033983,Kyrsten Sinema (D),2016,Commercial Banks,6476,85500,91976
L000578,N00033987,Doug LaMalfa (R),2016,Crop Production & Basic Processing,103451,62400,165851
L000578,N00033987,Doug LaMalfa (R),2016,Casinos/Gambling,77300,2000,79300
L000578,N00033987,Doug LaMalfa (R),2016,Leadership PACs,0,46500,46500
L000578,N00033987,Doug LaMalfa (R),2016,Livestock,26716,12500,39216
L000578,N00033987,Doug LaMalfa (R),2016,Agricultural Services/Products,3000,25706,28706
L000578,N00033987,Doug LaMalfa (R),2016,Oil & Gas,500,24750,25250
L000578,N00033987,Doug LaMalfa (R),2016,Automotive,0,25000,25000
L000578,N00033987,Doug LaMalfa (R),2016,Misc Energy,10800,14000,24800
L000578,N00033987,Doug LaMalfa (R),2016,Food Processing & Sales,7500,9500,17000
L000578,N00033987,Doug LaMalfa (R),2016,Real Estate,7500,9000,16500
A000371,N00033997,Pete Aguilar (D),2016,Democratic/Liberal,164325,12000,176325
A000371,N00033997,Pete Aguilar (D),2016,Leadership PACs,0,175500,175500
A000371,N00033997,Pete Aguilar (D),2016,Lawyers/Law Firms,113157,23500,136657
A000371,N00033997,Pete Aguilar (D),2016,Real Estate,99908,24000,123908
A000371,N00033997,Pete Aguilar (D),2016,Retired,82105,0,82105
A000371,N00033997,Pete Aguilar (D),2016,Health Professionals,44655,30100,74755
A000371,N00033997,Pete Aguilar (D),2016,Securities & Investment,30850,33500,64350
A000371,N00033997,Pete Aguilar (D),2016,Candidate Committees,0,64000,64000
A000371,N00033997,Pete Aguilar (D),2016,Public Sector Unions,50,63500,63550
A000371,N00033997,Pete Aguilar (D),2016,Casinos/Gambling,50600,5000,55600
M001184,N00034041,Thomas Massie (R),2016,Republican/Conservative,34543,7347,41890
M001184,N00034041,Thomas Massie (R),2016,Securities & Investment,39333,0,39333
M001184,N00034041,Thomas Massie (R),2016,Retired,28902,0,28902
M001184,N00034041,Thomas Massie (R),2016,Home Builders,16200,0,16200
M001184,N00034041,Thomas Massie (R),2016,Misc Manufacturing & Distributing,13800,2000,15800
M001184,N00034041,Thomas Massie (R),2016,Construction Services,0,14500,14500
M001184,N00034041,Thomas Massie (R),2016,Internet,9600,3000,12600
M001184,N00034041,Thomas Massie (R),2016,Oil & Gas,2500,10000,12500
M001184,N00034041,Thomas Massie (R),2016,Air Transport,7150,4500,11650
M001184,N00034041,Thomas Massie (R),2016,Lawyers/Law Firms,8901,2500,11401
K000379,N00034044,Joe Kennedy III (D),2016,Securities & Investment,321299,25000,346299
K000379,N00034044,Joe Kennedy III (D),2016,Lawyers/Law Firms,295612,32500,328112
K000379,N00034044,Joe Kennedy III (D),2016,Real Estate,222068,32500,254568
K000379,N00034044,Joe Kennedy III (D),2016,Pharmaceuticals/Health Products,32255,149298,181553
K000379,N00034044,Joe Kennedy III (D),2016,Health Professionals,51144,69500,120644
K000379,N00034044,Joe Kennedy III (D),2016,Lobbyists,100510,3762,104272
K000379,N00034044,Joe Kennedy III (D),2016,Retired,102235,0,102235
K000379,N00034044,Joe Kennedy III (D),2016,Insurance,33255,53000,86255
K000379,N00034044,Joe Kennedy III (D),2016,Business Services,62201,3700,65901
K000379,N00034044,Joe Kennedy III (D),2016,TV/Movies/Music,40285,12000,52285
L000581,N00034068,Brenda Lawrence (D),2016,Automotive,21233,44500,65733
L000581,N00034068,Brenda Lawrence (D),2016,Building Trade Unions,0,56000,56000
L000581,N00034068,Brenda Lawrence (D),2016,Public Sector Unions,500,50500,51000
L000581,N00034068,Brenda Lawrence (D),2016,Real Estate,38400,12500,50900
L000581,N00034068,Brenda Lawrence (D),2016,Lawyers/Law Firms,28200,15500,43700
L000581,N00034068,Brenda Lawrence (D),2016,Industrial Unions,125,42000,42125
L000581,N00034068,Brenda Lawrence (D),2016,Misc Unions,0,28500,28500
L000581,N00034068,Brenda Lawrence (D),2016,Insurance,8750,16500,25250
L000581,N00034068,Brenda Lawrence (D),2016,Hospitals/Nursing Homes,6200,17000,23200
L000581,N00034068,Brenda Lawrence (D),2016,Commercial Banks,2275,20500,22775
P000605,N00034120,Scott Perry (R),2016,Electric Utilities,0,42500,42500
P000605,N00034120,Scott Perry (R),2016,Oil & Gas,3500,31500,35000
P000605,N00034120,Scott Perry (R),2016,Health Professionals,15920,14000,29920
P000605,N00034120,Scott Perry (R),2016,Building Materials & Equipment,0,27500,27500
P000605,N00034120,Scott Perry (R),2016,Air Transport,0,23000,23000
P000605,N00034120,Scott Perry (R),2016,Real Estate,14070,8000,22070
P000605,N00034120,Scott Perry (R),2016,Railroads,500,21000,21500
P000605,N00034120,Scott Perry (R),2016,Retired,19773,0,19773
P000605,N00034120,Scott Perry (R),2016,Insurance,2500,16250,18750
P000605,N00034120,Scott Perry (R),2016,Automotive,1000,17500,18500
C001090,N00034128,Matt Cartwright (D),2016,Lawyers/Law Firms,255101,14000,269101
C001090,N00034128,Matt Cartwright (D),2016,Building Trade Unions,350,70000,70350
C001090,N00034128,Matt Cartwright (D),2016,Public Sector Unions,0,58000,58000
C001090,N00034128,Matt Cartwright (D),2016,Industrial Unions,0,48000,48000
C001090,N00034128,Matt Cartwright (D),2016,Transportation Unions,0,39500,39500
C001090,N00034128,Matt Cartwright (D),2016,Misc Unions,1000,22250,23250
C001090,N00034128,Matt Cartwright (D),2016,Defense Aerospace,0,19000,19000
C001090,N00034128,Matt Cartwright (D),2016,Hospitals/Nursing Homes,755,15000,15755
C001090,N00034128,Matt Cartwright (D),2016,Automotive,3150,11000,14150
C001090,N00034128,Matt Cartwright (D),2016,Environment,8100,5571,13671
C001094,N00034224,Paul Cook (R),2016,Leadership PACs,0,95700,95700
C001094,N00034224,Paul Cook (R),2016,Casinos/Gambling,76200,5000,81200
C001094,N00034224,Paul Cook (R),2016,Public Sector Unions,0,47500,47500
C001094,N00034224,Paul Cook (R),2016,Transportation Unions,0,46000,46000
C001094,N00034224,Paul Cook (R),2016,Building Trade Unions,0,42500,42500
C001094,N00034224,Paul Cook (R),2016,Defense Aerospace,0,41000,41000
C001094,N00034224,Paul Cook (R),2016,Real Estate,25600,10000,35600
C001094,N00034224,Paul Cook (R),2016,Defense Electronics,0,33000,33000
C001094,N00034224,Paul Cook (R),2016,Building Materials & Equipment,8650,22500,31150
C001094,N00034224,Paul Cook (R),2016,Republican/Conservative,5800,22750,28550
B001285,N00034254,Julia Brownley (D),2016,Women's Issues,218625,15000,233625
B001285,N00034254,Julia Brownley (D),2016,Retired,190656,0,190656
B001285,N00034254,Julia Brownley (D),2016,Leadership PACs,0,186266,186266
B001285,N00034254,Julia Brownley (D),2016,Democratic/Liberal,164180,2750,166930
B001285,N00034254,Julia Brownley (D),2016,Lawyers/Law Firms,107608,13000,120608
B001285,N00034254,Julia Brownley (D),2016,Misc Issues,81994,18500,100494
B001285,N00034254,Julia Brownley (D),2016,Transportation Unions,0,91505,91505
B001285,N00034254,Julia Brownley (D),2016,Human Rights,67240,21200,88440
B001285,N00034254,Julia Brownley (D),2016,Health Professionals,20109,67000,87109
B001285,N00034254,Julia Brownley (D),2016,Public Sector Unions,0,78900,78900
M001185,N00034277,Sean Patrick Maloney (D),2016,Securities & Investment,342259,101200,443459
M001185,N00034277,Sean Patrick Maloney (D),2016,Lawyers/Law Firms,310759,23100,333859
M001185,N00034277,Sean Patrick Maloney (D),2016,Real Estate,214288,36000,250288
M001185,N00034277,Sean Patrick Maloney (D),2016,Retired,166830,0,166830
M001185,N00034277,Sean Patrick Maloney (D),2016,Leadership PACs,0,163800,163800
M001185,N00034277,Sean Patrick Maloney (D),2016,Democratic/Liberal,74209,13000,87209
M001185,N00034277,Sean Patrick Maloney (D),2016,Misc Issues,73699,12500,86199
M001185,N00034277,Sean Patrick Maloney (D),2016,Insurance,29440,56000,85440
M001185,N00034277,Sean Patrick Maloney (D),2016,Business Services,85321,0,85321
M001185,N00034277,Sean Patrick Maloney (D),2016,Health Professionals,57918,24000,81918
V000132,N00034349,Filemon Vela (D),2016,Lawyers/Law Firms,97689,12821,110510
V000132,N00034349,Filemon Vela (D),2016,Health Professionals,79050,4000,83050
V000132,N00034349,Filemon Vela (D),2016,Crop Production & Basic Processing,33075,46000,79075
V000132,N00034349,Filemon Vela (D),2016,Oil & Gas,0,35000,35000
V000132,N00034349,Filemon Vela (D),2016,Building Trade Unions,0,32500,32500
V000132,N00034349,Filemon Vela (D),2016,Industrial Unions,0,32000,32000
V000132,N00034349,Filemon Vela (D),2016,Transportation Unions,0,31500,31500
V000132,N00034349,Filemon Vela (D),2016,Securities & Investment,14900,16500,31400
V000132,N00034349,Filemon Vela (D),2016,Real Estate,18100,10000,28100
V000132,N00034349,Filemon Vela (D),2016,Construction Services,25100,2700,27800
P000606,N00034416,Robert Pittenger (R),2016,Insurance,14550,92500,107050
P000606,N00034416,Robert Pittenger (R),2016,Real Estate,64450,36500,100950
P000606,N00034416,Robert Pittenger (R),2016,Retired,90850,0,90850
P000606,N00034416,Robert Pittenger (R),2016,Commercial Banks,3000,70000,73000
P000606,N00034416,Robert Pittenger (R),2016,Securities & Investment,28520,42500,71020
P000606,N00034416,Robert Pittenger (R),2016,Leadership PACs,0,67000,67000
P000606,N00034416,Robert Pittenger (R),2016,Retail Sales,31300,3000,34300
P000606,N00034416,Robert Pittenger (R),2016,Automotive,14750,19500,34250
P000606,N00034416,Robert Pittenger (R),2016,Accountants,8500,22000,30500
P000606,N00034416,Robert Pittenger (R),2016,Hospitals/Nursing Homes,21700,5000,26700
K000381,N00034453,Derek Kilmer (D),2016,Casinos/Gambling,107800,0,107800
K000381,N00034453,Derek Kilmer (D),2016,Retired,96600,0,96600
K000381,N00034453,Derek Kilmer (D),2016,Health Professionals,22250,61750,84000
K000381,N00034453,Derek Kilmer (D),2016,Securities & Investment,35350,37500,72850
K000381,N00034453,Derek Kilmer (D),2016,Electronics Mfg & Equip,28550,43590,72140
K000381,N00034453,Derek Kilmer (D),2016,Lawyers/Law Firms,48592,22500,71092
K000381,N00034453,Derek Kilmer (D),2016,Forestry & Forest Products,28050,38500,66550
K000381,N00034453,Derek Kilmer (D),2016,Real Estate,31400,32000,63400
K000381,N00034453,Derek Kilmer (D),2016,Democratic/Liberal,51970,11000,62970
K000381,N00034453,Derek Kilmer (D),2016,Insurance,4000,56000,60000
M001188,N00034547,Grace Meng (D),2016,Real Estate,67400,6000,73400
M001188,N00034547,Grace Meng (D),2016,Securities & Investment,38600,18500,57100
M001188,N00034547,Grace Meng (D),2016,Health Professionals,41551,13500,55051
M001188,N00034547,Grace Meng (D),2016,Retired,51564,0,51564
M001188,N00034547,Grace Meng (D),2016,Lawyers/Law Firms,35930,12500,48430
M001188,N00034547,Grace Meng (D),2016,Public Sector Unions,0,26500,26500
M001188,N00034547,Grace Meng (D),2016,Food & Beverage,26200,0,26200
M001188,N00034547,Grace Meng (D),2016,Industrial Unions,0,23500,23500
M001188,N00034547,Grace Meng (D),2016,Building Trade Unions,0,17500,17500
M001188,N00034547,Grace Meng (D),2016,Misc Business,17500,0,17500
E000297,N00034549,Adriano Espaillat (D),2016,Lawyers/Law Firms,34000,12500,46500
E000297,N00034549,Adriano Espaillat (D),2016,Health Professionals,39870,1000,40870
E000297,N00034549,Adriano Espaillat (D),2016,Real Estate,34550,6000,40550
E000297,N00034549,Adriano Espaillat (D),2016,Leadership PACs,0,31900,31900
E000297,N00034549,Adriano Espaillat (D),2016,Public Sector Unions,0,31000,31000
E000297,N00034549,Adriano Espaillat (D),2016,Securities & Investment,29000,0,29000
E000297,N00034549,Adriano Espaillat (D),2016,Retired,27650,0,27650
E000297,N00034549,Adriano Espaillat (D),2016,Education,23675,0,23675
E000297,N00034549,Adriano Espaillat (D),2016,Misc Business,22775,0,22775
E000297,N00034549,Adriano Espaillat (D),2016,Industrial Unions,0,22000,22000
K000383,N00034580,Angus King (I),2016,Retired,380342,0,380342
K000383,N00034580,Angus King (I),2016,Lawyers/Law Firms,278048,26500,304548
K000383,N00034580,Angus King (I),2016,Securities & Investment,128794,10500,139294
K000383,N00034580,Angus King (I),2016,Health Professionals,53675,48000,101675
K000383,N00034580,Angus King (I),2016,Real Estate,88000,12716,100716
K000383,N00034580,Angus King (I),2016,Insurance,28250,39000,67250
K000383,N00034580,Angus King (I),2016,Education,64048,0,64048
K000383,N00034580,Angus King (I),2016,Business Services,56273,0,56273
K000383,N00034580,Angus King (I),2016,Misc Finance,48550,0,48550
K000383,N00034580,Angus King (I),2016,Pro-Israel,29500,17000,46500
P000611,N00034584,Bruce Poliquin (R),2016,Leadership PACs,0,427482,427482
P000611,N00034584,Bruce Poliquin (R),2016,Securities & Investment,177850,117499,295349
P000611,N00034584,Bruce Poliquin (R),2016,Retired,273225,0,273225
P000611,N00034584,Bruce Poliquin (R),2016,Insurance,39050,147650,186700
P000611,N00034584,Bruce Poliquin (R),2016,Candidate Committees,0,162165,162165
P000611,N00034584,Bruce Poliquin (R),2016,Real Estate,47750,80500,128250
P000611,N00034584,Bruce Poliquin (R),2016,Commercial Banks,12850,85000,97850
P000611,N00034584,Bruce Poliquin (R),2016,Misc Finance,59000,21333,80333
P000611,N00034584,Bruce Poliquin (R),2016,Automotive,61900,10000,71900
P000611,N00034584,Bruce Poliquin (R),2016,Finance/Credit Companies,6749,57000,63749
P000604,N00034639,Donald M Payne Jr (D),2016,Building Trade Unions,1000,40800,41800
P000604,N00034639,Donald M Payne Jr (D),2016,Transportation Unions,0,32000,32000
P000604,N00034639,Donald M Payne Jr (D),2016,Lawyers/Law Firms,19250,9500,28750
P000604,N00034639,Donald M Payne Jr (D),2016,Misc Unions,0,28000,28000
P000604,N00034639,Donald M Payne Jr (D),2016,Electric Utilities,5600,19500,25100
P000604,N00034639,Donald M Payne Jr (D),2016,Public Sector Unions,0,24500,24500
P000604,N00034639,Donald M Payne Jr (D),2016,Insurance,4750,18200,22950
P000604,N00034639,Donald M Payne Jr (D),2016,Industrial Unions,0,21500,21500
P000604,N00034639,Donald M Payne Jr (D),2016,Lobbyists,15900,1000,16900
P000604,N00034639,Donald M Payne Jr (D),2016,Pharmaceuticals/Health Products,0,16000,16000
D000621,N00034746,Ron DeSantis (R),2016,Retired,806629,0,806629
D000621,N00034746,Ron DeSantis (R),2016,Republican/Conservative,589351,60069,649420
D000621,N00034746,Ron DeSantis (R),2016,Securities & Investment,282270,0,282270
D000621,N00034746,Ron DeSantis (R),2016,Real Estate,189196,4500,193696
D000621,N00034746,Ron DeSantis (R),2016,Misc Finance,120610,3500,124110
D000621,N00034746,Ron DeSantis (R),2016,Lawyers/Law Firms,105583,14000,119583
D000621,N00034746,Ron DeSantis (R),2016,Health Professionals,111310,6500,117810
D000621,N00034746,Ron DeSantis (R),2016,Leadership PACs,0,108900,108900
D000621,N00034746,Ron DeSantis (R),2016,Pro-Israel,69500,12500,82000
D000621,N00034746,Ron DeSantis (R),2016,Misc Manufacturing & Distributing,76100,5000,81100
D000619,N00034784,Rodney Davis (R),2016,Agricultural Services/Products,12170,153846,166016
D000619,N00034784,Rodney Davis (R),2016,Leadership PACs,0,161893,161893
D000619,N00034784,Rodney Davis (R),2016,Insurance,25146,101500,126646
D000619,N00034784,Rodney Davis (R),2016,Health Professionals,22575,70250,92825
D000619,N00034784,Rodney Davis (R),2016,Crop Production & Basic Processing,22785,68750,91535
D000619,N00034784,Rodney Davis (R),2016,Securities & Investment,32650,44500,77150
D000619,N00034784,Rodney Davis (R),2016,Air Transport,0,71999,71999
D000619,N00034784,Rodney Davis (R),2016,Lawyers/Law Firms,34070,28000,62070
D000619,N00034784,Rodney Davis (R),2016,Oil & Gas,2000,59000,61000
D000619,N00034784,Rodney Davis (R),2016,Food & Beverage,17357,42500,59857
P000610,N00035000,Stacey Plaskett (D),2016,Leadership PACs,0,31000,31000
P000610,N00035000,Stacey Plaskett (D),2016,Lawyers/Law Firms,23150,4500,27650
P000610,N00035000,Stacey Plaskett (D),2016,Public Sector Unions,0,16500,16500
P000610,N00035000,Stacey Plaskett (D),2016,Building Trade Unions,0,15000,15000
P000610,N00035000,Stacey Plaskett (D),2016,Human Rights,9550,5000,14550
P000610,N00035000,Stacey Plaskett (D),2016,Lobbyists,14247,0,14247
P000610,N00035000,Stacey Plaskett (D),2016,Real Estate,2250,9000,11250
P000610,N00035000,Stacey Plaskett (D),2016,Democratic/Liberal,0,11000,11000
P000610,N00035000,Stacey Plaskett (D),2016,Pharmaceuticals/Health Products,0,10500,10500
P000610,N00035000,Stacey Plaskett (D),2016,"Beer, Wine & Liquor",0,10488,10488
J000295,N00035007,David P Joyce (R),2016,Misc Manufacturing & Distributing,74982,54246,129228
J000295,N00035007,David P Joyce (R),2016,Leadership PACs,0,121126,121126
J000295,N00035007,David P Joyce (R),2016,Real Estate,79800,37000,116800
J000295,N00035007,David P Joyce (R),2016,Health Professionals,26569,70000,96569
J000295,N00035007,David P Joyce (R),2016,Transportation Unions,0,72750,72750
J000295,N00035007,David P Joyce (R),2016,Retired,65260,0,65260
J000295,N00035007,David P Joyce (R),2016,Lawyers/Law Firms,38260,24000,62260
J000295,N00035007,David P Joyce (R),2016,Securities & Investment,53298,4500,57798
J000295,N00035007,David P Joyce (R),2016,Chemical & Related Manufacturing,40750,15500,56250
J000295,N00035007,David P Joyce (R),2016,Public Sector Unions,0,52000,52000
R000605,N00035187,Mike Rounds (R),2016,Retired,323626,0,323626
R000605,N00035187,Mike Rounds (R),2016,Securities & Investment,294058,11500,305558
R000605,N00035187,Mike Rounds (R),2016,Leadership PACs,0,292500,292500
R000605,N00035187,Mike Rounds (R),2016,Commercial Banks,143360,102100,245460
R000605,N00035187,Mike Rounds (R),2016,Insurance,71800,152250,224050
R000605,N00035187,Mike Rounds (R),2016,Oil & Gas,80900,122500,203400
R000605,N00035187,Mike Rounds (R),2016,Real Estate,162400,35000,197400
R000605,N00035187,Mike Rounds (R),2016,Health Professionals,90300,62600,152900
R000605,N00035187,Mike Rounds (R),2016,Lawyers/Law Firms,106160,14000,120160
R000605,N00035187,Mike Rounds (R),2016,Retail Sales,56250,47625,103875
K000385,N00035215,Robin Kelly (D),2016,Lawyers/Law Firms,51440,17100,68540
K000385,N00035215,Robin Kelly (D),2016,Building Trade Unions,0,56500,56500
K000385,N00035215,Robin Kelly (D),2016,Insurance,10900,44500,55400
K000385,N00035215,Robin Kelly (D),2016,Pharmaceuticals/Health Products,0,54750,54750
K000385,N00035215,Robin Kelly (D),2016,Public Sector Unions,0,52500,52500
K000385,N00035215,Robin Kelly (D),2016,Securities & Investment,22846,24550,47396
K000385,N00035215,Robin Kelly (D),2016,Health Professionals,7020,35500,42520
K000385,N00035215,Robin Kelly (D),2016,Retired,36494,0,36494
K000385,N00035215,Robin Kelly (D),2016,Industrial Unions,0,34500,34500
K000385,N00035215,Robin Kelly (D),2016,Misc Unions,0,30000,30000
B001288,N00035267,Cory Booker (D),2016,Lawyers/Law Firms,2327325,186000,2513325
B001288,N00035267,Cory Booker (D),2016,Securities & Investment,2281577,61200,2342777
B001288,N00035267,Cory Booker (D),2016,Real Estate,1183160,29000,1212160
B001288,N00035267,Cory Booker (D),2016,TV/Movies/Music,725870,32000,757870
B001288,N00035267,Cory Booker (D),2016,Misc Finance,513925,15000,528925
B001288,N00035267,Cory Booker (D),2016,Business Services,478871,10500,489371
B001288,N00035267,Cory Booker (D),2016,Pro-Israel,397599,36527,434126
B001288,N00035267,Cory Booker (D),2016,Pharmaceuticals/Health Products,174941,218500,393441
B001288,N00035267,Cory Booker (D),2016,Insurance,254550,124000,378550
B001288,N00035267,Cory Booker (D),2016,Retired,376988,0,376988
C001101,N00035278,Katherine Clark (D),2016,Lawyers/Law Firms,83785,19000,102785
C001101,N00035278,Katherine Clark (D),2016,Pharmaceuticals/Health Products,10950,86000,96950
C001101,N00035278,Katherine Clark (D),2016,Retired,80529,0,80529
C001101,N00035278,Katherine Clark (D),2016,Securities & Investment,42700,23000,65700
C001101,N00035278,Katherine Clark (D),2016,Real Estate,52606,8500,61106
C001101,N00035278,Katherine Clark (D),2016,Building Trade Unions,0,60000,60000
C001101,N00035278,Katherine Clark (D),2016,Women's Issues,49008,5,49013
C001101,N00035278,Katherine Clark (D),2016,Public Sector Unions,0,49000,49000
C001101,N00035278,Katherine Clark (D),2016,Insurance,14163,32000,46163
C001101,N00035278,Katherine Clark (D),2016,Health Professionals,9894,26750,36644
S001195,N00035282,Jason Smith (R),2016,Crop Production & Basic Processing,51645,62000,113645
S001195,N00035282,Jason Smith (R),2016,Insurance,4500,93500,98000
S001195,N00035282,Jason Smith (R),2016,Health Professionals,29900,61000,90900
S001195,N00035282,Jason Smith (R),2016,Real Estate,26050,49500,75550
S001195,N00035282,Jason Smith (R),2016,Misc Manufacturing & Distributing,18300,50900,69200
S001195,N00035282,Jason Smith (R),2016,Securities & Investment,14300,49500,63800
S001195,N00035282,Jason Smith (R),2016,Lobbyists,59950,500,60450
S001195,N00035282,Jason Smith (R),2016,Leadership PACs,0,59578,59578
S001195,N00035282,Jason Smith (R),2016,Pharmaceuticals/Health Products,500,59000,59500
S001195,N00035282,Jason Smith (R),2016,Accountants,2850,45500,48350
B001296,N00035307,Brendan Boyle (D),2016,Lawyers/Law Firms,56950,19000,75950
B001296,N00035307,Brendan Boyle (D),2016,Public Sector Unions,0,60000,60000
B001296,N00035307,Brendan Boyle (D),2016,Building Trade Unions,0,53012,53012
B001296,N00035307,Brendan Boyle (D),2016,Securities & Investment,38750,7500,46250
B001296,N00035307,Brendan Boyle (D),2016,Insurance,9500,35500,45000
B001296,N00035307,Brendan Boyle (D),2016,Real Estate,33150,10500,43650
B001296,N00035307,Brendan Boyle (D),2016,Transportation Unions,0,43000,43000
B001296,N00035307,Brendan Boyle (D),2016,Pharmaceuticals/Health Products,500,41500,42000
B001296,N00035307,Brendan Boyle (D),2016,Industrial Unions,0,40000,40000
B001296,N00035307,Brendan Boyle (D),2016,Pro-Israel,15900,17500,33400
C001103,N00035346,Buddy Carter (R),2016,Health Professionals,51600,133700,185300
C001103,N00035346,Buddy Carter (R),2016,Retail Sales,78000,32500,110500
C001103,N00035346,Buddy Carter (R),2016,Pharmaceuticals/Health Products,9900,42900,52800
C001103,N00035346,Buddy Carter (R),2016,Retired,45445,0,45445
C001103,N00035346,Buddy Carter (R),2016,Forestry & Forest Products,7900,33998,41898
C001103,N00035346,Buddy Carter (R),2016,Insurance,5500,33000,38500
C001103,N00035346,Buddy Carter (R),2016,Crop Production & Basic Processing,1625,31500,33125
C001103,N00035346,Buddy Carter (R),2016,Air Transport,9700,19500,29200
C001103,N00035346,Buddy Carter (R),2016,Leadership PACs,0,27000,27000
C001103,N00035346,Buddy Carter (R),2016,Lawyers/Law Firms,12032,13500,25532
L000583,N00035347,Barry Loudermilk (R),2016,Leadership PACs,0,75600,75600
L000583,N00035347,Barry Loudermilk (R),2016,Health Professionals,14700,31500,46200
L000583,N00035347,Barry Loudermilk (R),2016,Insurance,2275,42500,44775
L000583,N00035347,Barry Loudermilk (R),2016,Commercial Banks,10200,29500,39700
L000583,N00035347,Barry Loudermilk (R),2016,Real Estate,25450,11000,36450
L000583,N00035347,Barry Loudermilk (R),2016,Air Transport,8795,18000,26795
L000583,N00035347,Barry Loudermilk (R),2016,Retired,24975,0,24975
L000583,N00035347,Barry Loudermilk (R),2016,"Beer, Wine & Liquor",12800,12000,24800
L000583,N00035347,Barry Loudermilk (R),2016,Candidate Committees,250,22500,22750
L000583,N00035347,Barry Loudermilk (R),2016,Construction Services,7550,12500,20050
B001289,N00035380,Bradley Byrne (R),2016,Lawyers/Law Firms,36800,33750,70550
B001289,N00035380,Bradley Byrne (R),2016,Defense Aerospace,1250,62500,63750
B001289,N00035380,Bradley Byrne (R),2016,Real Estate,33803,29000,62803
B001289,N00035380,Bradley Byrne (R),2016,Insurance,8700,51500,60200
B001289,N00035380,Bradley Byrne (R),2016,Leadership PACs,0,54150,54150
B001289,N00035380,Bradley Byrne (R),2016,Forestry & Forest Products,23639,25500,49139
B001289,N00035380,Bradley Byrne (R),2016,Crop Production & Basic Processing,8100,40500,48600
B001289,N00035380,Bradley Byrne (R),2016,Health Professionals,16672,28200,44872
B001289,N00035380,Bradley Byrne (R),2016,Building Materials & Equipment,12450,24000,36450
B001289,N00035380,Bradley Byrne (R),2016,General Contractors,22850,13500,36350
C001107,N00035403,Carlos Curbelo (R),2016,Leadership PACs,0,417700,417700
C001107,N00035403,Carlos Curbelo (R),2016,Real Estate,153975,46000,199975
C001107,N00035403,Carlos Curbelo (R),2016,Securities & Investment,141950,54000,195950
C001107,N00035403,Carlos Curbelo (R),2016,Retired,160535,0,160535
C001107,N00035403,Carlos Curbelo (R),2016,Insurance,5850,145000,150850
C001107,N00035403,Carlos Curbelo (R),2016,Foreign & Defense Policy,130349,10000,140349
C001107,N00035403,Carlos Curbelo (R),2016,Pro-Israel,102550,36500,139050
C001107,N00035403,Carlos Curbelo (R),2016,Lawyers/Law Firms,85903,29250,115153
C001107,N00035403,Carlos Curbelo (R),2016,Candidate Committees,667,107050,107717
C001107,N00035403,Carlos Curbelo (R),2016,Air Transport,2000,86500,88500
B001295,N00035420,Mike Bost (R),2016,Leadership PACs,1429,223700,225129
B001295,N00035420,Mike Bost (R),2016,Retired,150028,0,150028
B001295,N00035420,Mike Bost (R),2016,Crop Production & Basic Processing,72650,40500,113150
B001295,N00035420,Mike Bost (R),2016,Insurance,28150,42700,70850
B001295,N00035420,Mike Bost (R),2016,Agricultural Services/Products,2500,63889,66389
B001295,N00035420,Mike Bost (R),2016,Health Professionals,35770,28500,64270
B001295,N00035420,Mike Bost (R),2016,Lawyers/Law Firms,49045,15000,64045
B001295,N00035420,Mike Bost (R),2016,Securities & Investment,42350,20000,62350
B001295,N00035420,Mike Bost (R),2016,Candidate Committees,571,53116,53687
B001295,N00035420,Mike Bost (R),2016,Automotive,24250,24000,48250
M001196,N00035431,Seth Moulton (D),2016,Securities & Investment,351817,46949,398766
M001196,N00035431,Seth Moulton (D),2016,Lawyers/Law Firms,109264,25500,134764
M001196,N00035431,Seth Moulton (D),2016,Retired,124000,0,124000
M001196,N00035431,Seth Moulton (D),2016,Insurance,26876,66500,93376
M001196,N00035431,Seth Moulton (D),2016,Real Estate,72708,14500,87208
M001196,N00035431,Seth Moulton (D),2016,Misc Finance,84200,1000,85200
M001196,N00035431,Seth Moulton (D),2016,Education,73900,0,73900
M001196,N00035431,Seth Moulton (D),2016,Pharmaceuticals/Health Products,5600,65000,70600
M001196,N00035431,Seth Moulton (D),2016,Leadership PACs,2500,54500,57000
M001196,N00035431,Seth Moulton (D),2016,Democratic/Liberal,44446,12500,56946
E000294,N00035440,Tom Emmer (R),2016,Retired,151758,0,151758
E000294,N00035440,Tom Emmer (R),2016,Securities & Investment,39600,67850,107450
E000294,N00035440,Tom Emmer (R),2016,Insurance,17325,84000,101325
E000294,N00035440,Tom Emmer (R),2016,Commercial Banks,14030,81500,95530
E000294,N00035440,Tom Emmer (R),2016,Republican/Conservative,64733,9000,73733
E000294,N00035440,Tom Emmer (R),2016,Real Estate,18500,45000,63500
E000294,N00035440,Tom Emmer (R),2016,Crop Production & Basic Processing,16771,36000,52771
E000294,N00035440,Tom Emmer (R),2016,Agricultural Services/Products,12500,32500,45000
E000294,N00035440,Tom Emmer (R),2016,Lawyers/Law Firms,24100,20875,44975
E000294,N00035440,Tom Emmer (R),2016,Misc Finance,28950,13500,42450
A000370,N00035451,Alma Adams (D),2016,Leadership PACs,0,70500,70500
A000370,N00035451,Alma Adams (D),2016,Industrial Unions,0,67000,67000
A000370,N00035451,Alma Adams (D),2016,Public Sector Unions,0,57000,57000
A000370,N00035451,Alma Adams (D),2016,Candidate Committees,0,44500,44500
A000370,N00035451,Alma Adams (D),2016,Health Professionals,26400,11500,37900
A000370,N00035451,Alma Adams (D),2016,Women's Issues,26265,6000,32265
A000370,N00035451,Alma Adams (D),2016,Insurance,1000,29500,30500
A000370,N00035451,Alma Adams (D),2016,Building Trade Unions,0,30000,30000
A000370,N00035451,Alma Adams (D),2016,Securities & Investment,4300,22000,26300
A000370,N00035451,Alma Adams (D),2016,Lawyers/Law Firms,16665,9500,26165
E000295,N00035483,Joni Ernst (R),2016,Leadership PACs,2000,361036,363036
E000295,N00035483,Joni Ernst (R),2016,Retired,265542,0,265542
E000295,N00035483,Joni Ernst (R),2016,Securities & Investment,217770,6000,223770
E000295,N00035483,Joni Ernst (R),2016,Republican/Conservative,90191,86530,176721
E000295,N00035483,Joni Ernst (R),2016,Oil & Gas,70800,86000,156800
E000295,N00035483,Joni Ernst (R),2016,Real Estate,111022,15000,126022
E000295,N00035483,Joni Ernst (R),2016,Insurance,34115,64000,98115
E000295,N00035483,Joni Ernst (R),2016,Food & Beverage,16300,65600,81900
E000295,N00035483,Joni Ernst (R),2016,Commercial Banks,25450,56000,81450
E000295,N00035483,Joni Ernst (R),2016,Lawyers/Law Firms,51395,24250,75645
T000476,N00035492,Thom Tillis (R),2016,Retired,1300564,0,1300564
T000476,N00035492,Thom Tillis (R),2016,Real Estate,580259,22500,602759
T000476,N00035492,Thom Tillis (R),2016,Securities & Investment,568100,27000,595100
T000476,N00035492,Thom Tillis (R),2016,Lawyers/Law Firms,395709,44708,440417
T000476,N00035492,Thom Tillis (R),2016,Health Professionals,288698,95400,384098
T000476,N00035492,Thom Tillis (R),2016,Leadership PACs,30600,341175,371775
T000476,N00035492,Thom Tillis (R),2016,Oil & Gas,131300,132100,263400
T000476,N00035492,Thom Tillis (R),2016,Business Services,215144,13500,228644
T000476,N00035492,Thom Tillis (R),2016,Republican/Conservative,154184,65450,219634
T000476,N00035492,Thom Tillis (R),2016,Misc Manufacturing & Distributing,149750,47500,197250
C001109,N00035504,Liz Cheney (R),2016,Retired,302629,0,302629
C001109,N00035504,Liz Cheney (R),2016,Securities & Investment,209316,0,209316
C001109,N00035504,Liz Cheney (R),2016,Real Estate,115882,6000,121882
C001109,N00035504,Liz Cheney (R),2016,Oil & Gas,80275,35200,115475
C001109,N00035504,Liz Cheney (R),2016,Leadership PACs,0,83500,83500
C001109,N00035504,Liz Cheney (R),2016,Misc Finance,73800,0,73800
C001109,N00035504,Liz Cheney (R),2016,Lawyers/Law Firms,58700,3500,62200
C001109,N00035504,Liz Cheney (R),2016,Retail Sales,44550,7500,52050
C001109,N00035504,Liz Cheney (R),2016,Health Professionals,38000,3500,41500
C001109,N00035504,Liz Cheney (R),2016,Republican/Conservative,30928,5000,35928
P000612,N00035516,David Perdue (R),2016,Retired,1707902,0,1707902
P000612,N00035516,David Perdue (R),2016,Securities & Investment,641082,42000,683082
P000612,N00035516,David Perdue (R),2016,Real Estate,419362,20000,439362
P000612,N00035516,David Perdue (R),2016,Leadership PACs,0,311200,311200
P000612,N00035516,David Perdue (R),2016,Lawyers/Law Firms,255542,52000,307542
P000612,N00035516,David Perdue (R),2016,Insurance,195795,75500,271295
P000612,N00035516,David Perdue (R),2016,Misc Finance,212700,1000,213700
P000612,N00035516,David Perdue (R),2016,Health Professionals,178640,29500,208140
P000612,N00035516,David Perdue (R),2016,Republican/Conservative,166552,37576,204128
P000612,N00035516,David Perdue (R),2016,Food & Beverage,133000,57100,190100
S001196,N00035523,Elise Stefanik (R),2016,Securities & Investment,307354,46000,353354
S001196,N00035523,Elise Stefanik (R),2016,Leadership PACs,1000,247064,248064
S001196,N00035523,Elise Stefanik (R),2016,Insurance,17200,120500,137700
S001196,N00035523,Elise Stefanik (R),2016,Retired,117688,0,117688
S001196,N00035523,Elise Stefanik (R),2016,Lobbyists,111375,2500,113875
S001196,N00035523,Elise Stefanik (R),2016,Real Estate,65197,25500,90697
S001196,N00035523,Elise Stefanik (R),2016,Lawyers/Law Firms,64860,24500,89360
S001196,N00035523,Elise Stefanik (R),2016,Republican/Conservative,41638,39500,81138
S001196,N00035523,Elise Stefanik (R),2016,Defense Aerospace,7500,56500,64000
S001196,N00035523,Elise Stefanik (R),2016,Health Professionals,19306,38500,57806
J000297,N00035531,Evan Jenkins (R),2016,Health Professionals,66300,90750,157050
J000297,N00035531,Evan Jenkins (R),2016,Leadership PACs,0,82400,82400
J000297,N00035531,Evan Jenkins (R),2016,Lawyers/Law Firms,58200,4000,62200
J000297,N00035531,Evan Jenkins (R),2016,Mining,26200,22500,48700
J000297,N00035531,Evan Jenkins (R),2016,Oil & Gas,2600,40000,42600
J000297,N00035531,Evan Jenkins (R),2016,Transportation Unions,0,40000,40000
J000297,N00035531,Evan Jenkins (R),2016,Hospitals/Nursing Homes,27400,8000,35400
J000297,N00035531,Evan Jenkins (R),2016,Automotive,16250,19000,35250
J000297,N00035531,Evan Jenkins (R),2016,Real Estate,9050,26000,35050
J000297,N00035531,Evan Jenkins (R),2016,Building Trade Unions,0,33500,33500
T000473,N00035535,Mark Takai (D),2016,Retired,69893,0,69893
T000473,N00035535,Mark Takai (D),2016,Leadership PACs,0,47438,47438
T000473,N00035535,Mark Takai (D),2016,Lawyers/Law Firms,32823,12250,45073
T000473,N00035535,Mark Takai (D),2016,Transportation Unions,0,44000,44000
T000473,N00035535,Mark Takai (D),2016,Sea Transport,16900,22500,39400
T000473,N00035535,Mark Takai (D),2016,Building Trade Unions,0,37500,37500
T000473,N00035535,Mark Takai (D),2016,Defense Aerospace,4500,32500,37000
T000473,N00035535,Mark Takai (D),2016,Health Professionals,7800,25000,32800
T000473,N00035535,Mark Takai (D),2016,Public Sector Unions,250,32500,32750
T000473,N00035535,Mark Takai (D),2016,Real Estate,23737,9000,32737
S001197,N00035544,Ben Sasse (R),2016,Republican/Conservative,620207,83495,703702
S001197,N00035544,Ben Sasse (R),2016,Securities & Investment,416388,52500,468888
S001197,N00035544,Ben Sasse (R),2016,Retired,386747,0,386747
S001197,N00035544,Ben Sasse (R),2016,Insurance,72850,141460,214310
S001197,N00035544,Ben Sasse (R),2016,Leadership PACs,0,196382,196382
S001197,N00035544,Ben Sasse (R),2016,Real Estate,158238,29500,187738
S001197,N00035544,Ben Sasse (R),2016,Oil & Gas,106085,76500,182585
S001197,N00035544,Ben Sasse (R),2016,Lawyers/Law Firms,127050,53750,180800
S001197,N00035544,Ben Sasse (R),2016,Health Professionals,106388,57600,163988
S001197,N00035544,Ben Sasse (R),2016,Business Services,151150,3600,154750
T000475,N00035607,Dave Trott (R),2016,Real Estate,108515,23700,132215
T000475,N00035607,Dave Trott (R),2016,Lawyers/Law Firms,109135,23000,132135
T000475,N00035607,Dave Trott (R),2016,Automotive,12050,37000,49050
T000475,N00035607,Dave Trott (R),2016,Leadership PACs,0,47500,47500
T000475,N00035607,Dave Trott (R),2016,Misc Manufacturing & Distributing,22799,20443,43242
T000475,N00035607,Dave Trott (R),2016,Business Services,37105,2500,39605
T000475,N00035607,Dave Trott (R),2016,Retired,38545,0,38545
T000475,N00035607,Dave Trott (R),2016,Securities & Investment,35650,0,35650
T000475,N00035607,Dave Trott (R),2016,Health Professionals,14200,17500,31700
T000475,N00035607,Dave Trott (R),2016,Insurance,9850,21000,30850
H001070,N00035628,Cresent Hardy (R),2016,Leadership PACs,0,267300,267300
H001070,N00035628,Cresent Hardy (R),2016,Casinos/Gambling,77384,35000,112384
H001070,N00035628,Cresent Hardy (R),2016,Retired,108435,0,108435
H001070,N00035628,Cresent Hardy (R),2016,Real Estate,65010,17500,82510
H001070,N00035628,Cresent Hardy (R),2016,General Contractors,57250,23000,80250
H001070,N00035628,Cresent Hardy (R),2016,Candidate Committees,500,62500,63000
H001070,N00035628,Cresent Hardy (R),2016,Lawyers/Law Firms,42471,19500,61971
H001070,N00035628,Cresent Hardy (R),2016,Health Professionals,20150,26500,46650
H001070,N00035628,Cresent Hardy (R),2016,Oil & Gas,17500,27500,45000
H001070,N00035628,Cresent Hardy (R),2016,Automotive,21300,18995,40295
G000575,N00035688,Gwen Graham (D),2016,Lawyers/Law Firms,149879,11000,160879
G000575,N00035688,Gwen Graham (D),2016,Retired,108175,0,108175
G000575,N00035688,Gwen Graham (D),2016,Leadership PACs,250,102597,102847
G000575,N00035688,Gwen Graham (D),2016,Real Estate,72525,12500,85025
G000575,N00035688,Gwen Graham (D),2016,Health Professionals,22014,32300,54314
G000575,N00035688,Gwen Graham (D),2016,Securities & Investment,42250,9000,51250
G000575,N00035688,Gwen Graham (D),2016,Lobbyists,50596,0,50596
G000575,N00035688,Gwen Graham (D),2016,Democratic/Liberal,37520,13000,50520
G000575,N00035688,Gwen Graham (D),2016,Insurance,19850,27000,46850
G000575,N00035688,Gwen Graham (D),2016,Women's Issues,38041,7500,45541
P000609,N00035691,Gary Palmer (R),2016,Retired,118150,0,118150
P000609,N00035691,Gary Palmer (R),2016,General Contractors,67500,2000,69500
P000609,N00035691,Gary Palmer (R),2016,Health Professionals,41350,14000,55350
P000609,N00035691,Gary Palmer (R),2016,Lawyers/Law Firms,32150,19500,51650
P000609,N00035691,Gary Palmer (R),2016,Real Estate,30750,20000,50750
P000609,N00035691,Gary Palmer (R),2016,Commercial Banks,33400,17000,50400
P000609,N00035691,Gary Palmer (R),2016,Building Materials & Equipment,45100,4000,49100
P000609,N00035691,Gary Palmer (R),2016,Insurance,26050,23000,49050
P000609,N00035691,Gary Palmer (R),2016,Leadership PACs,0,39000,39000
P000609,N00035691,Gary Palmer (R),2016,Misc Manufacturing & Distributing,32200,1998,34198
J000296,N00035717,David Jolly (R),2016,Securities & Investment,150050,23500,173550
J000296,N00035717,David Jolly (R),2016,Retired,125895,0,125895
J000296,N00035717,David Jolly (R),2016,Real Estate,98325,23000,121325
J000296,N00035717,David Jolly (R),2016,Lobbyists,91091,9968,101059
J000296,N00035717,David Jolly (R),2016,Health Professionals,48200,19500,67700
J000296,N00035717,David Jolly (R),2016,Food & Beverage,48600,17200,65800
J000296,N00035717,David Jolly (R),2016,Defense Electronics,12650,43500,56150
J000296,N00035717,David Jolly (R),2016,Electric Utilities,17650,38500,56150
J000296,N00035717,David Jolly (R),2016,Leadership PACs,0,54000,54000
J000296,N00035717,David Jolly (R),2016,Insurance,22785,26250,49035
S001198,N00035774,Dan Sullivan (R),2016,Securities & Investment,1071287,0,1071287
S001198,N00035774,Dan Sullivan (R),2016,Retired,701335,0,701335
S001198,N00035774,Dan Sullivan (R),2016,Republican/Conservative,550923,48700,599623
S001198,N00035774,Dan Sullivan (R),2016,Real Estate,439543,12000,451543
S001198,N00035774,Dan Sullivan (R),2016,Oil & Gas,326185,78700,404885
S001198,N00035774,Dan Sullivan (R),2016,Leadership PACs,0,305100,305100
S001198,N00035774,Dan Sullivan (R),2016,Lawyers/Law Firms,261361,12250,273611
S001198,N00035774,Dan Sullivan (R),2016,Misc Finance,242284,1000,243284
S001198,N00035774,Dan Sullivan (R),2016,Misc Manufacturing & Distributing,160000,10000,170000
S001198,N00035774,Dan Sullivan (R),2016,Chemical & Related Manufacturing,123075,18500,141575
H001072,N00035792,French Hill (R),2016,Securities & Investment,130175,126350,256525
H001072,N00035792,French Hill (R),2016,Commercial Banks,80475,114750,195225
H001072,N00035792,French Hill (R),2016,Retired,147825,0,147825
H001072,N00035792,French Hill (R),2016,Insurance,19500,123000,142500
H001072,N00035792,French Hill (R),2016,Real Estate,33850,86000,119850
H001072,N00035792,French Hill (R),2016,Health Professionals,75650,23000,98650
H001072,N00035792,French Hill (R),2016,Misc Issues,79750,100,79850
H001072,N00035792,French Hill (R),2016,Lawyers/Law Firms,51082,11000,62082
H001072,N00035792,French Hill (R),2016,Leadership PACs,0,58282,58282
H001072,N00035792,French Hill (R),2016,Accountants,16150,41500,57650
K000387,N00035820,Steve Knight (R),2016,Leadership PACs,0,328700,328700
K000387,N00035820,Steve Knight (R),2016,Real Estate,57948,38900,96848
K000387,N00035820,Steve Knight (R),2016,Candidate Committees,0,68733,68733
K000387,N00035820,Steve Knight (R),2016,Insurance,13700,54500,68200
K000387,N00035820,Steve Knight (R),2016,Defense Aerospace,1250,53000,54250
K000387,N00035820,Steve Knight (R),2016,Oil & Gas,6400,44000,50400
K000387,N00035820,Steve Knight (R),2016,Republican/Conservative,12880,23000,35880
K000387,N00035820,Steve Knight (R),2016,Securities & Investment,27000,8000,35000
K000387,N00035820,Steve Knight (R),2016,Defense Electronics,0,34500,34500
K000387,N00035820,Steve Knight (R),2016,Automotive,18150,15000,33150
L000582,N00035825,Ted Lieu (D),2016,Lawyers/Law Firms,130753,16450,147203
L000582,N00035825,Ted Lieu (D),2016,Retired,140901,0,140901
L000582,N00035825,Ted Lieu (D),2016,Real Estate,116940,7000,123940
L000582,N00035825,Ted Lieu (D),2016,Securities & Investment,83350,10000,93350
L000582,N00035825,Ted Lieu (D),2016,Health Professionals,37300,42500,79800
L000582,N00035825,Ted Lieu (D),2016,Pro-Israel,49295,13000,62295
L000582,N00035825,Ted Lieu (D),2016,Pharmaceuticals/Health Products,28050,26600,54650
L000582,N00035825,Ted Lieu (D),2016,Public Sector Unions,0,44500,44500
L000582,N00035825,Ted Lieu (D),2016,Human Rights,33201,11000,44201
L000582,N00035825,Ted Lieu (D),2016,TV/Movies/Music,28900,10500,39400
C001102,N00035854,Curt Clawson (R),2016,Retired,139387,0,139387
C001102,N00035854,Curt Clawson (R),2016,Lawyers/Law Firms,24147,0,24147
C001102,N00035854,Curt Clawson (R),2016,Real Estate,17623,0,17623
C001102,N00035854,Curt Clawson (R),2016,Securities & Investment,12850,0,12850
C001102,N00035854,Curt Clawson (R),2016,Health Professionals,7250,0,7250
C001102,N00035854,Curt Clawson (R),2016,Automotive,5750,0,5750
C001102,N00035854,Curt Clawson (R),2016,Misc Transport,5200,0,5200
C001102,N00035854,Curt Clawson (R),2016,Leadership PACs,0,5000,5000
C001102,N00035854,Curt Clawson (R),2016,General Contractors,4041,0,4041
C001102,N00035854,Curt Clawson (R),2016,TV/Movies/Music,3500,0,3500
R000602,N00035927,Kathleen Rice (D),2016,Securities & Investment,178600,39500,218100
R000602,N00035927,Kathleen Rice (D),2016,Real Estate,175305,8000,183305
R000602,N00035927,Kathleen Rice (D),2016,Lawyers/Law Firms,164617,12750,177367
R000602,N00035927,Kathleen Rice (D),2016,Retired,103550,0,103550
R000602,N00035927,Kathleen Rice (D),2016,Pro-Israel,77210,2500,79710
R000602,N00035927,Kathleen Rice (D),2016,Business Services,79300,0,79300
R000602,N00035927,Kathleen Rice (D),2016,Leadership PACs,0,74700,74700
R000602,N00035927,Kathleen Rice (D),2016,Insurance,11655,46500,58155
R000602,N00035927,Kathleen Rice (D),2016,Health Professionals,28300,23500,51800
R000602,N00035927,Kathleen Rice (D),2016,Misc Manufacturing & Distributing,25300,22000,47300
K000386,N00035934,John Katko (R),2016,Leadership PACs,0,264341,264341
K000386,N00035934,John Katko (R),2016,Securities & Investment,111441,11000,122441
K000386,N00035934,John Katko (R),2016,Insurance,21791,85000,106791
K000386,N00035934,John Katko (R),2016,Air Transport,8850,94500,103350
K000386,N00035934,John Katko (R),2016,Real Estate,59200,35000,94200
K000386,N00035934,John Katko (R),2016,Lawyers/Law Firms,77588,10500,88088
K000386,N00035934,John Katko (R),2016,Transportation Unions,0,71500,71500
K000386,N00035934,John Katko (R),2016,Retired,66829,0,66829
K000386,N00035934,John Katko (R),2016,Health Professionals,30625,35000,65625
K000386,N00035934,John Katko (R),2016,Oil & Gas,16450,48500,64950
R000601,N00035972,John Lee Ratcliffe (R),2016,Securities & Investment,49150,7000,56150
R000601,N00035972,John Lee Ratcliffe (R),2016,Real Estate,30550,16000,46550
R000601,N00035972,John Lee Ratcliffe (R),2016,Leadership PACs,0,45000,45000
R000601,N00035972,John Lee Ratcliffe (R),2016,Oil & Gas,17450,23000,40450
R000601,N00035972,John Lee Ratcliffe (R),2016,Lawyers/Law Firms,34225,4000,38225
R000601,N00035972,John Lee Ratcliffe (R),2016,Commercial Banks,2350,29000,31350
R000601,N00035972,John Lee Ratcliffe (R),2016,Crop Production & Basic Processing,5250,26000,31250
R000601,N00035972,John Lee Ratcliffe (R),2016,Retired,28150,0,28150
R000601,N00035972,John Lee Ratcliffe (R),2016,Finance/Credit Companies,2000,24000,26000
R000601,N00035972,John Lee Ratcliffe (R),2016,Retail Sales,0,25500,25500
B001290,N00036013,Dave Brat (R),2016,Retired,156995,0,156995
B001290,N00036013,Dave Brat (R),2016,Republican/Conservative,83526,19100,102626
B001290,N00036013,Dave Brat (R),2016,Real Estate,81900,6000,87900
B001290,N00036013,Dave Brat (R),2016,Securities & Investment,73633,0,73633
B001290,N00036013,Dave Brat (R),2016,Lawyers/Law Firms,24674,1250,25924
B001290,N00036013,Dave Brat (R),2016,Automotive,8550,16000,24550
B001290,N00036013,Dave Brat (R),2016,Misc Manufacturing & Distributing,21900,1998,23898
B001290,N00036013,Dave Brat (R),2016,Health Services/HMOs,11800,8500,20300
B001290,N00036013,Dave Brat (R),2016,Insurance,11025,8750,19775
B001290,N00036013,Dave Brat (R),2016,Misc Finance,19610,0,19610
B001292,N00036018,Don Beyer (D),2016,Lawyers/Law Firms,144420,36950,181370
B001292,N00036018,Don Beyer (D),2016,Retired,149313,0,149313
B001292,N00036018,Don Beyer (D),2016,Real Estate,108175,25000,133175
B001292,N00036018,Don Beyer (D),2016,Automotive,57975,43182,101157
B001292,N00036018,Don Beyer (D),2016,Securities & Investment,34600,21000,55600
B001292,N00036018,Don Beyer (D),2016,Health Professionals,10851,41500,52351
B001292,N00036018,Don Beyer (D),2016,Misc Defense,6950,43300,50250
B001292,N00036018,Don Beyer (D),2016,Business Services,39328,10000,49328
B001292,N00036018,Don Beyer (D),2016,Insurance,4250,45000,49250
B001292,N00036018,Don Beyer (D),2016,Electronics Mfg & Equip,15025,33850,48875
C001105,N00036023,Barbara Comstock (R),2016,Leadership PACs,2900,367100,370000
C001105,N00036023,Barbara Comstock (R),2016,Retired,313407,0,313407
C001105,N00036023,Barbara Comstock (R),2016,Securities & Investment,292029,4500,296529
C001105,N00036023,Barbara Comstock (R),2016,Lobbyists,247525,7513,255038
C001105,N00036023,Barbara Comstock (R),2016,Lawyers/Law Firms,204040,46250,250290
C001105,N00036023,Barbara Comstock (R),2016,Real Estate,188313,29000,217313
C001105,N00036023,Barbara Comstock (R),2016,Business Services,126900,15700,142600
C001105,N00036023,Barbara Comstock (R),2016,Republican/Conservative,66174,53000,119174
C001105,N00036023,Barbara Comstock (R),2016,Electronics Mfg & Equip,61150,53183,114333
C001105,N00036023,Barbara Comstock (R),2016,Air Transport,7764,99500,107264
G000574,N00036097,Ruben Gallego (D),2016,Lawyers/Law Firms,40069,17500,57569
G000574,N00036097,Ruben Gallego (D),2016,Real Estate,40500,11500,52000
G000574,N00036097,Ruben Gallego (D),2016,Transportation Unions,0,47500,47500
G000574,N00036097,Ruben Gallego (D),2016,Health Professionals,17883,18000,35883
G000574,N00036097,Ruben Gallego (D),2016,Misc Unions,0,30000,30000
G000574,N00036097,Ruben Gallego (D),2016,Industrial Unions,0,29500,29500
G000574,N00036097,Ruben Gallego (D),2016,Lobbyists,28396,0,28396
G000574,N00036097,Ruben Gallego (D),2016,Building Trade Unions,0,28000,28000
G000574,N00036097,Ruben Gallego (D),2016,Casinos/Gambling,26191,0,26191
G000574,N00036097,Ruben Gallego (D),2016,Business Services,25630,0,25630
T000474,N00036107,Norma Torres (D),2016,Casinos/Gambling,44400,0,44400
T000474,N00036107,Norma Torres (D),2016,Public Sector Unions,0,41000,41000
T000474,N00036107,Norma Torres (D),2016,Building Trade Unions,0,36500,36500
T000474,N00036107,Norma Torres (D),2016,Industrial Unions,0,31500,31500
T000474,N00036107,Norma Torres (D),2016,Health Professionals,9400,19000,28400
T000474,N00036107,Norma Torres (D),2016,Lawyers/Law Firms,18483,9000,27483
T000474,N00036107,Norma Torres (D),2016,Leadership PACs,0,23500,23500
T000474,N00036107,Norma Torres (D),2016,Pharmaceuticals/Health Products,0,22500,22500
T000474,N00036107,Norma Torres (D),2016,Transportation Unions,0,21500,21500
T000474,N00036107,Norma Torres (D),2016,Misc Unions,0,20000,20000
G000577,N00036135,Garret Graves (R),2016,Oil & Gas,58966,135233,194199
G000577,N00036135,Garret Graves (R),2016,Lawyers/Law Firms,69650,47100,116750
G000577,N00036135,Garret Graves (R),2016,Sea Transport,37750,42100,79850
G000577,N00036135,Garret Graves (R),2016,Lobbyists,72287,7000,79287
G000577,N00036135,Garret Graves (R),2016,Insurance,18300,47250,65550
G000577,N00036135,Garret Graves (R),2016,General Contractors,47590,15500,63090
G000577,N00036135,Garret Graves (R),2016,Construction Services,35837,26250,62087
G000577,N00036135,Garret Graves (R),2016,Real Estate,39833,14000,53833
G000577,N00036135,Garret Graves (R),2016,Food & Beverage,39050,12000,51050
G000577,N00036135,Garret Graves (R),2016,Air Transport,6900,37000,43900
D000624,N00036149,Debbie Dingell (D),2016,Lawyers/Law Firms,47475,38100,85575
D000624,N00036149,Debbie Dingell (D),2016,Industrial Unions,100,54500,54600
D000624,N00036149,Debbie Dingell (D),2016,Automotive,15300,39000,54300
D000624,N00036149,Debbie Dingell (D),2016,Retired,53899,0,53899
D000624,N00036149,Debbie Dingell (D),2016,Electric Utilities,6200,42500,48700
D000624,N00036149,Debbie Dingell (D),2016,Building Trade Unions,0,44500,44500
D000624,N00036149,Debbie Dingell (D),2016,Public Sector Unions,0,39500,39500
D000624,N00036149,Debbie Dingell (D),2016,Real Estate,30450,7000,37450
D000624,N00036149,Debbie Dingell (D),2016,Lobbyists,26900,1500,28400
D000624,N00036149,Debbie Dingell (D),2016,Defense Aerospace,4000,18000,22000
N000188,N00036154,Don Norcross (D),2016,Lawyers/Law Firms,192906,36891,229797
N000188,N00036154,Don Norcross (D),2016,Real Estate,126450,34600,161050
N000188,N00036154,Don Norcross (D),2016,Building Trade Unions,0,90900,90900
N000188,N00036154,Don Norcross (D),2016,Construction Services,68150,14750,82900
N000188,N00036154,Don Norcross (D),2016,Insurance,17800,41200,59000
N000188,N00036154,Don Norcross (D),2016,Special Trade Contractors,40000,18500,58500
N000188,N00036154,Don Norcross (D),2016,Misc Finance,54800,0,54800
N000188,N00036154,Don Norcross (D),2016,Transportation Unions,0,50500,50500
N000188,N00036154,Don Norcross (D),2016,Lobbyists,46542,1622,48164
N000188,N00036154,Don Norcross (D),2016,Industrial Unions,230,47500,47730
M001193,N00036155,Thomas MacArthur (R),2016,Insurance,37653,79400,117053
M001193,N00036155,Thomas MacArthur (R),2016,Leadership PACs,0,110616,110616
M001193,N00036155,Thomas MacArthur (R),2016,Lawyers/Law Firms,56567,20900,77467
M001193,N00036155,Thomas MacArthur (R),2016,Real Estate,42800,18000,60800
M001193,N00036155,Thomas MacArthur (R),2016,Securities & Investment,43175,16500,59675
M001193,N00036155,Thomas MacArthur (R),2016,Defense Aerospace,7750,45500,53250
M001193,N00036155,Thomas MacArthur (R),2016,Building Trade Unions,0,50500,50500
M001193,N00036155,Thomas MacArthur (R),2016,Retired,48220,0,48220
M001193,N00036155,Thomas MacArthur (R),2016,Health Professionals,2350,35500,37850
M001193,N00036155,Thomas MacArthur (R),2016,Republican/Conservative,2250,34700,36950
R000604,N00036175,Steven Russell (R),2016,Leadership PACs,0,84900,84900
R000604,N00036175,Steven Russell (R),2016,Oil & Gas,31100,43000,74100
R000604,N00036175,Steven Russell (R),2016,Retired,49000,0,49000
R000604,N00036175,Steven Russell (R),2016,Commercial Banks,32200,6750,38950
R000604,N00036175,Steven Russell (R),2016,General Contractors,33050,2500,35550
R000604,N00036175,Steven Russell (R),2016,Lawyers/Law Firms,13740,19500,33240
R000604,N00036175,Steven Russell (R),2016,Real Estate,21400,9000,30400
R000604,N00036175,Steven Russell (R),2016,Insurance,4125,18200,22325
R000604,N00036175,Steven Russell (R),2016,Electric Utilities,0,21500,21500
R000604,N00036175,Steven Russell (R),2016,Defense Aerospace,560,20000,20560
M001201,N00036274,Paul Mitchell (R),2016,Leadership PACs,0,39500,39500
M001201,N00036274,Paul Mitchell (R),2016,Automotive,4593,20000,24593
M001201,N00036274,Paul Mitchell (R),2016,Misc Manufacturing & Distributing,10300,9500,19800
M001201,N00036274,Paul Mitchell (R),2016,Real Estate,10800,7500,18300
M001201,N00036274,Paul Mitchell (R),2016,Securities & Investment,13000,0,13000
M001201,N00036274,Paul Mitchell (R),2016,Electric Utilities,0,13000,13000
M001201,N00036274,Paul Mitchell (R),2016,Lawyers/Law Firms,7100,5000,12100
M001201,N00036274,Paul Mitchell (R),2016,Retail Sales,9700,2000,11700
M001201,N00036274,Paul Mitchell (R),2016,Crop Production & Basic Processing,625,10500,11125
M001201,N00036274,Paul Mitchell (R),2016,Education,4446,6500,10946
M001194,N00036275,John Moolenaar (R),2016,Leadership PACs,0,86000,86000
M001194,N00036275,John Moolenaar (R),2016,Chemical & Related Manufacturing,62040,11000,73040
M001194,N00036275,John Moolenaar (R),2016,Retired,48115,0,48115
M001194,N00036275,John Moolenaar (R),2016,Crop Production & Basic Processing,4585,39250,43835
M001194,N00036275,John Moolenaar (R),2016,Health Professionals,8250,33750,42000
M001194,N00036275,John Moolenaar (R),2016,Agricultural Services/Products,0,36000,36000
M001194,N00036275,John Moolenaar (R),2016,Misc Manufacturing & Distributing,7700,26244,33944
M001194,N00036275,John Moolenaar (R),2016,Automotive,3850,29500,33350
M001194,N00036275,John Moolenaar (R),2016,Insurance,9250,22607,31857
M001194,N00036275,John Moolenaar (R),2016,Electric Utilities,500,29900,30400
T000478,N00036351,Claudia Tenney (R),2016,Leadership PACs,0,114500,114500
T000478,N00036351,Claudia Tenney (R),2016,Retired,61139,0,61139
T000478,N00036351,Claudia Tenney (R),2016,Republican/Conservative,12750,31100,43850
T000478,N00036351,Claudia Tenney (R),2016,Misc Business,32498,5000,37498
T000478,N00036351,Claudia Tenney (R),2016,Lawyers/Law Firms,32100,3000,35100
T000478,N00036351,Claudia Tenney (R),2016,Real Estate,26000,3500,29500
T000478,N00036351,Claudia Tenney (R),2016,General Contractors,22950,5000,27950
T000478,N00036351,Claudia Tenney (R),2016,Candidate Committees,0,23500,23500
T000478,N00036351,Claudia Tenney (R),2016,Health Professionals,16100,5000,21100
T000478,N00036351,Claudia Tenney (R),2016,Abortion Policy/Anti-Abortion,5400,15000,20400
N000189,N00036403,Daniel Milton Newhouse (R),2016,Crop Production & Basic Processing,66793,53500,120293
N000189,N00036403,Daniel Milton Newhouse (R),2016,Leadership PACs,1429,74335,75764
N000189,N00036403,Daniel Milton Newhouse (R),2016,Agricultural Services/Products,9150,58000,67150
N000189,N00036403,Daniel Milton Newhouse (R),2016,Dairy,45005,14500,59505
N000189,N00036403,Daniel Milton Newhouse (R),2016,Food Processing & Sales,2600,44850,47450
N000189,N00036403,Daniel Milton Newhouse (R),2016,Retired,44770,0,44770
N000189,N00036403,Daniel Milton Newhouse (R),2016,Forestry & Forest Products,5250,33250,38500
N000189,N00036403,Daniel Milton Newhouse (R),2016,Real Estate,28360,10000,38360
N000189,N00036403,Daniel Milton Newhouse (R),2016,Oil & Gas,4150,28000,32150
N000189,N00036403,Daniel Milton Newhouse (R),2016,Health Professionals,12750,18500,31250
G000576,N00036409,Glenn S Grothman (R),2016,Retired,140896,0,140896
G000576,N00036409,Glenn S Grothman (R),2016,Misc Manufacturing & Distributing,17275,19998,37273
G000576,N00036409,Glenn S Grothman (R),2016,Insurance,6994,27500,34494
G000576,N00036409,Glenn S Grothman (R),2016,Real Estate,25225,7000,32225
G000576,N00036409,Glenn S Grothman (R),2016,Securities & Investment,22970,4000,26970
G000576,N00036409,Glenn S Grothman (R),2016,Lawyers/Law Firms,22660,3000,25660
G000576,N00036409,Glenn S Grothman (R),2016,Leadership PACs,0,25500,25500
G000576,N00036409,Glenn S Grothman (R),2016,General Contractors,20883,2500,23383
G000576,N00036409,Glenn S Grothman (R),2016,Oil & Gas,8700,14500,23200
G000576,N00036409,Glenn S Grothman (R),2016,Trucking,4450,16000,20450
B001293,N00036449,Mike Bishop (R),2016,Leadership PACs,0,212450,212450
B001293,N00036449,Mike Bishop (R),2016,Insurance,9400,73500,82900
B001293,N00036449,Mike Bishop (R),2016,Real Estate,59775,21700,81475
B001293,N00036449,Mike Bishop (R),2016,Automotive,31050,35000,66050
B001293,N00036449,Mike Bishop (R),2016,Securities & Investment,41350,14500,55850
B001293,N00036449,Mike Bishop (R),2016,Health Professionals,8100,45250,53350
B001293,N00036449,Mike Bishop (R),2016,Retail Sales,19900,25000,44900
B001293,N00036449,Mike Bishop (R),2016,Electric Utilities,1250,41500,42750
B001293,N00036449,Mike Bishop (R),2016,Lawyers/Law Firms,24975,12000,36975
B001293,N00036449,Mike Bishop (R),2016,Candidate Committees,0,35500,35500
A000374,N00036633,Ralph Abraham (R),2016,Crop Production & Basic Processing,22871,45000,67871
A000374,N00036633,Ralph Abraham (R),2016,Health Professionals,19050,30000,49050
A000374,N00036633,Ralph Abraham (R),2016,Agricultural Services/Products,3700,30000,33700
A000374,N00036633,Ralph Abraham (R),2016,Leadership PACs,1429,30000,31429
A000374,N00036633,Ralph Abraham (R),2016,Real Estate,13425,8500,21925
A000374,N00036633,Ralph Abraham (R),2016,Commercial Banks,12100,8500,20600
A000374,N00036633,Ralph Abraham (R),2016,Forestry & Forest Products,6400,13000,19400
A000374,N00036633,Ralph Abraham (R),2016,Lawyers/Law Firms,8250,9000,17250
A000374,N00036633,Ralph Abraham (R),2016,Oil & Gas,5250,11000,16250
A000374,N00036633,Ralph Abraham (R),2016,Misc Business,15100,0,15100
H001075,N00036915,Kamala D Harris (D),2016,Lawyers/Law Firms,2137201,64000,2201201
H001075,N00036915,Kamala D Harris (D),2016,TV/Movies/Music,973403,8500,981903
H001075,N00036915,Kamala D Harris (D),2016,Women's Issues,764047,30487,794534
H001075,N00036915,Kamala D Harris (D),2016,Retired,792646,0,792646
H001075,N00036915,Kamala D Harris (D),2016,Securities & Investment,722674,5000,727674
H001075,N00036915,Kamala D Harris (D),2016,Real Estate,497868,500,498368
H001075,N00036915,Kamala D Harris (D),2016,Democratic/Liberal,406543,21436,427979
H001075,N00036915,Kamala D Harris (D),2016,Business Services,379408,8200,387608
H001075,N00036915,Kamala D Harris (D),2016,Electronics Mfg & Equip,263638,17000,280638
H001075,N00036915,Kamala D Harris (D),2016,Education,244070,0,244070
D000625,N00036928,Dan Donovan (R),2016,Leadership PACs,0,181200,181200
D000625,N00036928,Dan Donovan (R),2016,Real Estate,120722,29500,150222
D000625,N00036928,Dan Donovan (R),2016,Lawyers/Law Firms,118384,11750,130134
D000625,N00036928,Dan Donovan (R),2016,Securities & Investment,99846,10500,110346
D000625,N00036928,Dan Donovan (R),2016,Building Trade Unions,0,70500,70500
D000625,N00036928,Dan Donovan (R),2016,Retired,69032,0,69032
D000625,N00036928,Dan Donovan (R),2016,Insurance,7185,47000,54185
D000625,N00036928,Dan Donovan (R),2016,Commercial Banks,14150,38000,52150
D000625,N00036928,Dan Donovan (R),2016,Transportation Unions,500,50750,51250
D000625,N00036928,Dan Donovan (R),2016,Health Professionals,38775,8000,46775
G000583,N00036944,Josh Gottheimer (D),2016,Securities & Investment,550581,5000,555581
G000583,N00036944,Josh Gottheimer (D),2016,Lawyers/Law Firms,423886,14000,437886
G000583,N00036944,Josh Gottheimer (D),2016,Retired,210631,0,210631
G000583,N00036944,Josh Gottheimer (D),2016,Leadership PACs,8100,184074,192174
G000583,N00036944,Josh Gottheimer (D),2016,Real Estate,173314,11000,184314
G000583,N00036944,Josh Gottheimer (D),2016,Business Services,138247,0,138247
G000583,N00036944,Josh Gottheimer (D),2016,Democratic/Liberal,107235,29500,136735
G000583,N00036944,Josh Gottheimer (D),2016,Lobbyists,115436,5000,120436
G000583,N00036944,Josh Gottheimer (D),2016,Misc Finance,98156,0,98156
G000583,N00036944,Josh Gottheimer (D),2016,Health Professionals,67035,21000,88035
B001304,N00036999,Anthony Brown (D),2016,Lawyers/Law Firms,94994,12750,107744
B001304,N00036999,Anthony Brown (D),2016,Real Estate,62821,11500,74321
B001304,N00036999,Anthony Brown (D),2016,Public Sector Unions,0,60000,60000
B001304,N00036999,Anthony Brown (D),2016,Health Professionals,30975,21500,52475
B001304,N00036999,Anthony Brown (D),2016,Retired,44867,0,44867
B001304,N00036999,Anthony Brown (D),2016,Leadership PACs,0,40700,40700
B001304,N00036999,Anthony Brown (D),2016,Human Rights,5238,19500,24738
B001304,N00036999,Anthony Brown (D),2016,Misc Unions,0,22500,22500
B001304,N00036999,Anthony Brown (D),2016,Transportation Unions,0,22500,22500
B001304,N00036999,Anthony Brown (D),2016,Lobbyists,22300,0,22300
K000388,N00037003,Trent Kelly (R),2016,Leadership PACs,0,90400,90400
K000388,N00037003,Trent Kelly (R),2016,Lawyers/Law Firms,67400,11000,78400
K000388,N00037003,Trent Kelly (R),2016,Crop Production & Basic Processing,23050,41800,64850
K000388,N00037003,Trent Kelly (R),2016,Commercial Banks,10910,37700,48610
K000388,N00037003,Trent Kelly (R),2016,Health Professionals,30050,11500,41550
K000388,N00037003,Trent Kelly (R),2016,Electric Utilities,250,38500,38750
K000388,N00037003,Trent Kelly (R),2016,Retired,36670,0,36670
K000388,N00037003,Trent Kelly (R),2016,Automotive,17000,19500,36500
K000388,N00037003,Trent Kelly (R),2016,Insurance,18250,14500,32750
K000388,N00037003,Trent Kelly (R),2016,Lobbyists,30000,1114,31114
C001112,N00037015,Salud Carbajal (D),2016,Retired,575172,0,575172
C001112,N00037015,Salud Carbajal (D),2016,Leadership PACs,2700,167444,170144
C001112,N00037015,Salud Carbajal (D),2016,Democratic/Liberal,145088,19200,164288
C001112,N00037015,Salud Carbajal (D),2016,Real Estate,143106,5000,148106
C001112,N00037015,Salud Carbajal (D),2016,Lawyers/Law Firms,124580,6000,130580
C001112,N00037015,Salud Carbajal (D),2016,Misc Finance,74550,0,74550
C001112,N00037015,Salud Carbajal (D),2016,Public Sector Unions,500,63000,63500
C001112,N00037015,Salud Carbajal (D),2016,Health Professionals,37190,19500,56690
C001112,N00037015,Salud Carbajal (D),2016,TV/Movies/Music,55785,0,55785
C001112,N00037015,Salud Carbajal (D),2016,Building Trade Unions,0,55000,55000
B001300,N00037019,Nanette Barragan (D),2016,Lawyers/Law Firms,227045,9816,236861
B001300,N00037019,Nanette Barragan (D),2016,Women's Issues,147554,31500,179054
B001300,N00037019,Nanette Barragan (D),2016,Democratic/Liberal,141768,12393,154161
B001300,N00037019,Nanette Barragan (D),2016,Human Rights,35832,26962,62794
B001300,N00037019,Nanette Barragan (D),2016,Securities & Investment,61968,0,61968
B001300,N00037019,Nanette Barragan (D),2016,Leadership PACs,0,61200,61200
B001300,N00037019,Nanette Barragan (D),2016,Retired,58468,0,58468
B001300,N00037019,Nanette Barragan (D),2016,Environment,40782,15130,55912
B001300,N00037019,Nanette Barragan (D),2016,Real Estate,43897,0,43897
B001300,N00037019,Nanette Barragan (D),2016,Education,31998,0,31998
L000585,N00037031,Darin LaHood (R),2016,Retired,161883,0,161883
L000585,N00037031,Darin LaHood (R),2016,Health Professionals,80850,53500,134350
L000585,N00037031,Darin LaHood (R),2016,Leadership PACs,0,117500,117500
L000585,N00037031,Darin LaHood (R),2016,Securities & Investment,69700,19500,89200
L000585,N00037031,Darin LaHood (R),2016,Lawyers/Law Firms,75073,9750,84823
L000585,N00037031,Darin LaHood (R),2016,Insurance,25650,54500,80150
L000585,N00037031,Darin LaHood (R),2016,Real Estate,36150,37500,73650
L000585,N00037031,Darin LaHood (R),2016,Automotive,30800,39500,70300
L000585,N00037031,Darin LaHood (R),2016,Crop Production & Basic Processing,30600,35000,65600
L000585,N00037031,Darin LaHood (R),2016,Agricultural Services/Products,1500,56549,58049
M001198,N00037034,Roger Marshall (R),2016,Health Professionals,32000,74500,106500
M001198,N00037034,Roger Marshall (R),2016,Leadership PACs,0,82200,82200
M001198,N00037034,Roger Marshall (R),2016,Crop Production & Basic Processing,38150,32500,70650
M001198,N00037034,Roger Marshall (R),2016,Securities & Investment,52400,12200,64600
M001198,N00037034,Roger Marshall (R),2016,Retired,51125,0,51125
M001198,N00037034,Roger Marshall (R),2016,Livestock,24500,16000,40500
M001198,N00037034,Roger Marshall (R),2016,Commercial Banks,17800,19500,37300
M001198,N00037034,Roger Marshall (R),2016,Agricultural Services/Products,6550,25000,31550
M001198,N00037034,Roger Marshall (R),2016,Misc Energy,13450,12000,25450
M001198,N00037034,Roger Marshall (R),2016,Accountants,6400,17000,23400
R000606,N00037036,Jamie Raskin (D),2016,Lawyers/Law Firms,344732,14604,359336
R000606,N00037036,Jamie Raskin (D),2016,Retired,200958,0,200958
R000606,N00037036,Jamie Raskin (D),2016,Education,186038,0,186038
R000606,N00037036,Jamie Raskin (D),2016,Democratic/Liberal,101165,9819,110984
R000606,N00037036,Jamie Raskin (D),2016,Real Estate,81866,6000,87866
R000606,N00037036,Jamie Raskin (D),2016,Civil Servants/Public Officials,80025,0,80025
R000606,N00037036,Jamie Raskin (D),2016,Public Sector Unions,1016,63750,64766
R000606,N00037036,Jamie Raskin (D),2016,Securities & Investment,48178,0,48178
R000606,N00037036,Jamie Raskin (D),2016,Health Professionals,41915,4500,46415
R000606,N00037036,Jamie Raskin (D),2016,Printing & Publishing,39411,0,39411
B001298,N00037049,Don Bacon (R),2016,Leadership PACs,0,225100,225100
B001298,N00037049,Don Bacon (R),2016,Retired,152702,0,152702
B001298,N00037049,Don Bacon (R),2016,Republican/Conservative,29665,39998,69663
B001298,N00037049,Don Bacon (R),2016,Candidate Committees,0,58725,58725
B001298,N00037049,Don Bacon (R),2016,Other,40950,0,40950
B001298,N00037049,Don Bacon (R),2016,Securities & Investment,34075,2000,36075
B001298,N00037049,Don Bacon (R),2016,Lawyers/Law Firms,28732,6000,34732
B001298,N00037049,Don Bacon (R),2016,Insurance,16365,14000,30365
B001298,N00037049,Don Bacon (R),2016,Health Professionals,22175,7000,29175
B001298,N00037049,Don Bacon (R),2016,Real Estate,26462,2500,28962
C001113,N00037161,Catherine Cortez Masto (D),2016,Women's Issues,1627058,41485,1668543
C001113,N00037161,Catherine Cortez Masto (D),2016,Democratic/Liberal,1431489,25234,1456723
C001113,N00037161,Catherine Cortez Masto (D),2016,Lawyers/Law Firms,1314378,21474,1335852
C001113,N00037161,Catherine Cortez Masto (D),2016,Retired,673735,0,673735
C001113,N00037161,Catherine Cortez Masto (D),2016,Education,570239,0,570239
C001113,N00037161,Catherine Cortez Masto (D),2016,Human Rights,493695,52271,545966
C001113,N00037161,Catherine Cortez Masto (D),2016,Environment,492597,19863,512460
C001113,N00037161,Catherine Cortez Masto (D),2016,Securities & Investment,475490,0,475490
C001113,N00037161,Catherine Cortez Masto (D),2016,Leadership PACs,7900,396876,404776
C001113,N00037161,Catherine Cortez Masto (D),2016,Real Estate,354282,0,354282
B001299,N00037185,Jim Banks (R),2016,Republican/Conservative,297108,42098,339206
B001299,N00037185,Jim Banks (R),2016,Leadership PACs,15275,79700,94975
B001299,N00037185,Jim Banks (R),2016,Retired,68073,0,68073
B001299,N00037185,Jim Banks (R),2016,Environment,57650,0,57650
B001299,N00037185,Jim Banks (R),2016,Real Estate,29685,13700,43385
B001299,N00037185,Jim Banks (R),2016,Health Professionals,18400,22000,40400
B001299,N00037185,Jim Banks (R),2016,Oil & Gas,7535,20000,27535
B001299,N00037185,Jim Banks (R),2016,Food & Beverage,19900,1000,20900
B001299,N00037185,Jim Banks (R),2016,Misc Manufacturing & Distributing,14100,5000,19100
B001299,N00037185,Jim Banks (R),2016,Women's Issues,18750,0,18750
C001110,N00037260,Lou Correa (D),2016,Leadership PACs,2700,59800,62500
C001110,N00037260,Lou Correa (D),2016,Casinos/Gambling,41800,6000,47800
C001110,N00037260,Lou Correa (D),2016,Health Professionals,11149,31500,42649
C001110,N00037260,Lou Correa (D),2016,Democratic/Liberal,24250,17500,41750
C001110,N00037260,Lou Correa (D),2016,Real Estate,26018,12000,38018
C001110,N00037260,Lou Correa (D),2016,Lawyers/Law Firms,31425,3000,34425
C001110,N00037260,Lou Correa (D),2016,Insurance,4300,26622,30922
C001110,N00037260,Lou Correa (D),2016,Human Rights,5200,22500,27700
C001110,N00037260,Lou Correa (D),2016,Public Sector Unions,6000,20500,26500
C001110,N00037260,Lou Correa (D),2016,Pharmaceuticals/Health Products,750,24000,24750
M001199,N00037269,Brian Mast (R),2016,Retired,463912,0,463912
M001199,N00037269,Brian Mast (R),2016,Republican/Conservative,170159,46800,216959
M001199,N00037269,Brian Mast (R),2016,Leadership PACs,0,195700,195700
M001199,N00037269,Brian Mast (R),2016,Real Estate,95807,4500,100307
M001199,N00037269,Brian Mast (R),2016,Pro-Israel,67678,22500,90178
M001199,N00037269,Brian Mast (R),2016,Securities & Investment,49950,5000,54950
M001199,N00037269,Brian Mast (R),2016,Candidate Committees,1000,50550,51550
M001199,N00037269,Brian Mast (R),2016,Insurance,35950,15500,51450
M001199,N00037269,Brian Mast (R),2016,Health Professionals,29701,18000,47701
M001199,N00037269,Brian Mast (R),2016,General Contractors,28850,10000,38850
F000464,N00037288,John Faso (R),2016,Securities & Investment,359099,0,359099
F000464,N00037288,John Faso (R),2016,Retired,297385,0,297385
F000464,N00037288,John Faso (R),2016,Lawyers/Law Firms,163303,500,163803
F000464,N00037288,John Faso (R),2016,Real Estate,140932,10000,150932
F000464,N00037288,John Faso (R),2016,Leadership PACs,0,136200,136200
F000464,N00037288,John Faso (R),2016,Insurance,56439,47500,103939
F000464,N00037288,John Faso (R),2016,Misc Finance,61800,0,61800
F000464,N00037288,John Faso (R),2016,Pro-Israel,41750,18200,59950
F000464,N00037288,John Faso (R),2016,Misc Manufacturing & Distributing,51750,7000,58750
F000464,N00037288,John Faso (R),2016,Business Services,50654,6000,56654
S001200,N00037422,Darren Soto (D),2016,Lawyers/Law Firms,119866,15500,135366
S001200,N00037422,Darren Soto (D),2016,Leadership PACs,2000,61950,63950
S001200,N00037422,Darren Soto (D),2016,Health Professionals,28376,24000,52376
S001200,N00037422,Darren Soto (D),2016,Real Estate,27930,15000,42930
S001200,N00037422,Darren Soto (D),2016,Crop Production & Basic Processing,15465,22500,37965
S001200,N00037422,Darren Soto (D),2016,Retired,37676,0,37676
S001200,N00037422,Darren Soto (D),2016,Building Trade Unions,0,37500,37500
S001200,N00037422,Darren Soto (D),2016,Lobbyists,37412,0,37412
S001200,N00037422,Darren Soto (D),2016,Industrial Unions,0,35000,35000
S001200,N00037422,Darren Soto (D),2016,Hospitals/Nursing Homes,14970,17000,31970
D000628,N00037442,Neal Dunn (R),2016,Health Professionals,258022,73000,331022
D000628,N00037442,Neal Dunn (R),2016,Retired,125451,0,125451
D000628,N00037442,Neal Dunn (R),2016,Leadership PACs,0,87500,87500
D000628,N00037442,Neal Dunn (R),2016,Real Estate,66660,10000,76660
D000628,N00037442,Neal Dunn (R),2016,Lawyers/Law Firms,33153,6500,39653
D000628,N00037442,Neal Dunn (R),2016,General Contractors,30100,6000,36100
D000628,N00037442,Neal Dunn (R),2016,Crop Production & Basic Processing,23900,5000,28900
D000628,N00037442,Neal Dunn (R),2016,"Beer, Wine & Liquor",21000,7500,28500
D000628,N00037442,Neal Dunn (R),2016,Automotive,11970,13000,24970
D000628,N00037442,Neal Dunn (R),2016,Candidate Committees,0,22950,22950
O000171,N00037515,Tom O'Halleran (D),2016,Retired,197975,0,197975
O000171,N00037515,Tom O'Halleran (D),2016,Leadership PACs,0,133400,133400
O000171,N00037515,Tom O'Halleran (D),2016,Democratic/Liberal,95620,21000,116620
O000171,N00037515,Tom O'Halleran (D),2016,Lawyers/Law Firms,92851,2250,95101
O000171,N00037515,Tom O'Halleran (D),2016,Real Estate,70255,2500,72755
O000171,N00037515,Tom O'Halleran (D),2016,Public Sector Unions,0,70000,70000
O000171,N00037515,Tom O'Halleran (D),2016,Building Trade Unions,0,55000,55000
O000171,N00037515,Tom O'Halleran (D),2016,Candidate Committees,0,46500,46500
O000171,N00037515,Tom O'Halleran (D),2016,Industrial Unions,0,45500,45500
O000171,N00037515,Tom O'Halleran (D),2016,Transportation Unions,0,41500,41500
G000582,N00037615,Jenniffer Gonzalez (3),2016,Lawyers/Law Firms,135678,7748,143426
G000582,N00037615,Jenniffer Gonzalez (3),2016,Health Professionals,46500,0,46500
G000582,N00037615,Jenniffer Gonzalez (3),2016,Misc Business,41758,0,41758
G000582,N00037615,Jenniffer Gonzalez (3),2016,Business Services,31780,1000,32780
G000582,N00037615,Jenniffer Gonzalez (3),2016,Lobbyists,29150,1000,30150
G000582,N00037615,Jenniffer Gonzalez (3),2016,Food & Beverage,28111,1000,29111
G000582,N00037615,Jenniffer Gonzalez (3),2016,Real Estate,24250,3000,27250
G000582,N00037615,Jenniffer Gonzalez (3),2016,Retired,23595,0,23595
G000582,N00037615,Jenniffer Gonzalez (3),2016,Retail Sales,17700,2500,20200
G000582,N00037615,Jenniffer Gonzalez (3),2016,Misc Finance,17700,0,17700
C001108,N00038260,James Comer (R),2016,Crop Production & Basic Processing,63390,10500,73890
C001108,N00038260,James Comer (R),2016,Leadership PACs,0,66000,66000
C001108,N00038260,James Comer (R),2016,Retired,64150,0,64150
C001108,N00038260,James Comer (R),2016,Real Estate,42800,15000,57800
C001108,N00038260,James Comer (R),2016,Health Professionals,28250,8500,36750
C001108,N00038260,James Comer (R),2016,General Contractors,25800,7000,32800
C001108,N00038260,James Comer (R),2016,Lobbyists,31300,0,31300
C001108,N00038260,James Comer (R),2016,Lawyers/Law Firms,23665,2700,26365
C001108,N00038260,James Comer (R),2016,Commercial Banks,15700,6000,21700
C001108,N00038260,James Comer (R),2016,Agricultural Services/Products,13600,6000,19600
A000375,N00038285,Jodey Arrington (R),2016,Retired,135425,0,135425
A000375,N00038285,Jodey Arrington (R),2016,Crop Production & Basic Processing,80130,38700,118830
A000375,N00038285,Jodey Arrington (R),2016,Commercial Banks,63797,20000,83797
A000375,N00038285,Jodey Arrington (R),2016,Leadership PACs,0,82500,82500
A000375,N00038285,Jodey Arrington (R),2016,Oil & Gas,41550,36000,77550
A000375,N00038285,Jodey Arrington (R),2016,Real Estate,58950,13000,71950
A000375,N00038285,Jodey Arrington (R),2016,Health Professionals,49372,15500,64872
A000375,N00038285,Jodey Arrington (R),2016,Lawyers/Law Firms,57624,5000,62624
A000375,N00038285,Jodey Arrington (R),2016,Livestock,35315,23500,58815
A000375,N00038285,Jodey Arrington (R),2016,Automotive,19400,14000,33400
H001076,N00038397,Maggie Hassan (D),2016,Women's Issues,1689794,55835,1745629
H001076,N00038397,Maggie Hassan (D),2016,Retired,1585895,0,1585895
H001076,N00038397,Maggie Hassan (D),2016,Democratic/Liberal,1539380,19505,1558885
H001076,N00038397,Maggie Hassan (D),2016,Lawyers/Law Firms,1406609,17833,1424442
H001076,N00038397,Maggie Hassan (D),2016,Education,712632,0,712632
H001076,N00038397,Maggie Hassan (D),2016,Real Estate,418436,0,418436
H001076,N00038397,Maggie Hassan (D),2016,Securities & Investment,414125,0,414125
H001076,N00038397,Maggie Hassan (D),2016,Leadership PACs,5400,382250,387650
H001076,N00038397,Maggie Hassan (D),2016,Business Services,306422,0,306422
H001076,N00038397,Maggie Hassan (D),2016,Pro-Israel,288769,7209,295978
L000587,N00038400,Jason Lewis (R),2016,Leadership PACs,0,99000,99000
L000587,N00038400,Jason Lewis (R),2016,Retired,98723,0,98723
L000587,N00038400,Jason Lewis (R),2016,Republican/Conservative,22875,13600,36475
L000587,N00038400,Jason Lewis (R),2016,Candidate Committees,0,34000,34000
L000587,N00038400,Jason Lewis (R),2016,Insurance,20850,7500,28350
L000587,N00038400,Jason Lewis (R),2016,Real Estate,16300,3500,19800
L000587,N00038400,Jason Lewis (R),2016,Retail Sales,18410,0,18410
L000587,N00038400,Jason Lewis (R),2016,TV/Movies/Music,14800,3000,17800
L000587,N00038400,Jason Lewis (R),2016,Electronics Mfg & Equip,14350,0,14350
L000587,N00038400,Jason Lewis (R),2016,Commercial Banks,6100,7500,13600
B001303,N00038414,Lisa Blunt Rochester (D),2016,Women's Issues,74508,5500,80008
B001303,N00038414,Lisa Blunt Rochester (D),2016,Leadership PACs,0,68150,68150
B001303,N00038414,Lisa Blunt Rochester (D),2016,Retired,62611,0,62611
B001303,N00038414,Lisa Blunt Rochester (D),2016,Lawyers/Law Firms,42590,10500,53090
B001303,N00038414,Lisa Blunt Rochester (D),2016,Human Rights,22508,13214,35722
B001303,N00038414,Lisa Blunt Rochester (D),2016,Public Sector Unions,0,32000,32000
B001303,N00038414,Lisa Blunt Rochester (D),2016,Industrial Unions,0,29500,29500
B001303,N00038414,Lisa Blunt Rochester (D),2016,Health Professionals,11075,15500,26575
B001303,N00038414,Lisa Blunt Rochester (D),2016,Commercial Banks,7550,18500,26050
B001303,N00038414,Lisa Blunt Rochester (D),2016,Candidate Committees,0,24814,24814
H001074,N00038429,Trey Hollingsworth (R),2016,Leadership PACs,0,81200,81200
H001074,N00038429,Trey Hollingsworth (R),2016,Candidate Committees,0,20541,20541
H001074,N00038429,Trey Hollingsworth (R),2016,General Contractors,7400,7500,14900
H001074,N00038429,Trey Hollingsworth (R),2016,Automotive,5000,9500,14500
H001074,N00038429,Trey Hollingsworth (R),2016,Republican/Conservative,5954,8000,13954
H001074,N00038429,Trey Hollingsworth (R),2016,Real Estate,11350,2500,13850
H001074,N00038429,Trey Hollingsworth (R),2016,Commercial Banks,0,13500,13500
H001074,N00038429,Trey Hollingsworth (R),2016,Oil & Gas,0,12500,12500
H001074,N00038429,Trey Hollingsworth (R),2016,Telecom Services,2700,7500,10200
H001074,N00038429,Trey Hollingsworth (R),2016,Retail Sales,0,10000,10000
H001074,N00038429,Trey Hollingsworth (R),2016,Livestock,0,10000,10000
E000296,N00038450,Dwight Evans (D),2016,Lawyers/Law Firms,143898,22324,166222
E000296,N00038450,Dwight Evans (D),2016,Real Estate,86341,13000,99341
E000296,N00038450,Dwight Evans (D),2016,Building Trade Unions,250,50500,50750
E000296,N00038450,Dwight Evans (D),2016,Public Sector Unions,950,35000,35950
E000296,N00038450,Dwight Evans (D),2016,Insurance,22500,13000,35500
E000296,N00038450,Dwight Evans (D),2016,Democratic/Liberal,34322,1000,35322
E000296,N00038450,Dwight Evans (D),2016,Lobbyists,31100,1000,32100
E000296,N00038450,Dwight Evans (D),2016,Civil Servants/Public Officials,28087,0,28087
E000296,N00038450,Dwight Evans (D),2016,Food Processing & Sales,25825,2250,28075
E000296,N00038450,Dwight Evans (D),2016,Industrial Unions,0,28000,28000
P000613,N00038601,Jimmy Panetta (D),2016,Retired,182734,0,182734
P000613,N00038601,Jimmy Panetta (D),2016,Lawyers/Law Firms,76074,11000,87074
P000613,N00038601,Jimmy Panetta (D),2016,Crop Production & Basic Processing,59050,25924,84974
P000613,N00038601,Jimmy Panetta (D),2016,Real Estate,60098,10000,70098
P000613,N00038601,Jimmy Panetta (D),2016,Lobbyists,42620,0,42620
P000613,N00038601,Jimmy Panetta (D),2016,Public Sector Unions,0,38500,38500
P000613,N00038601,Jimmy Panetta (D),2016,Building Trade Unions,0,37500,37500
P000613,N00038601,Jimmy Panetta (D),2016,Securities & Investment,25250,4000,29250
P000613,N00038601,Jimmy Panetta (D),2016,Leadership PACs,0,28417,28417
P000613,N00038601,Jimmy Panetta (D),2016,Health Professionals,15350,12000,27350
R000608,N00038734,Jacky Rosen (D),2016,Leadership PACs,12900,149085,161985
R000608,N00038734,Jacky Rosen (D),2016,Women's Issues,104148,16500,120648
R000608,N00038734,Jacky Rosen (D),2016,Lawyers/Law Firms,73456,5100,78556
R000608,N00038734,Jacky Rosen (D),2016,Real Estate,60247,2500,62747
R000608,N00038734,Jacky Rosen (D),2016,Democratic/Liberal,57170,4000,61170
R000608,N00038734,Jacky Rosen (D),2016,Candidate Committees,0,59500,59500
R000608,N00038734,Jacky Rosen (D),2016,Retired,56188,0,56188
R000608,N00038734,Jacky Rosen (D),2016,Pro-Israel,40570,12633,53203
R000608,N00038734,Jacky Rosen (D),2016,Public Sector Unions,0,51000,51000
R000608,N00038734,Jacky Rosen (D),2016,Environment,35319,9384,44703
S001201,N00038742,Tom Suozzi (D),2016,Real Estate,237812,2000,239812
S001201,N00038742,Tom Suozzi (D),2016,Lawyers/Law Firms,219183,7750,226933
S001201,N00038742,Tom Suozzi (D),2016,Retired,174648,0,174648
S001201,N00038742,Tom Suozzi (D),2016,Securities & Investment,111263,0,111263
S001201,N00038742,Tom Suozzi (D),2016,Leadership PACs,0,78200,78200
S001201,N00038742,Tom Suozzi (D),2016,Insurance,37750,10000,47750
S001201,N00038742,Tom Suozzi (D),2016,Candidate Committees,0,44218,44218
S001201,N00038742,Tom Suozzi (D),2016,Health Professionals,41402,2500,43902
S001201,N00038742,Tom Suozzi (D),2016,Pro-Israel,34100,4000,38100
S001201,N00038742,Tom Suozzi (D),2016,Business Services,36027,0,36027
D000626,N00038767,Warren Davidson (R),2016,Republican/Conservative,79442,11242,90684
D000626,N00038767,Warren Davidson (R),2016,Leadership PACs,26900,35000,61900
D000626,N00038767,Warren Davidson (R),2016,Retired,40061,0,40061
D000626,N00038767,Warren Davidson (R),2016,Misc Manufacturing & Distributing,27220,5500,32720
D000626,N00038767,Warren Davidson (R),2016,Securities & Investment,30403,0,30403
D000626,N00038767,Warren Davidson (R),2016,Misc Finance,27055,0,27055
D000626,N00038767,Warren Davidson (R),2016,Non-Profit Institutions,22600,0,22600
D000626,N00038767,Warren Davidson (R),2016,Accountants,19363,0,19363
D000626,N00038767,Warren Davidson (R),2016,Real Estate,7845,5000,12845
D000626,N00038767,Warren Davidson (R),2016,Misc Business,11642,1000,12642
F000466,N00038779,Brian Fitzpatrick (R),2016,Leadership PACs,0,202950,202950
F000466,N00038779,Brian Fitzpatrick (R),2016,Retired,116041,0,116041
F000466,N00038779,Brian Fitzpatrick (R),2016,Lawyers/Law Firms,85656,8000,93656
F000466,N00038779,Brian Fitzpatrick (R),2016,Health Professionals,21975,50000,71975
F000466,N00038779,Brian Fitzpatrick (R),2016,Real Estate,48350,18000,66350
F000466,N00038779,Brian Fitzpatrick (R),2016,Securities & Investment,62575,2700,65275
F000466,N00038779,Brian Fitzpatrick (R),2016,Candidate Committees,0,55000,55000
F000466,N00038779,Brian Fitzpatrick (R),2016,Insurance,20350,30700,51050
F000466,N00038779,Brian Fitzpatrick (R),2016,Accountants,5100,37000,42100
F000466,N00038779,Brian Fitzpatrick (R),2016,Republican/Conservative,18647,22500,41147
S001199,N00038781,Lloyd Smucker (R),2016,Leadership PACs,0,134100,134100
S001199,N00038781,Lloyd Smucker (R),2016,Retired,88750,0,88750
S001199,N00038781,Lloyd Smucker (R),2016,General Contractors,74050,14000,88050
S001199,N00038781,Lloyd Smucker (R),2016,Health Professionals,4000,34500,38500
S001199,N00038781,Lloyd Smucker (R),2016,Candidate Committees,3000,28500,31500
S001199,N00038781,Lloyd Smucker (R),2016,Real Estate,19000,12000,31000
S001199,N00038781,Lloyd Smucker (R),2016,Republican/Conservative,5200,25000,30200
S001199,N00038781,Lloyd Smucker (R),2016,Agricultural Services/Products,17500,12500,30000
S001199,N00038781,Lloyd Smucker (R),2016,Lawyers/Law Firms,12750,11500,24250
S001199,N00038781,Lloyd Smucker (R),2016,Crop Production & Basic Processing,21600,1250,22850
G000581,N00038809,Vicente Gonzalez (D),2016,Lawyers/Law Firms,58450,5000,63450
G000581,N00038809,Vicente Gonzalez (D),2016,Leadership PACs,0,41600,41600
G000581,N00038809,Vicente Gonzalez (D),2016,Human Rights,15650,17662,33312
G000581,N00038809,Vicente Gonzalez (D),2016,Building Trade Unions,0,25000,25000
G000581,N00038809,Vicente Gonzalez (D),2016,Public Sector Unions,0,21000,21000
G000581,N00038809,Vicente Gonzalez (D),2016,Crop Production & Basic Processing,3250,17000,20250
G000581,N00038809,Vicente Gonzalez (D),2016,Industrial Unions,0,20000,20000
G000581,N00038809,Vicente Gonzalez (D),2016,Hospitals/Nursing Homes,3500,16000,19500
G000581,N00038809,Vicente Gonzalez (D),2016,Candidate Committees,0,19012,19012
G000581,N00038809,Vicente Gonzalez (D),2016,Real Estate,4250,8500,12750
G000580,N00038847,Tom Garrett (R),2016,Leadership PACs,0,81500,81500
G000580,N00038847,Tom Garrett (R),2016,Retired,52575,0,52575
G000580,N00038847,Tom Garrett (R),2016,Candidate Committees,0,25000,25000
G000580,N00038847,Tom Garrett (R),2016,Business Services,24040,0,24040
G000580,N00038847,Tom Garrett (R),2016,Crop Production & Basic Processing,13950,5000,18950
G000580,N00038847,Tom Garrett (R),2016,Republican/Conservative,11000,7600,18600
G000580,N00038847,Tom Garrett (R),2016,"Beer, Wine & Liquor",6000,10000,16000
G000580,N00038847,Tom Garrett (R),2016,Automotive,3700,10000,13700
G000580,N00038847,Tom Garrett (R),2016,Electric Utilities,1500,11000,12500
G000580,N00038847,Tom Garrett (R),2016,Oil & Gas,6400,6000,12400
J000298,N00038858,Pramila Jayapal (D),2016,Democratic/Liberal,133841,3976,137817
J000298,N00038858,Pramila Jayapal (D),2016,Women's Issues,118326,11000,129326
J000298,N00038858,Pramila Jayapal (D),2016,Retired,115351,0,115351
J000298,N00038858,Pramila Jayapal (D),2016,Human Rights,46947,28200,75147
J000298,N00038858,Pramila Jayapal (D),2016,Lawyers/Law Firms,64142,5000,69142
J000298,N00038858,Pramila Jayapal (D),2016,Building Trade Unions,2000,59000,61000
J000298,N00038858,Pramila Jayapal (D),2016,Public Sector Unions,4725,50500,55225
J000298,N00038858,Pramila Jayapal (D),2016,Securities & Investment,52600,0,52600
J000298,N00038858,Pramila Jayapal (D),2016,Leadership PACs,0,51200,51200
J000298,N00038858,Pramila Jayapal (D),2016,Misc Unions,6973,42000,48973
F000465,N00039090,Drew Ferguson (R),2016,Health Professionals,210880,83500,294380
F000465,N00039090,Drew Ferguson (R),2016,Leadership PACs,0,103866,103866
F000465,N00039090,Drew Ferguson (R),2016,Retired,84205,0,84205
F000465,N00039090,Drew Ferguson (R),2016,Insurance,21200,20500,41700
F000465,N00039090,Drew Ferguson (R),2016,Real Estate,27450,5000,32450
F000465,N00039090,Drew Ferguson (R),2016,Commercial Banks,10650,21000,31650
F000465,N00039090,Drew Ferguson (R),2016,General Contractors,22150,7500,29650
F000465,N00039090,Drew Ferguson (R),2016,Candidate Committees,1000,27500,28500
F000465,N00039090,Drew Ferguson (R),2016,Lawyers/Law Firms,23434,4000,27434
F000465,N00039090,Drew Ferguson (R),2016,Building Materials & Equipment,14750,10500,25250
J000299,N00039106,Mike Johnson (R),2016,Republican/Conservative,83822,16600,100422
J000299,N00039106,Mike Johnson (R),2016,Retired,57087,0,57087
J000299,N00039106,Mike Johnson (R),2016,Health Professionals,56050,0,56050
J000299,N00039106,Mike Johnson (R),2016,Leadership PACs,18300,37000,55300
J000299,N00039106,Mike Johnson (R),2016,Oil & Gas,35500,16500,52000
J000299,N00039106,Mike Johnson (R),2016,Securities & Investment,36400,0,36400
J000299,N00039106,Mike Johnson (R),2016,Lawyers/Law Firms,27485,7000,34485
J000299,N00039106,Mike Johnson (R),2016,General Contractors,22000,8500,30500
J000299,N00039106,Mike Johnson (R),2016,Real Estate,25404,5000,30404
J000299,N00039106,Mike Johnson (R),2016,Hospitals/Nursing Homes,23100,0,23100
B001302,N00039293,Andy Biggs (R),2016,Republican/Conservative,74522,17150,91672
B001302,N00039293,Andy Biggs (R),2016,Retired,57510,0,57510
B001302,N00039293,Andy Biggs (R),2016,Leadership PACs,6650,42000,48650
B001302,N00039293,Andy Biggs (R),2016,Real Estate,33550,6000,39550
B001302,N00039293,Andy Biggs (R),2016,Candidate Committees,0,32000,32000
B001302,N00039293,Andy Biggs (R),2016,Health Professionals,14200,10500,24700
B001302,N00039293,Andy Biggs (R),2016,Finance/Credit Companies,17200,5000,22200
B001302,N00039293,Andy Biggs (R),2016,Automotive,13800,7500,21300
B001302,N00039293,Andy Biggs (R),2016,Home Builders,10000,10500,20500
B001302,N00039293,Andy Biggs (R),2016,Electric Utilities,4600,15000,19600
M001200,N00039327,Donald McEachin (D),2016,Lawyers/Law Firms,89306,14000,103306
M001200,N00039327,Donald McEachin (D),2016,Leadership PACs,0,57000,57000
M001200,N00039327,Donald McEachin (D),2016,Retired,43819,0,43819
M001200,N00039327,Donald McEachin (D),2016,Public Sector Unions,0,35000,35000
M001200,N00039327,Donald McEachin (D),2016,Building Trade Unions,0,33500,33500
M001200,N00039327,Donald McEachin (D),2016,Candidate Committees,0,24250,24250
M001200,N00039327,Donald McEachin (D),2016,Industrial Unions,0,24000,24000
M001200,N00039327,Donald McEachin (D),2016,Real Estate,14845,8500,23345
M001200,N00039327,Donald McEachin (D),2016,Democratic/Liberal,19158,2500,21658
M001200,N00039327,Donald McEachin (D),2016,Human Rights,5660,13000,18660
G000579,N00039330,Mike Gallagher (R),2016,Retired,293592,0,293592
G000579,N00039330,Mike Gallagher (R),2016,Securities & Investment,267397,0,267397
G000579,N00039330,Mike Gallagher (R),2016,Leadership PACs,0,184500,184500
G000579,N00039330,Mike Gallagher (R),2016,Real Estate,119290,11000,130290
G000579,N00039330,Mike Gallagher (R),2016,Health Professionals,107530,18500,126030
G000579,N00039330,Mike Gallagher (R),2016,Lawyers/Law Firms,91884,2000,93884
G000579,N00039330,Mike Gallagher (R),2016,Republican/Conservative,44591,30500,75091
G000579,N00039330,Mike Gallagher (R),2016,Misc Finance,69000,2000,71000
G000579,N00039330,Mike Gallagher (R),2016,General Contractors,45850,12900,58750
G000579,N00039330,Mike Gallagher (R),2016,Candidate Committees,0,58500,58500
G000578,N00039503,Matt Gaetz (R),2016,Real Estate,63500,12318,75818
G000578,N00039503,Matt Gaetz (R),2016,Retired,54263,0,54263
G000578,N00039503,Matt Gaetz (R),2016,Leadership PACs,0,51000,51000
G000578,N00039503,Matt Gaetz (R),2016,Health Professionals,33750,16000,49750
G000578,N00039503,Matt Gaetz (R),2016,"Beer, Wine & Liquor",37000,7500,44500
G000578,N00039503,Matt Gaetz (R),2016,Crop Production & Basic Processing,20400,8000,28400
G000578,N00039503,Matt Gaetz (R),2016,Food & Beverage,24106,1000,25106
G000578,N00039503,Matt Gaetz (R),2016,Lawyers/Law Firms,23050,2000,25050
G000578,N00039503,Matt Gaetz (R),2016,Marijuana,21600,0,21600
G000578,N00039503,Matt Gaetz (R),2016,Lobbyists,17250,1000,18250
B001301,N00039533,John Bergman (R),2016,Leadership PACs,0,143000,143000
B001301,N00039533,John Bergman (R),2016,Retired,87018,0,87018
B001301,N00039533,John Bergman (R),2016,Candidate Committees,0,37000,37000
B001301,N00039533,John Bergman (R),2016,Republican/Conservative,6675,25000,31675
B001301,N00039533,John Bergman (R),2016,Real Estate,22450,5000,27450
B001301,N00039533,John Bergman (R),2016,Retail Sales,21000,5000,26000
B001301,N00039533,John Bergman (R),2016,Insurance,6100,16000,22100
B001301,N00039533,John Bergman (R),2016,Securities & Investment,22050,0,22050
B001301,N00039533,John Bergman (R),2016,Misc Business,14870,6000,20870
B001301,N00039533,John Bergman (R),2016,Automotive,16200,4495,20695
B001305,N00039551,Ted Budd (R),2016,Leadership PACs,13200,58000,71200
B001305,N00039551,Ted Budd (R),2016,Retired,44950,0,44950
B001305,N00039551,Ted Budd (R),2016,Republican/Conservative,33723,5000,38723
B001305,N00039551,Ted Budd (R),2016,Candidate Committees,0,23500,23500
B001305,N00039551,Ted Budd (R),2016,Trucking,18600,0,18600
B001305,N00039551,Ted Budd (R),2016,Gun Rights,8900,7000,15900
B001305,N00039551,Ted Budd (R),2016,Misc Finance,11900,2500,14400
B001305,N00039551,Ted Budd (R),2016,Real Estate,7950,5000,12950
B001305,N00039551,Ted Budd (R),2016,General Contractors,7800,5000,12800
B001305,N00039551,Ted Budd (R),2016,Retail Sales,1500,10000,11500
R000609,N00039777,John Rutherford (R),2016,Retired,70429,0,70429
R000609,N00039777,John Rutherford (R),2016,Real Estate,44900,5000,49900
R000609,N00039777,John Rutherford (R),2016,Railroads,23600,7500,31100
R000609,N00039777,John Rutherford (R),2016,Insurance,20050,10000,30050
R000609,N00039777,John Rutherford (R),2016,Leadership PACs,0,23000,23000
R000609,N00039777,John Rutherford (R),2016,Misc Defense,8100,9000,17100
R000609,N00039777,John Rutherford (R),2016,Special Trade Contractors,15500,0,15500
R000609,N00039777,John Rutherford (R),2016,Civil Servants/Public Officials,14350,0,14350
R000609,N00039777,John Rutherford (R),2016,Misc Manufacturing & Distributing,3250,10000,13250
R000609,N00039777,John Rutherford (R),2016,Forestry & Forest Products,8100,5000,13100
H001077,N00039953,Clay Higgins (R),2016,Leadership PACs,0,33000,33000
H001077,N00039953,Clay Higgins (R),2016,Retired,27035,0,27035
H001077,N00039953,Clay Higgins (R),2016,Lawyers/Law Firms,17850,0,17850
H001077,N00039953,Clay Higgins (R),2016,Republican/Conservative,1750,13450,15200
H001077,N00039953,Clay Higgins (R),2016,Construction Services,11050,0,11050
H001077,N00039953,Clay Higgins (R),2016,Food & Beverage,10035,0,10035
H001077,N00039953,Clay Higgins (R),2016,Real Estate,6200,2500,8700
H001077,N00039953,Clay Higgins (R),2016,Health Professionals,7200,0,7200
H001077,N00039953,Clay Higgins (R),2016,Crop Production & Basic Processing,5950,0,5950
H001077,N00039953,Clay Higgins (R),2016,Automotive,5600,0,5600
R000607,N00040007,Francis Rooney (R),2016,Retired,282480,0,282480
R000607,N00040007,Francis Rooney (R),2016,General Contractors,72795,0,72795
R000607,N00040007,Francis Rooney (R),2016,Real Estate,67287,0,67287
R000607,N00040007,Francis Rooney (R),2016,Securities & Investment,40350,0,40350
R000607,N00040007,Francis Rooney (R),2016,Republican/Conservative,28400,1000,29400
R000607,N00040007,Francis Rooney (R),2016,Lawyers/Law Firms,27515,0,27515
R000607,N00040007,Francis Rooney (R),2016,Misc Finance,26150,0,26150
R000607,N00040007,Francis Rooney (R),2016,Oil & Gas,16200,0,16200
R000607,N00040007,Francis Rooney (R),2016,Commercial Banks,9400,2500,11900
R000607,N00040007,Francis Rooney (R),2016,Civil Servants/Public Officials,11200,0,11200
M001202,N00040133,Stephanie Murphy (D),2016,Leadership PACs,8700,145700,154400
M001202,N00040133,Stephanie Murphy (D),2016,Democratic/Liberal,64458,11500,75958
M001202,N00040133,Stephanie Murphy (D),2016,Women's Issues,46985,15750,62735
M001202,N00040133,Stephanie Murphy (D),2016,Candidate Committees,0,55831,55831
M001202,N00040133,Stephanie Murphy (D),2016,Securities & Investment,47975,0,47975
M001202,N00040133,Stephanie Murphy (D),2016,Education,33475,5000,38475
M001202,N00040133,Stephanie Murphy (D),2016,Lawyers/Law Firms,28301,5500,33801
M001202,N00040133,Stephanie Murphy (D),2016,Public Sector Unions,0,33000,33000
M001202,N00040133,Stephanie Murphy (D),2016,Retired,31397,0,31397
M001202,N00040133,Stephanie Murphy (D),2016,Transportation Unions,0,29000,29000
