bioguide_id,crp_id,cand_name,cycle,sector_name,indivs,pacs,totals
A000210,N00000826,Robert E Andrews (D),2012,Agribusiness,11600,5500,17100
A000210,N00000826,Robert E Andrews (D),2012,Communic/Electronics,16275,16500,32775
A000210,N00000826,Robert E Andrews (D),2012,Construction,24700,28250,52950
A000210,N00000826,Robert E Andrews (D),2012,Defense,10600,105000,115600
A000210,N00000826,Robert E Andrews (D),2012,Energy/Nat Resource,13100,23000,36100
A000210,N00000826,Robert E Andrews (D),2012,Finance/Insur/RealEst,73225,81941,155166
A000210,N00000826,Robert E Andrews (D),2012,Health,32300,61000,93300
A000210,N00000826,Robert E Andrews (D),2012,Lawyers & Lobbyists,133248,58750,191998
A000210,N00000826,Robert E Andrews (D),2012,Transportation,3450,21000,24450
A000210,N00000826,Robert E Andrews (D),2012,Misc Business,70450,39825,110275
A000210,N00000826,Robert E Andrews (D),2012,Labor,0,211250,211250
A000210,N00000826,Robert E Andrews (D),2012,Ideology/Single-Issue,35575,34500,70075
A000210,N00000826,Robert E Andrews (D),2012,Other,106650,35101,141751
B000490,N00002674,Sanford D Bishop Jr (D),2012,Agribusiness,13250,178680,191930
B000490,N00002674,Sanford D Bishop Jr (D),2012,Communic/Electronics,12750,35000,47750
B000490,N00002674,Sanford D Bishop Jr (D),2012,Construction,4750,4000,8750
B000490,N00002674,Sanford D Bishop Jr (D),2012,Defense,1000,67500,68500
B000490,N00002674,Sanford D Bishop Jr (D),2012,Energy/Nat Resource,3750,30750,34500
B000490,N00002674,Sanford D Bishop Jr (D),2012,Finance/Insur/RealEst,44500,73750,118250
B000490,N00002674,Sanford D Bishop Jr (D),2012,Health,33780,50400,84180
B000490,N00002674,Sanford D Bishop Jr (D),2012,Lawyers & Lobbyists,89643,30400,120043
B000490,N00002674,Sanford D Bishop Jr (D),2012,Transportation,2250,36500,38750
B000490,N00002674,Sanford D Bishop Jr (D),2012,Misc Business,32800,94000,126800
B000490,N00002674,Sanford D Bishop Jr (D),2012,Labor,0,141500,141500
B000490,N00002674,Sanford D Bishop Jr (D),2012,Ideology/Single-Issue,3750,68400,72150
B000490,N00002674,Sanford D Bishop Jr (D),2012,Other,60336,500,60836
B000911,N00002713,Corrine Brown (D),2012,Agribusiness,5500,5500,11000
B000911,N00002713,Corrine Brown (D),2012,Communic/Electronics,4200,19000,23200
B000911,N00002713,Corrine Brown (D),2012,Construction,23000,9500,32500
B000911,N00002713,Corrine Brown (D),2012,Energy/Nat Resource,2433,4500,6933
B000911,N00002713,Corrine Brown (D),2012,Finance/Insur/RealEst,24150,12010,36160
B000911,N00002713,Corrine Brown (D),2012,Health,8000,14500,22500
B000911,N00002713,Corrine Brown (D),2012,Lawyers & Lobbyists,55300,8000,63300
B000911,N00002713,Corrine Brown (D),2012,Transportation,17450,99000,116450
B000911,N00002713,Corrine Brown (D),2012,Misc Business,12050,13500,25550
B000911,N00002713,Corrine Brown (D),2012,Labor,0,113500,113500
B000911,N00002713,Corrine Brown (D),2012,Ideology/Single-Issue,500,29500,30000
B000911,N00002713,Corrine Brown (D),2012,Other,21650,2000,23650
A000055,N00003028,Robert B Aderholt (R),2012,Agribusiness,7997,56000,63997
A000055,N00003028,Robert B Aderholt (R),2012,Communic/Electronics,20800,51000,71800
A000055,N00003028,Robert B Aderholt (R),2012,Construction,42500,21500,64000
A000055,N00003028,Robert B Aderholt (R),2012,Defense,27500,130000,157500
A000055,N00003028,Robert B Aderholt (R),2012,Energy/Nat Resource,9196,58500,67696
A000055,N00003028,Robert B Aderholt (R),2012,Finance/Insur/RealEst,56479,60500,116979
A000055,N00003028,Robert B Aderholt (R),2012,Health,33635,45500,79135
A000055,N00003028,Robert B Aderholt (R),2012,Lawyers & Lobbyists,51746,36000,87746
A000055,N00003028,Robert B Aderholt (R),2012,Transportation,64844,35000,99844
A000055,N00003028,Robert B Aderholt (R),2012,Misc Business,48491,68250,116741
A000055,N00003028,Robert B Aderholt (R),2012,Labor,0,6000,6000
A000055,N00003028,Robert B Aderholt (R),2012,Ideology/Single-Issue,1000,34250,35250
A000055,N00003028,Robert B Aderholt (R),2012,Other,19393,1000,20393
B000944,N00003535,Sherrod Brown (D),2012,Agribusiness,93325,107757,201082
B000944,N00003535,Sherrod Brown (D),2012,Communic/Electronics,504029,119250,623279
B000944,N00003535,Sherrod Brown (D),2012,Construction,229472,66300,295772
B000944,N00003535,Sherrod Brown (D),2012,Defense,32850,75500,108350
B000944,N00003535,Sherrod Brown (D),2012,Energy/Nat Resource,136910,142500,279410
B000944,N00003535,Sherrod Brown (D),2012,Finance/Insur/RealEst,1241088,425518,1666606
B000944,N00003535,Sherrod Brown (D),2012,Health,968085,486700,1454785
B000944,N00003535,Sherrod Brown (D),2012,Lawyers & Lobbyists,2320419,219004,2539423
B000944,N00003535,Sherrod Brown (D),2012,Transportation,92650,69000,161650
B000944,N00003535,Sherrod Brown (D),2012,Misc Business,748822,288416,1037238
B000944,N00003535,Sherrod Brown (D),2012,Labor,31656,466500,498156
B000944,N00003535,Sherrod Brown (D),2012,Ideology/Single-Issue,1362033,583097,1945130
B000944,N00003535,Sherrod Brown (D),2012,Other,2281468,31550,2313018
B000589,N00003675,John Boehner (R),2012,Agribusiness,525040,205000,730040
B000589,N00003675,John Boehner (R),2012,Communic/Electronics,443541,174665,618206
B000589,N00003675,John Boehner (R),2012,Construction,588799,89000,677799
B000589,N00003675,John Boehner (R),2012,Defense,45100,84250,129350
B000589,N00003675,John Boehner (R),2012,Energy/Nat Resource,1007766,359000,1366766
B000589,N00003675,John Boehner (R),2012,Finance/Insur/RealEst,2900305,572800,3473105
B000589,N00003675,John Boehner (R),2012,Health,879182,412250,1291432
B000589,N00003675,John Boehner (R),2012,Lawyers & Lobbyists,801402,87406,888808
B000589,N00003675,John Boehner (R),2012,Transportation,326575,133250,459825
B000589,N00003675,John Boehner (R),2012,Misc Business,1472209,455222,1927431
B000589,N00003675,John Boehner (R),2012,Labor,250,43500,43750
B000589,N00003675,John Boehner (R),2012,Ideology/Single-Issue,629636,64500,694136
B000589,N00003675,John Boehner (R),2012,Other,1436181,12250,1448431
B000243,N00004643,Max Baucus (D),2012,Agribusiness,219819,431500,651319
B000243,N00004643,Max Baucus (D),2012,Communic/Electronics,171993,333272,505265
B000243,N00004643,Max Baucus (D),2012,Construction,115175,204065,319240
B000243,N00004643,Max Baucus (D),2012,Defense,23400,84000,107400
B000243,N00004643,Max Baucus (D),2012,Energy/Nat Resource,210778,508800,719578
B000243,N00004643,Max Baucus (D),2012,Finance/Insur/RealEst,1671179,867116,2538295
B000243,N00004643,Max Baucus (D),2012,Health,863579,1298218,2161797
B000243,N00004643,Max Baucus (D),2012,Lawyers & Lobbyists,1030381,233603,1263984
B000243,N00004643,Max Baucus (D),2012,Transportation,123088,290300,413388
B000243,N00004643,Max Baucus (D),2012,Misc Business,608047,590100,1198147
B000243,N00004643,Max Baucus (D),2012,Labor,2652,236025,238677
B000243,N00004643,Max Baucus (D),2012,Ideology/Single-Issue,163900,226475,390375
B000243,N00004643,Max Baucus (D),2012,Other,292385,16000,308385
B000575,N00005195,Roy Blunt (R),2012,Agribusiness,407000,318191,725191
B000575,N00005195,Roy Blunt (R),2012,Communic/Electronics,249201,257686,506887
B000575,N00005195,Roy Blunt (R),2012,Construction,314185,111000,425185
B000575,N00005195,Roy Blunt (R),2012,Defense,26400,74000,100400
B000575,N00005195,Roy Blunt (R),2012,Energy/Nat Resource,478558,377750,856308
B000575,N00005195,Roy Blunt (R),2012,Finance/Insur/RealEst,1804450,563800,2368250
B000575,N00005195,Roy Blunt (R),2012,Health,570872,449250,1020122
B000575,N00005195,Roy Blunt (R),2012,Lawyers & Lobbyists,733627,131600,865227
B000575,N00005195,Roy Blunt (R),2012,Transportation,371886,210350,582236
B000575,N00005195,Roy Blunt (R),2012,Misc Business,1149911,479750,1629661
B000575,N00005195,Roy Blunt (R),2012,Labor,2900,13500,16400
B000575,N00005195,Roy Blunt (R),2012,Ideology/Single-Issue,238444,757164,995608
B000575,N00005195,Roy Blunt (R),2012,Other,798035,6000,804035
B000213,N00005656,Joe Barton (R),2012,Agribusiness,8300,22547,30847
B000213,N00005656,Joe Barton (R),2012,Communic/Electronics,23050,75600,98650
B000213,N00005656,Joe Barton (R),2012,Construction,18050,5500,23550
B000213,N00005656,Joe Barton (R),2012,Defense,2500,13000,15500
B000213,N00005656,Joe Barton (R),2012,Energy/Nat Resource,75600,264500,340100
B000213,N00005656,Joe Barton (R),2012,Finance/Insur/RealEst,61150,57500,118650
B000213,N00005656,Joe Barton (R),2012,Health,50400,108800,159200
B000213,N00005656,Joe Barton (R),2012,Lawyers & Lobbyists,38192,35750,73942
B000213,N00005656,Joe Barton (R),2012,Transportation,10750,50500,61250
B000213,N00005656,Joe Barton (R),2012,Misc Business,87450,88353,175803
B000213,N00005656,Joe Barton (R),2012,Labor,0,1300,1300
B000213,N00005656,Joe Barton (R),2012,Ideology/Single-Issue,2000,19600,21600
B000213,N00005656,Joe Barton (R),2012,Other,23100,0,23100
B000755,N00005883,Kevin Brady (R),2012,Agribusiness,1000,83897,84897
B000755,N00005883,Kevin Brady (R),2012,Communic/Electronics,2750,74000,76750
B000755,N00005883,Kevin Brady (R),2012,Construction,7500,29000,36500
B000755,N00005883,Kevin Brady (R),2012,Defense,0,24000,24000
B000755,N00005883,Kevin Brady (R),2012,Energy/Nat Resource,15665,185500,201165
B000755,N00005883,Kevin Brady (R),2012,Finance/Insur/RealEst,28350,282439,310789
B000755,N00005883,Kevin Brady (R),2012,Health,37200,164250,201450
B000755,N00005883,Kevin Brady (R),2012,Lawyers & Lobbyists,47700,31318,79018
B000755,N00005883,Kevin Brady (R),2012,Transportation,18500,55999,74499
B000755,N00005883,Kevin Brady (R),2012,Misc Business,31967,144250,176217
B000755,N00005883,Kevin Brady (R),2012,Labor,0,4500,4500
B000755,N00005883,Kevin Brady (R),2012,Ideology/Single-Issue,1500,12500,14000
B000755,N00005883,Kevin Brady (R),2012,Other,11400,2500,13900
B000711,N00006692,Barbara Boxer (D),2012,Agribusiness,112400,107300,219700
B000711,N00006692,Barbara Boxer (D),2012,Communic/Electronics,1616893,244031,1860924
B000711,N00006692,Barbara Boxer (D),2012,Construction,238429,187866,426295
B000711,N00006692,Barbara Boxer (D),2012,Defense,14400,11500,25900
B000711,N00006692,Barbara Boxer (D),2012,Energy/Nat Resource,178600,154399,332999
B000711,N00006692,Barbara Boxer (D),2012,Finance/Insur/RealEst,1571246,95941,1667187
B000711,N00006692,Barbara Boxer (D),2012,Health,611840,126200,738040
B000711,N00006692,Barbara Boxer (D),2012,Lawyers & Lobbyists,2396670,156968,2553638
B000711,N00006692,Barbara Boxer (D),2012,Transportation,80099,156558,236657
B000711,N00006692,Barbara Boxer (D),2012,Misc Business,1267534,114702,1382236
B000711,N00006692,Barbara Boxer (D),2012,Labor,13950,414600,428550
B000711,N00006692,Barbara Boxer (D),2012,Ideology/Single-Issue,2238102,675171,2913273
B000711,N00006692,Barbara Boxer (D),2012,Other,2365320,4500,2369820
B000574,N00007727,Earl Blumenauer (D),2012,Agribusiness,4623,10250,14873
B000574,N00007727,Earl Blumenauer (D),2012,Communic/Electronics,14125,22250,36375
B000574,N00007727,Earl Blumenauer (D),2012,Construction,31460,110000,141460
B000574,N00007727,Earl Blumenauer (D),2012,Defense,0,7000,7000
B000574,N00007727,Earl Blumenauer (D),2012,Energy/Nat Resource,17900,37255,55155
B000574,N00007727,Earl Blumenauer (D),2012,Finance/Insur/RealEst,84869,85000,169869
B000574,N00007727,Earl Blumenauer (D),2012,Health,12815,141750,154565
B000574,N00007727,Earl Blumenauer (D),2012,Lawyers & Lobbyists,45550,27500,73050
B000574,N00007727,Earl Blumenauer (D),2012,Transportation,20975,89145,110120
B000574,N00007727,Earl Blumenauer (D),2012,Misc Business,89895,66206,156101
B000574,N00007727,Earl Blumenauer (D),2012,Labor,0,152750,152750
B000574,N00007727,Earl Blumenauer (D),2012,Ideology/Single-Issue,14900,27300,42200
B000574,N00007727,Earl Blumenauer (D),2012,Other,32345,0,32345
B000013,N00008091,Spencer Bachus (R),2012,Agribusiness,11600,33302,44902
B000013,N00008091,Spencer Bachus (R),2012,Communic/Electronics,14950,20000,34950
B000013,N00008091,Spencer Bachus (R),2012,Construction,62500,48500,111000
B000013,N00008091,Spencer Bachus (R),2012,Defense,0,18500,18500
B000013,N00008091,Spencer Bachus (R),2012,Energy/Nat Resource,16500,66000,82500
B000013,N00008091,Spencer Bachus (R),2012,Finance/Insur/RealEst,469745,891500,1361245
B000013,N00008091,Spencer Bachus (R),2012,Health,25350,31500,56850
B000013,N00008091,Spencer Bachus (R),2012,Lawyers & Lobbyists,104434,83304,187738
B000013,N00008091,Spencer Bachus (R),2012,Transportation,24500,75000,99500
B000013,N00008091,Spencer Bachus (R),2012,Misc Business,87130,99500,186630
B000013,N00008091,Spencer Bachus (R),2012,Labor,0,11500,11500
B000013,N00008091,Spencer Bachus (R),2012,Ideology/Single-Issue,12150,107000,119150
B000013,N00008091,Spencer Bachus (R),2012,Other,43700,1000,44700
B000287,N00009774,Xavier Becerra (D),2012,Agribusiness,3000,27000,30000
B000287,N00009774,Xavier Becerra (D),2012,Communic/Electronics,34900,114500,149400
B000287,N00009774,Xavier Becerra (D),2012,Construction,16835,10500,27335
B000287,N00009774,Xavier Becerra (D),2012,Defense,0,28000,28000
B000287,N00009774,Xavier Becerra (D),2012,Energy/Nat Resource,1000,31750,32750
B000287,N00009774,Xavier Becerra (D),2012,Finance/Insur/RealEst,162008,259000,421008
B000287,N00009774,Xavier Becerra (D),2012,Health,86722,354492,441214
B000287,N00009774,Xavier Becerra (D),2012,Lawyers & Lobbyists,88255,40785,129040
B000287,N00009774,Xavier Becerra (D),2012,Transportation,0,53000,53000
B000287,N00009774,Xavier Becerra (D),2012,Misc Business,85850,113000,198850
B000287,N00009774,Xavier Becerra (D),2012,Labor,0,170000,170000
B000287,N00009774,Xavier Becerra (D),2012,Ideology/Single-Issue,5100,18000,23100
B000287,N00009774,Xavier Becerra (D),2012,Other,20250,0,20250
A000360,N00009888,Lamar Alexander (R),2012,Agribusiness,94544,132477,227021
A000360,N00009888,Lamar Alexander (R),2012,Communic/Electronics,110999,83932,194931
A000360,N00009888,Lamar Alexander (R),2012,Construction,238950,91000,329950
A000360,N00009888,Lamar Alexander (R),2012,Defense,14650,73300,87950
A000360,N00009888,Lamar Alexander (R),2012,Energy/Nat Resource,77050,190500,267550
A000360,N00009888,Lamar Alexander (R),2012,Finance/Insur/RealEst,943054,231100,1174154
A000360,N00009888,Lamar Alexander (R),2012,Health,305061,282900,587961
A000360,N00009888,Lamar Alexander (R),2012,Lawyers & Lobbyists,410275,76750,487025
A000360,N00009888,Lamar Alexander (R),2012,Transportation,93300,123300,216600
A000360,N00009888,Lamar Alexander (R),2012,Misc Business,456766,255900,712666
A000360,N00009888,Lamar Alexander (R),2012,Labor,0,10500,10500
A000360,N00009888,Lamar Alexander (R),2012,Ideology/Single-Issue,33300,328550,361850
A000360,N00009888,Lamar Alexander (R),2012,Other,579382,25400,604782
A000361,N00025464,Rodney Alexander (R),2012,Agribusiness,64500,67100,131600
A000361,N00025464,Rodney Alexander (R),2012,Communic/Electronics,3250,26000,29250
A000361,N00025464,Rodney Alexander (R),2012,Construction,89940,22500,112440
A000361,N00025464,Rodney Alexander (R),2012,Defense,0,25000,25000
A000361,N00025464,Rodney Alexander (R),2012,Energy/Nat Resource,39638,66000,105638
A000361,N00025464,Rodney Alexander (R),2012,Finance/Insur/RealEst,94656,48500,143156
A000361,N00025464,Rodney Alexander (R),2012,Health,109166,58000,167166
A000361,N00025464,Rodney Alexander (R),2012,Lawyers & Lobbyists,92581,27729,120310
A000361,N00025464,Rodney Alexander (R),2012,Transportation,21000,26500,47500
A000361,N00025464,Rodney Alexander (R),2012,Misc Business,75711,40200,115911
A000361,N00025464,Rodney Alexander (R),2012,Labor,0,28500,28500
A000361,N00025464,Rodney Alexander (R),2012,Ideology/Single-Issue,12650,43000,55650
A000361,N00025464,Rodney Alexander (R),2012,Other,42450,0,42450
A000368,N00030980,Kelly Ayotte (R),2012,Agribusiness,39400,60050,99450
A000368,N00030980,Kelly Ayotte (R),2012,Communic/Electronics,165768,138501,304269
A000368,N00030980,Kelly Ayotte (R),2012,Construction,114638,42000,156638
A000368,N00030980,Kelly Ayotte (R),2012,Defense,9600,61000,70600
A000368,N00030980,Kelly Ayotte (R),2012,Energy/Nat Resource,179208,151150,330358
A000368,N00030980,Kelly Ayotte (R),2012,Finance/Insur/RealEst,1148283,323210,1471493
A000368,N00030980,Kelly Ayotte (R),2012,Health,169510,245749,415259
A000368,N00030980,Kelly Ayotte (R),2012,Lawyers & Lobbyists,475895,33500,509395
A000368,N00030980,Kelly Ayotte (R),2012,Transportation,70201,106500,176701
A000368,N00030980,Kelly Ayotte (R),2012,Misc Business,452458,243800,696258
A000368,N00030980,Kelly Ayotte (R),2012,Labor,0,5000,5000
A000368,N00030980,Kelly Ayotte (R),2012,Ideology/Single-Issue,181692,341529,523221
A000368,N00030980,Kelly Ayotte (R),2012,Other,452004,2000,454004
A000369,N00031177,Mark Amodei (R),2012,Agribusiness,16323,19500,35823
A000369,N00031177,Mark Amodei (R),2012,Communic/Electronics,9987,54750,64737
A000369,N00031177,Mark Amodei (R),2012,Construction,32099,43500,75599
A000369,N00031177,Mark Amodei (R),2012,Defense,250,12000,12250
A000369,N00031177,Mark Amodei (R),2012,Energy/Nat Resource,8750,81000,89750
A000369,N00031177,Mark Amodei (R),2012,Finance/Insur/RealEst,39600,86428,126028
A000369,N00031177,Mark Amodei (R),2012,Health,31750,54000,85750
A000369,N00031177,Mark Amodei (R),2012,Lawyers & Lobbyists,81615,22750,104365
A000369,N00031177,Mark Amodei (R),2012,Transportation,11050,33000,44050
A000369,N00031177,Mark Amodei (R),2012,Misc Business,98934,120101,219035
A000369,N00031177,Mark Amodei (R),2012,Labor,0,3500,3500
A000369,N00031177,Mark Amodei (R),2012,Ideology/Single-Issue,9000,148842,157842
A000369,N00031177,Mark Amodei (R),2012,Other,59292,0,59292
A000367,N00031938,Justin Amash (R),2012,Agribusiness,38151,1950,40101
A000367,N00031938,Justin Amash (R),2012,Communic/Electronics,27550,4000,31550
A000367,N00031938,Justin Amash (R),2012,Construction,27450,3000,30450
A000367,N00031938,Justin Amash (R),2012,Defense,400,1000,1400
A000367,N00031938,Justin Amash (R),2012,Energy/Nat Resource,21250,24000,45250
A000367,N00031938,Justin Amash (R),2012,Finance/Insur/RealEst,101650,38000,139650
A000367,N00031938,Justin Amash (R),2012,Health,81100,11000,92100
A000367,N00031938,Justin Amash (R),2012,Lawyers & Lobbyists,38525,3000,41525
A000367,N00031938,Justin Amash (R),2012,Transportation,33150,8000,41150
A000367,N00031938,Justin Amash (R),2012,Misc Business,202481,16750,219231
A000367,N00031938,Justin Amash (R),2012,Labor,0,500,500
A000367,N00031938,Justin Amash (R),2012,Ideology/Single-Issue,16450,60936,77386
A000367,N00031938,Justin Amash (R),2012,Other,87561,0,87561
A000210,N00000826,Robert E Andrews (D),2014,Agribusiness,16600,14500,31100
A000210,N00000826,Robert E Andrews (D),2014,Communic/Electronics,2400,9000,11400
A000210,N00000826,Robert E Andrews (D),2014,Construction,5600,20500,26100
A000210,N00000826,Robert E Andrews (D),2014,Defense,4350,34000,38350
A000210,N00000826,Robert E Andrews (D),2014,Energy/Nat Resource,1000,16500,17500
A000210,N00000826,Robert E Andrews (D),2014,Finance/Insur/RealEst,25750,43761,69511
A000210,N00000826,Robert E Andrews (D),2014,Health,15825,32000,47825
A000210,N00000826,Robert E Andrews (D),2014,Lawyers & Lobbyists,62516,43500,106016
A000210,N00000826,Robert E Andrews (D),2014,Transportation,8800,11000,19800
A000210,N00000826,Robert E Andrews (D),2014,Misc Business,28164,20500,48664
A000210,N00000826,Robert E Andrews (D),2014,Labor,0,98500,98500
A000210,N00000826,Robert E Andrews (D),2014,Ideology/Single-Issue,10400,15000,25400
A000210,N00000826,Robert E Andrews (D),2014,Other,45950,26499,72449
B000490,N00002674,Sanford Bishop (D),2014,Agribusiness,12500,180988,193488
B000490,N00002674,Sanford Bishop (D),2014,Communic/Electronics,10850,48500,59350
B000490,N00002674,Sanford Bishop (D),2014,Construction,14300,9500,23800
B000490,N00002674,Sanford Bishop (D),2014,Defense,250,48000,48250
B000490,N00002674,Sanford Bishop (D),2014,Energy/Nat Resource,6500,41000,47500
B000490,N00002674,Sanford Bishop (D),2014,Finance/Insur/RealEst,24550,107140,131690
B000490,N00002674,Sanford Bishop (D),2014,Health,24550,43000,67550
B000490,N00002674,Sanford Bishop (D),2014,Lawyers & Lobbyists,54350,33944,88294
B000490,N00002674,Sanford Bishop (D),2014,Transportation,10100,35500,45600
B000490,N00002674,Sanford Bishop (D),2014,Misc Business,51100,86000,137100
B000490,N00002674,Sanford Bishop (D),2014,Labor,0,157800,157800
B000490,N00002674,Sanford Bishop (D),2014,Ideology/Single-Issue,5720,52303,58023
B000490,N00002674,Sanford Bishop (D),2014,Other,37300,0,37300
B000911,N00002713,Corrine Brown (D),2014,Agribusiness,10300,17000,27300
B000911,N00002713,Corrine Brown (D),2014,Communic/Electronics,2800,14000,16800
B000911,N00002713,Corrine Brown (D),2014,Construction,28650,5000,33650
B000911,N00002713,Corrine Brown (D),2014,Defense,0,2000,2000
B000911,N00002713,Corrine Brown (D),2014,Energy/Nat Resource,8500,2500,11000
B000911,N00002713,Corrine Brown (D),2014,Finance/Insur/RealEst,28900,12500,41400
B000911,N00002713,Corrine Brown (D),2014,Health,13500,11500,25000
B000911,N00002713,Corrine Brown (D),2014,Lawyers & Lobbyists,44650,19600,64250
B000911,N00002713,Corrine Brown (D),2014,Transportation,11700,93975,105675
B000911,N00002713,Corrine Brown (D),2014,Misc Business,20600,21000,41600
B000911,N00002713,Corrine Brown (D),2014,Labor,0,102000,102000
B000911,N00002713,Corrine Brown (D),2014,Ideology/Single-Issue,1000,16800,17800
B000911,N00002713,Corrine Brown (D),2014,Other,6100,0,6100
A000055,N00003028,Robert B Aderholt (R),2014,Agribusiness,26585,209000,235585
A000055,N00003028,Robert B Aderholt (R),2014,Communic/Electronics,14997,38600,53597
A000055,N00003028,Robert B Aderholt (R),2014,Construction,32397,17500,49897
A000055,N00003028,Robert B Aderholt (R),2014,Defense,36145,96000,132145
A000055,N00003028,Robert B Aderholt (R),2014,Energy/Nat Resource,11244,59000,70244
A000055,N00003028,Robert B Aderholt (R),2014,Finance/Insur/RealEst,21847,111500,133347
A000055,N00003028,Robert B Aderholt (R),2014,Health,16544,43000,59544
A000055,N00003028,Robert B Aderholt (R),2014,Lawyers & Lobbyists,50365,30119,80484
A000055,N00003028,Robert B Aderholt (R),2014,Transportation,26946,49000,75946
A000055,N00003028,Robert B Aderholt (R),2014,Misc Business,25596,55000,80596
A000055,N00003028,Robert B Aderholt (R),2014,Labor,0,22000,22000
A000055,N00003028,Robert B Aderholt (R),2014,Ideology/Single-Issue,3048,23000,26048
A000055,N00003028,Robert B Aderholt (R),2014,Other,15445,2000,17445
B000944,N00003535,Sherrod Brown (D),2014,Agribusiness,127375,101500,228875
B000944,N00003535,Sherrod Brown (D),2014,Communic/Electronics,493879,116000,609879
B000944,N00003535,Sherrod Brown (D),2014,Construction,188672,89300,277972
B000944,N00003535,Sherrod Brown (D),2014,Defense,25600,72000,97600
B000944,N00003535,Sherrod Brown (D),2014,Energy/Nat Resource,136210,147500,283710
B000944,N00003535,Sherrod Brown (D),2014,Finance/Insur/RealEst,1305138,526649,1831787
B000944,N00003535,Sherrod Brown (D),2014,Health,910985,484950,1395935
B000944,N00003535,Sherrod Brown (D),2014,Lawyers & Lobbyists,2253252,224473,2477725
B000944,N00003535,Sherrod Brown (D),2014,Transportation,97750,74000,171750
B000944,N00003535,Sherrod Brown (D),2014,Misc Business,735532,292300,1027832
B000944,N00003535,Sherrod Brown (D),2014,Labor,31406,434550,465956
B000944,N00003535,Sherrod Brown (D),2014,Ideology/Single-Issue,1361983,572740,1934723
B000944,N00003535,Sherrod Brown (D),2014,Other,2263346,29550,2292896
B000589,N00003675,John Boehner (R),2014,Agribusiness,616208,189650,805858
B000589,N00003675,John Boehner (R),2014,Communic/Electronics,394000,166950,560950
B000589,N00003675,John Boehner (R),2014,Construction,701008,84750,785758
B000589,N00003675,John Boehner (R),2014,Defense,31101,87000,118101
B000589,N00003675,John Boehner (R),2014,Energy/Nat Resource,1382912,348550,1731462
B000589,N00003675,John Boehner (R),2014,Finance/Insur/RealEst,2635071,647000,3282071
B000589,N00003675,John Boehner (R),2014,Health,668107,402375,1070482
B000589,N00003675,John Boehner (R),2014,Lawyers & Lobbyists,800382,48400,848782
B000589,N00003675,John Boehner (R),2014,Transportation,427800,144500,572300
B000589,N00003675,John Boehner (R),2014,Misc Business,1423050,391715,1814765
B000589,N00003675,John Boehner (R),2014,Labor,0,42500,42500
B000589,N00003675,John Boehner (R),2014,Ideology/Single-Issue,430969,27150,458119
B000589,N00003675,John Boehner (R),2014,Other,1402283,14500,1416783
B000243,N00004643,Max Baucus (D),2014,Agribusiness,54296,133500,187796
B000243,N00004643,Max Baucus (D),2014,Communic/Electronics,84246,123750,207996
B000243,N00004643,Max Baucus (D),2014,Construction,26525,58750,85275
B000243,N00004643,Max Baucus (D),2014,Defense,3500,23500,27000
B000243,N00004643,Max Baucus (D),2014,Energy/Nat Resource,94800,264750,359550
B000243,N00004643,Max Baucus (D),2014,Finance/Insur/RealEst,652523,404900,1057423
B000243,N00004643,Max Baucus (D),2014,Health,264328,579418,843746
B000243,N00004643,Max Baucus (D),2014,Lawyers & Lobbyists,436926,117049,553975
B000243,N00004643,Max Baucus (D),2014,Transportation,40394,70750,111144
B000243,N00004643,Max Baucus (D),2014,Misc Business,158356,225750,384106
B000243,N00004643,Max Baucus (D),2014,Labor,2400,66900,69300
B000243,N00004643,Max Baucus (D),2014,Ideology/Single-Issue,39499,39450,78949
B000243,N00004643,Max Baucus (D),2014,Other,101479,2000,103479
B000575,N00005195,Roy Blunt (R),2014,Agribusiness,524950,377191,902141
B000575,N00005195,Roy Blunt (R),2014,Communic/Electronics,301901,325336,627237
B000575,N00005195,Roy Blunt (R),2014,Construction,372735,135350,508085
B000575,N00005195,Roy Blunt (R),2014,Defense,66166,117000,183166
B000575,N00005195,Roy Blunt (R),2014,Energy/Nat Resource,582108,437750,1019858
B000575,N00005195,Roy Blunt (R),2014,Finance/Insur/RealEst,2259650,716000,2975650
B000575,N00005195,Roy Blunt (R),2014,Health,649122,549850,1198972
B000575,N00005195,Roy Blunt (R),2014,Lawyers & Lobbyists,874124,184038,1058162
B000575,N00005195,Roy Blunt (R),2014,Transportation,479686,298950,778636
B000575,N00005195,Roy Blunt (R),2014,Misc Business,1402186,590750,1992936
B000575,N00005195,Roy Blunt (R),2014,Labor,2900,30250,33150
B000575,N00005195,Roy Blunt (R),2014,Ideology/Single-Issue,242544,871230,1113774
B000575,N00005195,Roy Blunt (R),2014,Other,898085,6000,904085
A000373,N00005293,Brad Ashford (D),2014,Agribusiness,9500,1500,11000
A000373,N00005293,Brad Ashford (D),2014,Communic/Electronics,18500,11500,30000
A000373,N00005293,Brad Ashford (D),2014,Construction,14150,5250,19400
A000373,N00005293,Brad Ashford (D),2014,Defense,250,0,250
A000373,N00005293,Brad Ashford (D),2014,Energy/Nat Resource,9200,0,9200
A000373,N00005293,Brad Ashford (D),2014,Finance/Insur/RealEst,91750,17500,109250
A000373,N00005293,Brad Ashford (D),2014,Health,42500,7500,50000
A000373,N00005293,Brad Ashford (D),2014,Lawyers & Lobbyists,75545,16500,92045
A000373,N00005293,Brad Ashford (D),2014,Transportation,9000,0,9000
A000373,N00005293,Brad Ashford (D),2014,Misc Business,24355,2500,26855
A000373,N00005293,Brad Ashford (D),2014,Labor,250,120000,120250
A000373,N00005293,Brad Ashford (D),2014,Ideology/Single-Issue,14105,155828,169933
A000373,N00005293,Brad Ashford (D),2014,Other,137165,0,137165
B000213,N00005656,Joe Barton (R),2014,Agribusiness,6600,11000,17600
B000213,N00005656,Joe Barton (R),2014,Communic/Electronics,16200,70600,86800
B000213,N00005656,Joe Barton (R),2014,Construction,16400,35000,51400
B000213,N00005656,Joe Barton (R),2014,Defense,0,29600,29600
B000213,N00005656,Joe Barton (R),2014,Energy/Nat Resource,56350,209500,265850
B000213,N00005656,Joe Barton (R),2014,Finance/Insur/RealEst,43550,45000,88550
B000213,N00005656,Joe Barton (R),2014,Health,29250,66250,95500
B000213,N00005656,Joe Barton (R),2014,Lawyers & Lobbyists,19325,25125,44450
B000213,N00005656,Joe Barton (R),2014,Transportation,3000,49000,52000
B000213,N00005656,Joe Barton (R),2014,Misc Business,52400,81355,133755
B000213,N00005656,Joe Barton (R),2014,Labor,0,1500,1500
B000213,N00005656,Joe Barton (R),2014,Ideology/Single-Issue,1000,13600,14600
B000213,N00005656,Joe Barton (R),2014,Other,20350,0,20350
B000755,N00005883,Kevin Brady (R),2014,Agribusiness,17700,53132,70832
B000755,N00005883,Kevin Brady (R),2014,Communic/Electronics,8200,62230,70430
B000755,N00005883,Kevin Brady (R),2014,Construction,17750,61500,79250
B000755,N00005883,Kevin Brady (R),2014,Defense,0,42000,42000
B000755,N00005883,Kevin Brady (R),2014,Energy/Nat Resource,157150,203600,360750
B000755,N00005883,Kevin Brady (R),2014,Finance/Insur/RealEst,160856,339500,500356
B000755,N00005883,Kevin Brady (R),2014,Health,160245,510932,671177
B000755,N00005883,Kevin Brady (R),2014,Lawyers & Lobbyists,86750,61500,148250
B000755,N00005883,Kevin Brady (R),2014,Transportation,3500,63500,67000
B000755,N00005883,Kevin Brady (R),2014,Misc Business,69800,176000,245800
B000755,N00005883,Kevin Brady (R),2014,Labor,0,1000,1000
B000755,N00005883,Kevin Brady (R),2014,Ideology/Single-Issue,75375,17000,92375
B000755,N00005883,Kevin Brady (R),2014,Other,9000,2000,11000
B000711,N00006692,Barbara Boxer (D),2014,Agribusiness,75800,91300,167100
B000711,N00006692,Barbara Boxer (D),2014,Communic/Electronics,1211075,174683,1385758
B000711,N00006692,Barbara Boxer (D),2014,Construction,189038,142117,331155
B000711,N00006692,Barbara Boxer (D),2014,Defense,14400,6500,20900
B000711,N00006692,Barbara Boxer (D),2014,Energy/Nat Resource,160750,103699,264449
B000711,N00006692,Barbara Boxer (D),2014,Finance/Insur/RealEst,1186744,74941,1261685
B000711,N00006692,Barbara Boxer (D),2014,Health,523215,116150,639365
B000711,N00006692,Barbara Boxer (D),2014,Lawyers & Lobbyists,1855560,118322,1973882
B000711,N00006692,Barbara Boxer (D),2014,Transportation,51349,104200,155549
B000711,N00006692,Barbara Boxer (D),2014,Misc Business,1006369,87202,1093571
B000711,N00006692,Barbara Boxer (D),2014,Labor,13400,321100,334500
B000711,N00006692,Barbara Boxer (D),2014,Ideology/Single-Issue,1850424,527268,2377692
B000711,N00006692,Barbara Boxer (D),2014,Other,2087070,3500,2090570
B000574,N00007727,Earl Blumenauer (D),2014,Agribusiness,3910,15750,19660
B000574,N00007727,Earl Blumenauer (D),2014,Communic/Electronics,11100,20000,31100
B000574,N00007727,Earl Blumenauer (D),2014,Construction,23000,110500,133500
B000574,N00007727,Earl Blumenauer (D),2014,Defense,0,3000,3000
B000574,N00007727,Earl Blumenauer (D),2014,Energy/Nat Resource,6000,20842,26842
B000574,N00007727,Earl Blumenauer (D),2014,Finance/Insur/RealEst,53125,108500,161625
B000574,N00007727,Earl Blumenauer (D),2014,Health,6000,151000,157000
B000574,N00007727,Earl Blumenauer (D),2014,Lawyers & Lobbyists,47191,31606,78797
B000574,N00007727,Earl Blumenauer (D),2014,Transportation,16450,86900,103350
B000574,N00007727,Earl Blumenauer (D),2014,Misc Business,71098,76025,147123
B000574,N00007727,Earl Blumenauer (D),2014,Labor,0,174125,174125
B000574,N00007727,Earl Blumenauer (D),2014,Ideology/Single-Issue,19550,27511,47061
B000574,N00007727,Earl Blumenauer (D),2014,Other,34813,0,34813
B000013,N00008091,Spencer Bachus (R),2014,Agribusiness,0,2000,2000
B000013,N00008091,Spencer Bachus (R),2014,Communic/Electronics,2500,27000,29500
B000013,N00008091,Spencer Bachus (R),2014,Construction,0,-1000,-1000
B000013,N00008091,Spencer Bachus (R),2014,Defense,0,1000,1000
B000013,N00008091,Spencer Bachus (R),2014,Energy/Nat Resource,0,0,0
B000013,N00008091,Spencer Bachus (R),2014,Finance/Insur/RealEst,5000,133000,138000
B000013,N00008091,Spencer Bachus (R),2014,Health,0,1000,1000
B000013,N00008091,Spencer Bachus (R),2014,Lawyers & Lobbyists,11750,18500,30250
B000013,N00008091,Spencer Bachus (R),2014,Transportation,500,25176,25676
B000013,N00008091,Spencer Bachus (R),2014,Misc Business,2600,21555,24155
B000013,N00008091,Spencer Bachus (R),2014,Labor,0,0,0
B000013,N00008091,Spencer Bachus (R),2014,Ideology/Single-Issue,0,9500,9500
B000287,N00009774,Xavier Becerra (D),2014,Agribusiness,500,27000,27500
B000287,N00009774,Xavier Becerra (D),2014,Communic/Electronics,40131,100590,140721
B000287,N00009774,Xavier Becerra (D),2014,Construction,32304,17000,49304
B000287,N00009774,Xavier Becerra (D),2014,Defense,0,40000,40000
B000287,N00009774,Xavier Becerra (D),2014,Energy/Nat Resource,0,35750,35750
B000287,N00009774,Xavier Becerra (D),2014,Finance/Insur/RealEst,109549,319700,429249
B000287,N00009774,Xavier Becerra (D),2014,Health,48900,277000,325900
B000287,N00009774,Xavier Becerra (D),2014,Lawyers & Lobbyists,99833,43500,143333
B000287,N00009774,Xavier Becerra (D),2014,Transportation,2310,54500,56810
B000287,N00009774,Xavier Becerra (D),2014,Misc Business,78400,106600,185000
B000287,N00009774,Xavier Becerra (D),2014,Labor,0,155000,155000
B000287,N00009774,Xavier Becerra (D),2014,Ideology/Single-Issue,50250,13500,63750
B000287,N00009774,Xavier Becerra (D),2014,Other,24950,750,25700
A000360,N00009888,Lamar Alexander (R),2014,Agribusiness,102250,153436,255686
A000360,N00009888,Lamar Alexander (R),2014,Communic/Electronics,94300,122000,216300
A000360,N00009888,Lamar Alexander (R),2014,Construction,186067,87950,274017
A000360,N00009888,Lamar Alexander (R),2014,Defense,14450,107500,121950
A000360,N00009888,Lamar Alexander (R),2014,Energy/Nat Resource,149260,304683,453943
A000360,N00009888,Lamar Alexander (R),2014,Finance/Insur/RealEst,602450,422500,1024950
A000360,N00009888,Lamar Alexander (R),2014,Health,256200,657467,913667
A000360,N00009888,Lamar Alexander (R),2014,Lawyers & Lobbyists,250882,116988,367870
A000360,N00009888,Lamar Alexander (R),2014,Transportation,77083,180000,257083
A000360,N00009888,Lamar Alexander (R),2014,Misc Business,326660,365728,692388
A000360,N00009888,Lamar Alexander (R),2014,Labor,0,10000,10000
A000360,N00009888,Lamar Alexander (R),2014,Ideology/Single-Issue,60600,358515,419115
A000360,N00009888,Lamar Alexander (R),2014,Other,412653,64400,477053
A000361,N00025464,Rodney Alexander (R),2014,Agribusiness,16799,0,16799
A000361,N00025464,Rodney Alexander (R),2014,Communic/Electronics,2000,4500,6500
A000361,N00025464,Rodney Alexander (R),2014,Construction,25850,2500,28350
A000361,N00025464,Rodney Alexander (R),2014,Defense,0,5000,5000
A000361,N00025464,Rodney Alexander (R),2014,Energy/Nat Resource,13500,10500,24000
A000361,N00025464,Rodney Alexander (R),2014,Finance/Insur/RealEst,24400,6500,30900
A000361,N00025464,Rodney Alexander (R),2014,Health,13500,4500,18000
A000361,N00025464,Rodney Alexander (R),2014,Lawyers & Lobbyists,14860,2500,17360
A000361,N00025464,Rodney Alexander (R),2014,Transportation,18350,6000,24350
A000361,N00025464,Rodney Alexander (R),2014,Misc Business,8900,1000,9900
A000361,N00025464,Rodney Alexander (R),2014,Labor,0,5000,5000
A000361,N00025464,Rodney Alexander (R),2014,Ideology/Single-Issue,0,-5000,-5000
A000361,N00025464,Rodney Alexander (R),2014,Other,10750,0,10750
A000368,N00030980,Kelly Ayotte (R),2014,Agribusiness,44900,75550,120450
A000368,N00030980,Kelly Ayotte (R),2014,Communic/Electronics,219493,254594,474087
A000368,N00030980,Kelly Ayotte (R),2014,Construction,128788,47000,175788
A000368,N00030980,Kelly Ayotte (R),2014,Defense,12300,144400,156700
A000368,N00030980,Kelly Ayotte (R),2014,Energy/Nat Resource,222108,197800,419908
A000368,N00030980,Kelly Ayotte (R),2014,Finance/Insur/RealEst,1386233,461650,1847883
A000368,N00030980,Kelly Ayotte (R),2014,Health,218610,372999,591609
A000368,N00030980,Kelly Ayotte (R),2014,Lawyers & Lobbyists,610298,78087,688385
A000368,N00030980,Kelly Ayotte (R),2014,Transportation,95851,221700,317551
A000368,N00030980,Kelly Ayotte (R),2014,Misc Business,609658,321800,931458
A000368,N00030980,Kelly Ayotte (R),2014,Labor,0,36500,36500
A000368,N00030980,Kelly Ayotte (R),2014,Ideology/Single-Issue,255291,430129,685420
A000368,N00030980,Kelly Ayotte (R),2014,Other,601886,6000,607886
A000369,N00031177,Mark Amodei (R),2014,Agribusiness,16800,14500,31300
A000369,N00031177,Mark Amodei (R),2014,Communic/Electronics,8600,34000,42600
A000369,N00031177,Mark Amodei (R),2014,Construction,21100,23000,44100
A000369,N00031177,Mark Amodei (R),2014,Defense,500,19500,20000
A000369,N00031177,Mark Amodei (R),2014,Energy/Nat Resource,2750,51750,54500
A000369,N00031177,Mark Amodei (R),2014,Finance/Insur/RealEst,25800,32999,58799
A000369,N00031177,Mark Amodei (R),2014,Health,5000,28500,33500
A000369,N00031177,Mark Amodei (R),2014,Lawyers & Lobbyists,45250,9000,54250
A000369,N00031177,Mark Amodei (R),2014,Transportation,13550,23500,37050
A000369,N00031177,Mark Amodei (R),2014,Misc Business,39400,68500,107900
A000369,N00031177,Mark Amodei (R),2014,Labor,0,3000,3000
A000369,N00031177,Mark Amodei (R),2014,Ideology/Single-Issue,20950,26550,47500
A000369,N00031177,Mark Amodei (R),2014,Other,34050,0,34050
A000367,N00031938,Justin Amash (R),2014,Agribusiness,46400,1000,47400
A000367,N00031938,Justin Amash (R),2014,Communic/Electronics,40500,0,40500
A000367,N00031938,Justin Amash (R),2014,Construction,38460,5000,43460
A000367,N00031938,Justin Amash (R),2014,Defense,700,0,700
A000367,N00031938,Justin Amash (R),2014,Energy/Nat Resource,22750,11000,33750
A000367,N00031938,Justin Amash (R),2014,Finance/Insur/RealEst,147000,4500,151500
A000367,N00031938,Justin Amash (R),2014,Health,62809,2000,64809
A000367,N00031938,Justin Amash (R),2014,Lawyers & Lobbyists,31650,2750,34400
A000367,N00031938,Justin Amash (R),2014,Transportation,38150,4200,42350
A000367,N00031938,Justin Amash (R),2014,Misc Business,200749,1000,201749
A000367,N00031938,Justin Amash (R),2014,Ideology/Single-Issue,261065,91700,352765
A000367,N00031938,Justin Amash (R),2014,Other,103858,0,103858
A000372,N00033720,Richard W Allen (R),2014,Agribusiness,52650,6000,58650
A000372,N00033720,Richard W Allen (R),2014,Communic/Electronics,6600,4500,11100
A000372,N00033720,Richard W Allen (R),2014,Construction,91425,17500,108925
A000372,N00033720,Richard W Allen (R),2014,Defense,0,2500,2500
A000372,N00033720,Richard W Allen (R),2014,Energy/Nat Resource,33750,12500,46250
A000372,N00033720,Richard W Allen (R),2014,Finance/Insur/RealEst,178715,27500,206215
A000372,N00033720,Richard W Allen (R),2014,Health,108600,2000,110600
A000372,N00033720,Richard W Allen (R),2014,Lawyers & Lobbyists,28700,1000,29700
A000372,N00033720,Richard W Allen (R),2014,Transportation,30650,4500,35150
A000372,N00033720,Richard W Allen (R),2014,Misc Business,67610,10000,77610
A000372,N00033720,Richard W Allen (R),2014,Ideology/Single-Issue,9000,150750,159750
A000372,N00033720,Richard W Allen (R),2014,Other,129970,0,129970
A000371,N00033997,Pete Aguilar (D),2014,Agribusiness,1750,6500,8250
A000371,N00033997,Pete Aguilar (D),2014,Communic/Electronics,46675,11640,58315
A000371,N00033997,Pete Aguilar (D),2014,Construction,53725,4000,57725
A000371,N00033997,Pete Aguilar (D),2014,Defense,2600,2000,4600
A000371,N00033997,Pete Aguilar (D),2014,Energy/Nat Resource,5400,3000,8400
A000371,N00033997,Pete Aguilar (D),2014,Finance/Insur/RealEst,158096,47500,205596
A000371,N00033997,Pete Aguilar (D),2014,Health,54799,42500,97299
A000371,N00033997,Pete Aguilar (D),2014,Lawyers & Lobbyists,142719,11250,153969
A000371,N00033997,Pete Aguilar (D),2014,Transportation,7875,23000,30875
A000371,N00033997,Pete Aguilar (D),2014,Misc Business,103055,6034,109089
A000371,N00033997,Pete Aguilar (D),2014,Labor,950,245000,245950
A000371,N00033997,Pete Aguilar (D),2014,Ideology/Single-Issue,150336,277053,427389
A000371,N00033997,Pete Aguilar (D),2014,Other,107506,0,107506
A000370,N00035451,Alma Adams (D),2014,Agribusiness,2500,1000,3500
A000370,N00035451,Alma Adams (D),2014,Communic/Electronics,7743,5000,12743
A000370,N00035451,Alma Adams (D),2014,Construction,4100,0,4100
A000370,N00035451,Alma Adams (D),2014,Defense,0,6500,6500
A000370,N00035451,Alma Adams (D),2014,Energy/Nat Resource,500,9000,9500
A000370,N00035451,Alma Adams (D),2014,Finance/Insur/RealEst,6650,14000,20650
A000370,N00035451,Alma Adams (D),2014,Health,29850,55500,85350
A000370,N00035451,Alma Adams (D),2014,Lawyers & Lobbyists,11186,7500,18686
A000370,N00035451,Alma Adams (D),2014,Transportation,750,2000,2750
A000370,N00035451,Alma Adams (D),2014,Misc Business,15150,10500,25650
A000370,N00035451,Alma Adams (D),2014,Labor,1000,86000,87000
A000370,N00035451,Alma Adams (D),2014,Ideology/Single-Issue,55246,100090,155336
A000370,N00035451,Alma Adams (D),2014,Other,59421,3000,62421
A000374,N00036633,Ralph Abraham (R),2014,Agribusiness,71850,16500,88350
A000374,N00036633,Ralph Abraham (R),2014,Communic/Electronics,1500,5500,7000
A000374,N00036633,Ralph Abraham (R),2014,Construction,25350,1000,26350
A000374,N00036633,Ralph Abraham (R),2014,Energy/Nat Resource,15453,13000,28453
A000374,N00036633,Ralph Abraham (R),2014,Finance/Insur/RealEst,39387,7500,46887
A000374,N00036633,Ralph Abraham (R),2014,Health,118000,16600,134600
A000374,N00036633,Ralph Abraham (R),2014,Lawyers & Lobbyists,13150,1000,14150
A000374,N00036633,Ralph Abraham (R),2014,Transportation,14150,6000,20150
A000374,N00036633,Ralph Abraham (R),2014,Misc Business,41400,3500,44900
A000374,N00036633,Ralph Abraham (R),2014,Ideology/Single-Issue,500,75000,75500
A000374,N00036633,Ralph Abraham (R),2014,Other,56714,0,56714
B000490,N00002674,Sanford Bishop (D),2016,Agribusiness,19584,160000,179584
B000490,N00002674,Sanford Bishop (D),2016,Communic/Electronics,4000,50230,54230
B000490,N00002674,Sanford Bishop (D),2016,Construction,8250,12500,20750
B000490,N00002674,Sanford Bishop (D),2016,Defense,500,45500,46000
B000490,N00002674,Sanford Bishop (D),2016,Energy/Nat Resource,0,53000,53000
B000490,N00002674,Sanford Bishop (D),2016,Finance/Insur/RealEst,24752,97000,121752
B000490,N00002674,Sanford Bishop (D),2016,Health,15150,56000,71150
B000490,N00002674,Sanford Bishop (D),2016,Lawyers & Lobbyists,40484,24750,65234
B000490,N00002674,Sanford Bishop (D),2016,Transportation,7500,38500,46000
B000490,N00002674,Sanford Bishop (D),2016,Misc Business,43850,96400,140250
B000490,N00002674,Sanford Bishop (D),2016,Labor,0,135000,135000
B000490,N00002674,Sanford Bishop (D),2016,Ideology/Single-Issue,8530,40520,49050
B000490,N00002674,Sanford Bishop (D),2016,Other,37100,0,37100
B000911,N00002713,Corrine Brown (D),2016,Agribusiness,5000,2000,7000
B000911,N00002713,Corrine Brown (D),2016,Communic/Electronics,750,15000,15750
B000911,N00002713,Corrine Brown (D),2016,Construction,5000,4000,9000
B000911,N00002713,Corrine Brown (D),2016,Defense,0,3500,3500
B000911,N00002713,Corrine Brown (D),2016,Energy/Nat Resource,1000,0,1000
B000911,N00002713,Corrine Brown (D),2016,Finance/Insur/RealEst,23900,15500,39400
B000911,N00002713,Corrine Brown (D),2016,Health,250,13500,13750
B000911,N00002713,Corrine Brown (D),2016,Lawyers & Lobbyists,11700,16000,27700
B000911,N00002713,Corrine Brown (D),2016,Transportation,14300,91000,105300
B000911,N00002713,Corrine Brown (D),2016,Misc Business,2000,23900,25900
B000911,N00002713,Corrine Brown (D),2016,Labor,0,86500,86500
B000911,N00002713,Corrine Brown (D),2016,Ideology/Single-Issue,0,71500,71500
B000911,N00002713,Corrine Brown (D),2016,Other,13475,0,13475
A000055,N00003028,Robert B Aderholt (R),2016,Agribusiness,29537,294000,323537
A000055,N00003028,Robert B Aderholt (R),2016,Communic/Electronics,22300,29000,51300
A000055,N00003028,Robert B Aderholt (R),2016,Construction,54850,37000,91850
A000055,N00003028,Robert B Aderholt (R),2016,Defense,35351,128877,164228
A000055,N00003028,Robert B Aderholt (R),2016,Energy/Nat Resource,11850,52000,63850
A000055,N00003028,Robert B Aderholt (R),2016,Finance/Insur/RealEst,29334,118450,147784
A000055,N00003028,Robert B Aderholt (R),2016,Health,32404,54932,87336
A000055,N00003028,Robert B Aderholt (R),2016,Lawyers & Lobbyists,59853,46130,105983
A000055,N00003028,Robert B Aderholt (R),2016,Transportation,17401,43500,60901
A000055,N00003028,Robert B Aderholt (R),2016,Misc Business,44829,94500,139329
A000055,N00003028,Robert B Aderholt (R),2016,Labor,0,13500,13500
A000055,N00003028,Robert B Aderholt (R),2016,Ideology/Single-Issue,2500,27500,30000
A000055,N00003028,Robert B Aderholt (R),2016,Other,14811,1000,15811
B000944,N00003535,Sherrod Brown (D),2016,Agribusiness,145173,103000,248173
B000944,N00003535,Sherrod Brown (D),2016,Communic/Electronics,502212,133500,635712
B000944,N00003535,Sherrod Brown (D),2016,Construction,206143,92800,298943
B000944,N00003535,Sherrod Brown (D),2016,Defense,18590,77000,95590
B000944,N00003535,Sherrod Brown (D),2016,Energy/Nat Resource,127985,135600,263585
B000944,N00003535,Sherrod Brown (D),2016,Finance/Insur/RealEst,1406308,784350,2190658
B000944,N00003535,Sherrod Brown (D),2016,Health,868849,395550,1264399
B000944,N00003535,Sherrod Brown (D),2016,Lawyers & Lobbyists,2357013,239723,2596736
B000944,N00003535,Sherrod Brown (D),2016,Transportation,115163,70500,185663
B000944,N00003535,Sherrod Brown (D),2016,Misc Business,810838,301400,1112238
B000944,N00003535,Sherrod Brown (D),2016,Labor,32296,419050,451346
B000944,N00003535,Sherrod Brown (D),2016,Ideology/Single-Issue,1560844,583523,2144367
B000944,N00003535,Sherrod Brown (D),2016,Other,2454517,20650,2475167
B000589,N00003675,John Boehner (R),2016,Agribusiness,171590,0,171590
B000589,N00003675,John Boehner (R),2016,Communic/Electronics,36198,-5000,31198
B000589,N00003675,John Boehner (R),2016,Construction,158400,0,158400
B000589,N00003675,John Boehner (R),2016,Defense,5350,0,5350
B000589,N00003675,John Boehner (R),2016,Energy/Nat Resource,232800,-5000,227800
B000589,N00003675,John Boehner (R),2016,Finance/Insur/RealEst,654390,0,654390
B000589,N00003675,John Boehner (R),2016,Health,205225,-5000,200225
B000589,N00003675,John Boehner (R),2016,Lawyers & Lobbyists,295300,0,295300
B000589,N00003675,John Boehner (R),2016,Transportation,81650,0,81650
B000589,N00003675,John Boehner (R),2016,Misc Business,320735,0,320735
B000589,N00003675,John Boehner (R),2016,Ideology/Single-Issue,32975,0,32975
B000589,N00003675,John Boehner (R),2016,Other,399718,0,399718
B000575,N00005195,Roy Blunt (R),2016,Agribusiness,489994,443648,933642
B000575,N00005195,Roy Blunt (R),2016,Communic/Electronics,256150,403900,660050
B000575,N00005195,Roy Blunt (R),2016,Construction,317126,179900,497026
B000575,N00005195,Roy Blunt (R),2016,Defense,60566,170500,231066
B000575,N00005195,Roy Blunt (R),2016,Energy/Nat Resource,366153,425800,791953
B000575,N00005195,Roy Blunt (R),2016,Finance/Insur/RealEst,1971837,852300,2824137
B000575,N00005195,Roy Blunt (R),2016,Health,654338,699500,1353838
B000575,N00005195,Roy Blunt (R),2016,Lawyers & Lobbyists,955103,219288,1174391
B000575,N00005195,Roy Blunt (R),2016,Transportation,452683,378600,831283
B000575,N00005195,Roy Blunt (R),2016,Misc Business,1082657,714500,1797157
B000575,N00005195,Roy Blunt (R),2016,Labor,500,74500,75000
B000575,N00005195,Roy Blunt (R),2016,Ideology/Single-Issue,428487,801543,1230030
B000575,N00005195,Roy Blunt (R),2016,Other,997273,45000,1042273
A000373,N00005293,Brad Ashford (D),2016,Agribusiness,14300,139250,153550
A000373,N00005293,Brad Ashford (D),2016,Communic/Electronics,20030,57630,77660
A000373,N00005293,Brad Ashford (D),2016,Construction,10445,27500,37945
A000373,N00005293,Brad Ashford (D),2016,Defense,10,36000,36010
A000373,N00005293,Brad Ashford (D),2016,Energy/Nat Resource,17450,54000,71450
A000373,N00005293,Brad Ashford (D),2016,Finance/Insur/RealEst,191065,204000,395065
A000373,N00005293,Brad Ashford (D),2016,Health,70359,98250,168609
A000373,N00005293,Brad Ashford (D),2016,Lawyers & Lobbyists,129285,20750,150035
A000373,N00005293,Brad Ashford (D),2016,Transportation,13265,50500,63765
A000373,N00005293,Brad Ashford (D),2016,Misc Business,85167,96000,181167
A000373,N00005293,Brad Ashford (D),2016,Labor,500,64500,65000
A000373,N00005293,Brad Ashford (D),2016,Ideology/Single-Issue,87985,392317,480302
A000373,N00005293,Brad Ashford (D),2016,Other,174840,1000,175840
B000213,N00005656,Joe Barton (R),2016,Agribusiness,6700,16829,23529
B000213,N00005656,Joe Barton (R),2016,Communic/Electronics,29950,78640,108590
B000213,N00005656,Joe Barton (R),2016,Construction,15250,28200,43450
B000213,N00005656,Joe Barton (R),2016,Defense,0,26500,26500
B000213,N00005656,Joe Barton (R),2016,Energy/Nat Resource,96900,239150,336050
B000213,N00005656,Joe Barton (R),2016,Finance/Insur/RealEst,77337,33100,110437
B000213,N00005656,Joe Barton (R),2016,Health,11530,100750,112280
B000213,N00005656,Joe Barton (R),2016,Lawyers & Lobbyists,42150,16500,58650
B000213,N00005656,Joe Barton (R),2016,Transportation,6600,48750,55350
B000213,N00005656,Joe Barton (R),2016,Misc Business,77624,88500,166124
B000213,N00005656,Joe Barton (R),2016,Labor,0,3000,3000
B000213,N00005656,Joe Barton (R),2016,Ideology/Single-Issue,10050,34100,44150
B000213,N00005656,Joe Barton (R),2016,Other,37690,0,37690
B000755,N00005883,Kevin Brady (R),2016,Agribusiness,32675,194229,226904
B000755,N00005883,Kevin Brady (R),2016,Communic/Electronics,19600,194584,214184
B000755,N00005883,Kevin Brady (R),2016,Construction,52850,139000,191850
B000755,N00005883,Kevin Brady (R),2016,Defense,0,51000,51000
B000755,N00005883,Kevin Brady (R),2016,Energy/Nat Resource,190200,351600,541800
B000755,N00005883,Kevin Brady (R),2016,Finance/Insur/RealEst,347600,657750,1005350
B000755,N00005883,Kevin Brady (R),2016,Health,234600,731600,966200
B000755,N00005883,Kevin Brady (R),2016,Lawyers & Lobbyists,241259,128000,369259
B000755,N00005883,Kevin Brady (R),2016,Transportation,40170,145870,186040
B000755,N00005883,Kevin Brady (R),2016,Misc Business,157510,377681,535191
B000755,N00005883,Kevin Brady (R),2016,Labor,0,15000,15000
B000755,N00005883,Kevin Brady (R),2016,Ideology/Single-Issue,112450,60547,172997
B000755,N00005883,Kevin Brady (R),2016,Other,61190,9000,70190
B000711,N00006692,Barbara Boxer (D),2016,Agribusiness,3000,1000,4000
B000711,N00006692,Barbara Boxer (D),2016,Communic/Electronics,66100,4500,70600
B000711,N00006692,Barbara Boxer (D),2016,Construction,3750,19500,23250
B000711,N00006692,Barbara Boxer (D),2016,Defense,1000,0,1000
B000711,N00006692,Barbara Boxer (D),2016,Energy/Nat Resource,250,4000,4250
B000711,N00006692,Barbara Boxer (D),2016,Finance/Insur/RealEst,27350,3010,30360
B000711,N00006692,Barbara Boxer (D),2016,Health,10250,4000,14250
B000711,N00006692,Barbara Boxer (D),2016,Lawyers & Lobbyists,39492,2500,41992
B000711,N00006692,Barbara Boxer (D),2016,Transportation,1000,26500,27500
B000711,N00006692,Barbara Boxer (D),2016,Misc Business,40275,10902,51177
B000711,N00006692,Barbara Boxer (D),2016,Labor,0,16000,16000
B000711,N00006692,Barbara Boxer (D),2016,Ideology/Single-Issue,13947,9278,23225
B000711,N00006692,Barbara Boxer (D),2016,Other,43625,0,43625
B000574,N00007727,Earl Blumenauer (D),2016,Agribusiness,10976,21250,32226
B000574,N00007727,Earl Blumenauer (D),2016,Communic/Electronics,15084,37500,52584
B000574,N00007727,Earl Blumenauer (D),2016,Construction,30600,141500,172100
B000574,N00007727,Earl Blumenauer (D),2016,Defense,0,4000,4000
B000574,N00007727,Earl Blumenauer (D),2016,Energy/Nat Resource,10134,26000,36134
B000574,N00007727,Earl Blumenauer (D),2016,Finance/Insur/RealEst,91843,147200,239043
B000574,N00007727,Earl Blumenauer (D),2016,Health,16092,207150,223242
B000574,N00007727,Earl Blumenauer (D),2016,Lawyers & Lobbyists,65719,28000,93719
B000574,N00007727,Earl Blumenauer (D),2016,Transportation,26775,96000,122775
B000574,N00007727,Earl Blumenauer (D),2016,Misc Business,63274,105247,168521
B000574,N00007727,Earl Blumenauer (D),2016,Labor,0,56500,56500
B000574,N00007727,Earl Blumenauer (D),2016,Ideology/Single-Issue,33655,39000,72655
B000574,N00007727,Earl Blumenauer (D),2016,Other,49833,0,49833
B000287,N00009774,Xavier Becerra (D),2016,Agribusiness,1500,22000,23500
B000287,N00009774,Xavier Becerra (D),2016,Communic/Electronics,61375,98000,159375
B000287,N00009774,Xavier Becerra (D),2016,Construction,13800,20900,34700
B000287,N00009774,Xavier Becerra (D),2016,Defense,510,25000,25510
B000287,N00009774,Xavier Becerra (D),2016,Energy/Nat Resource,250,40700,40950
B000287,N00009774,Xavier Becerra (D),2016,Finance/Insur/RealEst,158112,288000,446112
B000287,N00009774,Xavier Becerra (D),2016,Health,55054,274200,329254
B000287,N00009774,Xavier Becerra (D),2016,Lawyers & Lobbyists,92057,36100,128157
B000287,N00009774,Xavier Becerra (D),2016,Transportation,1000,41000,42000
B000287,N00009774,Xavier Becerra (D),2016,Misc Business,98910,107000,205910
B000287,N00009774,Xavier Becerra (D),2016,Labor,250,147500,147750
B000287,N00009774,Xavier Becerra (D),2016,Ideology/Single-Issue,34896,18249,53145
B000287,N00009774,Xavier Becerra (D),2016,Other,30120,0,30120
A000360,N00009888,Lamar Alexander (R),2016,Agribusiness,102000,156936,258936
A000360,N00009888,Lamar Alexander (R),2016,Communic/Electronics,96750,128000,224750
A000360,N00009888,Lamar Alexander (R),2016,Construction,184567,91950,276517
A000360,N00009888,Lamar Alexander (R),2016,Defense,13450,100500,113950
A000360,N00009888,Lamar Alexander (R),2016,Energy/Nat Resource,150710,299183,449893
A000360,N00009888,Lamar Alexander (R),2016,Finance/Insur/RealEst,611850,420000,1031850
A000360,N00009888,Lamar Alexander (R),2016,Health,251150,721967,973117
A000360,N00009888,Lamar Alexander (R),2016,Lawyers & Lobbyists,252875,114988,367863
A000360,N00009888,Lamar Alexander (R),2016,Transportation,75583,178000,253583
A000360,N00009888,Lamar Alexander (R),2016,Misc Business,310010,361728,671738
A000360,N00009888,Lamar Alexander (R),2016,Labor,0,8500,8500
A000360,N00009888,Lamar Alexander (R),2016,Ideology/Single-Issue,60600,362515,423115
A000360,N00009888,Lamar Alexander (R),2016,Other,374153,55000,429153
A000368,N00030980,Kelly Ayotte (R),2016,Agribusiness,186532,146147,332679
A000368,N00030980,Kelly Ayotte (R),2016,Communic/Electronics,392400,468544,860944
A000368,N00030980,Kelly Ayotte (R),2016,Construction,238218,126750,364968
A000368,N00030980,Kelly Ayotte (R),2016,Defense,96240,257400,353640
A000368,N00030980,Kelly Ayotte (R),2016,Energy/Nat Resource,302917,368000,670917
A000368,N00030980,Kelly Ayotte (R),2016,Finance/Insur/RealEst,2795481,735140,3530621
A000368,N00030980,Kelly Ayotte (R),2016,Health,412556,564999,977555
A000368,N00030980,Kelly Ayotte (R),2016,Lawyers & Lobbyists,883581,195811,1079392
A000368,N00030980,Kelly Ayotte (R),2016,Transportation,382395,452599,834994
A000368,N00030980,Kelly Ayotte (R),2016,Misc Business,1035333,564099,1599432
A000368,N00030980,Kelly Ayotte (R),2016,Labor,0,91625,91625
A000368,N00030980,Kelly Ayotte (R),2016,Ideology/Single-Issue,852658,845082,1697740
A000368,N00030980,Kelly Ayotte (R),2016,Other,2275284,14000,2289284
A000369,N00031177,Mark Amodei (R),2016,Agribusiness,8700,23569,32269
A000369,N00031177,Mark Amodei (R),2016,Communic/Electronics,15850,28135,43985
A000369,N00031177,Mark Amodei (R),2016,Construction,23350,35000,58350
A000369,N00031177,Mark Amodei (R),2016,Defense,400,32000,32400
A000369,N00031177,Mark Amodei (R),2016,Energy/Nat Resource,4000,49200,53200
A000369,N00031177,Mark Amodei (R),2016,Finance/Insur/RealEst,28500,42000,70500
A000369,N00031177,Mark Amodei (R),2016,Health,20250,30600,50850
A000369,N00031177,Mark Amodei (R),2016,Lawyers & Lobbyists,40200,13750,53950
A000369,N00031177,Mark Amodei (R),2016,Transportation,17450,38250,55700
A000369,N00031177,Mark Amodei (R),2016,Misc Business,49950,69550,119500
A000369,N00031177,Mark Amodei (R),2016,Labor,0,6000,6000
A000369,N00031177,Mark Amodei (R),2016,Ideology/Single-Issue,21200,28849,50049
A000369,N00031177,Mark Amodei (R),2016,Other,64800,0,64800
A000367,N00031938,Justin Amash (R),2016,Agribusiness,44500,0,44500
A000367,N00031938,Justin Amash (R),2016,Communic/Electronics,23200,0,23200
A000367,N00031938,Justin Amash (R),2016,Construction,20741,1000,21741
A000367,N00031938,Justin Amash (R),2016,Energy/Nat Resource,14400,10000,24400
A000367,N00031938,Justin Amash (R),2016,Finance/Insur/RealEst,101861,4000,105861
A000367,N00031938,Justin Amash (R),2016,Health,29036,1500,30536
A000367,N00031938,Justin Amash (R),2016,Lawyers & Lobbyists,10200,0,10200
A000367,N00031938,Justin Amash (R),2016,Transportation,20200,1000,21200
A000367,N00031938,Justin Amash (R),2016,Misc Business,113405,1000,114405
A000367,N00031938,Justin Amash (R),2016,Ideology/Single-Issue,36765,12797,49562
A000367,N00031938,Justin Amash (R),2016,Other,43180,0,43180
A000372,N00033720,Richard W Allen (R),2016,Agribusiness,42372,109027,151399
A000372,N00033720,Richard W Allen (R),2016,Communic/Electronics,2500,21000,23500
A000372,N00033720,Richard W Allen (R),2016,Construction,46400,35500,81900
A000372,N00033720,Richard W Allen (R),2016,Defense,0,12000,12000
A000372,N00033720,Richard W Allen (R),2016,Energy/Nat Resource,9750,21000,30750
A000372,N00033720,Richard W Allen (R),2016,Finance/Insur/RealEst,86975,92500,179475
A000372,N00033720,Richard W Allen (R),2016,Health,51650,27000,78650
A000372,N00033720,Richard W Allen (R),2016,Lawyers & Lobbyists,27700,2250,29950
A000372,N00033720,Richard W Allen (R),2016,Transportation,15200,28500,43700
A000372,N00033720,Richard W Allen (R),2016,Misc Business,36650,59498,96148
A000372,N00033720,Richard W Allen (R),2016,Labor,0,4000,4000
A000372,N00033720,Richard W Allen (R),2016,Ideology/Single-Issue,10030,72000,82030
A000372,N00033720,Richard W Allen (R),2016,Other,101800,3500,105300
A000371,N00033997,Pete Aguilar (D),2016,Agribusiness,607,28600,29207
A000371,N00033997,Pete Aguilar (D),2016,Communic/Electronics,52665,49090,101755
A000371,N00033997,Pete Aguilar (D),2016,Construction,57215,16500,73715
A000371,N00033997,Pete Aguilar (D),2016,Defense,872,86499,87371
A000371,N00033997,Pete Aguilar (D),2016,Energy/Nat Resource,16308,13000,29308
A000371,N00033997,Pete Aguilar (D),2016,Finance/Insur/RealEst,183238,180000,363238
A000371,N00033997,Pete Aguilar (D),2016,Health,79633,97100,176733
A000371,N00033997,Pete Aguilar (D),2016,Lawyers & Lobbyists,144488,23500,167988
A000371,N00033997,Pete Aguilar (D),2016,Transportation,8445,31587,40032
A000371,N00033997,Pete Aguilar (D),2016,Misc Business,90967,49700,140667
A000371,N00033997,Pete Aguilar (D),2016,Labor,470,219000,219470
A000371,N00033997,Pete Aguilar (D),2016,Ideology/Single-Issue,292732,313026,605758
A000371,N00033997,Pete Aguilar (D),2016,Other,159949,1000,160949
A000370,N00035451,Alma Adams (D),2016,Agribusiness,4510,41000,45510
A000370,N00035451,Alma Adams (D),2016,Communic/Electronics,1930,28500,30430
A000370,N00035451,Alma Adams (D),2016,Construction,3962,0,3962
A000370,N00035451,Alma Adams (D),2016,Defense,0,8000,8000
A000370,N00035451,Alma Adams (D),2016,Energy/Nat Resource,250,11000,11250
A000370,N00035451,Alma Adams (D),2016,Finance/Insur/RealEst,13217,76000,89217
A000370,N00035451,Alma Adams (D),2016,Health,28725,29500,58225
A000370,N00035451,Alma Adams (D),2016,Lawyers & Lobbyists,25965,9500,35465
A000370,N00035451,Alma Adams (D),2016,Transportation,150,24500,24650
A000370,N00035451,Alma Adams (D),2016,Misc Business,18942,27417,46359
A000370,N00035451,Alma Adams (D),2016,Labor,0,190000,190000
A000370,N00035451,Alma Adams (D),2016,Ideology/Single-Issue,35644,165472,201116
A000370,N00035451,Alma Adams (D),2016,Other,55767,2000,57767
A000374,N00036633,Ralph Abraham (R),2016,Agribusiness,32971,96250,129221
A000374,N00036633,Ralph Abraham (R),2016,Communic/Electronics,2500,8500,11000
A000374,N00036633,Ralph Abraham (R),2016,Construction,11500,7500,19000
A000374,N00036633,Ralph Abraham (R),2016,Defense,0,8000,8000
A000374,N00036633,Ralph Abraham (R),2016,Energy/Nat Resource,6250,22000,28250
A000374,N00036633,Ralph Abraham (R),2016,Finance/Insur/RealEst,42875,23000,65875
A000374,N00036633,Ralph Abraham (R),2016,Health,32350,35500,67850
A000374,N00036633,Ralph Abraham (R),2016,Lawyers & Lobbyists,13250,9000,22250
A000374,N00036633,Ralph Abraham (R),2016,Transportation,4000,11000,15000
A000374,N00036633,Ralph Abraham (R),2016,Misc Business,31200,13000,44200
A000374,N00036633,Ralph Abraham (R),2016,Labor,0,6500,6500
A000374,N00036633,Ralph Abraham (R),2016,Ideology/Single-Issue,4700,49500,54200
A000374,N00036633,Ralph Abraham (R),2016,Other,14100,1000,15100
A000375,N00038285,Jodey Arrington (R),2016,Agribusiness,134595,90310,224905
A000375,N00038285,Jodey Arrington (R),2016,Communic/Electronics,13350,15000,28350
A000375,N00038285,Jodey Arrington (R),2016,Construction,30700,10000,40700
A000375,N00038285,Jodey Arrington (R),2016,Defense,1000,6000,7000
A000375,N00038285,Jodey Arrington (R),2016,Energy/Nat Resource,51650,41500,93150
A000375,N00038285,Jodey Arrington (R),2016,Finance/Insur/RealEst,180447,56000,236447
A000375,N00038285,Jodey Arrington (R),2016,Health,64072,22500,86572
A000375,N00038285,Jodey Arrington (R),2016,Lawyers & Lobbyists,71924,5000,76924
A000375,N00038285,Jodey Arrington (R),2016,Transportation,21650,26000,47650
A000375,N00038285,Jodey Arrington (R),2016,Misc Business,48667,20500,69167
A000375,N00038285,Jodey Arrington (R),2016,Ideology/Single-Issue,3751,108000,111751
A000375,N00038285,Jodey Arrington (R),2016,Other,173400,1000,174400
