bioguide_id,crp_id,cand_name,cycle,ind_name,indivs,pacs,totals
C000380,N00000133,Donna Christian-Christensen (D),2012,Pharmaceuticals/Health Products,350,38615,38965
C000380,N00000133,Donna Christian-Christensen (D),2012,Accountants,23200,0,23200
C000380,N00000133,Donna Christian-Christensen (D),2012,Telephone Utilities,1500,20500,22000
C000380,N00000133,Donna Christian-Christensen (D),2012,Health Professionals,700,21000,21700
C000380,N00000133,Donna Christian-Christensen (D),2012,Health Services/HMOs,5000,10000,15000
C000380,N00000133,Donna Christian-Christensen (D),2012,Leadership PACs,0,13000,13000
C000380,N00000133,Donna Christian-Christensen (D),2012,Lawyers/Law Firms,5850,7000,12850
C000380,N00000133,Donna Christian-Christensen (D),2012,Telecom Services,0,11500,11500
C000380,N00000133,Donna Christian-Christensen (D),2012,Human Rights,900,10000,10900
C000380,N00000133,Donna Christian-Christensen (D),2012,Lobbyists,9200,1500,10700
C001037,N00000267,Michael E Capuano (D),2012,Insurance,3250,62000,65250
C001037,N00000267,Michael E Capuano (D),2012,Lawyers/Law Firms,48150,16250,64400
C001037,N00000267,Michael E Capuano (D),2012,Real Estate,33700,25500,59200
C001037,N00000267,Michael E Capuano (D),2012,Securities & Investment,15050,34500,49550
C001037,N00000267,Michael E Capuano (D),2012,Pharmaceuticals/Health Products,3500,38750,42250
C001037,N00000267,Michael E Capuano (D),2012,Transportation Unions,0,41500,41500
C001037,N00000267,Michael E Capuano (D),2012,Public Sector Unions,250,39750,40000
C001037,N00000267,Michael E Capuano (D),2012,Building Trade Unions,0,40000,40000
C001037,N00000267,Michael E Capuano (D),2012,Oil & Gas,21000,5000,26000
C001037,N00000267,Michael E Capuano (D),2012,Construction Services,7750,16500,24250
C001035,N00000491,Susan Collins (R),2012,Retired,501049,0,501049
C001035,N00000491,Susan Collins (R),2012,Lawyers/Law Firms,343714,142416,486130
C001035,N00000491,Susan Collins (R),2012,Securities & Investment,381615,80500,462115
C001035,N00000491,Susan Collins (R),2012,Health Professionals,106969,269300,376269
C001035,N00000491,Susan Collins (R),2012,Leadership PACs,0,365300,365300
C001035,N00000491,Susan Collins (R),2012,Lobbyists,343859,9031,352890
C001035,N00000491,Susan Collins (R),2012,Real Estate,248450,46500,294950
C001035,N00000491,Susan Collins (R),2012,Insurance,80150,170500,250650
C001035,N00000491,Susan Collins (R),2012,Health Services/HMOs,69000,120523,189523
C001035,N00000491,Susan Collins (R),2012,Misc Finance,176294,5500,181794
D000216,N00000615,Rosa L DeLauro (D),2012,Health Professionals,18196,95000,113196
D000216,N00000615,Rosa L DeLauro (D),2012,Lobbyists,77043,1175,78218
D000216,N00000615,Rosa L DeLauro (D),2012,Public Sector Unions,0,73000,73000
D000216,N00000615,Rosa L DeLauro (D),2012,Lawyers/Law Firms,42652,30000,72652
D000216,N00000615,Rosa L DeLauro (D),2012,Democratic/Liberal,47250,2050,49300
D000216,N00000615,Rosa L DeLauro (D),2012,Building Trade Unions,0,48000,48000
D000216,N00000615,Rosa L DeLauro (D),2012,Industrial Unions,0,43000,43000
D000216,N00000615,Rosa L DeLauro (D),2012,Misc Unions,0,36500,36500
D000216,N00000615,Rosa L DeLauro (D),2012,Pharmaceuticals/Health Products,1500,33000,34500
D000216,N00000615,Rosa L DeLauro (D),2012,Misc Issues,2900,30000,32900
F000372,N00000684,Rodney Frelinghuysen (R),2012,Pharmaceuticals/Health Products,3500,73000,76500
F000372,N00000684,Rodney Frelinghuysen (R),2012,Electric Utilities,5050,70500,75550
F000372,N00000684,Rodney Frelinghuysen (R),2012,Retired,72725,0,72725
F000372,N00000684,Rodney Frelinghuysen (R),2012,Defense Aerospace,5950,51000,56950
F000372,N00000684,Rodney Frelinghuysen (R),2012,Defense Electronics,2500,51500,54000
F000372,N00000684,Rodney Frelinghuysen (R),2012,Lobbyists,44625,6000,50625
F000372,N00000684,Rodney Frelinghuysen (R),2012,General Contractors,10650,32150,42800
F000372,N00000684,Rodney Frelinghuysen (R),2012,Securities & Investment,42300,0,42300
F000372,N00000684,Rodney Frelinghuysen (R),2012,Lawyers/Law Firms,18500,20749,39249
F000372,N00000684,Rodney Frelinghuysen (R),2012,Real Estate,23675,13000,36675
G000548,N00000743,Scott Garrett (R),2012,Securities & Investment,322895,227125,550020
G000548,N00000743,Scott Garrett (R),2012,Insurance,42522,137500,180022
G000548,N00000743,Scott Garrett (R),2012,Real Estate,61225,84472,145697
G000548,N00000743,Scott Garrett (R),2012,Commercial Banks,47150,81499,128649
G000548,N00000743,Scott Garrett (R),2012,Lawyers/Law Firms,59525,41500,101025
G000548,N00000743,Scott Garrett (R),2012,Misc Finance,50750,19000,69750
G000548,N00000743,Scott Garrett (R),2012,Retired,66850,0,66850
G000548,N00000743,Scott Garrett (R),2012,Accountants,36075,28000,64075
G000548,N00000743,Scott Garrett (R),2012,Finance/Credit Companies,6300,53150,59450
G000548,N00000743,Scott Garrett (R),2012,Lobbyists,45415,6000,51415
A000210,N00000826,Robert E Andrews (D),2012,Lawyers/Law Firms,90612,52000,142612
A000210,N00000826,Robert E Andrews (D),2012,Education,85900,35101,121001
A000210,N00000826,Robert E Andrews (D),2012,Building Trade Unions,0,61000,61000
A000210,N00000826,Robert E Andrews (D),2012,Defense Aerospace,5200,54500,59700
A000210,N00000826,Robert E Andrews (D),2012,Public Sector Unions,0,58250,58250
A000210,N00000826,Robert E Andrews (D),2012,Pro-Israel,28775,21500,50275
A000210,N00000826,Robert E Andrews (D),2012,Lobbyists,42636,6750,49386
A000210,N00000826,Robert E Andrews (D),2012,Health Professionals,14500,34000,48500
A000210,N00000826,Robert E Andrews (D),2012,Insurance,6500,36441,42941
A000210,N00000826,Robert E Andrews (D),2012,Industrial Unions,0,39000,39000
H001032,N00000860,Rush Holt (D),2012,Retired,300945,0,300945
H001032,N00000860,Rush Holt (D),2012,Securities & Investment,52450,79000,131450
H001032,N00000860,Rush Holt (D),2012,Education,96510,0,96510
H001032,N00000860,Rush Holt (D),2012,Pharmaceuticals/Health Products,25200,56000,81200
H001032,N00000860,Rush Holt (D),2012,Insurance,2089,71500,73589
H001032,N00000860,Rush Holt (D),2012,Lawyers/Law Firms,38806,22500,61306
H001032,N00000860,Rush Holt (D),2012,Building Trade Unions,0,51500,51500
H001032,N00000860,Rush Holt (D),2012,Public Sector Unions,250,50000,50250
H001032,N00000860,Rush Holt (D),2012,Democratic/Liberal,34456,11000,45456
H001032,N00000860,Rush Holt (D),2012,Pro-Israel,43400,2000,45400
E000179,N00001003,Eliot L Engel (D),2012,Health Professionals,13351,95000,108351
E000179,N00001003,Eliot L Engel (D),2012,Pro-Israel,53150,41000,94150
E000179,N00001003,Eliot L Engel (D),2012,Real Estate,67300,8000,75300
E000179,N00001003,Eliot L Engel (D),2012,Education,56125,0,56125
E000179,N00001003,Eliot L Engel (D),2012,Building Trade Unions,0,45000,45000
E000179,N00001003,Eliot L Engel (D),2012,Lawyers/Law Firms,22250,21500,43750
E000179,N00001003,Eliot L Engel (D),2012,Telephone Utilities,15360,17000,32360
E000179,N00001003,Eliot L Engel (D),2012,Pharmaceuticals/Health Products,750,31000,31750
E000179,N00001003,Eliot L Engel (D),2012,Public Sector Unions,0,28000,28000
E000179,N00001003,Eliot L Engel (D),2012,Hospitals/Nursing Homes,17600,9000,26600
C001038,N00001127,Joseph Crowley (D),2012,Securities & Investment,119399,164500,283899
C001038,N00001127,Joseph Crowley (D),2012,Insurance,31250,212500,243750
C001038,N00001127,Joseph Crowley (D),2012,Real Estate,96600,73096,169696
C001038,N00001127,Joseph Crowley (D),2012,Lawyers/Law Firms,65150,48750,113900
C001038,N00001127,Joseph Crowley (D),2012,Lobbyists,97551,2600,100151
C001038,N00001127,Joseph Crowley (D),2012,Pharmaceuticals/Health Products,5650,91500,97150
C001038,N00001127,Joseph Crowley (D),2012,Health Professionals,10250,70250,80500
C001038,N00001127,Joseph Crowley (D),2012,Commercial Banks,8000,68500,76500
C001038,N00001127,Joseph Crowley (D),2012,Accountants,11000,49000,60000
C001038,N00001127,Joseph Crowley (D),2012,Retail Sales,10501,45000,55501
C001092,N00001285,Chris Collins (R),2012,Leadership PACs,0,96720,96720
C001092,N00001285,Chris Collins (R),2012,Health Professionals,19800,13500,33300
C001092,N00001285,Chris Collins (R),2012,Oil & Gas,10250,23000,33250
C001092,N00001285,Chris Collins (R),2012,Real Estate,31900,0,31900
C001092,N00001285,Chris Collins (R),2012,Candidate Committees,3500,27000,30500
C001092,N00001285,Chris Collins (R),2012,Retired,28800,0,28800
C001092,N00001285,Chris Collins (R),2012,General Contractors,18700,8500,27200
C001092,N00001285,Chris Collins (R),2012,Automotive,4600,17500,22100
C001092,N00001285,Chris Collins (R),2012,Misc Manufacturing & Distributing,15750,4000,19750
C001092,N00001285,Chris Collins (R),2012,Lawyers/Law Firms,16700,1000,17700
D000482,N00001373,Mike Doyle (D),2012,Electric Utilities,0,75500,75500
D000482,N00001373,Mike Doyle (D),2012,Industrial Unions,0,59000,59000
D000482,N00001373,Mike Doyle (D),2012,Building Trade Unions,0,50000,50000
D000482,N00001373,Mike Doyle (D),2012,Lawyers/Law Firms,25450,18750,44200
D000482,N00001373,Mike Doyle (D),2012,Telecom Services,0,40000,40000
D000482,N00001373,Mike Doyle (D),2012,Health Professionals,5500,31000,36500
D000482,N00001373,Mike Doyle (D),2012,Real Estate,23100,13000,36100
D000482,N00001373,Mike Doyle (D),2012,Public Sector Unions,0,35500,35500
D000482,N00001373,Mike Doyle (D),2012,Oil & Gas,1000,25250,26250
D000482,N00001373,Mike Doyle (D),2012,Telephone Utilities,0,24620,24620
B001227,N00001619,Robert A Brady (D),2012,Lawyers/Law Firms,43950,23250,67200
B001227,N00001619,Robert A Brady (D),2012,Building Trade Unions,500,51150,51650
B001227,N00001619,Robert A Brady (D),2012,Industrial Unions,0,47000,47000
B001227,N00001619,Robert A Brady (D),2012,Transportation Unions,0,32500,32500
B001227,N00001619,Robert A Brady (D),2012,General Contractors,30900,0,30900
B001227,N00001619,Robert A Brady (D),2012,Misc Unions,0,24350,24350
B001227,N00001619,Robert A Brady (D),2012,Business Services,23700,0,23700
B001227,N00001619,Robert A Brady (D),2012,Real Estate,16750,1500,18250
B001227,N00001619,Robert A Brady (D),2012,Public Sector Unions,0,17500,17500
B001227,N00001619,Robert A Brady (D),2012,Automotive,5500,10000,15500
F000043,N00001746,Chaka Fattah (D),2012,Lawyers/Law Firms,33400,33000,66400
F000043,N00001746,Chaka Fattah (D),2012,Public Sector Unions,0,43500,43500
F000043,N00001746,Chaka Fattah (D),2012,Defense Aerospace,0,31000,31000
F000043,N00001746,Chaka Fattah (D),2012,Building Trade Unions,0,27500,27500
F000043,N00001746,Chaka Fattah (D),2012,Real Estate,16500,10500,27000
F000043,N00001746,Chaka Fattah (D),2012,Lobbyists,21704,2000,23704
F000043,N00001746,Chaka Fattah (D),2012,Telecom Services,9250,12000,21250
F000043,N00001746,Chaka Fattah (D),2012,Pharmaceuticals/Health Products,1250,15000,16250
F000043,N00001746,Chaka Fattah (D),2012,Industrial Unions,0,16000,16000
F000043,N00001746,Chaka Fattah (D),2012,Air Transport,9750,5500,15250
G000386,N00001758,Chuck Grassley (R),2012,Health Professionals,107260,293710,400970
G000386,N00001758,Chuck Grassley (R),2012,Insurance,109302,275900,385202
G000386,N00001758,Chuck Grassley (R),2012,Leadership PACs,0,311300,311300
G000386,N00001758,Chuck Grassley (R),2012,Lobbyists,287050,12818,299868
G000386,N00001758,Chuck Grassley (R),2012,Securities & Investment,154150,129750,283900
G000386,N00001758,Chuck Grassley (R),2012,Pharmaceuticals/Health Products,61950,157700,219650
G000386,N00001758,Chuck Grassley (R),2012,Lawyers/Law Firms,102300,111873,214173
G000386,N00001758,Chuck Grassley (R),2012,Health Services/HMOs,57550,156600,214150
G000386,N00001758,Chuck Grassley (R),2012,Retired,208157,0,208157
G000386,N00001758,Chuck Grassley (R),2012,Hospitals/Nursing Homes,97037,107800,204837
D000355,N00001783,John D Dingell (D),2012,Health Professionals,3750,106000,109750
D000355,N00001783,John D Dingell (D),2012,Electric Utilities,14550,93500,108050
D000355,N00001783,John D Dingell (D),2012,Lobbyists,96366,4566,100932
D000355,N00001783,John D Dingell (D),2012,Lawyers/Law Firms,21400,64571,85971
D000355,N00001783,John D Dingell (D),2012,Pharmaceuticals/Health Products,1000,71500,72500
D000355,N00001783,John D Dingell (D),2012,Automotive,29550,37500,67050
D000355,N00001783,John D Dingell (D),2012,Building Trade Unions,0,55000,55000
D000355,N00001783,John D Dingell (D),2012,TV/Movies/Music,7550,43000,50550
D000355,N00001783,John D Dingell (D),2012,Industrial Unions,0,50000,50000
D000355,N00001783,John D Dingell (D),2012,Telephone Utilities,6500,37500,44000
H000874,N00001821,Steny H Hoyer (D),2012,Securities & Investment,104760,141750,246510
H000874,N00001821,Steny H Hoyer (D),2012,Electric Utilities,10050,227500,237550
H000874,N00001821,Steny H Hoyer (D),2012,Health Professionals,27496,209075,236571
H000874,N00001821,Steny H Hoyer (D),2012,Insurance,45633,181500,227133
H000874,N00001821,Steny H Hoyer (D),2012,Lawyers/Law Firms,107250,85750,193000
H000874,N00001821,Steny H Hoyer (D),2012,Real Estate,76570,80020,156590
H000874,N00001821,Steny H Hoyer (D),2012,Lobbyists,145315,10600,155915
H000874,N00001821,Steny H Hoyer (D),2012,Pharmaceuticals/Health Products,13000,141000,154000
H000874,N00001821,Steny H Hoyer (D),2012,Pro-Israel,105925,37850,143775
H000874,N00001821,Steny H Hoyer (D),2012,Public Sector Unions,0,124500,124500
C000141,N00001955,Ben Cardin (D),2012,Lawyers/Law Firms,412226,118900,531126
C000141,N00001955,Ben Cardin (D),2012,Real Estate,383720,62500,446220
C000141,N00001955,Ben Cardin (D),2012,Health Professionals,141310,264399,405709
C000141,N00001955,Ben Cardin (D),2012,Securities & Investment,281833,117000,398833
C000141,N00001955,Ben Cardin (D),2012,Pro-Israel,218262,59280,277542
C000141,N00001955,Ben Cardin (D),2012,Retired,269660,0,269660
C000141,N00001955,Ben Cardin (D),2012,Lobbyists,251643,9366,261009
C000141,N00001955,Ben Cardin (D),2012,Insurance,52600,181000,233600
C000141,N00001955,Ben Cardin (D),2012,Leadership PACs,0,192000,192000
C000141,N00001955,Ben Cardin (D),2012,Health Services/HMOs,72550,114300,186850
C000984,N00001971,Elijah E Cummings (D),2012,Public Sector Unions,0,87500,87500
C000984,N00001971,Elijah E Cummings (D),2012,Transportation Unions,0,67100,67100
C000984,N00001971,Elijah E Cummings (D),2012,Sea Transport,8000,35500,43500
C000984,N00001971,Elijah E Cummings (D),2012,Health Professionals,12050,23000,35050
C000984,N00001971,Elijah E Cummings (D),2012,Air Transport,0,34000,34000
C000984,N00001971,Elijah E Cummings (D),2012,Industrial Unions,0,32000,32000
C000984,N00001971,Elijah E Cummings (D),2012,Railroads,0,31000,31000
C000984,N00001971,Elijah E Cummings (D),2012,Lawyers/Law Firms,11500,19000,30500
C000984,N00001971,Elijah E Cummings (D),2012,Real Estate,14000,9500,23500
C000984,N00001971,Elijah E Cummings (D),2012,Building Trade Unions,0,22000,22000
B001135,N00002221,Richard Burr (R),2012,Retired,643631,0,643631
B001135,N00002221,Richard Burr (R),2012,Health Professionals,308239,209241,517480
B001135,N00002221,Richard Burr (R),2012,Lawyers/Law Firms,327550,140500,468050
B001135,N00002221,Richard Burr (R),2012,Insurance,209151,247000,456151
B001135,N00002221,Richard Burr (R),2012,Pharmaceuticals/Health Products,113250,326619,439869
B001135,N00002221,Richard Burr (R),2012,Securities & Investment,287802,107400,395202
B001135,N00002221,Richard Burr (R),2012,Lobbyists,334041,13000,347041
B001135,N00002221,Richard Burr (R),2012,Real Estate,283629,51000,334629
B001135,N00002221,Richard Burr (R),2012,Electric Utilities,142531,155999,298530
B001135,N00002221,Richard Burr (R),2012,Leadership PACs,0,295241,295241
C000556,N00002247,Howard Coble (R),2012,Lawyers/Law Firms,7500,22500,30000
C000556,N00002247,Howard Coble (R),2012,Air Transport,250,28000,28250
C000556,N00002247,Howard Coble (R),2012,Tobacco,14250,13498,27748
C000556,N00002247,Howard Coble (R),2012,Lobbyists,17000,2000,19000
C000556,N00002247,Howard Coble (R),2012,Leadership PACs,0,18000,18000
C000556,N00002247,Howard Coble (R),2012,"Beer, Wine & Liquor",6345,11000,17345
C000556,N00002247,Howard Coble (R),2012,Retired,17300,0,17300
C000556,N00002247,Howard Coble (R),2012,TV/Movies/Music,2000,14000,16000
C000556,N00002247,Howard Coble (R),2012,Trucking,2000,13000,15000
C000556,N00002247,Howard Coble (R),2012,Electric Utilities,0,15000,15000
C000537,N00002408,James E Clyburn (D),2012,Health Professionals,4000,135000,139000
C000537,N00002408,James E Clyburn (D),2012,Electric Utilities,6250,130500,136750
C000537,N00002408,James E Clyburn (D),2012,Pharmaceuticals/Health Products,5250,118894,124144
C000537,N00002408,James E Clyburn (D),2012,Lawyers/Law Firms,50096,64359,114455
C000537,N00002408,James E Clyburn (D),2012,Insurance,3750,88500,92250
C000537,N00002408,James E Clyburn (D),2012,Public Sector Unions,0,88500,88500
C000537,N00002408,James E Clyburn (D),2012,Telecom Services,21000,63500,84500
C000537,N00002408,James E Clyburn (D),2012,Lobbyists,66029,5500,71529
C000537,N00002408,James E Clyburn (D),2012,Commercial Banks,6750,59000,65750
C000537,N00002408,James E Clyburn (D),2012,Securities & Investment,13000,52390,65390
B000490,N00002674,Sanford D Bishop Jr (D),2012,Lawyers/Law Firms,51150,28157,79307
B000490,N00002674,Sanford D Bishop Jr (D),2012,Crop Production & Basic Processing,11750,67000,78750
B000490,N00002674,Sanford D Bishop Jr (D),2012,Defense Aerospace,1000,41000,42000
B000490,N00002674,Sanford D Bishop Jr (D),2012,Lobbyists,38493,2243,40736
B000490,N00002674,Sanford D Bishop Jr (D),2012,Industrial Unions,0,37500,37500
B000490,N00002674,Sanford D Bishop Jr (D),2012,Agricultural Services/Products,250,37000,37250
B000490,N00002674,Sanford D Bishop Jr (D),2012,Public Sector Unions,0,37000,37000
B000490,N00002674,Sanford D Bishop Jr (D),2012,Insurance,19750,16500,36250
B000490,N00002674,Sanford D Bishop Jr (D),2012,Health Professionals,6980,25900,32880
B000490,N00002674,Sanford D Bishop Jr (D),2012,Real Estate,13250,18000,31250
C000286,N00002685,Saxby Chambliss (R),2012,Retired,785081,0,785081
C000286,N00002685,Saxby Chambliss (R),2012,Crop Production & Basic Processing,431194,250696,681890
C000286,N00002685,Saxby Chambliss (R),2012,Lawyers/Law Firms,488880,168188,657068
C000286,N00002685,Saxby Chambliss (R),2012,Real Estate,491920,66300,558220
C000286,N00002685,Saxby Chambliss (R),2012,Securities & Investment,428550,125400,553950
C000286,N00002685,Saxby Chambliss (R),2012,Leadership PACs,0,500349,500349
C000286,N00002685,Saxby Chambliss (R),2012,Insurance,256636,232500,489136
C000286,N00002685,Saxby Chambliss (R),2012,Health Professionals,272884,152500,425384
C000286,N00002685,Saxby Chambliss (R),2012,Agricultural Services/Products,125388,258070,383458
C000286,N00002685,Saxby Chambliss (R),2012,Lobbyists,349693,16045,365738
B000911,N00002713,Corrine Brown (D),2012,Transportation Unions,0,59000,59000
B000911,N00002713,Corrine Brown (D),2012,Railroads,6000,49500,55500
B000911,N00002713,Corrine Brown (D),2012,Lawyers/Law Firms,43050,5000,48050
B000911,N00002713,Corrine Brown (D),2012,Air Transport,0,29000,29000
B000911,N00002713,Corrine Brown (D),2012,Building Trade Unions,0,21000,21000
B000911,N00002713,Corrine Brown (D),2012,Sea Transport,5000,15000,20000
B000911,N00002713,Corrine Brown (D),2012,Real Estate,12500,7010,19510
B000911,N00002713,Corrine Brown (D),2012,Public Sector Unions,0,19500,19500
B000911,N00002713,Corrine Brown (D),2012,Lobbyists,12250,3000,15250
B000911,N00002713,Corrine Brown (D),2012,Leadership PACs,0,15000,15000
H000324,N00002884,Alcee L Hastings (D),2012,Education,38750,31250,70000
H000324,N00002884,Alcee L Hastings (D),2012,Crop Production & Basic Processing,17300,23500,40800
H000324,N00002884,Alcee L Hastings (D),2012,Lawyers/Law Firms,26426,13000,39426
H000324,N00002884,Alcee L Hastings (D),2012,Business Services,27400,0,27400
H000324,N00002884,Alcee L Hastings (D),2012,Building Trade Unions,0,27000,27000
H000324,N00002884,Alcee L Hastings (D),2012,Pro-Israel,18250,8000,26250
H000324,N00002884,Alcee L Hastings (D),2012,Industrial Unions,0,25250,25250
H000324,N00002884,Alcee L Hastings (D),2012,Transportation Unions,250,24500,24750
H000324,N00002884,Alcee L Hastings (D),2012,Retired,20550,0,20550
H000324,N00002884,Alcee L Hastings (D),2012,Public Sector Unions,0,20000,20000
F000462,N00002893,Lois J Frankel (D),2012,Lawyers/Law Firms,402104,14000,416104
F000462,N00002893,Lois J Frankel (D),2012,Retired,295600,0,295600
F000462,N00002893,Lois J Frankel (D),2012,Women's Issues,139686,26033,165719
F000462,N00002893,Lois J Frankel (D),2012,Real Estate,150504,0,150504
F000462,N00002893,Lois J Frankel (D),2012,Business Services,64550,5200,69750
F000462,N00002893,Lois J Frankel (D),2012,Health Professionals,62950,6000,68950
F000462,N00002893,Lois J Frankel (D),2012,Leadership PACs,0,61250,61250
F000462,N00002893,Lois J Frankel (D),2012,Public Sector Unions,0,56500,56500
F000462,N00002893,Lois J Frankel (D),2012,Pro-Israel,50790,4500,55290
F000462,N00002893,Lois J Frankel (D),2012,Building Trade Unions,0,45000,45000
A000055,N00003028,Robert B Aderholt (R),2012,Lawyers/Law Firms,24746,35500,60246
A000055,N00003028,Robert B Aderholt (R),2012,Defense Aerospace,3000,56500,59500
A000055,N00003028,Robert B Aderholt (R),2012,Misc Defense,23500,34500,58000
A000055,N00003028,Robert B Aderholt (R),2012,Electronics Mfg & Equip,15750,35000,50750
A000055,N00003028,Robert B Aderholt (R),2012,Defense Electronics,1000,39000,40000
A000055,N00003028,Robert B Aderholt (R),2012,Sea Transport,34500,1000,35500
A000055,N00003028,Robert B Aderholt (R),2012,Health Professionals,23635,10500,34135
A000055,N00003028,Robert B Aderholt (R),2012,Building Materials & Equipment,13500,17500,31000
A000055,N00003028,Robert B Aderholt (R),2012,Pharmaceuticals/Health Products,0,30000,30000
A000055,N00003028,Robert B Aderholt (R),2012,Accountants,12896,17000,29896
B001243,N00003105,Marsha Blackburn (R),2012,Health Professionals,36818,171000,207818
B001243,N00003105,Marsha Blackburn (R),2012,Pharmaceuticals/Health Products,9000,110433,119433
B001243,N00003105,Marsha Blackburn (R),2012,Oil & Gas,13250,81000,94250
B001243,N00003105,Marsha Blackburn (R),2012,TV/Movies/Music,26950,44500,71450
B001243,N00003105,Marsha Blackburn (R),2012,Hospitals/Nursing Homes,18000,51750,69750
B001243,N00003105,Marsha Blackburn (R),2012,Health Services/HMOs,19500,44250,63750
B001243,N00003105,Marsha Blackburn (R),2012,Automotive,26000,28500,54500
B001243,N00003105,Marsha Blackburn (R),2012,Insurance,5750,41913,47663
B001243,N00003105,Marsha Blackburn (R),2012,Retail Sales,12250,28500,40750
B001243,N00003105,Marsha Blackburn (R),2012,Telecom Services,0,39000,39000
C000754,N00003132,Jim Cooper (D),2012,Lawyers/Law Firms,111950,10750,122700
C000754,N00003132,Jim Cooper (D),2012,Retired,69925,0,69925
C000754,N00003132,Jim Cooper (D),2012,Securities & Investment,49900,4000,53900
C000754,N00003132,Jim Cooper (D),2012,Real Estate,41531,6000,47531
C000754,N00003132,Jim Cooper (D),2012,Accountants,9000,30344,39344
C000754,N00003132,Jim Cooper (D),2012,Insurance,18750,19000,37750
C000754,N00003132,Jim Cooper (D),2012,Education,35400,0,35400
C000754,N00003132,Jim Cooper (D),2012,"Beer, Wine & Liquor",19847,11500,31347
C000754,N00003132,Jim Cooper (D),2012,Business Services,24550,3000,27550
C000754,N00003132,Jim Cooper (D),2012,Misc Finance,26000,0,26000
D000533,N00003209,John J Duncan Jr (R),2012,Air Transport,4000,56947,60947
D000533,N00003209,John J Duncan Jr (R),2012,Railroads,4000,50750,54750
D000533,N00003209,John J Duncan Jr (R),2012,Construction Services,3000,45500,48500
D000533,N00003209,John J Duncan Jr (R),2012,Building Materials & Equipment,7000,41194,48194
D000533,N00003209,John J Duncan Jr (R),2012,General Contractors,8750,27150,35900
D000533,N00003209,John J Duncan Jr (R),2012,Lobbyists,32250,2000,34250
D000533,N00003209,John J Duncan Jr (R),2012,Lawyers/Law Firms,4250,28500,32750
D000533,N00003209,John J Duncan Jr (R),2012,Trucking,1000,20500,21500
D000533,N00003209,John J Duncan Jr (R),2012,Transportation Unions,0,20500,20500
D000533,N00003209,John J Duncan Jr (R),2012,Oil & Gas,0,16000,16000
C001068,N00003225,Steve Cohen (D),2012,Lawyers/Law Firms,28350,19000,47350
C001068,N00003225,Steve Cohen (D),2012,Transportation Unions,0,40000,40000
C001068,N00003225,Steve Cohen (D),2012,Health Professionals,17750,19000,36750
C001068,N00003225,Steve Cohen (D),2012,Real Estate,31750,5000,36750
C001068,N00003225,Steve Cohen (D),2012,Public Sector Unions,0,34500,34500
C001068,N00003225,Steve Cohen (D),2012,Railroads,250,33250,33500
C001068,N00003225,Steve Cohen (D),2012,Industrial Unions,0,32500,32500
C001068,N00003225,Steve Cohen (D),2012,Retired,25475,0,25475
C001068,N00003225,Steve Cohen (D),2012,Air Transport,1000,23000,24000
C001068,N00003225,Steve Cohen (D),2012,Automotive,3250,20000,23250
C000567,N00003328,Thad Cochran (R),2012,Crop Production & Basic Processing,150844,65000,215844
C000567,N00003328,Thad Cochran (R),2012,Lawyers/Law Firms,124414,84500,208914
C000567,N00003328,Thad Cochran (R),2012,Lobbyists,114300,3800,118100
C000567,N00003328,Thad Cochran (R),2012,Agricultural Services/Products,15200,81500,96700
C000567,N00003328,Thad Cochran (R),2012,Health Professionals,32300,64000,96300
C000567,N00003328,Thad Cochran (R),2012,Oil & Gas,39156,48000,87156
C000567,N00003328,Thad Cochran (R),2012,Defense Aerospace,5800,71000,76800
C000567,N00003328,Thad Cochran (R),2012,Leadership PACs,0,71800,71800
C000567,N00003328,Thad Cochran (R),2012,Real Estate,53550,13010,66560
C000567,N00003328,Thad Cochran (R),2012,Pharmaceuticals/Health Products,6500,55500,62000
B000944,N00003535,Sherrod Brown (D),2012,Lawyers/Law Firms,1865503,195154,2060657
B000944,N00003535,Sherrod Brown (D),2012,Retired,1272358,0,1272358
B000944,N00003535,Sherrod Brown (D),2012,Health Professionals,447477,265300,712777
B000944,N00003535,Sherrod Brown (D),2012,Education,604739,6000,610739
B000944,N00003535,Sherrod Brown (D),2012,Real Estate,509062,78907,587969
B000944,N00003535,Sherrod Brown (D),2012,Lobbyists,454916,23850,478766
B000944,N00003535,Sherrod Brown (D),2012,Women's Issues,402684,1500,404184
B000944,N00003535,Sherrod Brown (D),2012,Leadership PACs,200,387605,387805
B000944,N00003535,Sherrod Brown (D),2012,Hospitals/Nursing Homes,329488,50250,379738
B000944,N00003535,Sherrod Brown (D),2012,Democratic/Liberal,341621,36071,377692
B000589,N00003675,John Boehner (R),2012,Securities & Investment,1393575,143250,1536825
B000589,N00003675,John Boehner (R),2012,Retired,1215279,0,1215279
B000589,N00003675,John Boehner (R),2012,Health Professionals,413997,183500,597497
B000589,N00003675,John Boehner (R),2012,Real Estate,540076,45500,585576
B000589,N00003675,John Boehner (R),2012,Misc Manufacturing & Distributing,406837,83500,490337
B000589,N00003675,John Boehner (R),2012,Oil & Gas,333099,146500,479599
B000589,N00003675,John Boehner (R),2012,Lawyers/Law Firms,389952,80106,470058
B000589,N00003675,John Boehner (R),2012,Insurance,272051,187800,459851
B000589,N00003675,John Boehner (R),2012,Republican/Conservative,444836,13500,458336
B000589,N00003675,John Boehner (R),2012,Lobbyists,411450,7300,418750
C000266,N00003689,Steve Chabot (R),2012,Misc Manufacturing & Distributing,41300,25500,66800
C000266,N00003689,Steve Chabot (R),2012,Retired,64800,0,64800
C000266,N00003689,Steve Chabot (R),2012,Lawyers/Law Firms,44100,17250,61350
C000266,N00003689,Steve Chabot (R),2012,Leadership PACs,0,55052,55052
C000266,N00003689,Steve Chabot (R),2012,Health Professionals,31950,20000,51950
C000266,N00003689,Steve Chabot (R),2012,Insurance,32700,13300,46000
C000266,N00003689,Steve Chabot (R),2012,Automotive,10000,21500,31500
C000266,N00003689,Steve Chabot (R),2012,Electronics Mfg & Equip,19500,9000,28500
C000266,N00003689,Steve Chabot (R),2012,Real Estate,21750,6000,27750
C000266,N00003689,Steve Chabot (R),2012,Food Processing & Sales,17950,9000,26950
C000542,N00003845,Dan Coats (R),2012,Securities & Investment,244081,9500,253581
C000542,N00003845,Dan Coats (R),2012,Leadership PACs,0,216354,216354
C000542,N00003845,Dan Coats (R),2012,Lawyers/Law Firms,154554,46000,200554
C000542,N00003845,Dan Coats (R),2012,Retired,173996,0,173996
C000542,N00003845,Dan Coats (R),2012,Real Estate,126349,19000,145349
C000542,N00003845,Dan Coats (R),2012,Insurance,24850,113400,138250
C000542,N00003845,Dan Coats (R),2012,Lobbyists,126233,9500,135733
C000542,N00003845,Dan Coats (R),2012,Oil & Gas,21483,99750,121233
C000542,N00003845,Dan Coats (R),2012,Health Professionals,36300,80000,116300
C000542,N00003845,Dan Coats (R),2012,Pharmaceuticals/Health Products,19450,73949,93399
C000714,N00004029,John Conyers Jr (D),2012,Lawyers/Law Firms,79532,38250,117782
C000714,N00004029,John Conyers Jr (D),2012,Telecom Services,21500,75500,97000
C000714,N00004029,John Conyers Jr (D),2012,Lobbyists,60103,6000,66103
C000714,N00004029,John Conyers Jr (D),2012,TV/Movies/Music,13050,46500,59550
C000714,N00004029,John Conyers Jr (D),2012,Health Professionals,7032,34000,41032
C000714,N00004029,John Conyers Jr (D),2012,Public Sector Unions,0,40000,40000
C000714,N00004029,John Conyers Jr (D),2012,Industrial Unions,0,38000,38000
C000714,N00004029,John Conyers Jr (D),2012,Misc Unions,775,32000,32775
C000714,N00004029,John Conyers Jr (D),2012,Leadership PACs,0,29000,29000
C000714,N00004029,John Conyers Jr (D),2012,Building Trade Unions,0,28500,28500
H000206,N00004207,Tom Harkin (D),2012,Lawyers/Law Firms,415226,156086,571312
H000206,N00004207,Tom Harkin (D),2012,Health Professionals,169650,354148,523798
H000206,N00004207,Tom Harkin (D),2012,Lobbyists,399251,7501,406752
H000206,N00004207,Tom Harkin (D),2012,Securities & Investment,327230,47500,374730
H000206,N00004207,Tom Harkin (D),2012,Pharmaceuticals/Health Products,107250,239816,347066
H000206,N00004207,Tom Harkin (D),2012,Retired,288663,0,288663
H000206,N00004207,Tom Harkin (D),2012,Hospitals/Nursing Homes,160000,74500,234500
H000206,N00004207,Tom Harkin (D),2012,Crop Production & Basic Processing,99810,109425,209235
H000206,N00004207,Tom Harkin (D),2012,Real Estate,183350,20400,203750
H000206,N00004207,Tom Harkin (D),2012,Insurance,74530,108500,183030
B001230,N00004367,Tammy Baldwin (D),2012,Women's Issues,882131,36972,919103
B001230,N00004367,Tammy Baldwin (D),2012,Retired,762873,0,762873
B001230,N00004367,Tammy Baldwin (D),2012,Lawyers/Law Firms,582657,18250,600907
B001230,N00004367,Tammy Baldwin (D),2012,Democratic/Liberal,388594,173765,562359
B001230,N00004367,Tammy Baldwin (D),2012,Leadership PACs,8750,300680,309430
B001230,N00004367,Tammy Baldwin (D),2012,Education,297525,0,297525
B001230,N00004367,Tammy Baldwin (D),2012,Human Rights,185468,29993,215461
B001230,N00004367,Tammy Baldwin (D),2012,Health Professionals,159704,40750,200454
B001230,N00004367,Tammy Baldwin (D),2012,Business Services,175688,0,175688
B001230,N00004367,Tammy Baldwin (D),2012,Pro-Israel,147665,24715,172380
C001096,N00004614,Kevin Cramer (R),2012,Oil & Gas,159000,49500,208500
C001096,N00004614,Kevin Cramer (R),2012,Leadership PACs,500,85000,85500
C001096,N00004614,Kevin Cramer (R),2012,Crop Production & Basic Processing,63540,17500,81040
C001096,N00004614,Kevin Cramer (R),2012,Retired,71860,0,71860
C001096,N00004614,Kevin Cramer (R),2012,Real Estate,31155,5000,36155
C001096,N00004614,Kevin Cramer (R),2012,Commercial Banks,21000,9500,30500
C001096,N00004614,Kevin Cramer (R),2012,General Contractors,25050,4000,29050
C001096,N00004614,Kevin Cramer (R),2012,Civil Servants/Public Officials,27860,0,27860
C001096,N00004614,Kevin Cramer (R),2012,Republican/Conservative,22429,4500,26929
C001096,N00004614,Kevin Cramer (R),2012,Misc Business,23600,0,23600
B000243,N00004643,Max Baucus (D),2012,Securities & Investment,735869,177400,913269
B000243,N00004643,Max Baucus (D),2012,Lawyers/Law Firms,459369,220978,680347
B000243,N00004643,Max Baucus (D),2012,Insurance,242450,368650,611100
B000243,N00004643,Max Baucus (D),2012,Lobbyists,571012,12625,583637
B000243,N00004643,Max Baucus (D),2012,Health Professionals,142529,417500,560029
B000243,N00004643,Max Baucus (D),2012,Health Services/HMOs,282018,271200,553218
B000243,N00004643,Max Baucus (D),2012,Pharmaceuticals/Health Products,177214,351218,528432
B000243,N00004643,Max Baucus (D),2012,Hospitals/Nursing Homes,234018,224950,458968
B000243,N00004643,Max Baucus (D),2012,Real Estate,375580,83250,458830
B000243,N00004643,Max Baucus (D),2012,Electric Utilities,28942,258700,287642
G000535,N00004874,Luis V Gutierrez (D),2012,Building Trade Unions,0,29500,29500
G000535,N00004874,Luis V Gutierrez (D),2012,Real Estate,6750,21000,27750
G000535,N00004874,Luis V Gutierrez (D),2012,Securities & Investment,0,27000,27000
G000535,N00004874,Luis V Gutierrez (D),2012,Insurance,0,26000,26000
G000535,N00004874,Luis V Gutierrez (D),2012,Lawyers/Law Firms,14240,9000,23240
G000535,N00004874,Luis V Gutierrez (D),2012,Accountants,0,17911,17911
G000535,N00004874,Luis V Gutierrez (D),2012,Misc Services,2500,9000,11500
G000535,N00004874,Luis V Gutierrez (D),2012,Industrial Unions,0,10500,10500
G000535,N00004874,Luis V Gutierrez (D),2012,TV/Movies/Music,500,9000,9500
G000535,N00004874,Luis V Gutierrez (D),2012,Commercial Banks,500,7500,8000
D000096,N00004884,Danny K Davis (D),2012,Public Sector Unions,0,49500,49500
D000096,N00004884,Danny K Davis (D),2012,Building Trade Unions,0,21500,21500
D000096,N00004884,Danny K Davis (D),2012,Lawyers/Law Firms,3071,16500,19571
D000096,N00004884,Danny K Davis (D),2012,Pharmaceuticals/Health Products,0,16500,16500
D000096,N00004884,Danny K Davis (D),2012,Business Services,3650,10500,14150
D000096,N00004884,Danny K Davis (D),2012,Health Professionals,4350,9000,13350
D000096,N00004884,Danny K Davis (D),2012,Insurance,0,13000,13000
D000096,N00004884,Danny K Davis (D),2012,Food & Beverage,0,12500,12500
D000096,N00004884,Danny K Davis (D),2012,Industrial Unions,0,12500,12500
D000096,N00004884,Danny K Davis (D),2012,Printing & Publishing,0,11500,11500
D000096,N00004884,Danny K Davis (D),2012,Electric Utilities,0,11500,11500
D000563,N00004981,Dick Durbin (D),2012,Lawyers/Law Firms,1535901,148088,1683989
D000563,N00004981,Dick Durbin (D),2012,Securities & Investment,650987,107500,758487
D000563,N00004981,Dick Durbin (D),2012,Real Estate,426396,36500,462896
D000563,N00004981,Dick Durbin (D),2012,Lobbyists,335696,16407,352103
D000563,N00004981,Dick Durbin (D),2012,Pro-Israel,296012,42000,338012
D000563,N00004981,Dick Durbin (D),2012,Health Professionals,133346,186191,319537
D000563,N00004981,Dick Durbin (D),2012,Retired,287774,0,287774
D000563,N00004981,Dick Durbin (D),2012,Insurance,72410,128900,201310
D000563,N00004981,Dick Durbin (D),2012,Business Services,174525,24500,199025
D000563,N00004981,Dick Durbin (D),2012,Hospitals/Nursing Homes,98625,95500,194125
E000172,N00005090,Jo Ann Emerson (R),2012,Crop Production & Basic Processing,56262,62004,118266
E000172,N00005090,Jo Ann Emerson (R),2012,Lobbyists,82729,2000,84729
E000172,N00005090,Jo Ann Emerson (R),2012,Public Sector Unions,0,59500,59500
E000172,N00005090,Jo Ann Emerson (R),2012,Building Trade Unions,0,55500,55500
E000172,N00005090,Jo Ann Emerson (R),2012,Health Professionals,25178,24500,49678
E000172,N00005090,Jo Ann Emerson (R),2012,Commercial Banks,8700,39000,47700
E000172,N00005090,Jo Ann Emerson (R),2012,Insurance,3200,40800,44000
E000172,N00005090,Jo Ann Emerson (R),2012,Agricultural Services/Products,12750,28500,41250
E000172,N00005090,Jo Ann Emerson (R),2012,Transportation Unions,0,39000,39000
E000172,N00005090,Jo Ann Emerson (R),2012,Lawyers/Law Firms,16300,21750,38050
B000575,N00005195,Roy Blunt (R),2012,Securities & Investment,760305,86500,846805
B000575,N00005195,Roy Blunt (R),2012,Retired,618249,0,618249
B000575,N00005195,Roy Blunt (R),2012,Leadership PACs,0,532203,532203
B000575,N00005195,Roy Blunt (R),2012,Lawyers/Law Firms,342347,122600,464947
B000575,N00005195,Roy Blunt (R),2012,Health Professionals,287280,166500,453780
B000575,N00005195,Roy Blunt (R),2012,Real Estate,383035,37900,420935
B000575,N00005195,Roy Blunt (R),2012,Lobbyists,391280,9000,400280
B000575,N00005195,Roy Blunt (R),2012,Oil & Gas,238885,160750,399635
B000575,N00005195,Roy Blunt (R),2012,Insurance,185734,185900,371634
B000575,N00005195,Roy Blunt (R),2012,Misc Manufacturing & Distributing,297900,62900,360800
C000560,N00005601,Tom Coburn (R),2012,Health Professionals,93572,117500,211072
C000560,N00005601,Tom Coburn (R),2012,Oil & Gas,68300,106050,174350
C000560,N00005601,Tom Coburn (R),2012,Pharmaceuticals/Health Products,7452,122000,129452
C000560,N00005601,Tom Coburn (R),2012,Leadership PACs,200,125043,125243
C000560,N00005601,Tom Coburn (R),2012,Insurance,8150,106500,114650
C000560,N00005601,Tom Coburn (R),2012,Republican/Conservative,90900,9193,100093
C000560,N00005601,Tom Coburn (R),2012,Lobbyists,89100,9303,98403
C000560,N00005601,Tom Coburn (R),2012,Retired,98150,0,98150
C000560,N00005601,Tom Coburn (R),2012,Securities & Investment,66050,29000,95050
C000560,N00005601,Tom Coburn (R),2012,Lawyers/Law Firms,43350,45315,88665
H000067,N00005645,Ralph Hall (R),2012,Oil & Gas,20500,39000,59500
H000067,N00005645,Ralph Hall (R),2012,Health Professionals,23750,23000,46750
H000067,N00005645,Ralph Hall (R),2012,Defense Aerospace,3000,26500,29500
H000067,N00005645,Ralph Hall (R),2012,Electric Utilities,1000,28000,29000
H000067,N00005645,Ralph Hall (R),2012,Lawyers/Law Firms,15500,13000,28500
H000067,N00005645,Ralph Hall (R),2012,Leadership PACs,0,23500,23500
H000067,N00005645,Ralph Hall (R),2012,Air Transport,3204,15500,18704
H000067,N00005645,Ralph Hall (R),2012,Retired,16500,0,16500
H000067,N00005645,Ralph Hall (R),2012,Telephone Utilities,0,16000,16000
H000067,N00005645,Ralph Hall (R),2012,Real Estate,7000,8010,15010
B000213,N00005656,Joe Barton (R),2012,Oil & Gas,52150,114500,166650
B000213,N00005656,Joe Barton (R),2012,Electric Utilities,8450,116500,124950
B000213,N00005656,Joe Barton (R),2012,Health Professionals,27600,58500,86100
B000213,N00005656,Joe Barton (R),2012,Pharmaceuticals/Health Products,19200,35000,54200
B000213,N00005656,Joe Barton (R),2012,Lawyers/Law Firms,12050,32750,44800
B000213,N00005656,Joe Barton (R),2012,Misc Manufacturing & Distributing,37000,7000,44000
B000213,N00005656,Joe Barton (R),2012,Misc Finance,34250,0,34250
B000213,N00005656,Joe Barton (R),2012,Telecom Services,2500,27000,29500
B000213,N00005656,Joe Barton (R),2012,Lobbyists,26142,3000,29142
B000213,N00005656,Joe Barton (R),2012,TV/Movies/Music,13000,15500,28500
B000213,N00005656,Joe Barton (R),2012,Misc Energy,11500,17000,28500
G000410,N00005870,Gene Green (D),2012,Oil & Gas,1500,95200,96700
G000410,N00005870,Gene Green (D),2012,Health Professionals,6200,89500,95700
G000410,N00005870,Gene Green (D),2012,Chemical & Related Manufacturing,3100,58000,61100
G000410,N00005870,Gene Green (D),2012,Building Trade Unions,0,61000,61000
G000410,N00005870,Gene Green (D),2012,Electric Utilities,6000,54800,60800
G000410,N00005870,Gene Green (D),2012,Lawyers/Law Firms,22000,34000,56000
G000410,N00005870,Gene Green (D),2012,Pharmaceuticals/Health Products,10700,44000,54700
G000410,N00005870,Gene Green (D),2012,Industrial Unions,0,51000,51000
G000410,N00005870,Gene Green (D),2012,Transportation Unions,1400,38500,39900
G000410,N00005870,Gene Green (D),2012,TV/Movies/Music,4750,25500,30250
B000755,N00005883,Kevin Brady (R),2012,Oil & Gas,8165,159000,167165
B000755,N00005883,Kevin Brady (R),2012,Insurance,5300,104000,109300
B000755,N00005883,Kevin Brady (R),2012,Health Professionals,12250,54250,66500
B000755,N00005883,Kevin Brady (R),2012,Securities & Investment,6000,49000,55000
B000755,N00005883,Kevin Brady (R),2012,Pharmaceuticals/Health Products,16500,37500,54000
B000755,N00005883,Kevin Brady (R),2012,Electronics Mfg & Equip,2750,49000,51750
B000755,N00005883,Kevin Brady (R),2012,Real Estate,4000,43000,47000
B000755,N00005883,Kevin Brady (R),2012,Lawyers/Law Firms,15750,29250,45000
B000755,N00005883,Kevin Brady (R),2012,Health Services/HMOs,5750,34000,39750
B000755,N00005883,Kevin Brady (R),2012,Hospitals/Nursing Homes,1000,38500,39500
H000636,N00006008,Ruben Hinojosa (D),2012,Health Professionals,67000,8800,75800
H000636,N00006008,Ruben Hinojosa (D),2012,"Beer, Wine & Liquor",21800,12000,33800
H000636,N00006008,Ruben Hinojosa (D),2012,Lawyers/Law Firms,24100,8000,32100
H000636,N00006008,Ruben Hinojosa (D),2012,Public Sector Unions,0,28500,28500
H000636,N00006008,Ruben Hinojosa (D),2012,Insurance,1550,24000,25550
H000636,N00006008,Ruben Hinojosa (D),2012,Building Trade Unions,0,25000,25000
H000636,N00006008,Ruben Hinojosa (D),2012,Hospitals/Nursing Homes,13350,10000,23350
H000636,N00006008,Ruben Hinojosa (D),2012,Crop Production & Basic Processing,500,21500,22000
H000636,N00006008,Ruben Hinojosa (D),2012,Oil & Gas,2500,18000,20500
H000636,N00006008,Ruben Hinojosa (D),2012,Real Estate,2950,17000,19950
D000399,N00006023,Lloyd Doggett (D),2012,Lawyers/Law Firms,347309,27750,375059
D000399,N00006023,Lloyd Doggett (D),2012,Retired,123972,0,123972
D000399,N00006023,Lloyd Doggett (D),2012,Health Professionals,28568,42300,70868
D000399,N00006023,Lloyd Doggett (D),2012,Building Trade Unions,0,60500,60500
D000399,N00006023,Lloyd Doggett (D),2012,Industrial Unions,0,48000,48000
D000399,N00006023,Lloyd Doggett (D),2012,Real Estate,22500,17000,39500
D000399,N00006023,Lloyd Doggett (D),2012,Public Sector Unions,0,35500,35500
D000399,N00006023,Lloyd Doggett (D),2012,Transportation Unions,0,35500,35500
D000399,N00006023,Lloyd Doggett (D),2012,Misc Finance,34500,0,34500
D000399,N00006023,Lloyd Doggett (D),2012,Securities & Investment,26500,6500,33000
D000197,N00006134,Diana DeGette (D),2012,Pharmaceuticals/Health Products,750,97159,97909
D000197,N00006134,Diana DeGette (D),2012,Lawyers/Law Firms,51600,34500,86100
D000197,N00006134,Diana DeGette (D),2012,Health Professionals,6250,76500,82750
D000197,N00006134,Diana DeGette (D),2012,Democratic/Liberal,80883,1755,82638
D000197,N00006134,Diana DeGette (D),2012,Retired,54450,0,54450
D000197,N00006134,Diana DeGette (D),2012,Telecom Services,6245,45500,51745
D000197,N00006134,Diana DeGette (D),2012,Real Estate,27700,12500,40200
D000197,N00006134,Diana DeGette (D),2012,Telephone Utilities,0,32000,32000
D000197,N00006134,Diana DeGette (D),2012,Building Trade Unions,0,31000,31000
D000197,N00006134,Diana DeGette (D),2012,Transportation Unions,0,30000,30000
B001261,N00006236,John A Barrasso (R),2012,Health Professionals,531643,333450,865093
B001261,N00006236,John A Barrasso (R),2012,Oil & Gas,208816,337900,546716
B001261,N00006236,John A Barrasso (R),2012,Leadership PACs,0,455228,455228
B001261,N00006236,John A Barrasso (R),2012,Pharmaceuticals/Health Products,60350,222089,282439
B001261,N00006236,John A Barrasso (R),2012,Securities & Investment,206310,71571,277881
B001261,N00006236,John A Barrasso (R),2012,Lobbyists,269773,6625,276398
B001261,N00006236,John A Barrasso (R),2012,Electric Utilities,15050,261000,276050
B001261,N00006236,John A Barrasso (R),2012,Mining,131781,99000,230781
B001261,N00006236,John A Barrasso (R),2012,Insurance,38750,173875,212625
B001261,N00006236,John A Barrasso (R),2012,Retired,169434,0,169434
E000285,N00006249,Mike Enzi (R),2012,Pharmaceuticals/Health Products,13400,257250,270650
E000285,N00006249,Mike Enzi (R),2012,Health Professionals,10050,143499,153549
E000285,N00006249,Mike Enzi (R),2012,Securities & Investment,26050,106434,132484
E000285,N00006249,Mike Enzi (R),2012,Oil & Gas,28500,97800,126300
E000285,N00006249,Mike Enzi (R),2012,Insurance,1250,122500,123750
E000285,N00006249,Mike Enzi (R),2012,Leadership PACs,0,108550,108550
E000285,N00006249,Mike Enzi (R),2012,Lobbyists,76806,3750,80556
E000285,N00006249,Mike Enzi (R),2012,Health Services/HMOs,18500,45500,64000
E000285,N00006249,Mike Enzi (R),2012,Commercial Banks,11400,41500,52900
E000285,N00006249,Mike Enzi (R),2012,Real Estate,11500,41000,52500
C000880,N00006267,Mike Crapo (R),2012,Securities & Investment,189165,237350,426515
C000880,N00006267,Mike Crapo (R),2012,Insurance,65300,308750,374050
C000880,N00006267,Mike Crapo (R),2012,Lobbyists,190400,4169,194569
C000880,N00006267,Mike Crapo (R),2012,Pharmaceuticals/Health Products,31750,137871,169621
C000880,N00006267,Mike Crapo (R),2012,Leadership PACs,0,168484,168484
C000880,N00006267,Mike Crapo (R),2012,Real Estate,79204,82010,161214
C000880,N00006267,Mike Crapo (R),2012,Health Professionals,23844,123000,146844
C000880,N00006267,Mike Crapo (R),2012,Hospitals/Nursing Homes,21900,112200,134100
C000880,N00006267,Mike Crapo (R),2012,Retired,129147,0,129147
C000880,N00006267,Mike Crapo (R),2012,Lawyers/Law Firms,55018,71822,126840
F000448,N00006423,Trent Franks (R),2012,Defense Aerospace,1000,37500,38500
F000448,N00006423,Trent Franks (R),2012,Lobbyists,22500,0,22500
F000448,N00006423,Trent Franks (R),2012,Retired,21550,0,21550
F000448,N00006423,Trent Franks (R),2012,Defense Electronics,3000,15000,18000
F000448,N00006423,Trent Franks (R),2012,Oil & Gas,3400,11500,14900
F000448,N00006423,Trent Franks (R),2012,Real Estate,5400,6000,11400
F000448,N00006423,Trent Franks (R),2012,Republican/Conservative,5600,5000,10600
F000448,N00006423,Trent Franks (R),2012,Telecom Services,0,10500,10500
F000448,N00006423,Trent Franks (R),2012,Electric Utilities,0,10000,10000
F000448,N00006423,Trent Franks (R),2012,Construction Services,6500,3000,9500
F000448,N00006423,Trent Franks (R),2012,Internet,0,9500,9500
B000711,N00006692,Barbara Boxer (D),2012,Lawyers/Law Firms,1983749,144721,2128470
B000711,N00006692,Barbara Boxer (D),2012,Retired,1461995,0,1461995
B000711,N00006692,Barbara Boxer (D),2012,Women's Issues,1284001,30895,1314896
B000711,N00006692,Barbara Boxer (D),2012,TV/Movies/Music,936545,76300,1012845
B000711,N00006692,Barbara Boxer (D),2012,Real Estate,566755,25681,592436
B000711,N00006692,Barbara Boxer (D),2012,Securities & Investment,541124,21300,562424
B000711,N00006692,Barbara Boxer (D),2012,Health Professionals,394110,67900,462010
B000711,N00006692,Barbara Boxer (D),2012,Education,445639,1000,446639
B000711,N00006692,Barbara Boxer (D),2012,Business Services,438375,6500,444875
B000711,N00006692,Barbara Boxer (D),2012,Leadership PACs,0,428910,428910
H001063,N00006806,Janice Hahn (D),2012,Real Estate,108650,26500,135150
H001063,N00006806,Janice Hahn (D),2012,Building Trade Unions,1500,109499,110999
H001063,N00006806,Janice Hahn (D),2012,Lawyers/Law Firms,89450,20500,109950
H001063,N00006806,Janice Hahn (D),2012,Public Sector Unions,0,91000,91000
H001063,N00006806,Janice Hahn (D),2012,Retired,87418,0,87418
H001063,N00006806,Janice Hahn (D),2012,Women's Issues,71401,15500,86901
H001063,N00006806,Janice Hahn (D),2012,Transportation Unions,750,83500,84250
H001063,N00006806,Janice Hahn (D),2012,Industrial Unions,0,81000,81000
H001063,N00006806,Janice Hahn (D),2012,Lobbyists,57450,0,57450
H001063,N00006806,Janice Hahn (D),2012,Leadership PACs,0,55000,55000
C000059,N00007099,Ken Calvert (R),2012,Real Estate,39640,12000,51640
C000059,N00007099,Ken Calvert (R),2012,Lobbyists,48801,2000,50801
C000059,N00007099,Ken Calvert (R),2012,Air Transport,3500,43500,47000
C000059,N00007099,Ken Calvert (R),2012,Defense Electronics,2150,44000,46150
C000059,N00007099,Ken Calvert (R),2012,Defense Aerospace,0,46000,46000
C000059,N00007099,Ken Calvert (R),2012,Misc Manufacturing & Distributing,16986,24884,41870
C000059,N00007099,Ken Calvert (R),2012,Construction Services,25250,15500,40750
C000059,N00007099,Ken Calvert (R),2012,Building Materials & Equipment,30300,9500,39800
C000059,N00007099,Ken Calvert (R),2012,Casinos/Gambling,34000,0,34000
C000059,N00007099,Ken Calvert (R),2012,Republican/Conservative,20600,13000,33600
C001036,N00007232,Lois Capps (D),2012,Retired,303750,0,303750
C001036,N00007232,Lois Capps (D),2012,Health Professionals,65175,214500,279675
C001036,N00007232,Lois Capps (D),2012,Women's Issues,147017,29130,176147
C001036,N00007232,Lois Capps (D),2012,Leadership PACs,2750,125973,128723
C001036,N00007232,Lois Capps (D),2012,Lawyers/Law Firms,87945,34500,122445
C001036,N00007232,Lois Capps (D),2012,Democratic/Liberal,58105,22026,80131
C001036,N00007232,Lois Capps (D),2012,Candidate Committees,0,80000,80000
C001036,N00007232,Lois Capps (D),2012,Public Sector Unions,0,74500,74500
C001036,N00007232,Lois Capps (D),2012,Pro-Israel,56893,10450,67343
C001036,N00007232,Lois Capps (D),2012,Education,63700,0,63700
F000030,N00007312,Sam Farr (D),2012,Crop Production & Basic Processing,32991,54500,87491
F000030,N00007312,Sam Farr (D),2012,Retired,48965,0,48965
F000030,N00007312,Sam Farr (D),2012,Health Professionals,13200,27500,40700
F000030,N00007312,Sam Farr (D),2012,Agricultural Services/Products,3000,30023,33023
F000030,N00007312,Sam Farr (D),2012,Public Sector Unions,0,27500,27500
F000030,N00007312,Sam Farr (D),2012,Lodging/Tourism,3750,19500,23250
F000030,N00007312,Sam Farr (D),2012,Lawyers/Law Firms,4360,17000,21360
F000030,N00007312,Sam Farr (D),2012,Building Trade Unions,0,17000,17000
F000030,N00007312,Sam Farr (D),2012,"Beer, Wine & Liquor",4238,12300,16538
F000030,N00007312,Sam Farr (D),2012,Transportation Unions,0,16000,16000
E000215,N00007335,Anna Eshoo (D),2012,Pharmaceuticals/Health Products,67678,141300,208978
E000215,N00007335,Anna Eshoo (D),2012,Electronics Mfg & Equip,86300,83331,169631
E000215,N00007335,Anna Eshoo (D),2012,Retired,107750,0,107750
E000215,N00007335,Anna Eshoo (D),2012,Telecom Services,0,86500,86500
E000215,N00007335,Anna Eshoo (D),2012,Securities & Investment,71500,12500,84000
E000215,N00007335,Anna Eshoo (D),2012,Lawyers/Law Firms,50610,16500,67110
E000215,N00007335,Anna Eshoo (D),2012,Telephone Utilities,2000,41620,43620
E000215,N00007335,Anna Eshoo (D),2012,Health Professionals,3520,38400,41920
E000215,N00007335,Anna Eshoo (D),2012,Lobbyists,39000,2000,41000
E000215,N00007335,Anna Eshoo (D),2012,Real Estate,27500,8000,35500
F000062,N00007364,Dianne Feinstein (D),2012,Lawyers/Law Firms,430579,136500,567079
F000062,N00007364,Dianne Feinstein (D),2012,Retired,454358,0,454358
F000062,N00007364,Dianne Feinstein (D),2012,Crop Production & Basic Processing,262633,113499,376132
F000062,N00007364,Dianne Feinstein (D),2012,Securities & Investment,339357,26850,366207
F000062,N00007364,Dianne Feinstein (D),2012,Real Estate,325471,35000,360471
F000062,N00007364,Dianne Feinstein (D),2012,Lobbyists,307072,14874,321946
F000062,N00007364,Dianne Feinstein (D),2012,Electric Utilities,205800,105150,310950
F000062,N00007364,Dianne Feinstein (D),2012,TV/Movies/Music,194965,54400,249365
F000062,N00007364,Dianne Feinstein (D),2012,Women's Issues,201449,11000,212449
F000062,N00007364,Dianne Feinstein (D),2012,Electronics Mfg & Equip,92750,106789,199539
F000010,N00007632,Eni F H Faleomavaega (D),2012,Misc Business,15000,0,15000
F000010,N00007632,Eni F H Faleomavaega (D),2012,Food & Beverage,13000,0,13000
F000010,N00007632,Eni F H Faleomavaega (D),2012,Transportation Unions,0,5000,5000
F000010,N00007632,Eni F H Faleomavaega (D),2012,Fisheries & Wildlife,4500,0,4500
F000010,N00007632,Eni F H Faleomavaega (D),2012,Misc Finance,4500,0,4500
F000010,N00007632,Eni F H Faleomavaega (D),2012,Business Services,3000,0,3000
F000010,N00007632,Eni F H Faleomavaega (D),2012,General Contractors,2500,0,2500
F000010,N00007632,Eni F H Faleomavaega (D),2012,Health Professionals,2500,0,2500
F000010,N00007632,Eni F H Faleomavaega (D),2012,Retired,2500,0,2500
F000010,N00007632,Eni F H Faleomavaega (D),2012,Health Services/HMOs,2000,0,2000
F000010,N00007632,Eni F H Faleomavaega (D),2012,Securities & Investment,2000,0,2000
F000010,N00007632,Eni F H Faleomavaega (D),2012,Lobbyists,2000,0,2000
B000574,N00007727,Earl Blumenauer (D),2012,Health Professionals,2600,92250,94850
B000574,N00007727,Earl Blumenauer (D),2012,Construction Services,28410,53000,81410
B000574,N00007727,Earl Blumenauer (D),2012,Railroads,16425,64165,80590
B000574,N00007727,Earl Blumenauer (D),2012,Real Estate,32850,28000,60850
B000574,N00007727,Earl Blumenauer (D),2012,Public Sector Unions,0,53000,53000
B000574,N00007727,Earl Blumenauer (D),2012,Misc Manufacturing & Distributing,21900,30750,52650
B000574,N00007727,Earl Blumenauer (D),2012,Lawyers/Law Firms,22750,27250,50000
B000574,N00007727,Earl Blumenauer (D),2012,Transportation Unions,0,43500,43500
B000574,N00007727,Earl Blumenauer (D),2012,Securities & Investment,36999,4500,41499
B000574,N00007727,Earl Blumenauer (D),2012,General Contractors,2550,35500,38050
D000191,N00007781,Peter DeFazio (D),2012,Transportation Unions,0,78500,78500
D000191,N00007781,Peter DeFazio (D),2012,Retired,73995,0,73995
D000191,N00007781,Peter DeFazio (D),2012,Air Transport,0,58000,58000
D000191,N00007781,Peter DeFazio (D),2012,Railroads,3500,44500,48000
D000191,N00007781,Peter DeFazio (D),2012,Lawyers/Law Firms,16000,26500,42500
D000191,N00007781,Peter DeFazio (D),2012,Industrial Unions,0,42000,42000
D000191,N00007781,Peter DeFazio (D),2012,Public Sector Unions,0,40000,40000
D000191,N00007781,Peter DeFazio (D),2012,Building Trade Unions,0,39500,39500
D000191,N00007781,Peter DeFazio (D),2012,Leadership PACs,0,29500,29500
D000191,N00007781,Peter DeFazio (D),2012,Construction Services,2000,26500,28500
C000127,N00007836,Maria Cantwell (D),2012,Lawyers/Law Firms,765319,8000,773319
C000127,N00007836,Maria Cantwell (D),2012,Retired,713191,0,713191
C000127,N00007836,Maria Cantwell (D),2012,Lobbyists,585315,250,585565
C000127,N00007836,Maria Cantwell (D),2012,Securities & Investment,376837,0,376837
C000127,N00007836,Maria Cantwell (D),2012,Real Estate,230985,0,230985
C000127,N00007836,Maria Cantwell (D),2012,Electronics Mfg & Equip,211499,2512,214011
C000127,N00007836,Maria Cantwell (D),2012,Health Professionals,194463,15000,209463
C000127,N00007836,Maria Cantwell (D),2012,Casinos/Gambling,206550,0,206550
C000127,N00007836,Maria Cantwell (D),2012,Business Services,200077,0,200077
C000127,N00007836,Maria Cantwell (D),2012,Misc Finance,140832,0,140832
C000071,N00008086,Dave Camp (R),2012,Health Professionals,43273,295500,338773
C000071,N00008086,Dave Camp (R),2012,Securities & Investment,147800,153750,301550
C000071,N00008086,Dave Camp (R),2012,Insurance,38000,252508,290508
C000071,N00008086,Dave Camp (R),2012,Oil & Gas,82300,156300,238600
C000071,N00008086,Dave Camp (R),2012,Pharmaceuticals/Health Products,25400,212500,237900
C000071,N00008086,Dave Camp (R),2012,Lobbyists,181350,14001,195351
C000071,N00008086,Dave Camp (R),2012,Health Services/HMOs,16950,151400,168350
C000071,N00008086,Dave Camp (R),2012,Electric Utilities,1500,162500,164000
C000071,N00008086,Dave Camp (R),2012,Hospitals/Nursing Homes,50572,105000,155572
C000071,N00008086,Dave Camp (R),2012,Commercial Banks,30150,104500,134650
B000013,N00008091,Spencer Bachus (R),2012,Securities & Investment,88177,199500,287677
B000013,N00008091,Spencer Bachus (R),2012,Commercial Banks,115700,164500,280200
B000013,N00008091,Spencer Bachus (R),2012,Insurance,46710,222500,269210
B000013,N00008091,Spencer Bachus (R),2012,Real Estate,122700,95000,217700
B000013,N00008091,Spencer Bachus (R),2012,Finance/Credit Companies,36708,87500,124208
B000013,N00008091,Spencer Bachus (R),2012,Lawyers/Law Firms,40384,83304,123688
B000013,N00008091,Spencer Bachus (R),2012,Misc Finance,42000,45000,87000
B000013,N00008091,Spencer Bachus (R),2012,Leadership PACs,0,81000,81000
B000013,N00008091,Spencer Bachus (R),2012,Accountants,13250,52000,65250
B000013,N00008091,Spencer Bachus (R),2012,Lobbyists,64050,0,64050
G000377,N00008799,Kay Granger (R),2012,Defense Aerospace,54950,56000,110950
G000377,N00008799,Kay Granger (R),2012,Oil & Gas,63500,16000,79500
G000377,N00008799,Kay Granger (R),2012,Real Estate,49245,20500,69745
G000377,N00008799,Kay Granger (R),2012,Retired,60825,0,60825
G000377,N00008799,Kay Granger (R),2012,Lobbyists,58260,2500,60760
G000377,N00008799,Kay Granger (R),2012,Lawyers/Law Firms,31222,26990,58212
G000377,N00008799,Kay Granger (R),2012,Securities & Investment,36700,15000,51700
G000377,N00008799,Kay Granger (R),2012,Misc Manufacturing & Distributing,23750,23500,47250
G000377,N00008799,Kay Granger (R),2012,Air Transport,2000,45100,47100
G000377,N00008799,Kay Granger (R),2012,Misc Defense,500,37000,37500
G000289,N00009154,Bob Goodlatte (R),2012,Retired,87672,0,87672
G000289,N00009154,Bob Goodlatte (R),2012,Electronics Mfg & Equip,5000,75093,80093
G000289,N00009154,Bob Goodlatte (R),2012,TV/Movies/Music,19000,60000,79000
G000289,N00009154,Bob Goodlatte (R),2012,Lawyers/Law Firms,28793,35250,64043
G000289,N00009154,Bob Goodlatte (R),2012,Food Processing & Sales,6500,45566,52066
G000289,N00009154,Bob Goodlatte (R),2012,Lobbyists,48400,2000,50400
G000289,N00009154,Bob Goodlatte (R),2012,Telecom Services,4750,42400,47150
G000289,N00009154,Bob Goodlatte (R),2012,Internet,18250,26000,44250
G000289,N00009154,Bob Goodlatte (R),2012,Railroads,750,40760,41510
G000289,N00009154,Bob Goodlatte (R),2012,Agricultural Services/Products,1750,32762,34512
H000329,N00009157,Doc Hastings (R),2012,Oil & Gas,65050,112499,177549
H000329,N00009157,Doc Hastings (R),2012,Mining,69128,48000,117128
H000329,N00009157,Doc Hastings (R),2012,Crop Production & Basic Processing,52720,30500,83220
H000329,N00009157,Doc Hastings (R),2012,Casinos/Gambling,58499,0,58499
H000329,N00009157,Doc Hastings (R),2012,Retired,55950,0,55950
H000329,N00009157,Doc Hastings (R),2012,Forestry & Forest Products,18499,26620,45119
H000329,N00009157,Doc Hastings (R),2012,Lobbyists,44000,1000,45000
H000329,N00009157,Doc Hastings (R),2012,Lawyers/Law Firms,11978,28000,39978
H000329,N00009157,Doc Hastings (R),2012,Electric Utilities,5300,33261,38561
H000329,N00009157,Doc Hastings (R),2012,Misc Manufacturing & Distributing,27475,7500,34975
F000444,N00009573,Jeff Flake (R),2012,Republican/Conservative,1259937,59843,1319780
F000444,N00009573,Jeff Flake (R),2012,Retired,608043,0,608043
F000444,N00009573,Jeff Flake (R),2012,Securities & Investment,326329,13000,339329
F000444,N00009573,Jeff Flake (R),2012,Leadership PACs,0,325868,325868
F000444,N00009573,Jeff Flake (R),2012,Real Estate,300322,17500,317822
F000444,N00009573,Jeff Flake (R),2012,Misc Finance,199622,2500,202122
F000444,N00009573,Jeff Flake (R),2012,Lawyers/Law Firms,164952,33500,198452
F000444,N00009573,Jeff Flake (R),2012,Mining,124102,52000,176102
F000444,N00009573,Jeff Flake (R),2012,Health Professionals,131807,42500,174307
F000444,N00009573,Jeff Flake (R),2012,Oil & Gas,70860,96000,166860
D000598,N00009604,Susan A Davis (D),2012,Women's Issues,27550,7500,35050
D000598,N00009604,Susan A Davis (D),2012,Electronics Mfg & Equip,17250,16000,33250
D000598,N00009604,Susan A Davis (D),2012,Retired,31600,0,31600
D000598,N00009604,Susan A Davis (D),2012,Public Sector Unions,0,31550,31550
D000598,N00009604,Susan A Davis (D),2012,Health Professionals,5894,22500,28394
D000598,N00009604,Susan A Davis (D),2012,Pharmaceuticals/Health Products,500,27500,28000
D000598,N00009604,Susan A Davis (D),2012,Defense Aerospace,250,23000,23250
D000598,N00009604,Susan A Davis (D),2012,Misc Defense,9800,12000,21800
D000598,N00009604,Susan A Davis (D),2012,Lawyers/Law Firms,6750,12500,19250
D000598,N00009604,Susan A Davis (D),2012,Defense Electronics,0,18500,18500
C001048,N00009738,John Culberson (R),2012,Oil & Gas,29850,71000,100850
C001048,N00009738,John Culberson (R),2012,Real Estate,52200,15500,67700
C001048,N00009738,John Culberson (R),2012,Retired,50900,0,50900
C001048,N00009738,John Culberson (R),2012,Health Professionals,22000,21000,43000
C001048,N00009738,John Culberson (R),2012,Construction Services,21000,15000,36000
C001048,N00009738,John Culberson (R),2012,Defense Aerospace,0,32500,32500
C001048,N00009738,John Culberson (R),2012,Lawyers/Law Firms,21316,10500,31816
C001048,N00009738,John Culberson (R),2012,Misc Manufacturing & Distributing,12900,12000,24900
C001048,N00009738,John Culberson (R),2012,Misc Finance,22700,0,22700
C001048,N00009738,John Culberson (R),2012,Air Transport,2500,20000,22500
C001047,N00009771,Shelley Moore Capito (R),2012,Commercial Banks,22750,165750,188500
C001047,N00009771,Shelley Moore Capito (R),2012,Mining,127187,50749,177936
C001047,N00009771,Shelley Moore Capito (R),2012,Insurance,16000,117300,133300
C001047,N00009771,Shelley Moore Capito (R),2012,Securities & Investment,18400,107000,125400
C001047,N00009771,Shelley Moore Capito (R),2012,Lawyers/Law Firms,108963,15000,123963
C001047,N00009771,Shelley Moore Capito (R),2012,Real Estate,44400,55500,99900
C001047,N00009771,Shelley Moore Capito (R),2012,Retired,99850,0,99850
C001047,N00009771,Shelley Moore Capito (R),2012,Finance/Credit Companies,22000,56800,78800
C001047,N00009771,Shelley Moore Capito (R),2012,Health Professionals,28200,46500,74700
C001047,N00009771,Shelley Moore Capito (R),2012,General Contractors,60550,7000,67550
B000287,N00009774,Xavier Becerra (D),2012,Health Professionals,14600,173000,187600
B000287,N00009774,Xavier Becerra (D),2012,Securities & Investment,60600,59500,120100
B000287,N00009774,Xavier Becerra (D),2012,Insurance,12500,98500,111000
B000287,N00009774,Xavier Becerra (D),2012,Health Services/HMOs,43673,52000,95673
B000287,N00009774,Xavier Becerra (D),2012,Real Estate,63774,29500,93274
B000287,N00009774,Xavier Becerra (D),2012,Pharmaceuticals/Health Products,17049,63992,81041
B000287,N00009774,Xavier Becerra (D),2012,Lawyers/Law Firms,31250,38285,69535
B000287,N00009774,Xavier Becerra (D),2012,Public Sector Unions,0,69000,69000
B000287,N00009774,Xavier Becerra (D),2012,Hospitals/Nursing Homes,7300,58000,65300
B000287,N00009774,Xavier Becerra (D),2012,Lobbyists,57005,2500,59505
H000338,N00009869,Orrin G Hatch (R),2012,Securities & Investment,966875,208071,1174946
H000338,N00009869,Orrin G Hatch (R),2012,Pharmaceuticals/Health Products,284360,563641,848001
H000338,N00009869,Orrin G Hatch (R),2012,Lobbyists,507317,12500,519817
H000338,N00009869,Orrin G Hatch (R),2012,Insurance,154194,352174,506368
H000338,N00009869,Orrin G Hatch (R),2012,Lawyers/Law Firms,252640,221081,473721
H000338,N00009869,Orrin G Hatch (R),2012,Health Professionals,106115,350500,456615
H000338,N00009869,Orrin G Hatch (R),2012,Real Estate,303492,108900,412392
H000338,N00009869,Orrin G Hatch (R),2012,Health Services/HMOs,168982,234500,403482
H000338,N00009869,Orrin G Hatch (R),2012,Leadership PACs,0,391878,391878
H000338,N00009869,Orrin G Hatch (R),2012,Oil & Gas,153650,235500,389150
A000360,N00009888,Lamar Alexander (R),2012,Real Estate,323633,30500,354133
A000360,N00009888,Lamar Alexander (R),2012,Retired,345966,0,345966
A000360,N00009888,Lamar Alexander (R),2012,Lawyers/Law Firms,269100,73750,342850
A000360,N00009888,Lamar Alexander (R),2012,Leadership PACs,0,291550,291550
A000360,N00009888,Lamar Alexander (R),2012,Securities & Investment,237549,37000,274549
A000360,N00009888,Lamar Alexander (R),2012,Health Professionals,127800,60500,188300
A000360,N00009888,Lamar Alexander (R),2012,Misc Finance,178200,9000,187200
A000360,N00009888,Lamar Alexander (R),2012,Education,142950,21900,164850
A000360,N00009888,Lamar Alexander (R),2012,Pharmaceuticals/Health Products,23300,134400,157700
A000360,N00009888,Lamar Alexander (R),2012,Oil & Gas,61750,91000,152750
G000359,N00009975,Lindsey Graham (R),2012,Lawyers/Law Firms,796566,75250,871816
G000359,N00009975,Lindsey Graham (R),2012,Electric Utilities,221510,147952,369462
G000359,N00009975,Lindsey Graham (R),2012,Real Estate,298880,19500,318380
G000359,N00009975,Lindsey Graham (R),2012,Retired,283264,0,283264
G000359,N00009975,Lindsey Graham (R),2012,Securities & Investment,258244,21000,279244
G000359,N00009975,Lindsey Graham (R),2012,Leadership PACs,0,233500,233500
G000359,N00009975,Lindsey Graham (R),2012,Lobbyists,198358,4953,203311
G000359,N00009975,Lindsey Graham (R),2012,General Contractors,103338,45000,148338
G000359,N00009975,Lindsey Graham (R),2012,Health Professionals,103562,38000,141562
G000359,N00009975,Lindsey Graham (R),2012,Business Services,129199,10500,139699
C001049,N00012460,William L Clay Jr (D),2012,Lawyers/Law Firms,34750,16000,50750
C001049,N00012460,William L Clay Jr (D),2012,Public Sector Unions,0,42000,42000
C001049,N00012460,William L Clay Jr (D),2012,Misc Services,9750,30000,39750
C001049,N00012460,William L Clay Jr (D),2012,Building Trade Unions,0,38700,38700
C001049,N00012460,William L Clay Jr (D),2012,Real Estate,14950,20900,35850
C001049,N00012460,William L Clay Jr (D),2012,Industrial Unions,0,32000,32000
C001049,N00012460,William L Clay Jr (D),2012,Insurance,500,29500,30000
C001049,N00012460,William L Clay Jr (D),2012,Transportation Unions,0,28500,28500
C001049,N00012460,William L Clay Jr (D),2012,Securities & Investment,2000,26000,28000
C001049,N00012460,William L Clay Jr (D),2012,Retired,25450,0,25450
C000174,N00012508,Tom Carper (D),2012,Insurance,94070,292840,386910
C000174,N00012508,Tom Carper (D),2012,Lawyers/Law Firms,180879,132231,313110
C000174,N00012508,Tom Carper (D),2012,Securities & Investment,135700,173500,309200
C000174,N00012508,Tom Carper (D),2012,Lobbyists,215375,9220,224595
C000174,N00012508,Tom Carper (D),2012,Pharmaceuticals/Health Products,50900,150250,201150
C000174,N00012508,Tom Carper (D),2012,Commercial Banks,83930,111500,195430
C000174,N00012508,Tom Carper (D),2012,Chemical & Related Manufacturing,59287,105370,164657
C000174,N00012508,Tom Carper (D),2012,Leadership PACs,0,162500,162500
C000174,N00012508,Tom Carper (D),2012,Health Professionals,29300,118150,147450
C000174,N00012508,Tom Carper (D),2012,Retired,134200,0,134200
H001034,N00012611,Mike Honda (D),2012,Electronics Mfg & Equip,49250,25250,74500
H001034,N00012611,Mike Honda (D),2012,Building Trade Unions,0,47400,47400
H001034,N00012611,Mike Honda (D),2012,Human Rights,37700,6000,43700
H001034,N00012611,Mike Honda (D),2012,Lawyers/Law Firms,26650,14500,41150
H001034,N00012611,Mike Honda (D),2012,Real Estate,32550,8000,40550
H001034,N00012611,Mike Honda (D),2012,Retired,39200,0,39200
H001034,N00012611,Mike Honda (D),2012,Public Sector Unions,0,33000,33000
H001034,N00012611,Mike Honda (D),2012,Pharmaceuticals/Health Products,1450,30500,31950
H001034,N00012611,Mike Honda (D),2012,Industrial Unions,0,27700,27700
H001034,N00012611,Mike Honda (D),2012,Business Services,26410,0,26410
C001045,N00012739,Ander Crenshaw (R),2012,Defense Aerospace,0,48500,48500
C001045,N00012739,Ander Crenshaw (R),2012,Real Estate,23500,14466,37966
C001045,N00012739,Ander Crenshaw (R),2012,Defense Electronics,0,29500,29500
C001045,N00012739,Ander Crenshaw (R),2012,Retired,27950,0,27950
C001045,N00012739,Ander Crenshaw (R),2012,Misc Manufacturing & Distributing,0,25000,25000
C001045,N00012739,Ander Crenshaw (R),2012,Lawyers/Law Firms,4000,13250,17250
C001045,N00012739,Ander Crenshaw (R),2012,Air Transport,0,14500,14500
C001045,N00012739,Ander Crenshaw (R),2012,Insurance,4500,9500,14000
C001045,N00012739,Ander Crenshaw (R),2012,Health Professionals,10450,3000,13450
C001045,N00012739,Ander Crenshaw (R),2012,Securities & Investment,10250,3000,13250
C001046,N00013131,Eric Cantor (R),2012,Securities & Investment,852132,153000,1005132
C001046,N00013131,Eric Cantor (R),2012,Real Estate,321000,86000,407000
C001046,N00013131,Eric Cantor (R),2012,Insurance,174550,191600,366150
C001046,N00013131,Eric Cantor (R),2012,Retired,315157,0,315157
C001046,N00013131,Eric Cantor (R),2012,Health Professionals,70410,240900,311310
C001046,N00013131,Eric Cantor (R),2012,Lawyers/Law Firms,201781,69750,271531
C001046,N00013131,Eric Cantor (R),2012,Oil & Gas,76450,181000,257450
C001046,N00013131,Eric Cantor (R),2012,Pharmaceuticals/Health Products,81000,139800,220800
C001046,N00013131,Eric Cantor (R),2012,Pro-Israel,202210,9600,211810
C001046,N00013131,Eric Cantor (R),2012,Misc Finance,153850,31500,185350
G000546,N00013323,Sam Graves (R),2012,Air Transport,500,83200,83700
G000546,N00013323,Sam Graves (R),2012,Health Professionals,2500,60500,63000
G000546,N00013323,Sam Graves (R),2012,Automotive,27750,30000,57750
G000546,N00013323,Sam Graves (R),2012,Agricultural Services/Products,2000,49750,51750
G000546,N00013323,Sam Graves (R),2012,Trucking,7500,39488,46988
G000546,N00013323,Sam Graves (R),2012,General Contractors,18900,25499,44399
G000546,N00013323,Sam Graves (R),2012,Construction Services,0,38500,38500
G000546,N00013323,Sam Graves (R),2012,Crop Production & Basic Processing,6430,32000,38430
G000546,N00013323,Sam Graves (R),2012,Commercial Banks,2250,34700,36950
G000546,N00013323,Sam Graves (R),2012,Public Sector Unions,0,36500,36500
F000445,N00013799,Randy Forbes (R),2012,Retired,66008,0,66008
F000445,N00013799,Randy Forbes (R),2012,Misc Defense,25500,20500,46000
F000445,N00013799,Randy Forbes (R),2012,Defense Electronics,500,44000,44500
F000445,N00013799,Randy Forbes (R),2012,Defense Aerospace,300,43500,43800
F000445,N00013799,Randy Forbes (R),2012,Automotive,22000,10000,32000
F000445,N00013799,Randy Forbes (R),2012,General Contractors,25383,3000,28383
F000445,N00013799,Randy Forbes (R),2012,Real Estate,24300,4000,28300
F000445,N00013799,Randy Forbes (R),2012,Electric Utilities,15250,9500,24750
F000445,N00013799,Randy Forbes (R),2012,Commercial Banks,7450,17000,24450
F000445,N00013799,Randy Forbes (R),2012,Lawyers/Law Firms,16533,7250,23783
B001236,N00013873,John Boozman (R),2012,Retired,286426,0,286426
B001236,N00013873,John Boozman (R),2012,Health Professionals,195714,57000,252714
B001236,N00013873,John Boozman (R),2012,Securities & Investment,199829,15000,214829
B001236,N00013873,John Boozman (R),2012,Leadership PACs,0,213036,213036
B001236,N00013873,John Boozman (R),2012,Real Estate,87933,7500,95433
B001236,N00013873,John Boozman (R),2012,Oil & Gas,65202,28000,93202
B001236,N00013873,John Boozman (R),2012,Retail Sales,72900,19000,91900
B001236,N00013873,John Boozman (R),2012,Commercial Banks,58780,28500,87280
B001236,N00013873,John Boozman (R),2012,Lawyers/Law Firms,60941,20298,81239
B001236,N00013873,John Boozman (R),2012,Misc Finance,69803,7500,77303
C001077,N00024753,Mike Coffman (R),2012,Leadership PACs,0,261341,261341
C001077,N00024753,Mike Coffman (R),2012,Retired,243365,0,243365
C001077,N00024753,Mike Coffman (R),2012,Oil & Gas,98725,92750,191475
C001077,N00024753,Mike Coffman (R),2012,Real Estate,125325,19000,144325
C001077,N00024753,Mike Coffman (R),2012,Lawyers/Law Firms,89903,8250,98153
C001077,N00024753,Mike Coffman (R),2012,Candidate Committees,0,72250,72250
C001077,N00024753,Mike Coffman (R),2012,Commercial Banks,41950,21500,63450
C001077,N00024753,Mike Coffman (R),2012,Securities & Investment,54834,5000,59834
C001077,N00024753,Mike Coffman (R),2012,Republican/Conservative,46735,13000,59735
C001077,N00024753,Mike Coffman (R),2012,Automotive,40675,19000,59675
G000550,N00024760,Phil Gingrey (R),2012,Health Professionals,116700,193750,310450
G000550,N00024760,Phil Gingrey (R),2012,Pharmaceuticals/Health Products,8000,99000,107000
G000550,N00024760,Phil Gingrey (R),2012,Insurance,23750,35000,58750
G000550,N00024760,Phil Gingrey (R),2012,Retired,56450,0,56450
G000550,N00024760,Phil Gingrey (R),2012,Hospitals/Nursing Homes,36700,18500,55200
G000550,N00024760,Phil Gingrey (R),2012,Real Estate,37500,17000,54500
G000550,N00024760,Phil Gingrey (R),2012,Lawyers/Law Firms,30950,20750,51700
G000550,N00024760,Phil Gingrey (R),2012,Oil & Gas,5000,44500,49500
G000550,N00024760,Phil Gingrey (R),2012,Health Services/HMOs,9950,37900,47850
G000550,N00024760,Phil Gingrey (R),2012,Telephone Utilities,1250,43600,44850
C001069,N00024842,Joe Courtney (D),2012,Lawyers/Law Firms,93829,14250,108079
C001069,N00024842,Joe Courtney (D),2012,Health Professionals,12750,78800,91550
C001069,N00024842,Joe Courtney (D),2012,Retired,65312,0,65312
C001069,N00024842,Joe Courtney (D),2012,Defense Aerospace,6000,56500,62500
C001069,N00024842,Joe Courtney (D),2012,Real Estate,34650,22000,56650
C001069,N00024842,Joe Courtney (D),2012,Public Sector Unions,0,53500,53500
C001069,N00024842,Joe Courtney (D),2012,Securities & Investment,37900,7000,44900
C001069,N00024842,Joe Courtney (D),2012,Industrial Unions,0,44000,44000
C001069,N00024842,Joe Courtney (D),2012,Pharmaceuticals/Health Products,9050,33500,42550
C001069,N00024842,Joe Courtney (D),2012,Building Trade Unions,500,40000,40500
C001056,N00024852,John Cornyn (R),2012,Oil & Gas,912725,197700,1110425
C001056,N00024852,John Cornyn (R),2012,Lawyers/Law Firms,955406,146890,1102296
C001056,N00024852,John Cornyn (R),2012,Retired,1030308,0,1030308
C001056,N00024852,John Cornyn (R),2012,Health Professionals,669613,172050,841663
C001056,N00024852,John Cornyn (R),2012,Real Estate,693065,68310,761375
C001056,N00024852,John Cornyn (R),2012,Misc Finance,638846,37000,675846
C001056,N00024852,John Cornyn (R),2012,Securities & Investment,572745,97500,670245
C001056,N00024852,John Cornyn (R),2012,Insurance,296730,179114,475844
C001056,N00024852,John Cornyn (R),2012,Lobbyists,319892,9785,329677
C001056,N00024852,John Cornyn (R),2012,Pharmaceuticals/Health Products,120500,198496,318996
B001245,N00024866,Madeleine Z Bordallo (D),2012,Misc Defense,9950,3700,13650
B001245,N00024866,Madeleine Z Bordallo (D),2012,Retail Sales,12590,0,12590
B001245,N00024866,Madeleine Z Bordallo (D),2012,Food Processing & Sales,10650,0,10650
B001245,N00024866,Madeleine Z Bordallo (D),2012,Defense Aerospace,0,9500,9500
B001245,N00024866,Madeleine Z Bordallo (D),2012,Insurance,8350,0,8350
B001245,N00024866,Madeleine Z Bordallo (D),2012,Commercial Banks,8250,0,8250
B001245,N00024866,Madeleine Z Bordallo (D),2012,Misc Business,8050,0,8050
B001245,N00024866,Madeleine Z Bordallo (D),2012,Real Estate,5824,2000,7824
B001245,N00024866,Madeleine Z Bordallo (D),2012,Retired,7350,0,7350
B001245,N00024866,Madeleine Z Bordallo (D),2012,Misc Finance,5350,0,5350
H001036,N00024922,Jeb Hensarling (R),2012,Securities & Investment,123250,188000,311250
H001036,N00024922,Jeb Hensarling (R),2012,Insurance,71897,227500,299397
H001036,N00024922,Jeb Hensarling (R),2012,Commercial Banks,66009,155500,221509
H001036,N00024922,Jeb Hensarling (R),2012,Oil & Gas,75800,76000,151800
H001036,N00024922,Jeb Hensarling (R),2012,Real Estate,58500,85000,143500
H001036,N00024922,Jeb Hensarling (R),2012,Misc Finance,120900,21500,142400
H001036,N00024922,Jeb Hensarling (R),2012,Health Professionals,32750,96500,129250
H001036,N00024922,Jeb Hensarling (R),2012,Finance/Credit Companies,26750,78150,104900
H001036,N00024922,Jeb Hensarling (R),2012,Lawyers/Law Firms,45800,57150,102950
H001036,N00024922,Jeb Hensarling (R),2012,Retired,102500,0,102500
C001063,N00024978,Henry Cuellar (D),2012,Oil & Gas,18375,78000,96375
C001063,N00024978,Henry Cuellar (D),2012,Health Professionals,44700,45500,90200
C001063,N00024978,Henry Cuellar (D),2012,Lawyers/Law Firms,54287,19000,73287
C001063,N00024978,Henry Cuellar (D),2012,Construction Services,50100,16250,66350
C001063,N00024978,Henry Cuellar (D),2012,Business Services,47150,6000,53150
C001063,N00024978,Henry Cuellar (D),2012,Crop Production & Basic Processing,9250,38000,47250
C001063,N00024978,Henry Cuellar (D),2012,Commercial Banks,16775,25000,41775
C001063,N00024978,Henry Cuellar (D),2012,Retail Sales,13200,25499,38699
C001063,N00024978,Henry Cuellar (D),2012,Agricultural Services/Products,0,37647,37647
C001063,N00024978,Henry Cuellar (D),2012,Insurance,11000,24500,35500
G000549,N00025025,Jim Gerlach (R),2012,Insurance,33900,155778,189678
G000549,N00025025,Jim Gerlach (R),2012,Health Professionals,10500,151000,161500
G000549,N00025025,Jim Gerlach (R),2012,Pharmaceuticals/Health Products,25450,122500,147950
G000549,N00025025,Jim Gerlach (R),2012,Lawyers/Law Firms,63300,47250,110550
G000549,N00025025,Jim Gerlach (R),2012,Securities & Investment,35500,49500,85000
G000549,N00025025,Jim Gerlach (R),2012,Hospitals/Nursing Homes,27250,43245,70495
G000549,N00025025,Jim Gerlach (R),2012,Lobbyists,65199,1000,66199
G000549,N00025025,Jim Gerlach (R),2012,Electric Utilities,750,51500,52250
G000549,N00025025,Jim Gerlach (R),2012,Health Services/HMOs,11250,38500,49750
G000549,N00025025,Jim Gerlach (R),2012,Real Estate,11200,37500,48700
C001051,N00025095,John Carter (R),2012,Real Estate,52150,18000,70150
C001051,N00025095,John Carter (R),2012,Oil & Gas,11000,48800,59800
C001051,N00025095,John Carter (R),2012,Electronics Mfg & Equip,7250,32000,39250
C001051,N00025095,John Carter (R),2012,Defense Aerospace,500,36000,36500
C001051,N00025095,John Carter (R),2012,Health Professionals,25375,10000,35375
C001051,N00025095,John Carter (R),2012,Commercial Banks,15800,16000,31800
C001051,N00025095,John Carter (R),2012,Lawyers/Law Firms,21769,7000,28769
C001051,N00025095,John Carter (R),2012,Special Trade Contractors,28000,0,28000
C001051,N00025095,John Carter (R),2012,"Beer, Wine & Liquor",14000,13500,27500
C001051,N00025095,John Carter (R),2012,Retired,24500,0,24500
B001248,N00025219,Michael Burgess (R),2012,Health Professionals,32388,259000,291388
B001248,N00025219,Michael Burgess (R),2012,Pharmaceuticals/Health Products,500,159750,160250
B001248,N00025219,Michael Burgess (R),2012,Health Services/HMOs,4500,69000,73500
B001248,N00025219,Michael Burgess (R),2012,Oil & Gas,3000,65000,68000
B001248,N00025219,Michael Burgess (R),2012,Hospitals/Nursing Homes,5750,32000,37750
B001248,N00025219,Michael Burgess (R),2012,Lobbyists,34594,0,34594
B001248,N00025219,Michael Burgess (R),2012,Lawyers/Law Firms,7550,23500,31050
B001248,N00025219,Michael Burgess (R),2012,Electric Utilities,500,30000,30500
B001248,N00025219,Michael Burgess (R),2012,Insurance,1200,23500,24700
B001248,N00025219,Michael Burgess (R),2012,Chemical & Related Manufacturing,5000,16000,21000
G000551,N00025284,Raul M Grijalva (D),2012,Public Sector Unions,1745,51500,53245
G000551,N00025284,Raul M Grijalva (D),2012,Casinos/Gambling,52900,41,52941
G000551,N00025284,Raul M Grijalva (D),2012,Retired,49500,0,49500
G000551,N00025284,Raul M Grijalva (D),2012,Industrial Unions,0,38000,38000
G000551,N00025284,Raul M Grijalva (D),2012,Misc Unions,0,32000,32000
G000551,N00025284,Raul M Grijalva (D),2012,Lawyers/Law Firms,20950,10500,31450
G000551,N00025284,Raul M Grijalva (D),2012,Lobbyists,30750,0,30750
G000551,N00025284,Raul M Grijalva (D),2012,Building Trade Unions,0,29500,29500
G000551,N00025284,Raul M Grijalva (D),2012,Transportation Unions,0,29000,29000
G000551,N00025284,Raul M Grijalva (D),2012,Candidate Committees,0,22500,22500
B001250,N00025292,Rob Bishop (R),2012,Oil & Gas,4000,50000,54000
B001250,N00025292,Rob Bishop (R),2012,Defense Aerospace,0,20000,20000
B001250,N00025292,Rob Bishop (R),2012,Lobbyists,19250,0,19250
B001250,N00025292,Rob Bishop (R),2012,Real Estate,8500,10000,18500
B001250,N00025292,Rob Bishop (R),2012,Mining,0,18000,18000
B001250,N00025292,Rob Bishop (R),2012,Insurance,8750,7000,15750
B001250,N00025292,Rob Bishop (R),2012,Misc Manufacturing & Distributing,0,15000,15000
B001250,N00025292,Rob Bishop (R),2012,Electronics Mfg & Equip,14000,0,14000
B001250,N00025292,Rob Bishop (R),2012,Leadership PACs,0,12000,12000
B001250,N00025292,Rob Bishop (R),2012,Livestock,2250,8500,10750
B001244,N00025330,Jo Bonner (R),2012,Real Estate,58000,8000,66000
B001244,N00025330,Jo Bonner (R),2012,Health Professionals,31125,33500,64625
B001244,N00025330,Jo Bonner (R),2012,Lawyers/Law Firms,31200,30000,61200
B001244,N00025330,Jo Bonner (R),2012,Leadership PACs,0,52000,52000
B001244,N00025330,Jo Bonner (R),2012,Retired,50300,0,50300
B001244,N00025330,Jo Bonner (R),2012,Defense Aerospace,1350,45500,46850
B001244,N00025330,Jo Bonner (R),2012,Lobbyists,30850,0,30850
B001244,N00025330,Jo Bonner (R),2012,Insurance,7250,22000,29250
B001244,N00025330,Jo Bonner (R),2012,Education,25250,0,25250
B001244,N00025330,Jo Bonner (R),2012,Commercial Banks,10000,14000,24000
D000600,N00025337,Mario Diaz-Balart (R),2012,Building Trade Unions,0,50500,50500
D000600,N00025337,Mario Diaz-Balart (R),2012,Health Professionals,43000,5500,48500
D000600,N00025337,Mario Diaz-Balart (R),2012,Real Estate,22700,21500,44200
D000600,N00025337,Mario Diaz-Balart (R),2012,Pro-Israel,31750,9750,41500
D000600,N00025337,Mario Diaz-Balart (R),2012,Lawyers/Law Firms,23000,13250,36250
D000600,N00025337,Mario Diaz-Balart (R),2012,Transportation Unions,0,28000,28000
D000600,N00025337,Mario Diaz-Balart (R),2012,Railroads,1000,26000,27000
D000600,N00025337,Mario Diaz-Balart (R),2012,Automotive,22500,4000,26500
D000600,N00025337,Mario Diaz-Balart (R),2012,Commercial Banks,5000,18500,23500
D000600,N00025337,Mario Diaz-Balart (R),2012,Air Transport,1000,21500,22500
B001242,N00025413,Timothy H Bishop (D),2012,Retired,183675,0,183675
B001242,N00025413,Timothy H Bishop (D),2012,Leadership PACs,2500,154134,156634
B001242,N00025413,Timothy H Bishop (D),2012,Lawyers/Law Firms,107149,19750,126899
B001242,N00025413,Timothy H Bishop (D),2012,Transportation Unions,0,108500,108500
B001242,N00025413,Timothy H Bishop (D),2012,Securities & Investment,86846,14000,100846
B001242,N00025413,Timothy H Bishop (D),2012,Health Professionals,36900,59500,96400
B001242,N00025413,Timothy H Bishop (D),2012,Public Sector Unions,250,88600,88850
B001242,N00025413,Timothy H Bishop (D),2012,Education,73861,4750,78611
B001242,N00025413,Timothy H Bishop (D),2012,Candidate Committees,0,74000,74000
B001242,N00025413,Timothy H Bishop (D),2012,Building Trade Unions,0,60650,60650
A000361,N00025464,Rodney Alexander (R),2012,Oil & Gas,31638,41000,72638
A000361,N00025464,Rodney Alexander (R),2012,Health Professionals,47000,23000,70000
A000361,N00025464,Rodney Alexander (R),2012,Crop Production & Basic Processing,36950,32500,69450
A000361,N00025464,Rodney Alexander (R),2012,Lawyers/Law Firms,37133,25750,62883
A000361,N00025464,Rodney Alexander (R),2012,Hospitals/Nursing Homes,45516,16000,61516
A000361,N00025464,Rodney Alexander (R),2012,Lobbyists,55448,1979,57427
A000361,N00025464,Rodney Alexander (R),2012,General Contractors,33890,16000,49890
A000361,N00025464,Rodney Alexander (R),2012,Commercial Banks,25750,20500,46250
A000361,N00025464,Rodney Alexander (R),2012,Real Estate,33106,8000,41106
A000361,N00025464,Rodney Alexander (R),2012,Retired,38900,0,38900
B001269,N00025495,Lou Barletta (R),2012,Leadership PACs,0,90187,90187
B001269,N00025495,Lou Barletta (R),2012,Railroads,14125,36265,50390
B001269,N00025495,Lou Barletta (R),2012,Health Professionals,25000,16000,41000
B001269,N00025495,Lou Barletta (R),2012,Retired,40730,0,40730
B001269,N00025495,Lou Barletta (R),2012,Oil & Gas,3050,32500,35550
B001269,N00025495,Lou Barletta (R),2012,Insurance,5050,29500,34550
B001269,N00025495,Lou Barletta (R),2012,Securities & Investment,23444,9000,32444
B001269,N00025495,Lou Barletta (R),2012,Air Transport,0,31499,31499
B001269,N00025495,Lou Barletta (R),2012,General Contractors,13850,17000,30850
B001269,N00025495,Lou Barletta (R),2012,Construction Services,12425,17000,29425
C001053,N00025726,Tom Cole (R),2012,Oil & Gas,49200,67000,116200
C001053,N00025726,Tom Cole (R),2012,Human Rights,101690,6000,107690
C001053,N00025726,Tom Cole (R),2012,Defense Aerospace,250,47000,47250
C001053,N00025726,Tom Cole (R),2012,Misc Finance,42850,0,42850
C001053,N00025726,Tom Cole (R),2012,Commercial Banks,25750,12500,38250
C001053,N00025726,Tom Cole (R),2012,Lobbyists,34642,1000,35642
C001053,N00025726,Tom Cole (R),2012,Electric Utilities,2000,28500,30500
C001053,N00025726,Tom Cole (R),2012,Retired,30250,0,30250
C001053,N00025726,Tom Cole (R),2012,Real Estate,12550,17000,29550
C001053,N00025726,Tom Cole (R),2012,Lawyers/Law Firms,13200,13250,26450
H001050,N00025881,Colleen Hanabusa (D),2012,Lawyers/Law Firms,65400,17000,82400
H001050,N00025881,Colleen Hanabusa (D),2012,Real Estate,56960,19000,75960
H001050,N00025881,Colleen Hanabusa (D),2012,Retired,73400,0,73400
H001050,N00025881,Colleen Hanabusa (D),2012,Building Trade Unions,4000,69000,73000
H001050,N00025881,Colleen Hanabusa (D),2012,Transportation Unions,1400,54500,55900
H001050,N00025881,Colleen Hanabusa (D),2012,Defense Aerospace,8300,46000,54300
H001050,N00025881,Colleen Hanabusa (D),2012,Sea Transport,18000,28500,46500
H001050,N00025881,Colleen Hanabusa (D),2012,General Contractors,41150,0,41150
H001050,N00025881,Colleen Hanabusa (D),2012,Public Sector Unions,0,41000,41000
H001050,N00025881,Colleen Hanabusa (D),2012,Health Professionals,17050,15000,32050
C001062,N00026041,Mike Conaway (R),2012,Oil & Gas,110300,50500,160800
C001062,N00026041,Mike Conaway (R),2012,Crop Production & Basic Processing,46700,103250,149950
C001062,N00026041,Mike Conaway (R),2012,Securities & Investment,22250,61000,83250
C001062,N00026041,Mike Conaway (R),2012,Accountants,17500,43499,60999
C001062,N00026041,Mike Conaway (R),2012,Livestock,41200,18500,59700
C001062,N00026041,Mike Conaway (R),2012,Retired,54175,0,54175
C001062,N00026041,Mike Conaway (R),2012,Agricultural Services/Products,750,52147,52897
C001062,N00026041,Mike Conaway (R),2012,Defense Aerospace,0,47500,47500
C001062,N00026041,Mike Conaway (R),2012,Lawyers/Law Firms,18049,15500,33549
C001062,N00026041,Mike Conaway (R),2012,Health Professionals,17850,11500,29350
B001252,N00026080,John Barrow (D),2012,Lawyers/Law Firms,369680,51755,421435
B001252,N00026080,John Barrow (D),2012,Health Professionals,29500,148500,178000
B001252,N00026080,John Barrow (D),2012,Leadership PACs,500,136500,137000
B001252,N00026080,John Barrow (D),2012,Oil & Gas,10000,97400,107400
B001252,N00026080,John Barrow (D),2012,Insurance,6250,89500,95750
B001252,N00026080,John Barrow (D),2012,Electric Utilities,14979,80750,95729
B001252,N00026080,John Barrow (D),2012,Pharmaceuticals/Health Products,1000,91000,92000
B001252,N00026080,John Barrow (D),2012,Lobbyists,72690,5000,77690
B001252,N00026080,John Barrow (D),2012,Health Services/HMOs,9400,62000,71400
B001252,N00026080,John Barrow (D),2012,Candidate Committees,0,70000,70000
G000552,N00026148,Louis B Gohmert Jr (R),2012,Retired,105250,0,105250
G000552,N00026148,Louis B Gohmert Jr (R),2012,Health Professionals,54237,1500,55737
G000552,N00026148,Louis B Gohmert Jr (R),2012,Oil & Gas,38950,16500,55450
G000552,N00026148,Louis B Gohmert Jr (R),2012,Commercial Banks,34250,1000,35250
G000552,N00026148,Louis B Gohmert Jr (R),2012,Real Estate,21750,3000,24750
G000552,N00026148,Louis B Gohmert Jr (R),2012,Misc Finance,23000,0,23000
G000552,N00026148,Louis B Gohmert Jr (R),2012,Lawyers/Law Firms,20500,0,20500
G000552,N00026148,Louis B Gohmert Jr (R),2012,Construction Services,14750,0,14750
G000552,N00026148,Louis B Gohmert Jr (R),2012,Forestry & Forest Products,3250,11000,14250
G000552,N00026148,Louis B Gohmert Jr (R),2012,Food Processing & Sales,11500,2000,13500
F000450,N00026166,Virginia Foxx (R),2012,Retired,129619,0,129619
F000450,N00026166,Virginia Foxx (R),2012,Education,27984,34084,62068
F000450,N00026166,Virginia Foxx (R),2012,Real Estate,25245,7569,32814
F000450,N00026166,Virginia Foxx (R),2012,Misc Manufacturing & Distributing,13840,11000,24840
F000450,N00026166,Virginia Foxx (R),2012,Lawyers/Law Firms,13140,11500,24640
F000450,N00026166,Virginia Foxx (R),2012,"Beer, Wine & Liquor",16250,7500,23750
F000450,N00026166,Virginia Foxx (R),2012,Food & Beverage,8230,14500,22730
F000450,N00026166,Virginia Foxx (R),2012,Health Professionals,18558,4000,22558
F000450,N00026166,Virginia Foxx (R),2012,Human Rights,10750,10000,20750
F000450,N00026166,Virginia Foxx (R),2012,Pharmaceuticals/Health Products,8000,10000,18000
D000604,N00026171,Charlie Dent (R),2012,Health Professionals,23750,97500,121250
D000604,N00026171,Charlie Dent (R),2012,Retired,106000,0,106000
D000604,N00026171,Charlie Dent (R),2012,Pharmaceuticals/Health Products,11406,69500,80906
D000604,N00026171,Charlie Dent (R),2012,Electric Utilities,36600,44000,80600
D000604,N00026171,Charlie Dent (R),2012,Chemical & Related Manufacturing,17500,44500,62000
D000604,N00026171,Charlie Dent (R),2012,Real Estate,46350,15000,61350
D000604,N00026171,Charlie Dent (R),2012,Lawyers/Law Firms,41000,17650,58650
D000604,N00026171,Charlie Dent (R),2012,Misc Manufacturing & Distributing,39000,18000,57000
D000604,N00026171,Charlie Dent (R),2012,Oil & Gas,6000,44500,50500
D000604,N00026171,Charlie Dent (R),2012,Automotive,33750,14500,48250
C001059,N00026341,Jim Costa (D),2012,Crop Production & Basic Processing,103475,85871,189346
C001059,N00026341,Jim Costa (D),2012,Oil & Gas,1000,78750,79750
C001059,N00026341,Jim Costa (D),2012,Real Estate,52550,10000,62550
C001059,N00026341,Jim Costa (D),2012,Health Professionals,52950,8000,60950
C001059,N00026341,Jim Costa (D),2012,Agricultural Services/Products,8000,44000,52000
C001059,N00026341,Jim Costa (D),2012,Dairy,19049,27000,46049
C001059,N00026341,Jim Costa (D),2012,Lawyers/Law Firms,34000,10750,44750
C001059,N00026341,Jim Costa (D),2012,Food Processing & Sales,19450,23771,43221
C001059,N00026341,Jim Costa (D),2012,Livestock,21100,18000,39100
C001059,N00026341,Jim Costa (D),2012,Building Trade Unions,0,39000,39000
D000607,N00026586,Joe Donnelly (D),2012,Lawyers/Law Firms,600913,25500,626413
D000607,N00026586,Joe Donnelly (D),2012,Leadership PACs,2750,347750,350500
D000607,N00026586,Joe Donnelly (D),2012,Retired,277418,0,277418
D000607,N00026586,Joe Donnelly (D),2012,Securities & Investment,167955,26500,194455
D000607,N00026586,Joe Donnelly (D),2012,Lobbyists,122490,21000,143490
D000607,N00026586,Joe Donnelly (D),2012,Education,132713,1000,133713
D000607,N00026586,Joe Donnelly (D),2012,Real Estate,98218,24000,122218
D000607,N00026586,Joe Donnelly (D),2012,Pharmaceuticals/Health Products,44862,56421,101283
D000607,N00026586,Joe Donnelly (D),2012,Candidate Committees,0,96798,96798
D000607,N00026586,Joe Donnelly (D),2012,Building Trade Unions,3190,86000,89190
B001255,N00026595,Charles W Boustany Jr (R),2012,Health Professionals,186225,309100,495325
B001255,N00026595,Charles W Boustany Jr (R),2012,Oil & Gas,154200,141750,295950
B001255,N00026595,Charles W Boustany Jr (R),2012,Insurance,45350,241700,287050
B001255,N00026595,Charles W Boustany Jr (R),2012,Health Services/HMOs,61400,142000,203400
B001255,N00026595,Charles W Boustany Jr (R),2012,Lobbyists,155784,4167,159951
B001255,N00026595,Charles W Boustany Jr (R),2012,Lawyers/Law Firms,85425,62720,148145
B001255,N00026595,Charles W Boustany Jr (R),2012,Hospitals/Nursing Homes,40820,100500,141320
B001255,N00026595,Charles W Boustany Jr (R),2012,Pharmaceuticals/Health Products,5000,127805,132805
B001255,N00026595,Charles W Boustany Jr (R),2012,Securities & Investment,33750,94500,128250
B001255,N00026595,Charles W Boustany Jr (R),2012,Leadership PACs,0,102000,102000
F000449,N00026631,Jeff Fortenberry (R),2012,Health Professionals,42617,13500,56117
F000449,N00026631,Jeff Fortenberry (R),2012,Commercial Banks,10451,27000,37451
F000449,N00026631,Jeff Fortenberry (R),2012,Insurance,10400,23500,33900
F000449,N00026631,Jeff Fortenberry (R),2012,Crop Production & Basic Processing,6100,25500,31600
F000449,N00026631,Jeff Fortenberry (R),2012,Republican/Conservative,10850,18000,28850
F000449,N00026631,Jeff Fortenberry (R),2012,Retired,27800,0,27800
F000449,N00026631,Jeff Fortenberry (R),2012,Agricultural Services/Products,7750,15750,23500
F000449,N00026631,Jeff Fortenberry (R),2012,Lawyers/Law Firms,17250,5000,22250
F000449,N00026631,Jeff Fortenberry (R),2012,Electric Utilities,500,17000,17500
F000449,N00026631,Jeff Fortenberry (R),2012,Real Estate,7730,8500,16230
G000553,N00026686,Al Green (D),2012,Lawyers/Law Firms,44339,14250,58589
G000553,N00026686,Al Green (D),2012,Building Trade Unions,0,32500,32500
G000553,N00026686,Al Green (D),2012,Industrial Unions,0,30000,30000
G000553,N00026686,Al Green (D),2012,Real Estate,7850,19000,26850
G000553,N00026686,Al Green (D),2012,Commercial Banks,5300,14500,19800
G000553,N00026686,Al Green (D),2012,Securities & Investment,6500,5500,12000
G000553,N00026686,Al Green (D),2012,Public Sector Unions,0,10000,10000
G000553,N00026686,Al Green (D),2012,Oil & Gas,5100,3000,8100
G000553,N00026686,Al Green (D),2012,Lobbyists,7100,0,7100
G000553,N00026686,Al Green (D),2012,Transportation Unions,0,6000,6000
C001061,N00026790,Emanuel Cleaver (D),2012,Lawyers/Law Firms,52950,40250,93200
C001061,N00026790,Emanuel Cleaver (D),2012,Building Trade Unions,5000,59500,64500
C001061,N00026790,Emanuel Cleaver (D),2012,Insurance,3050,52000,55050
C001061,N00026790,Emanuel Cleaver (D),2012,Securities & Investment,7000,44750,51750
C001061,N00026790,Emanuel Cleaver (D),2012,Industrial Unions,0,51500,51500
C001061,N00026790,Emanuel Cleaver (D),2012,Public Sector Unions,500,48000,48500
C001061,N00026790,Emanuel Cleaver (D),2012,Commercial Banks,1750,41000,42750
C001061,N00026790,Emanuel Cleaver (D),2012,Real Estate,8900,26500,35400
C001061,N00026790,Emanuel Cleaver (D),2012,Accountants,1500,32938,34438
C001061,N00026790,Emanuel Cleaver (D),2012,Misc Unions,0,30000,30000
C001067,N00026961,Yvette D Clarke (D),2012,Building Trade Unions,0,53100,53100
C001067,N00026961,Yvette D Clarke (D),2012,Public Sector Unions,200,41600,41800
C001067,N00026961,Yvette D Clarke (D),2012,Health Professionals,28022,8500,36522
C001067,N00026961,Yvette D Clarke (D),2012,Electronics Mfg & Equip,0,25500,25500
C001067,N00026961,Yvette D Clarke (D),2012,Securities & Investment,11900,11000,22900
C001067,N00026961,Yvette D Clarke (D),2012,Industrial Unions,0,20000,20000
C001067,N00026961,Yvette D Clarke (D),2012,Insurance,7450,12500,19950
C001067,N00026961,Yvette D Clarke (D),2012,Transportation Unions,0,19500,19500
C001067,N00026961,Yvette D Clarke (D),2012,Lawyers/Law Firms,9600,8000,17600
C001067,N00026961,Yvette D Clarke (D),2012,Telephone Utilities,0,17000,17000
B001251,N00027035,G K Butterfield (D),2012,Pharmaceuticals/Health Products,1850,62500,64350
B001251,N00027035,G K Butterfield (D),2012,Health Professionals,33350,30300,63650
B001251,N00027035,G K Butterfield (D),2012,Electric Utilities,7500,36250,43750
B001251,N00027035,G K Butterfield (D),2012,Lawyers/Law Firms,15318,24032,39350
B001251,N00027035,G K Butterfield (D),2012,Telephone Utilities,0,29000,29000
B001251,N00027035,G K Butterfield (D),2012,TV/Movies/Music,0,26500,26500
B001251,N00027035,G K Butterfield (D),2012,Telecom Services,0,23500,23500
B001251,N00027035,G K Butterfield (D),2012,Industrial Unions,0,23500,23500
B001251,N00027035,G K Butterfield (D),2012,Public Sector Unions,0,23192,23192
B001251,N00027035,G K Butterfield (D),2012,Retired,22025,0,22025
H001038,N00027060,Brian M Higgins (D),2012,Lawyers/Law Firms,83790,12500,96290
H001038,N00027060,Brian M Higgins (D),2012,Public Sector Unions,500,63500,64000
H001038,N00027060,Brian M Higgins (D),2012,Industrial Unions,0,47750,47750
H001038,N00027060,Brian M Higgins (D),2012,Transportation Unions,250,46500,46750
H001038,N00027060,Brian M Higgins (D),2012,Real Estate,23149,14000,37149
H001038,N00027060,Brian M Higgins (D),2012,Building Trade Unions,0,35500,35500
H001038,N00027060,Brian M Higgins (D),2012,Securities & Investment,28000,1000,29000
H001038,N00027060,Brian M Higgins (D),2012,Health Professionals,18750,8500,27250
H001038,N00027060,Brian M Higgins (D),2012,Misc Manufacturing & Distributing,7750,19500,27250
H001038,N00027060,Brian M Higgins (D),2012,Special Trade Contractors,26000,0,26000
F000451,N00027229,Michael G Fitzpatrick (R),2012,Lawyers/Law Firms,114267,31625,145892
F000451,N00027229,Michael G Fitzpatrick (R),2012,Insurance,38200,97500,135700
F000451,N00027229,Michael G Fitzpatrick (R),2012,Securities & Investment,84700,49400,134100
F000451,N00027229,Michael G Fitzpatrick (R),2012,Leadership PACs,0,133550,133550
F000451,N00027229,Michael G Fitzpatrick (R),2012,Construction Services,78100,15500,93600
F000451,N00027229,Michael G Fitzpatrick (R),2012,Commercial Banks,23400,60000,83400
F000451,N00027229,Michael G Fitzpatrick (R),2012,Real Estate,21650,55000,76650
F000451,N00027229,Michael G Fitzpatrick (R),2012,Republican/Conservative,37050,36500,73550
F000451,N00027229,Michael G Fitzpatrick (R),2012,Retired,72912,0,72912
F000451,N00027229,Michael G Fitzpatrick (R),2012,Health Professionals,23326,44000,67326
C001071,N00027441,Bob Corker (R),2012,Securities & Investment,946334,234070,1180404
C001071,N00027441,Bob Corker (R),2012,Real Estate,652970,118100,771070
C001071,N00027441,Bob Corker (R),2012,Insurance,229213,352550,581763
C001071,N00027441,Bob Corker (R),2012,Retired,557495,0,557495
C001071,N00027441,Bob Corker (R),2012,Lawyers/Law Firms,422123,118870,540993
C001071,N00027441,Bob Corker (R),2012,Health Professionals,414763,109500,524263
C001071,N00027441,Bob Corker (R),2012,Misc Finance,442463,38500,480963
C001071,N00027441,Bob Corker (R),2012,Commercial Banks,274990,186800,461790
C001071,N00027441,Bob Corker (R),2012,Lobbyists,306694,8265,314959
C001071,N00027441,Bob Corker (R),2012,Oil & Gas,152928,156500,309428
B001257,N00027462,Gus Bilirakis (R),2012,Health Professionals,40015,27500,67515
B001257,N00027462,Gus Bilirakis (R),2012,Retired,41800,0,41800
B001257,N00027462,Gus Bilirakis (R),2012,Food & Beverage,7000,25500,32500
B001257,N00027462,Gus Bilirakis (R),2012,Real Estate,11199,20000,31199
B001257,N00027462,Gus Bilirakis (R),2012,Insurance,7200,19500,26700
B001257,N00027462,Gus Bilirakis (R),2012,Lawyers/Law Firms,17900,7750,25650
B001257,N00027462,Gus Bilirakis (R),2012,Misc Manufacturing & Distributing,16964,5000,21964
B001257,N00027462,Gus Bilirakis (R),2012,Health Services/HMOs,10000,9000,19000
B001257,N00027462,Gus Bilirakis (R),2012,TV/Movies/Music,10245,5500,15745
B001257,N00027462,Gus Bilirakis (R),2012,Oil & Gas,14500,0,14500
B001259,N00027464,Bruce Braley (D),2012,Lawyers/Law Firms,956931,32497,989428
B001259,N00027464,Bruce Braley (D),2012,Health Professionals,23400,97500,120900
B001259,N00027464,Bruce Braley (D),2012,Public Sector Unions,0,95500,95500
B001259,N00027464,Bruce Braley (D),2012,Leadership PACs,0,83500,83500
B001259,N00027464,Bruce Braley (D),2012,Pharmaceuticals/Health Products,27250,34884,62134
B001259,N00027464,Bruce Braley (D),2012,Building Trade Unions,250,58000,58250
B001259,N00027464,Bruce Braley (D),2012,Retired,57320,0,57320
B001259,N00027464,Bruce Braley (D),2012,Industrial Unions,650,55000,55650
B001259,N00027464,Bruce Braley (D),2012,Real Estate,22163,12500,34663
B001259,N00027464,Bruce Braley (D),2012,Lobbyists,29626,0,29626
B001256,N00027493,Michele Bachmann (R),2012,Retired,895856,0,895856
B001256,N00027493,Michele Bachmann (R),2012,Republican/Conservative,530331,55350,585681
B001256,N00027493,Michele Bachmann (R),2012,Health Professionals,93869,1500,95369
B001256,N00027493,Michele Bachmann (R),2012,Real Estate,73352,10010,83362
B001256,N00027493,Michele Bachmann (R),2012,Misc Finance,73700,2000,75700
B001256,N00027493,Michele Bachmann (R),2012,Securities & Investment,61925,0,61925
B001256,N00027493,Michele Bachmann (R),2012,General Contractors,55750,0,55750
B001256,N00027493,Michele Bachmann (R),2012,Oil & Gas,37723,17500,55223
B001256,N00027493,Michele Bachmann (R),2012,Misc Business,51452,0,51452
B001256,N00027493,Michele Bachmann (R),2012,Abortion Policy/Anti-Abortion,25742,23166,48908
C001070,N00027503,Bob Casey (D),2012,Lawyers/Law Firms,1868910,226952,2095862
C001070,N00027503,Bob Casey (D),2012,Securities & Investment,321362,123500,444862
C001070,N00027503,Bob Casey (D),2012,Real Estate,327158,65500,392658
C001070,N00027503,Bob Casey (D),2012,Lobbyists,376241,8800,385041
C001070,N00027503,Bob Casey (D),2012,Health Professionals,219785,149000,368785
C001070,N00027503,Bob Casey (D),2012,Retired,352271,0,352271
C001070,N00027503,Bob Casey (D),2012,Pharmaceuticals/Health Products,118300,233830,352130
C001070,N00027503,Bob Casey (D),2012,Hospitals/Nursing Homes,204797,94750,299547
C001070,N00027503,Bob Casey (D),2012,Insurance,141800,126750,268550
C001070,N00027503,Bob Casey (D),2012,Leadership PACs,1000,258364,259364
C001066,N00027514,Kathy Castor (D),2012,Lawyers/Law Firms,79175,25000,104175
C001066,N00027514,Kathy Castor (D),2012,Health Professionals,22300,65300,87600
C001066,N00027514,Kathy Castor (D),2012,Public Sector Unions,0,42000,42000
C001066,N00027514,Kathy Castor (D),2012,Building Trade Unions,0,37500,37500
C001066,N00027514,Kathy Castor (D),2012,Hospitals/Nursing Homes,14650,22000,36650
C001066,N00027514,Kathy Castor (D),2012,Retired,35550,0,35550
C001066,N00027514,Kathy Castor (D),2012,Pro-Israel,11750,12500,24250
C001066,N00027514,Kathy Castor (D),2012,Insurance,10300,11000,21300
C001066,N00027514,Kathy Castor (D),2012,Industrial Unions,0,21000,21000
C001066,N00027514,Kathy Castor (D),2012,Tobacco,17000,3000,20000
H001041,N00027522,Dean Heller (R),2012,Retired,517342,0,517342
H001041,N00027522,Dean Heller (R),2012,Leadership PACs,500,433092,433592
H001041,N00027522,Dean Heller (R),2012,Securities & Investment,320865,74500,395365
H001041,N00027522,Dean Heller (R),2012,Insurance,82405,181500,263905
H001041,N00027522,Dean Heller (R),2012,Real Estate,237990,25500,263490
H001041,N00027522,Dean Heller (R),2012,Mining,162775,99825,262600
H001041,N00027522,Dean Heller (R),2012,Oil & Gas,105700,145750,251450
H001041,N00027522,Dean Heller (R),2012,Casinos/Gambling,171132,73500,244632
H001041,N00027522,Dean Heller (R),2012,Health Professionals,124934,98500,223434
H001041,N00027522,Dean Heller (R),2012,Lobbyists,175312,9000,184312
C001064,N00027565,John Campbell (R),2012,Real Estate,75489,66850,142339
C001064,N00027565,John Campbell (R),2012,Insurance,3750,101000,104750
C001064,N00027565,John Campbell (R),2012,Automotive,57000,34500,91500
C001064,N00027565,John Campbell (R),2012,Securities & Investment,18550,65500,84050
C001064,N00027565,John Campbell (R),2012,Retired,62177,0,62177
C001064,N00027565,John Campbell (R),2012,Accountants,750,58500,59250
C001064,N00027565,John Campbell (R),2012,Misc Issues,44000,7000,51000
C001064,N00027565,John Campbell (R),2012,Commercial Banks,4500,39500,44000
C001064,N00027565,John Campbell (R),2012,Pharmaceuticals/Health Products,2500,36500,39000
C001064,N00027565,John Campbell (R),2012,Misc Finance,16280,17000,33280
B001260,N00027626,Vernon Buchanan (R),2012,Health Professionals,150195,116000,266195
B001260,N00027626,Vernon Buchanan (R),2012,Retired,172950,0,172950
B001260,N00027626,Vernon Buchanan (R),2012,Real Estate,94850,15000,109850
B001260,N00027626,Vernon Buchanan (R),2012,Insurance,44200,56000,100200
B001260,N00027626,Vernon Buchanan (R),2012,Leadership PACs,0,96500,96500
B001260,N00027626,Vernon Buchanan (R),2012,Food & Beverage,62050,30000,92050
B001260,N00027626,Vernon Buchanan (R),2012,General Contractors,65300,4500,69800
B001260,N00027626,Vernon Buchanan (R),2012,Pharmaceuticals/Health Products,53500,8150,61650
B001260,N00027626,Vernon Buchanan (R),2012,Hospitals/Nursing Homes,26400,34500,60900
B001260,N00027626,Vernon Buchanan (R),2012,Lobbyists,49250,4000,53250
H001057,N00027649,Tim Huelskamp (R),2012,Crop Production & Basic Processing,26759,41050,67809
H001057,N00027649,Tim Huelskamp (R),2012,Oil & Gas,46550,15000,61550
H001057,N00027649,Tim Huelskamp (R),2012,Health Professionals,15630,28000,43630
H001057,N00027649,Tim Huelskamp (R),2012,Agricultural Services/Products,2500,31500,34000
H001057,N00027649,Tim Huelskamp (R),2012,Leadership PACs,0,23886,23886
H001057,N00027649,Tim Huelskamp (R),2012,Railroads,11750,10000,21750
H001057,N00027649,Tim Huelskamp (R),2012,Commercial Banks,4550,17000,21550
H001057,N00027649,Tim Huelskamp (R),2012,Livestock,4750,16700,21450
H001057,N00027649,Tim Huelskamp (R),2012,Retired,20250,0,20250
H001057,N00027649,Tim Huelskamp (R),2012,Dairy,2500,17500,20000
G000555,N00027658,Kirsten Gillibrand (D),2012,Lawyers/Law Firms,3915999,305442,4221441
G000555,N00027658,Kirsten Gillibrand (D),2012,Securities & Investment,2840598,290800,3131398
G000555,N00027658,Kirsten Gillibrand (D),2012,Real Estate,1242502,117000,1359502
G000555,N00027658,Kirsten Gillibrand (D),2012,Women's Issues,968246,27500,995746
G000555,N00027658,Kirsten Gillibrand (D),2012,Retired,935633,0,935633
G000555,N00027658,Kirsten Gillibrand (D),2012,Lobbyists,747472,33674,781146
G000555,N00027658,Kirsten Gillibrand (D),2012,TV/Movies/Music,682267,74000,756267
G000555,N00027658,Kirsten Gillibrand (D),2012,Business Services,606203,45400,651603
G000555,N00027658,Kirsten Gillibrand (D),2012,Misc Finance,587853,14000,601853
G000555,N00027658,Kirsten Gillibrand (D),2012,Insurance,292350,288216,580566
D000622,N00027860,Tammy Duckworth (D),2012,Women's Issues,361967,24860,386827
D000622,N00027860,Tammy Duckworth (D),2012,Lawyers/Law Firms,325725,28000,353725
D000622,N00027860,Tammy Duckworth (D),2012,Retired,247571,0,247571
D000622,N00027860,Tammy Duckworth (D),2012,Pro-Israel,118850,8500,127350
D000622,N00027860,Tammy Duckworth (D),2012,Leadership PACs,1500,120500,122000
D000622,N00027860,Tammy Duckworth (D),2012,Securities & Investment,99628,4000,103628
D000622,N00027860,Tammy Duckworth (D),2012,Real Estate,101632,0,101632
D000622,N00027860,Tammy Duckworth (D),2012,Democratic/Liberal,70600,14500,85100
D000622,N00027860,Tammy Duckworth (D),2012,Health Professionals,42392,42500,84892
D000622,N00027860,Tammy Duckworth (D),2012,Education,63094,5000,68094
H001042,N00028139,Mazie K Hirono (D),2012,Lawyers/Law Firms,501619,23000,524619
H001042,N00028139,Mazie K Hirono (D),2012,Women's Issues,310272,29500,339772
H001042,N00028139,Mazie K Hirono (D),2012,Retired,194557,0,194557
H001042,N00028139,Mazie K Hirono (D),2012,Leadership PACs,1000,185500,186500
H001042,N00028139,Mazie K Hirono (D),2012,Real Estate,125848,13500,139348
H001042,N00028139,Mazie K Hirono (D),2012,Lobbyists,112094,4750,116844
H001042,N00028139,Mazie K Hirono (D),2012,Transportation Unions,1400,109000,110400
H001042,N00028139,Mazie K Hirono (D),2012,Public Sector Unions,300,107000,107300
H001042,N00028139,Mazie K Hirono (D),2012,Sea Transport,46885,46000,92885
H001042,N00028139,Mazie K Hirono (D),2012,Construction Services,70849,14000,84849
E000290,N00028249,Donna Edwards (D),2012,Public Sector Unions,0,51250,51250
E000290,N00028249,Donna Edwards (D),2012,Building Trade Unions,0,47900,47900
E000290,N00028249,Donna Edwards (D),2012,Industrial Unions,200,43499,43699
E000290,N00028249,Donna Edwards (D),2012,Transportation Unions,0,41000,41000
E000290,N00028249,Donna Edwards (D),2012,Misc Unions,0,35500,35500
E000290,N00028249,Donna Edwards (D),2012,Lawyers/Law Firms,20900,12500,33400
E000290,N00028249,Donna Edwards (D),2012,Democratic/Liberal,11400,20483,31883
E000290,N00028249,Donna Edwards (D),2012,Non-Profit Institutions,31400,0,31400
E000290,N00028249,Donna Edwards (D),2012,Air Transport,0,27000,27000
E000290,N00028249,Donna Edwards (D),2012,Railroads,0,25500,25500
E000288,N00028257,Keith Ellison (D),2012,Health Professionals,163650,7550,171200
E000288,N00028257,Keith Ellison (D),2012,Lawyers/Law Firms,47135,26763,73898
E000288,N00028257,Keith Ellison (D),2012,Retired,58450,0,58450
E000288,N00028257,Keith Ellison (D),2012,Real Estate,33011,14000,47011
E000288,N00028257,Keith Ellison (D),2012,Industrial Unions,0,47000,47000
E000288,N00028257,Keith Ellison (D),2012,Public Sector Unions,0,44000,44000
E000288,N00028257,Keith Ellison (D),2012,Insurance,9751,30200,39951
E000288,N00028257,Keith Ellison (D),2012,Securities & Investment,33900,5000,38900
E000288,N00028257,Keith Ellison (D),2012,Misc Unions,250,38000,38250
E000288,N00028257,Keith Ellison (D),2012,Hospitals/Nursing Homes,32550,0,32550
G000556,N00028418,Alan Grayson (D),2012,Democratic/Liberal,100525,5890,106415
G000556,N00028418,Alan Grayson (D),2012,Retired,99010,0,99010
G000556,N00028418,Alan Grayson (D),2012,Public Sector Unions,0,63500,63500
G000556,N00028418,Alan Grayson (D),2012,Lawyers/Law Firms,33980,10000,43980
G000556,N00028418,Alan Grayson (D),2012,Building Trade Unions,0,33000,33000
G000556,N00028418,Alan Grayson (D),2012,Industrial Unions,0,32500,32500
G000556,N00028418,Alan Grayson (D),2012,Education,30529,0,30529
G000556,N00028418,Alan Grayson (D),2012,Transportation Unions,0,21500,21500
G000556,N00028418,Alan Grayson (D),2012,Misc Business,21200,0,21200
G000556,N00028418,Alan Grayson (D),2012,Electronics Mfg & Equip,20075,0,20075
C001076,N00028958,Jason Chaffetz (R),2012,Electronics Mfg & Equip,17750,39093,56843
C001076,N00028958,Jason Chaffetz (R),2012,Business Services,46680,2500,49180
C001076,N00028958,Jason Chaffetz (R),2012,Misc Manufacturing & Distributing,24900,19500,44400
C001076,N00028958,Jason Chaffetz (R),2012,Pharmaceuticals/Health Products,17250,23345,40595
C001076,N00028958,Jason Chaffetz (R),2012,Finance/Credit Companies,17900,19800,37700
C001076,N00028958,Jason Chaffetz (R),2012,Commercial Banks,10700,26000,36700
C001076,N00028958,Jason Chaffetz (R),2012,Lobbyists,30348,1500,31848
C001076,N00028958,Jason Chaffetz (R),2012,Oil & Gas,5000,25000,30000
C001076,N00028958,Jason Chaffetz (R),2012,Health Professionals,11900,16500,28400
C001076,N00028958,Jason Chaffetz (R),2012,Securities & Investment,14700,9500,24200
B001262,N00028986,Paul Broun Jr (R),2012,Health Professionals,49430,91000,140430
B001262,N00028986,Paul Broun Jr (R),2012,Retired,114363,0,114363
B001262,N00028986,Paul Broun Jr (R),2012,Republican/Conservative,63437,10000,73437
B001262,N00028986,Paul Broun Jr (R),2012,Real Estate,26012,7000,33012
B001262,N00028986,Paul Broun Jr (R),2012,Food & Beverage,12250,20000,32250
B001262,N00028986,Paul Broun Jr (R),2012,Leadership PACs,0,31000,31000
B001262,N00028986,Paul Broun Jr (R),2012,Insurance,6734,18000,24734
B001262,N00028986,Paul Broun Jr (R),2012,Lawyers/Law Firms,14649,8500,23149
B001262,N00028986,Paul Broun Jr (R),2012,Oil & Gas,12450,9500,21950
B001262,N00028986,Paul Broun Jr (R),2012,Misc Manufacturing & Distributing,11501,9000,20501
F000457,N00029016,Al Franken (D),2012,Lawyers/Law Firms,1509678,31646,1541324
F000457,N00029016,Al Franken (D),2012,Retired,1203940,0,1203940
F000457,N00029016,Al Franken (D),2012,TV/Movies/Music,999289,3000,1002289
F000457,N00029016,Al Franken (D),2012,Securities & Investment,675705,6000,681705
F000457,N00029016,Al Franken (D),2012,Printing & Publishing,402637,0,402637
F000457,N00029016,Al Franken (D),2012,Democratic/Liberal,357608,31950,389558
F000457,N00029016,Al Franken (D),2012,Education,388026,0,388026
F000457,N00029016,Al Franken (D),2012,Real Estate,378666,1010,379676
F000457,N00029016,Al Franken (D),2012,Business Services,371624,2000,373624
F000457,N00029016,Al Franken (D),2012,Health Professionals,307111,19000,326111
H001047,N00029070,Jim Himes (D),2012,Securities & Investment,347929,195499,543428
H001047,N00029070,Jim Himes (D),2012,Lawyers/Law Firms,176750,27750,204500
H001047,N00029070,Jim Himes (D),2012,Insurance,9500,182500,192000
H001047,N00029070,Jim Himes (D),2012,Retired,181175,0,181175
H001047,N00029070,Jim Himes (D),2012,Commercial Banks,85950,80000,165950
H001047,N00029070,Jim Himes (D),2012,Real Estate,91016,56000,147016
H001047,N00029070,Jim Himes (D),2012,Misc Finance,63050,18000,81050
H001047,N00029070,Jim Himes (D),2012,Misc Manufacturing & Distributing,49700,27000,76700
H001047,N00029070,Jim Himes (D),2012,Business Services,67600,2500,70100
H001047,N00029070,Jim Himes (D),2012,Accountants,10800,47500,58300
F000454,N00029139,Bill Foster (D),2012,Education,412376,0,412376
F000454,N00029139,Bill Foster (D),2012,Lawyers/Law Firms,232120,15500,247620
F000454,N00029139,Bill Foster (D),2012,Retired,190064,0,190064
F000454,N00029139,Bill Foster (D),2012,Civil Servants/Public Officials,123117,0,123117
F000454,N00029139,Bill Foster (D),2012,Securities & Investment,114110,2000,116110
F000454,N00029139,Bill Foster (D),2012,Pro-Israel,105219,3000,108219
F000454,N00029139,Bill Foster (D),2012,Leadership PACs,500,103500,104000
F000454,N00029139,Bill Foster (D),2012,Democratic/Liberal,88442,10000,98442
F000454,N00029139,Bill Foster (D),2012,Abortion Policy/Pro-Abortion Rights,64463,12500,76963
F000454,N00029139,Bill Foster (D),2012,Real Estate,68399,5000,73399
H001052,N00029147,Andy Harris (R),2012,Health Professionals,278085,130500,408585
H001052,N00029147,Andy Harris (R),2012,Retired,87481,0,87481
H001052,N00029147,Andy Harris (R),2012,Real Estate,46655,5000,51655
H001052,N00029147,Andy Harris (R),2012,Oil & Gas,6760,35000,41760
H001052,N00029147,Andy Harris (R),2012,Food & Beverage,29300,11000,40300
H001052,N00029147,Andy Harris (R),2012,Lawyers/Law Firms,36250,1000,37250
H001052,N00029147,Andy Harris (R),2012,Securities & Investment,27795,0,27795
H001052,N00029147,Andy Harris (R),2012,Air Transport,750,25499,26249
H001052,N00029147,Andy Harris (R),2012,Insurance,12250,12500,24750
H001052,N00029147,Andy Harris (R),2012,Education,24450,0,24450
H001048,N00029258,Duncan D Hunter (R),2012,Defense Aerospace,6800,56000,62800
H001048,N00029258,Duncan D Hunter (R),2012,Defense Electronics,2150,52000,54150
H001048,N00029258,Duncan D Hunter (R),2012,Air Transport,0,37000,37000
H001048,N00029258,Duncan D Hunter (R),2012,Misc Manufacturing & Distributing,19050,16500,35550
H001048,N00029258,Duncan D Hunter (R),2012,Real Estate,15350,20000,35350
H001048,N00029258,Duncan D Hunter (R),2012,Construction Services,17715,17000,34715
H001048,N00029258,Duncan D Hunter (R),2012,Misc Defense,2800,31900,34700
H001048,N00029258,Duncan D Hunter (R),2012,Retired,34352,0,34352
H001048,N00029258,Duncan D Hunter (R),2012,Health Professionals,4250,30000,34250
H001048,N00029258,Duncan D Hunter (R),2012,Transportation Unions,0,28000,28000
C001072,N00029513,Andre Carson (D),2012,Lawyers/Law Firms,73506,11500,85006
C001072,N00029513,Andre Carson (D),2012,Health Professionals,58550,21500,80050
C001072,N00029513,Andre Carson (D),2012,Securities & Investment,20000,30500,50500
C001072,N00029513,Andre Carson (D),2012,Industrial Unions,0,46000,46000
C001072,N00029513,Andre Carson (D),2012,Building Trade Unions,750,44250,45000
C001072,N00029513,Andre Carson (D),2012,Real Estate,18000,23750,41750
C001072,N00029513,Andre Carson (D),2012,Accountants,8000,29000,37000
C001072,N00029513,Andre Carson (D),2012,Public Sector Unions,0,37000,37000
C001072,N00029513,Andre Carson (D),2012,Insurance,5558,29000,34558
C001072,N00029513,Andre Carson (D),2012,Construction Services,30700,2000,32700
H001049,N00029617,Kay R Hagan (D),2012,Lawyers/Law Firms,763822,73326,837148
H001049,N00029617,Kay R Hagan (D),2012,Retired,703360,0,703360
H001049,N00029617,Kay R Hagan (D),2012,Women's Issues,598820,25661,624481
H001049,N00029617,Kay R Hagan (D),2012,Securities & Investment,319261,109000,428261
H001049,N00029617,Kay R Hagan (D),2012,Leadership PACs,1600,308000,309600
H001049,N00029617,Kay R Hagan (D),2012,Real Estate,267576,34050,301626
H001049,N00029617,Kay R Hagan (D),2012,Pharmaceuticals/Health Products,62950,199309,262259
H001049,N00029617,Kay R Hagan (D),2012,Education,227730,6000,233730
H001049,N00029617,Kay R Hagan (D),2012,Insurance,103548,120000,223548
H001049,N00029617,Kay R Hagan (D),2012,Democratic/Liberal,129797,82219,212016
H001045,N00029632,Gregg Harper (R),2012,Oil & Gas,51250,31000,82250
H001045,N00029632,Gregg Harper (R),2012,Health Professionals,22850,29999,52849
H001045,N00029632,Gregg Harper (R),2012,Electric Utilities,1000,43000,44000
H001045,N00029632,Gregg Harper (R),2012,Lawyers/Law Firms,26850,16000,42850
H001045,N00029632,Gregg Harper (R),2012,Leadership PACs,1000,32500,33500
H001045,N00029632,Gregg Harper (R),2012,General Contractors,28067,2000,30067
H001045,N00029632,Gregg Harper (R),2012,Real Estate,21950,8000,29950
H001045,N00029632,Gregg Harper (R),2012,Commercial Banks,10950,18700,29650
H001045,N00029632,Gregg Harper (R),2012,Telephone Utilities,8250,17500,25750
H001045,N00029632,Gregg Harper (R),2012,Lobbyists,25550,0,25550
G000558,N00029675,Brett Guthrie (R),2012,Health Professionals,22150,177000,199150
G000558,N00029675,Brett Guthrie (R),2012,Pharmaceuticals/Health Products,500,111000,111500
G000558,N00029675,Brett Guthrie (R),2012,Insurance,14250,51500,65750
G000558,N00029675,Brett Guthrie (R),2012,Health Services/HMOs,8250,47000,55250
G000558,N00029675,Brett Guthrie (R),2012,Oil & Gas,3000,41000,44000
G000558,N00029675,Brett Guthrie (R),2012,"Beer, Wine & Liquor",7500,35000,42500
G000558,N00029675,Brett Guthrie (R),2012,Retired,39300,0,39300
G000558,N00029675,Brett Guthrie (R),2012,Telecom Services,250,39000,39250
G000558,N00029675,Brett Guthrie (R),2012,Telephone Utilities,2500,36000,38500
G000558,N00029675,Brett Guthrie (R),2012,Hospitals/Nursing Homes,5600,32500,38100
F000456,N00029679,John Fleming (R),2012,Health Professionals,151026,61000,212026
F000456,N00029679,John Fleming (R),2012,Oil & Gas,169800,41500,211300
F000456,N00029679,John Fleming (R),2012,Retired,63850,0,63850
F000456,N00029679,John Fleming (R),2012,General Contractors,49250,9000,58250
F000456,N00029679,John Fleming (R),2012,Hospitals/Nursing Homes,53125,1000,54125
F000456,N00029679,John Fleming (R),2012,Real Estate,49797,4010,53807
F000456,N00029679,John Fleming (R),2012,Lawyers/Law Firms,42550,6500,49050
F000456,N00029679,John Fleming (R),2012,Crop Production & Basic Processing,34250,12000,46250
F000456,N00029679,John Fleming (R),2012,Insurance,31730,7000,38730
F000456,N00029679,John Fleming (R),2012,Defense Aerospace,0,33000,33000
H001046,N00029835,Martin Heinrich (D),2012,Lawyers/Law Firms,534066,41175,575241
H001046,N00029835,Martin Heinrich (D),2012,Retired,466675,0,466675
H001046,N00029835,Martin Heinrich (D),2012,Environment,214603,28672,243275
H001046,N00029835,Martin Heinrich (D),2012,Lobbyists,228813,1474,230287
H001046,N00029835,Martin Heinrich (D),2012,Leadership PACs,0,217000,217000
H001046,N00029835,Martin Heinrich (D),2012,Health Professionals,96666,72500,169166
H001046,N00029835,Martin Heinrich (D),2012,Pro-Israel,134380,23993,158373
H001046,N00029835,Martin Heinrich (D),2012,Education,126443,500,126943
H001046,N00029835,Martin Heinrich (D),2012,Democratic/Liberal,84562,30935,115497
H001046,N00029835,Martin Heinrich (D),2012,Real Estate,92965,17260,110225
C001078,N00029891,Gerry Connolly (D),2012,Retired,113095,0,113095
C001078,N00029891,Gerry Connolly (D),2012,Electronics Mfg & Equip,37729,72500,110229
C001078,N00029891,Gerry Connolly (D),2012,Public Sector Unions,0,106000,106000
C001078,N00029891,Gerry Connolly (D),2012,Lobbyists,78466,2540,81006
C001078,N00029891,Gerry Connolly (D),2012,Real Estate,60437,19500,79937
C001078,N00029891,Gerry Connolly (D),2012,Lawyers/Law Firms,45037,24928,69965
C001078,N00029891,Gerry Connolly (D),2012,Leadership PACs,0,69500,69500
C001078,N00029891,Gerry Connolly (D),2012,Business Services,47458,20000,67458
C001078,N00029891,Gerry Connolly (D),2012,Defense Electronics,12750,39000,51750
C001078,N00029891,Gerry Connolly (D),2012,Misc Defense,4300,41500,45800
B001265,N00029901,Mark Begich (D),2012,Lawyers/Law Firms,641356,72845,714201
B001265,N00029901,Mark Begich (D),2012,Leadership PACs,0,298299,298299
B001265,N00029901,Mark Begich (D),2012,Securities & Investment,255662,7500,263162
B001265,N00029901,Mark Begich (D),2012,Retired,239408,0,239408
B001265,N00029901,Mark Begich (D),2012,Oil & Gas,131455,98500,229955
B001265,N00029901,Mark Begich (D),2012,Lobbyists,203021,6500,209521
B001265,N00029901,Mark Begich (D),2012,Real Estate,173874,20000,193874
B001265,N00029901,Mark Begich (D),2012,TV/Movies/Music,148176,15250,163426
B001265,N00029901,Mark Begich (D),2012,Health Professionals,117498,18000,135498
B001265,N00029901,Mark Begich (D),2012,Business Services,129401,1500,130901
G000573,N00029908,Joe Garcia (D),2012,Lawyers/Law Firms,130543,10000,140543
G000573,N00029908,Joe Garcia (D),2012,Business Services,45300,500,45800
G000573,N00029908,Joe Garcia (D),2012,Retired,45350,0,45350
G000573,N00029908,Joe Garcia (D),2012,Real Estate,38250,0,38250
G000573,N00029908,Joe Garcia (D),2012,Leadership PACs,0,35500,35500
G000573,N00029908,Joe Garcia (D),2012,Health Services/HMOs,30750,2500,33250
G000573,N00029908,Joe Garcia (D),2012,Public Sector Unions,0,33000,33000
G000573,N00029908,Joe Garcia (D),2012,Education,32800,0,32800
G000573,N00029908,Joe Garcia (D),2012,Democratic/Liberal,22250,8456,30706
G000573,N00029908,Joe Garcia (D),2012,Health Professionals,22000,4000,26000
H001051,N00030197,Richard Hanna (R),2012,Securities & Investment,84566,19000,103566
H001051,N00030197,Richard Hanna (R),2012,General Contractors,42419,29753,72172
H001051,N00030197,Richard Hanna (R),2012,Leadership PACs,0,58000,58000
H001051,N00030197,Richard Hanna (R),2012,Air Transport,0,49999,49999
H001051,N00030197,Richard Hanna (R),2012,Insurance,0,35500,35500
H001051,N00030197,Richard Hanna (R),2012,Republican/Conservative,3250,27500,30750
H001051,N00030197,Richard Hanna (R),2012,Real Estate,18133,9000,27133
H001051,N00030197,Richard Hanna (R),2012,Retired,26166,0,26166
H001051,N00030197,Richard Hanna (R),2012,Lawyers/Law Firms,19798,5500,25298
H001051,N00030197,Richard Hanna (R),2012,Health Professionals,11550,13500,25050
C001075,N00030245,Bill Cassidy (R),2012,Health Professionals,111902,169000,280902
C001075,N00030245,Bill Cassidy (R),2012,Oil & Gas,78600,67250,145850
C001075,N00030245,Bill Cassidy (R),2012,Health Services/HMOs,24000,60191,84191
C001075,N00030245,Bill Cassidy (R),2012,Pharmaceuticals/Health Products,8453,64750,73203
C001075,N00030245,Bill Cassidy (R),2012,General Contractors,53350,2000,55350
C001075,N00030245,Bill Cassidy (R),2012,Lobbyists,50965,500,51465
C001075,N00030245,Bill Cassidy (R),2012,Retired,50300,0,50300
C001075,N00030245,Bill Cassidy (R),2012,Hospitals/Nursing Homes,32145,18000,50145
C001075,N00030245,Bill Cassidy (R),2012,Insurance,23881,23750,47631
C001075,N00030245,Bill Cassidy (R),2012,Lawyers/Law Firms,29400,14784,44184
F000455,N00030490,Marcia L Fudge (D),2012,Public Sector Unions,0,43500,43500
F000455,N00030490,Marcia L Fudge (D),2012,Building Trade Unions,0,42000,42000
F000455,N00030490,Marcia L Fudge (D),2012,Transportation Unions,0,34000,34000
F000455,N00030490,Marcia L Fudge (D),2012,Food Processing & Sales,250,27000,27250
F000455,N00030490,Marcia L Fudge (D),2012,Lawyers/Law Firms,7204,19525,26729
F000455,N00030490,Marcia L Fudge (D),2012,Food & Beverage,1750,23500,25250
F000455,N00030490,Marcia L Fudge (D),2012,Industrial Unions,0,24500,24500
F000455,N00030490,Marcia L Fudge (D),2012,Pharmaceuticals/Health Products,500,17500,18000
F000455,N00030490,Marcia L Fudge (D),2012,Real Estate,9425,8010,17435
F000455,N00030490,Marcia L Fudge (D),2012,Electric Utilities,1250,16025,17275
C001080,N00030600,Judy Chu (D),2012,Lawyers/Law Firms,48033,18500,66533
C001080,N00030600,Judy Chu (D),2012,Building Trade Unions,0,49500,49500
C001080,N00030600,Judy Chu (D),2012,Public Sector Unions,500,47000,47500
C001080,N00030600,Judy Chu (D),2012,Health Professionals,30551,11100,41651
C001080,N00030600,Judy Chu (D),2012,Real Estate,31600,8000,39600
C001080,N00030600,Judy Chu (D),2012,TV/Movies/Music,20550,18000,38550
C001080,N00030600,Judy Chu (D),2012,Industrial Unions,0,38500,38500
C001080,N00030600,Judy Chu (D),2012,Misc Unions,0,35500,35500
C001080,N00030600,Judy Chu (D),2012,Retired,34136,0,34136
C001080,N00030600,Judy Chu (D),2012,Human Rights,24616,7500,32116
B001267,N00030608,Michael F Bennet (D),2012,Lawyers/Law Firms,1269183,147401,1416584
B001267,N00030608,Michael F Bennet (D),2012,Securities & Investment,1310974,100000,1410974
B001267,N00030608,Michael F Bennet (D),2012,Retired,686270,0,686270
B001267,N00030608,Michael F Bennet (D),2012,Real Estate,495470,90500,585970
B001267,N00030608,Michael F Bennet (D),2012,Lobbyists,334412,17000,351412
B001267,N00030608,Michael F Bennet (D),2012,Leadership PACs,250,345262,345512
B001267,N00030608,Michael F Bennet (D),2012,Misc Finance,317907,14500,332407
B001267,N00030608,Michael F Bennet (D),2012,Education,303955,25100,329055
B001267,N00030608,Michael F Bennet (D),2012,Business Services,311051,14000,325051
B001267,N00030608,Michael F Bennet (D),2012,TV/Movies/Music,272166,28000,300166
H001058,N00030673,Bill Huizenga (R),2012,Real Estate,69175,51500,120675
H001058,N00030673,Bill Huizenga (R),2012,Insurance,7000,97165,104165
H001058,N00030673,Bill Huizenga (R),2012,Securities & Investment,21800,42500,64300
H001058,N00030673,Bill Huizenga (R),2012,Commercial Banks,4500,57500,62000
H001058,N00030673,Bill Huizenga (R),2012,Misc Manufacturing & Distributing,36200,14000,50200
H001058,N00030673,Bill Huizenga (R),2012,Leadership PACs,500,40879,41379
H001058,N00030673,Bill Huizenga (R),2012,Retail Sales,23500,10500,34000
H001058,N00030673,Bill Huizenga (R),2012,Accountants,2250,31411,33661
H001058,N00030673,Bill Huizenga (R),2012,Finance/Credit Companies,2500,28500,31000
H001058,N00030673,Bill Huizenga (R),2012,Electric Utilities,750,29000,29750
D000617,N00030693,Suzan DelBene (D),2012,Electronics Mfg & Equip,171900,0,171900
D000617,N00030693,Suzan DelBene (D),2012,Retired,103775,0,103775
D000617,N00030693,Suzan DelBene (D),2012,Lawyers/Law Firms,56742,10000,66742
D000617,N00030693,Suzan DelBene (D),2012,Leadership PACs,0,57000,57000
D000617,N00030693,Suzan DelBene (D),2012,Women's Issues,46795,6250,53045
D000617,N00030693,Suzan DelBene (D),2012,Business Services,51550,0,51550
D000617,N00030693,Suzan DelBene (D),2012,Industrial Unions,0,50000,50000
D000617,N00030693,Suzan DelBene (D),2012,Building Trade Unions,0,44500,44500
D000617,N00030693,Suzan DelBene (D),2012,Public Sector Unions,500,43500,44000
D000617,N00030693,Suzan DelBene (D),2012,Abortion Policy/Pro-Abortion Rights,26800,15000,41800
B001287,N00030717,Ami Bera (D),2012,Retired,322147,0,322147
B001287,N00030717,Ami Bera (D),2012,Health Professionals,125300,153499,278799
B001287,N00030717,Ami Bera (D),2012,Lawyers/Law Firms,129870,10000,139870
B001287,N00030717,Ami Bera (D),2012,Education,113699,0,113699
B001287,N00030717,Ami Bera (D),2012,Leadership PACs,0,106500,106500
B001287,N00030717,Ami Bera (D),2012,Electronics Mfg & Equip,95800,1000,96800
B001287,N00030717,Ami Bera (D),2012,Democratic/Liberal,67465,19370,86835
B001287,N00030717,Ami Bera (D),2012,Public Sector Unions,250,78300,78550
B001287,N00030717,Ami Bera (D),2012,Building Trade Unions,500,62000,62500
B001287,N00030717,Ami Bera (D),2012,Abortion Policy/Pro-Abortion Rights,34901,21000,55901
C001083,N00030736,John Carney (D),2012,Lawyers/Law Firms,168750,17100,185850
C001083,N00030736,John Carney (D),2012,Securities & Investment,20200,110000,130200
C001083,N00030736,John Carney (D),2012,Insurance,5750,121500,127250
C001083,N00030736,John Carney (D),2012,Commercial Banks,8550,73000,81550
C001083,N00030736,John Carney (D),2012,Real Estate,28125,51500,79625
C001083,N00030736,John Carney (D),2012,Pharmaceuticals/Health Products,15400,54952,70352
C001083,N00030736,John Carney (D),2012,Finance/Credit Companies,6500,51000,57500
C001083,N00030736,John Carney (D),2012,Accountants,0,45500,45500
C001083,N00030736,John Carney (D),2012,Retired,43190,0,43190
C001083,N00030736,John Carney (D),2012,Lobbyists,37301,0,37301
D000615,N00030752,Jeff Duncan (R),2012,Oil & Gas,1900,40000,41900
D000615,N00030752,Jeff Duncan (R),2012,Health Professionals,3700,27000,30700
D000615,N00030752,Jeff Duncan (R),2012,Insurance,3500,26000,29500
D000615,N00030752,Jeff Duncan (R),2012,Real Estate,6700,17500,24200
D000615,N00030752,Jeff Duncan (R),2012,Electric Utilities,4150,19000,23150
D000615,N00030752,Jeff Duncan (R),2012,Lawyers/Law Firms,11700,9500,21200
D000615,N00030752,Jeff Duncan (R),2012,Misc Manufacturing & Distributing,5000,16000,21000
D000615,N00030752,Jeff Duncan (R),2012,Leadership PACs,0,21000,21000
D000615,N00030752,Jeff Duncan (R),2012,General Contractors,6450,14000,20450
D000615,N00030752,Jeff Duncan (R),2012,Retail Sales,500,18500,19000
C001087,N00030770,Rick Crawford (R),2012,Crop Production & Basic Processing,68850,52000,120850
C001087,N00030770,Rick Crawford (R),2012,Leadership PACs,0,101500,101500
C001087,N00030770,Rick Crawford (R),2012,Health Professionals,47766,14000,61766
C001087,N00030770,Rick Crawford (R),2012,Securities & Investment,40600,20000,60600
C001087,N00030770,Rick Crawford (R),2012,Retired,43014,0,43014
C001087,N00030770,Rick Crawford (R),2012,Retail Sales,12500,20000,32500
C001087,N00030770,Rick Crawford (R),2012,Agricultural Services/Products,4250,27000,31250
C001087,N00030770,Rick Crawford (R),2012,Candidate Committees,0,31000,31000
C001087,N00030770,Rick Crawford (R),2012,Oil & Gas,14772,15000,29772
C001087,N00030770,Rick Crawford (R),2012,Commercial Banks,13111,16500,29611
G000565,N00030771,Paul Gosar (R),2012,Health Professionals,216781,82000,298781
G000565,N00030771,Paul Gosar (R),2012,Leadership PACs,0,65397,65397
G000565,N00030771,Paul Gosar (R),2012,Retired,35566,0,35566
G000565,N00030771,Paul Gosar (R),2012,Electric Utilities,6500,28000,34500
G000565,N00030771,Paul Gosar (R),2012,Lawyers/Law Firms,19800,6750,26550
G000565,N00030771,Paul Gosar (R),2012,Casinos/Gambling,23750,1000,24750
G000565,N00030771,Paul Gosar (R),2012,Business Services,24750,0,24750
G000565,N00030771,Paul Gosar (R),2012,Food Processing & Sales,13250,10000,23250
G000565,N00030771,Paul Gosar (R),2012,Crop Production & Basic Processing,16700,5000,21700
G000565,N00030771,Paul Gosar (R),2012,Food & Beverage,8000,13000,21000
G000562,N00030780,Cory Gardner (R),2012,Oil & Gas,71550,128000,199550
G000562,N00030780,Cory Gardner (R),2012,Retired,110901,0,110901
G000562,N00030780,Cory Gardner (R),2012,Real Estate,55356,30500,85856
G000562,N00030780,Cory Gardner (R),2012,Telecom Services,30480,41000,71480
G000562,N00030780,Cory Gardner (R),2012,Pharmaceuticals/Health Products,8000,62500,70500
G000562,N00030780,Cory Gardner (R),2012,Electric Utilities,2500,67000,69500
G000562,N00030780,Cory Gardner (R),2012,Health Professionals,4150,63500,67650
G000562,N00030780,Cory Gardner (R),2012,Lawyers/Law Firms,45139,18750,63889
G000562,N00030780,Cory Gardner (R),2012,Crop Production & Basic Processing,32450,21250,53700
G000562,N00030780,Cory Gardner (R),2012,Misc Manufacturing & Distributing,33900,19500,53400
G000560,N00030788,Tom Graves (R),2012,Health Professionals,40900,33500,74400
G000560,N00030788,Tom Graves (R),2012,Real Estate,32849,25500,58349
G000560,N00030788,Tom Graves (R),2012,Textiles,41408,6000,47408
G000560,N00030788,Tom Graves (R),2012,Retired,43710,0,43710
G000560,N00030788,Tom Graves (R),2012,Misc Manufacturing & Distributing,18500,19184,37684
G000560,N00030788,Tom Graves (R),2012,Oil & Gas,3750,30000,33750
G000560,N00030788,Tom Graves (R),2012,Lawyers/Law Firms,20333,10500,30833
G000560,N00030788,Tom Graves (R),2012,Leadership PACs,0,29122,29122
G000560,N00030788,Tom Graves (R),2012,Food & Beverage,5000,20250,25250
G000560,N00030788,Tom Graves (R),2012,"Beer, Wine & Liquor",11000,13000,24000
G000570,N00030801,Frank Guinta (R),2012,Leadership PACs,0,170017,170017
G000570,N00030801,Frank Guinta (R),2012,Insurance,47925,67500,115425
G000570,N00030801,Frank Guinta (R),2012,Real Estate,63308,25500,88808
G000570,N00030801,Frank Guinta (R),2012,Retired,80350,0,80350
G000570,N00030801,Frank Guinta (R),2012,Securities & Investment,54915,22000,76915
G000570,N00030801,Frank Guinta (R),2012,Candidate Committees,250,52500,52750
G000570,N00030801,Frank Guinta (R),2012,Food & Beverage,21100,29000,50100
G000570,N00030801,Frank Guinta (R),2012,Health Professionals,17100,30500,47600
G000570,N00030801,Frank Guinta (R),2012,Automotive,22192,21000,43192
G000570,N00030801,Frank Guinta (R),2012,Air Transport,3250,38134,41384
F000459,N00030815,Chuck Fleischmann (R),2012,Leadership PACs,0,104000,104000
F000459,N00030815,Chuck Fleischmann (R),2012,General Contractors,64050,17500,81550
F000459,N00030815,Chuck Fleischmann (R),2012,Real Estate,55250,13000,68250
F000459,N00030815,Chuck Fleischmann (R),2012,Lawyers/Law Firms,42850,15000,57850
F000459,N00030815,Chuck Fleischmann (R),2012,Insurance,32750,24000,56750
F000459,N00030815,Chuck Fleischmann (R),2012,Health Professionals,29600,25500,55100
F000459,N00030815,Chuck Fleischmann (R),2012,Retired,32100,0,32100
F000459,N00030815,Chuck Fleischmann (R),2012,Automotive,14000,15000,29000
F000459,N00030815,Chuck Fleischmann (R),2012,"Beer, Wine & Liquor",4300,22000,26300
F000459,N00030815,Chuck Fleischmann (R),2012,Business Services,15500,9000,24500
G000559,N00030856,John Garamendi (D),2012,Lawyers/Law Firms,79051,30250,109301
G000559,N00030856,John Garamendi (D),2012,Leadership PACs,0,103000,103000
G000559,N00030856,John Garamendi (D),2012,Real Estate,75215,6000,81215
G000559,N00030856,John Garamendi (D),2012,Public Sector Unions,0,75590,75590
G000559,N00030856,John Garamendi (D),2012,Building Trade Unions,0,75000,75000
G000559,N00030856,John Garamendi (D),2012,Retired,74150,0,74150
G000559,N00030856,John Garamendi (D),2012,"Beer, Wine & Liquor",51251,15500,66751
G000559,N00030856,John Garamendi (D),2012,Candidate Committees,0,56250,56250
G000559,N00030856,John Garamendi (D),2012,Insurance,32700,21000,53700
G000559,N00030856,John Garamendi (D),2012,Transportation Unions,0,50250,50250
G000566,N00030880,Trey Gowdy (R),2012,Health Professionals,15650,31000,46650
G000566,N00030880,Trey Gowdy (R),2012,Insurance,11350,22394,33744
G000566,N00030880,Trey Gowdy (R),2012,Leadership PACs,0,32272,32272
G000566,N00030880,Trey Gowdy (R),2012,Misc Manufacturing & Distributing,500,28000,28500
G000566,N00030880,Trey Gowdy (R),2012,Accountants,2250,23000,25250
G000566,N00030880,Trey Gowdy (R),2012,Lawyers/Law Firms,19100,2750,21850
G000566,N00030880,Trey Gowdy (R),2012,Lobbyists,21050,500,21550
G000566,N00030880,Trey Gowdy (R),2012,Real Estate,7750,13500,21250
G000566,N00030880,Trey Gowdy (R),2012,Textiles,10000,9000,19000
G000566,N00030880,Trey Gowdy (R),2012,Retired,18375,0,18375
B001274,N00030910,Mo Brooks (R),2012,Defense Aerospace,14920,75500,90420
B001274,N00030910,Mo Brooks (R),2012,Misc Defense,37300,34500,71800
B001274,N00030910,Mo Brooks (R),2012,Lawyers/Law Firms,34060,19500,53560
B001274,N00030910,Mo Brooks (R),2012,Health Professionals,28000,25000,53000
B001274,N00030910,Mo Brooks (R),2012,Defense Electronics,2300,48500,50800
B001274,N00030910,Mo Brooks (R),2012,Leadership PACs,0,35898,35898
B001274,N00030910,Mo Brooks (R),2012,Electronics Mfg & Equip,19580,15950,35530
B001274,N00030910,Mo Brooks (R),2012,Retired,33700,0,33700
B001274,N00030910,Mo Brooks (R),2012,Misc Manufacturing & Distributing,3750,22500,26250
B001274,N00030910,Mo Brooks (R),2012,Real Estate,12600,9000,21600
D000616,N00030957,Scott Desjarlais (R),2012,Leadership PACs,0,137000,137000
D000616,N00030957,Scott Desjarlais (R),2012,Health Professionals,81399,49884,131283
D000616,N00030957,Scott Desjarlais (R),2012,Retired,57460,0,57460
D000616,N00030957,Scott Desjarlais (R),2012,Real Estate,27800,14000,41800
D000616,N00030957,Scott Desjarlais (R),2012,Crop Production & Basic Processing,13500,23000,36500
D000616,N00030957,Scott Desjarlais (R),2012,Hospitals/Nursing Homes,15850,18500,34350
D000616,N00030957,Scott Desjarlais (R),2012,Insurance,13700,18500,32200
D000616,N00030957,Scott Desjarlais (R),2012,Lawyers/Law Firms,29550,2000,31550
D000616,N00030957,Scott Desjarlais (R),2012,Misc Manufacturing & Distributing,23672,7500,31172
D000616,N00030957,Scott Desjarlais (R),2012,Food & Beverage,5500,25500,31000
D000614,N00030967,Sean P Duffy (R),2012,Leadership PACs,0,201831,201831
D000614,N00030967,Sean P Duffy (R),2012,Retired,131248,0,131248
D000614,N00030967,Sean P Duffy (R),2012,Insurance,12450,117062,129512
D000614,N00030967,Sean P Duffy (R),2012,Health Professionals,89410,24750,114160
D000614,N00030967,Sean P Duffy (R),2012,Securities & Investment,50400,59650,110050
D000614,N00030967,Sean P Duffy (R),2012,Commercial Banks,27783,59250,87033
D000614,N00030967,Sean P Duffy (R),2012,Real Estate,32850,52000,84850
D000614,N00030967,Sean P Duffy (R),2012,Misc Manufacturing & Distributing,58300,17884,76184
D000614,N00030967,Sean P Duffy (R),2012,Republican/Conservative,28140,29250,57390
D000614,N00030967,Sean P Duffy (R),2012,Forestry & Forest Products,38750,10500,49250
A000368,N00030980,Kelly Ayotte (R),2012,Securities & Investment,670014,28000,698014
A000368,N00030980,Kelly Ayotte (R),2012,Retired,353704,0,353704
A000368,N00030980,Kelly Ayotte (R),2012,Lobbyists,276480,2000,278480
A000368,N00030980,Kelly Ayotte (R),2012,Insurance,115966,154000,269966
A000368,N00030980,Kelly Ayotte (R),2012,Leadership PACs,4149,250650,254799
A000368,N00030980,Kelly Ayotte (R),2012,Lawyers/Law Firms,199415,31500,230915
A000368,N00030980,Kelly Ayotte (R),2012,Real Estate,167778,29810,197588
A000368,N00030980,Kelly Ayotte (R),2012,Misc Finance,144359,25000,169359
A000368,N00030980,Kelly Ayotte (R),2012,Oil & Gas,75718,84650,160368
A000368,N00030980,Kelly Ayotte (R),2012,Health Professionals,59035,85000,144035
H001053,N00031005,Vicky Hartzler (R),2012,Leadership PACs,0,93879,93879
H001053,N00031005,Vicky Hartzler (R),2012,Crop Production & Basic Processing,36462,41240,77702
H001053,N00031005,Vicky Hartzler (R),2012,Retired,73950,0,73950
H001053,N00031005,Vicky Hartzler (R),2012,Agricultural Services/Products,24500,35500,60000
H001053,N00031005,Vicky Hartzler (R),2012,General Contractors,46600,5000,51600
H001053,N00031005,Vicky Hartzler (R),2012,Commercial Banks,34450,14500,48950
H001053,N00031005,Vicky Hartzler (R),2012,Real Estate,38800,7000,45800
H001053,N00031005,Vicky Hartzler (R),2012,Automotive,29650,15500,45150
H001053,N00031005,Vicky Hartzler (R),2012,Defense Aerospace,0,45134,45134
H001053,N00031005,Vicky Hartzler (R),2012,Health Professionals,31150,10500,41650
D000613,N00031103,Robert Dold (R),2012,Securities & Investment,440999,100150,541149
D000613,N00031103,Robert Dold (R),2012,Lawyers/Law Firms,255350,22000,277350
D000613,N00031103,Robert Dold (R),2012,Retired,258775,0,258775
D000613,N00031103,Robert Dold (R),2012,Leadership PACs,0,238499,238499
D000613,N00031103,Robert Dold (R),2012,Insurance,43500,151206,194706
D000613,N00031103,Robert Dold (R),2012,Real Estate,119250,47500,166750
D000613,N00031103,Robert Dold (R),2012,Pro-Israel,135700,18000,153700
D000613,N00031103,Robert Dold (R),2012,Misc Finance,96850,22500,119350
D000613,N00031103,Robert Dold (R),2012,Commercial Banks,46250,62056,108306
D000613,N00031103,Robert Dold (R),2012,Misc Manufacturing & Distributing,68923,34384,103307
H001059,N00031104,Randy Hultgren (R),2012,Securities & Investment,124500,14000,138500
H001059,N00031104,Randy Hultgren (R),2012,Retired,58375,0,58375
H001059,N00031104,Randy Hultgren (R),2012,Health Professionals,29625,22000,51625
H001059,N00031104,Randy Hultgren (R),2012,Agricultural Services/Products,3500,44808,48308
H001059,N00031104,Randy Hultgren (R),2012,Air Transport,0,43500,43500
H001059,N00031104,Randy Hultgren (R),2012,Leadership PACs,0,42900,42900
H001059,N00031104,Randy Hultgren (R),2012,Lawyers/Law Firms,29250,10000,39250
H001059,N00031104,Randy Hultgren (R),2012,General Contractors,21750,14000,35750
H001059,N00031104,Randy Hultgren (R),2012,Insurance,5700,30000,35700
H001059,N00031104,Randy Hultgren (R),2012,Crop Production & Basic Processing,2150,33000,35150
G000563,N00031128,Bob Gibbs (R),2012,Leadership PACs,0,113382,113382
G000563,N00031128,Bob Gibbs (R),2012,Oil & Gas,44550,40500,85050
G000563,N00031128,Bob Gibbs (R),2012,Mining,55900,21500,77400
G000563,N00031128,Bob Gibbs (R),2012,Misc Manufacturing & Distributing,64250,12500,76750
G000563,N00031128,Bob Gibbs (R),2012,Electric Utilities,28850,33000,61850
G000563,N00031128,Bob Gibbs (R),2012,Agricultural Services/Products,2500,47200,49700
G000563,N00031128,Bob Gibbs (R),2012,Retired,34150,0,34150
G000563,N00031128,Bob Gibbs (R),2012,Air Transport,0,31500,31500
G000563,N00031128,Bob Gibbs (R),2012,Insurance,7250,24250,31500
G000563,N00031128,Bob Gibbs (R),2012,Lawyers/Law Firms,13400,17500,30900
F000458,N00031141,Steve Fincher (R),2012,Crop Production & Basic Processing,219950,63631,283581
F000458,N00031141,Steve Fincher (R),2012,Retired,110900,0,110900
F000458,N00031141,Steve Fincher (R),2012,Insurance,26250,84000,110250
F000458,N00031141,Steve Fincher (R),2012,Commercial Banks,35065,72000,107065
F000458,N00031141,Steve Fincher (R),2012,Real Estate,53000,42000,95000
F000458,N00031141,Steve Fincher (R),2012,Leadership PACs,0,76910,76910
F000458,N00031141,Steve Fincher (R),2012,General Contractors,59250,14000,73250
F000458,N00031141,Steve Fincher (R),2012,Securities & Investment,11200,45650,56850
F000458,N00031141,Steve Fincher (R),2012,Agricultural Services/Products,4650,51500,56150
F000458,N00031141,Steve Fincher (R),2012,Oil & Gas,32200,23000,55200
A000369,N00031177,Mark Amodei (R),2012,Leadership PACs,1000,103000,104000
A000369,N00031177,Mark Amodei (R),2012,Casinos/Gambling,54528,44101,98629
A000369,N00031177,Mark Amodei (R),2012,Health Professionals,21750,51500,73250
A000369,N00031177,Mark Amodei (R),2012,Lawyers/Law Firms,47060,19750,66810
A000369,N00031177,Mark Amodei (R),2012,Retired,50300,0,50300
A000369,N00031177,Mark Amodei (R),2012,General Contractors,22849,18500,41349
A000369,N00031177,Mark Amodei (R),2012,Lobbyists,34555,3000,37555
A000369,N00031177,Mark Amodei (R),2012,Real Estate,12500,23000,35500
A000369,N00031177,Mark Amodei (R),2012,Mining,2500,33000,35500
A000369,N00031177,Mark Amodei (R),2012,Oil & Gas,1500,33500,35000
B001275,N00031227,Larry Bucshon (R),2012,Health Professionals,58750,151500,210250
B001275,N00031227,Larry Bucshon (R),2012,Leadership PACs,0,100750,100750
B001275,N00031227,Larry Bucshon (R),2012,Mining,29550,29250,58800
B001275,N00031227,Larry Bucshon (R),2012,Building Materials & Equipment,32850,13000,45850
B001275,N00031227,Larry Bucshon (R),2012,Insurance,15050,27500,42550
B001275,N00031227,Larry Bucshon (R),2012,General Contractors,21672,14500,36172
B001275,N00031227,Larry Bucshon (R),2012,Railroads,7650,23875,31525
B001275,N00031227,Larry Bucshon (R),2012,Pharmaceuticals/Health Products,9272,22150,31422
B001275,N00031227,Larry Bucshon (R),2012,Real Estate,25171,5000,30171
B001275,N00031227,Larry Bucshon (R),2012,Retired,27547,0,27547
B001282,N00031233,Andy Barr (R),2012,Mining,192332,43500,235832
B001282,N00031233,Andy Barr (R),2012,Retired,187615,0,187615
B001282,N00031233,Andy Barr (R),2012,Leadership PACs,0,133600,133600
B001282,N00031233,Andy Barr (R),2012,Health Professionals,55700,33000,88700
B001282,N00031233,Andy Barr (R),2012,Securities & Investment,82700,5000,87700
B001282,N00031233,Andy Barr (R),2012,Crop Production & Basic Processing,62450,0,62450
B001282,N00031233,Andy Barr (R),2012,Real Estate,56640,2500,59140
B001282,N00031233,Andy Barr (R),2012,Lawyers/Law Firms,50513,2500,53013
B001282,N00031233,Andy Barr (R),2012,Misc Manufacturing & Distributing,46800,1000,47800
B001282,N00031233,Andy Barr (R),2012,Insurance,32550,10500,43050
H001055,N00031244,Joe Heck (R),2012,Health Professionals,159667,170245,329912
H001055,N00031244,Joe Heck (R),2012,Casinos/Gambling,140750,46390,187140
H001055,N00031244,Joe Heck (R),2012,Leadership PACs,0,153879,153879
H001055,N00031244,Joe Heck (R),2012,Retired,105450,0,105450
H001055,N00031244,Joe Heck (R),2012,Real Estate,67000,23500,90500
H001055,N00031244,Joe Heck (R),2012,General Contractors,53040,16500,69540
H001055,N00031244,Joe Heck (R),2012,Oil & Gas,18600,42750,61350
H001055,N00031244,Joe Heck (R),2012,Insurance,8425,51500,59925
H001055,N00031244,Joe Heck (R),2012,Health Services/HMOs,13500,42500,56000
H001055,N00031244,Joe Heck (R),2012,Chemical & Related Manufacturing,47850,0,47850
H001060,N00031265,Robert Hurt (R),2012,Retired,144250,0,144250
H001060,N00031265,Robert Hurt (R),2012,Securities & Investment,64250,78250,142500
H001060,N00031265,Robert Hurt (R),2012,Insurance,13000,91506,104506
H001060,N00031265,Robert Hurt (R),2012,Real Estate,36751,48500,85251
H001060,N00031265,Robert Hurt (R),2012,Commercial Banks,6500,77500,84000
H001060,N00031265,Robert Hurt (R),2012,Leadership PACs,0,83455,83455
H001060,N00031265,Robert Hurt (R),2012,Lawyers/Law Firms,43697,19200,62897
H001060,N00031265,Robert Hurt (R),2012,Finance/Credit Companies,12625,37500,50125
H001060,N00031265,Robert Hurt (R),2012,Accountants,4000,44000,48000
H001060,N00031265,Robert Hurt (R),2012,Electric Utilities,7750,34500,42250
G000567,N00031297,Tim Griffin (R),2012,Health Professionals,73282,24500,97782
G000567,N00031297,Tim Griffin (R),2012,Commercial Banks,56650,31000,87650
G000567,N00031297,Tim Griffin (R),2012,Oil & Gas,49100,37000,86100
G000567,N00031297,Tim Griffin (R),2012,Securities & Investment,71000,10000,81000
G000567,N00031297,Tim Griffin (R),2012,Retail Sales,50050,24500,74550
G000567,N00031297,Tim Griffin (R),2012,Retired,73650,0,73650
G000567,N00031297,Tim Griffin (R),2012,Leadership PACs,0,49176,49176
G000567,N00031297,Tim Griffin (R),2012,Lobbyists,39600,2500,42100
G000567,N00031297,Tim Griffin (R),2012,Lawyers/Law Firms,27550,13164,40714
G000567,N00031297,Tim Griffin (R),2012,Insurance,16550,16000,32550
D000610,N00031317,Ted Deutch (D),2012,Lawyers/Law Firms,96100,22328,118428
D000610,N00031317,Ted Deutch (D),2012,Securities & Investment,84150,1500,85650
D000610,N00031317,Ted Deutch (D),2012,Retired,82310,0,82310
D000610,N00031317,Ted Deutch (D),2012,Pro-Israel,66040,14250,80290
D000610,N00031317,Ted Deutch (D),2012,Real Estate,68265,11500,79765
D000610,N00031317,Ted Deutch (D),2012,Business Services,29100,5000,34100
D000610,N00031317,Ted Deutch (D),2012,Health Professionals,22000,11000,33000
D000610,N00031317,Ted Deutch (D),2012,Health Services/HMOs,18000,12000,30000
D000610,N00031317,Ted Deutch (D),2012,Misc Finance,27300,2000,29300
D000610,N00031317,Ted Deutch (D),2012,Public Sector Unions,0,27500,27500
G000569,N00031401,Michael Grimm (R),2012,Securities & Investment,124582,98150,222732
G000569,N00031401,Michael Grimm (R),2012,Leadership PACs,250,156785,157035
G000569,N00031401,Michael Grimm (R),2012,Real Estate,55033,62000,117033
G000569,N00031401,Michael Grimm (R),2012,Insurance,8750,103006,111756
G000569,N00031401,Michael Grimm (R),2012,Transportation Unions,0,106500,106500
G000569,N00031401,Michael Grimm (R),2012,Lawyers/Law Firms,74658,8500,83158
G000569,N00031401,Michael Grimm (R),2012,Commercial Banks,22800,53000,75800
G000569,N00031401,Michael Grimm (R),2012,Building Trade Unions,0,64000,64000
G000569,N00031401,Michael Grimm (R),2012,Accountants,9700,47499,57199
G000569,N00031401,Michael Grimm (R),2012,Health Professionals,27801,22500,50301
E000291,N00031513,Renee Ellmers (R),2012,Health Professionals,18650,63750,82400
E000291,N00031513,Renee Ellmers (R),2012,Leadership PACs,0,70380,70380
E000291,N00031513,Renee Ellmers (R),2012,Crop Production & Basic Processing,20450,35500,55950
E000291,N00031513,Renee Ellmers (R),2012,Real Estate,22950,18000,40950
E000291,N00031513,Renee Ellmers (R),2012,Agricultural Services/Products,500,38000,38500
E000291,N00031513,Renee Ellmers (R),2012,Retired,37850,0,37850
E000291,N00031513,Renee Ellmers (R),2012,Insurance,6700,23000,29700
E000291,N00031513,Renee Ellmers (R),2012,Tobacco,1750,27500,29250
E000291,N00031513,Renee Ellmers (R),2012,Retail Sales,4250,22500,26750
E000291,N00031513,Renee Ellmers (R),2012,Misc Manufacturing & Distributing,10673,14999,25672
B001273,N00031539,Diane Black (R),2012,Health Professionals,48245,105344,153589
B001273,N00031539,Diane Black (R),2012,Insurance,35750,104528,140278
B001273,N00031539,Diane Black (R),2012,Hospitals/Nursing Homes,34150,98650,132800
B001273,N00031539,Diane Black (R),2012,Leadership PACs,0,96498,96498
B001273,N00031539,Diane Black (R),2012,Health Services/HMOs,26950,59650,86600
B001273,N00031539,Diane Black (R),2012,Pharmaceuticals/Health Products,3000,82591,85591
B001273,N00031539,Diane Black (R),2012,Oil & Gas,9405,52500,61905
B001273,N00031539,Diane Black (R),2012,Real Estate,18250,42000,60250
B001273,N00031539,Diane Black (R),2012,Lawyers/Law Firms,20950,29361,50311
B001273,N00031539,Diane Black (R),2012,Commercial Banks,12900,35500,48400
F000461,N00031545,Bill Flores (R),2012,Oil & Gas,121506,81000,202506
F000461,N00031545,Bill Flores (R),2012,Retired,125983,0,125983
F000461,N00031545,Bill Flores (R),2012,Health Professionals,32196,32500,64696
F000461,N00031545,Bill Flores (R),2012,Accountants,1250,42000,43250
F000461,N00031545,Bill Flores (R),2012,Misc Manufacturing & Distributing,24250,17134,41384
F000461,N00031545,Bill Flores (R),2012,Lawyers/Law Firms,26797,12000,38797
F000461,N00031545,Bill Flores (R),2012,Leadership PACs,0,37051,37051
F000461,N00031545,Bill Flores (R),2012,Real Estate,21400,11500,32900
F000461,N00031545,Bill Flores (R),2012,Commercial Banks,14000,18500,32500
F000461,N00031545,Bill Flores (R),2012,Crop Production & Basic Processing,4250,25350,29600
H001064,N00031557,Dennis Heck (D),2012,Retired,134037,0,134037
H001064,N00031557,Dennis Heck (D),2012,Lawyers/Law Firms,77795,12000,89795
H001064,N00031557,Dennis Heck (D),2012,Leadership PACs,0,87000,87000
H001064,N00031557,Dennis Heck (D),2012,Health Professionals,19882,54000,73882
H001064,N00031557,Dennis Heck (D),2012,Public Sector Unions,0,71500,71500
H001064,N00031557,Dennis Heck (D),2012,Lobbyists,69124,1500,70624
H001064,N00031557,Dennis Heck (D),2012,Building Trade Unions,250,68000,68250
H001064,N00031557,Dennis Heck (D),2012,Transportation Unions,3400,54000,57400
H001064,N00031557,Dennis Heck (D),2012,Business Services,50150,1000,51150
H001064,N00031557,Dennis Heck (D),2012,Democratic/Liberal,37300,10000,47300
H001056,N00031559,Jaime Herrera Beutler (R),2012,Retired,140888,0,140888
H001056,N00031559,Jaime Herrera Beutler (R),2012,Real Estate,60745,20000,80745
H001056,N00031559,Jaime Herrera Beutler (R),2012,Food & Beverage,50153,18500,68653
H001056,N00031559,Jaime Herrera Beutler (R),2012,Securities & Investment,44770,11000,55770
H001056,N00031559,Jaime Herrera Beutler (R),2012,Leadership PACs,0,53759,53759
H001056,N00031559,Jaime Herrera Beutler (R),2012,Forestry & Forest Products,30854,18500,49354
H001056,N00031559,Jaime Herrera Beutler (R),2012,Air Transport,4900,42500,47400
H001056,N00031559,Jaime Herrera Beutler (R),2012,General Contractors,31800,11000,42800
H001056,N00031559,Jaime Herrera Beutler (R),2012,Republican/Conservative,22535,16000,38535
H001056,N00031559,Jaime Herrera Beutler (R),2012,Health Professionals,15150,22500,37650
D000612,N00031593,Jeff Denham (R),2012,Crop Production & Basic Processing,248783,55000,303783
D000612,N00031593,Jeff Denham (R),2012,Leadership PACs,0,207906,207906
D000612,N00031593,Jeff Denham (R),2012,Casinos/Gambling,116590,7000,123590
D000612,N00031593,Jeff Denham (R),2012,Real Estate,79999,21500,101499
D000612,N00031593,Jeff Denham (R),2012,Oil & Gas,13900,77000,90900
D000612,N00031593,Jeff Denham (R),2012,Agricultural Services/Products,41750,44500,86250
D000612,N00031593,Jeff Denham (R),2012,Livestock,82782,0,82782
D000612,N00031593,Jeff Denham (R),2012,Dairy,53166,26250,79416
D000612,N00031593,Jeff Denham (R),2012,Candidate Committees,750,71454,72204
D000612,N00031593,Jeff Denham (R),2012,Health Professionals,29100,39384,68484
F000460,N00031672,Blake Farenthold (R),2012,Oil & Gas,42252,57500,99752
F000460,N00031672,Blake Farenthold (R),2012,Leadership PACs,0,77435,77435
F000460,N00031672,Blake Farenthold (R),2012,Health Professionals,35316,16500,51816
F000460,N00031672,Blake Farenthold (R),2012,General Contractors,44083,7500,51583
F000460,N00031672,Blake Farenthold (R),2012,Retired,49458,0,49458
F000460,N00031672,Blake Farenthold (R),2012,Air Transport,250,45133,45383
F000460,N00031672,Blake Farenthold (R),2012,Misc Finance,40725,0,40725
F000460,N00031672,Blake Farenthold (R),2012,Real Estate,23100,15000,38100
F000460,N00031672,Blake Farenthold (R),2012,Crop Production & Basic Processing,7350,28100,35450
F000460,N00031672,Blake Farenthold (R),2012,Lawyers/Law Firms,29375,1000,30375
B001277,N00031685,Richard Blumenthal (D),2012,Lawyers/Law Firms,611176,43500,654676
B001277,N00031685,Richard Blumenthal (D),2012,Securities & Investment,578397,19100,597497
B001277,N00031685,Richard Blumenthal (D),2012,Retired,517541,0,517541
B001277,N00031685,Richard Blumenthal (D),2012,Real Estate,453155,20000,473155
B001277,N00031685,Richard Blumenthal (D),2012,Health Professionals,127539,110750,238289
B001277,N00031685,Richard Blumenthal (D),2012,Leadership PACs,0,208400,208400
B001277,N00031685,Richard Blumenthal (D),2012,Education,156250,0,156250
B001277,N00031685,Richard Blumenthal (D),2012,Misc Finance,128300,0,128300
B001277,N00031685,Richard Blumenthal (D),2012,Lobbyists,110000,11000,121000
B001277,N00031685,Richard Blumenthal (D),2012,Business Services,99900,3250,103150
H001061,N00031688,John Hoeven (R),2012,Oil & Gas,176139,124998,301137
H001061,N00031688,John Hoeven (R),2012,Retired,230310,0,230310
H001061,N00031688,John Hoeven (R),2012,Insurance,49800,110050,159850
H001061,N00031688,John Hoeven (R),2012,Mining,89831,63975,153806
H001061,N00031688,John Hoeven (R),2012,Leadership PACs,1000,141900,142900
H001061,N00031688,John Hoeven (R),2012,Securities & Investment,115300,15000,130300
H001061,N00031688,John Hoeven (R),2012,Real Estate,94560,30500,125060
H001061,N00031688,John Hoeven (R),2012,Misc Manufacturing & Distributing,98000,26000,124000
H001061,N00031688,John Hoeven (R),2012,Health Professionals,49650,73000,122650
H001061,N00031688,John Hoeven (R),2012,Commercial Banks,63360,37500,100860
C001088,N00031820,Chris Coons (D),2012,Lawyers/Law Firms,724929,87400,812329
C001088,N00031820,Chris Coons (D),2012,Leadership PACs,0,287900,287900
C001088,N00031820,Chris Coons (D),2012,Lobbyists,243029,9080,252109
C001088,N00031820,Chris Coons (D),2012,Securities & Investment,153650,44500,198150
C001088,N00031820,Chris Coons (D),2012,Retired,161365,0,161365
C001088,N00031820,Chris Coons (D),2012,Real Estate,116450,21000,137450
C001088,N00031820,Chris Coons (D),2012,Pharmaceuticals/Health Products,27400,104000,131400
C001088,N00031820,Chris Coons (D),2012,Health Professionals,80350,41500,121850
C001088,N00031820,Chris Coons (D),2012,Insurance,23275,92500,115775
C001088,N00031820,Chris Coons (D),2012,Chemical & Related Manufacturing,44650,43500,88150
B001270,N00031877,Karen Bass (D),2012,Health Professionals,8550,42500,51050
B001270,N00031877,Karen Bass (D),2012,Public Sector Unions,0,42000,42000
B001270,N00031877,Karen Bass (D),2012,Lawyers/Law Firms,23850,15488,39338
B001270,N00031877,Karen Bass (D),2012,Industrial Unions,0,35000,35000
B001270,N00031877,Karen Bass (D),2012,Building Trade Unions,0,34500,34500
B001270,N00031877,Karen Bass (D),2012,TV/Movies/Music,16250,13748,29998
B001270,N00031877,Karen Bass (D),2012,Misc Unions,0,23500,23500
B001270,N00031877,Karen Bass (D),2012,Transportation Unions,0,20000,20000
B001270,N00031877,Karen Bass (D),2012,Health Services/HMOs,10750,7000,17750
B001270,N00031877,Karen Bass (D),2012,Lobbyists,17552,0,17552
B001271,N00031934,Dan Benishek (R),2012,Leadership PACs,0,273953,273953
B001271,N00031934,Dan Benishek (R),2012,Health Professionals,76575,154000,230575
B001271,N00031934,Dan Benishek (R),2012,Oil & Gas,36800,69000,105800
B001271,N00031934,Dan Benishek (R),2012,Retired,80901,0,80901
B001271,N00031934,Dan Benishek (R),2012,Candidate Committees,0,74626,74626
B001271,N00031934,Dan Benishek (R),2012,Real Estate,34000,23000,57000
B001271,N00031934,Dan Benishek (R),2012,Casinos/Gambling,51000,4000,55000
B001271,N00031934,Dan Benishek (R),2012,Republican/Conservative,20251,31900,52151
B001271,N00031934,Dan Benishek (R),2012,Electric Utilities,6150,42000,48150
B001271,N00031934,Dan Benishek (R),2012,Misc Manufacturing & Distributing,31450,16634,48084
A000367,N00031938,Justin Amash (R),2012,Misc Manufacturing & Distributing,87800,4000,91800
A000367,N00031938,Justin Amash (R),2012,Retired,74000,0,74000
A000367,N00031938,Justin Amash (R),2012,Health Professionals,61900,10000,71900
A000367,N00031938,Justin Amash (R),2012,Retail Sales,56750,1000,57750
A000367,N00031938,Justin Amash (R),2012,Securities & Investment,42500,3000,45500
A000367,N00031938,Justin Amash (R),2012,Lawyers/Law Firms,37025,3000,40025
A000367,N00031938,Justin Amash (R),2012,Leadership PACs,0,35000,35000
A000367,N00031938,Justin Amash (R),2012,Misc Finance,33300,0,33300
A000367,N00031938,Justin Amash (R),2012,Food Processing & Sales,31250,0,31250
A000367,N00031938,Justin Amash (R),2012,Automotive,23750,5000,28750
G000564,N00031998,Chris Gibson (R),2012,Leadership PACs,0,212500,212500
G000564,N00031998,Chris Gibson (R),2012,Securities & Investment,102333,27000,129333
G000564,N00031998,Chris Gibson (R),2012,General Contractors,59500,20000,79500
G000564,N00031998,Chris Gibson (R),2012,Retired,74469,0,74469
G000564,N00031998,Chris Gibson (R),2012,Real Estate,41333,25000,66333
G000564,N00031998,Chris Gibson (R),2012,Lawyers/Law Firms,51733,9500,61233
G000564,N00031998,Chris Gibson (R),2012,Candidate Committees,0,61050,61050
G000564,N00031998,Chris Gibson (R),2012,Crop Production & Basic Processing,31075,26750,57825
G000564,N00031998,Chris Gibson (R),2012,Defense Aerospace,0,50998,50998
G000564,N00031998,Chris Gibson (R),2012,Building Trade Unions,0,49500,49500
C001084,N00032019,David Cicilline (D),2012,Lawyers/Law Firms,175050,21000,196050
C001084,N00032019,David Cicilline (D),2012,Retired,133245,0,133245
C001084,N00032019,David Cicilline (D),2012,Real Estate,90262,12000,102262
C001084,N00032019,David Cicilline (D),2012,Leadership PACs,1000,100050,101050
C001084,N00032019,David Cicilline (D),2012,Securities & Investment,63200,9500,72700
C001084,N00032019,David Cicilline (D),2012,Human Rights,44500,26996,71496
C001084,N00032019,David Cicilline (D),2012,Lobbyists,71148,181,71329
C001084,N00032019,David Cicilline (D),2012,TV/Movies/Music,50350,6000,56350
C001084,N00032019,David Cicilline (D),2012,Public Sector Unions,350,55500,55850
C001084,N00032019,David Cicilline (D),2012,Candidate Committees,0,54900,54900
G000568,N00032029,Morgan Griffith (R),2012,Mining,94638,53500,148138
G000568,N00032029,Morgan Griffith (R),2012,Retired,66900,0,66900
G000568,N00032029,Morgan Griffith (R),2012,Oil & Gas,8550,51000,59550
G000568,N00032029,Morgan Griffith (R),2012,Health Professionals,22158,34000,56158
G000568,N00032029,Morgan Griffith (R),2012,Electric Utilities,3500,51750,55250
G000568,N00032029,Morgan Griffith (R),2012,Misc Manufacturing & Distributing,34650,18469,53119
G000568,N00032029,Morgan Griffith (R),2012,Lawyers/Law Firms,23650,16000,39650
G000568,N00032029,Morgan Griffith (R),2012,Leadership PACs,0,34075,34075
G000568,N00032029,Morgan Griffith (R),2012,Chemical & Related Manufacturing,6950,25000,31950
G000568,N00032029,Morgan Griffith (R),2012,Telecom Services,1000,25000,26000
D000618,N00033054,Steven Daines (R),2012,Retired,159584,0,159584
D000618,N00033054,Steven Daines (R),2012,Oil & Gas,70020,44500,114520
D000618,N00033054,Steven Daines (R),2012,Livestock,65400,10000,75400
D000618,N00033054,Steven Daines (R),2012,Leadership PACs,0,68500,68500
D000618,N00033054,Steven Daines (R),2012,General Contractors,47650,12500,60150
D000618,N00033054,Steven Daines (R),2012,Real Estate,48462,10000,58462
D000618,N00033054,Steven Daines (R),2012,Commercial Banks,29500,14500,44000
D000618,N00033054,Steven Daines (R),2012,Republican/Conservative,19950,24000,43950
D000618,N00033054,Steven Daines (R),2012,Automotive,22950,12000,34950
D000618,N00033054,Steven Daines (R),2012,Health Professionals,21185,12750,33935
C001098,N00033085,Ted Cruz (R),2012,Republican/Conservative,1334632,102081,1436713
C001098,N00033085,Ted Cruz (R),2012,Lawyers/Law Firms,760575,54250,814825
C001098,N00033085,Ted Cruz (R),2012,Oil & Gas,598782,184000,782782
C001098,N00033085,Ted Cruz (R),2012,Securities & Investment,590117,24500,614617
C001098,N00033085,Ted Cruz (R),2012,Retired,614264,0,614264
C001098,N00033085,Ted Cruz (R),2012,Real Estate,398920,22500,421420
C001098,N00033085,Ted Cruz (R),2012,Misc Finance,352789,3500,356289
C001098,N00033085,Ted Cruz (R),2012,Health Professionals,261779,38000,299779
C001098,N00033085,Ted Cruz (R),2012,Misc Business,248124,10000,258124
C001098,N00033085,Ted Cruz (R),2012,Misc Manufacturing & Distributing,194150,37000,231150
E000293,N00033217,Elizabeth Esty (D),2012,Lawyers/Law Firms,270736,12886,283622
E000293,N00033217,Elizabeth Esty (D),2012,Retired,191585,0,191585
E000293,N00033217,Elizabeth Esty (D),2012,Women's Issues,143059,20500,163559
E000293,N00033217,Elizabeth Esty (D),2012,Securities & Investment,143150,500,143650
E000293,N00033217,Elizabeth Esty (D),2012,Education,140652,0,140652
E000293,N00033217,Elizabeth Esty (D),2012,Business Services,100832,0,100832
E000293,N00033217,Elizabeth Esty (D),2012,Real Estate,81683,0,81683
E000293,N00033217,Elizabeth Esty (D),2012,Leadership PACs,250,71000,71250
E000293,N00033217,Elizabeth Esty (D),2012,Public Sector Unions,0,64500,64500
E000293,N00033217,Elizabeth Esty (D),2012,Health Professionals,34154,28500,62654
G000571,N00033281,Tulsi Gabbard (D),2012,Retired,82164,0,82164
G000571,N00033281,Tulsi Gabbard (D),2012,Construction Services,56401,1000,57401
G000571,N00033281,Tulsi Gabbard (D),2012,Women's Issues,42911,9000,51911
G000571,N00033281,Tulsi Gabbard (D),2012,Lawyers/Law Firms,43528,7500,51028
G000571,N00033281,Tulsi Gabbard (D),2012,Leadership PACs,250,49000,49250
G000571,N00033281,Tulsi Gabbard (D),2012,Real Estate,42304,5000,47304
G000571,N00033281,Tulsi Gabbard (D),2012,Health Professionals,26251,20500,46751
G000571,N00033281,Tulsi Gabbard (D),2012,Civil Servants/Public Officials,43925,0,43925
G000571,N00033281,Tulsi Gabbard (D),2012,General Contractors,43450,0,43450
G000571,N00033281,Tulsi Gabbard (D),2012,Public Sector Unions,0,41500,41500
C001091,N00033316,Joaquin Castro (D),2012,Lawyers/Law Firms,132688,21999,154687
C001091,N00033316,Joaquin Castro (D),2012,Real Estate,58666,22500,81166
C001091,N00033316,Joaquin Castro (D),2012,Oil & Gas,29550,36500,66050
C001091,N00033316,Joaquin Castro (D),2012,Health Professionals,35949,22000,57949
C001091,N00033316,Joaquin Castro (D),2012,Building Trade Unions,0,43500,43500
C001091,N00033316,Joaquin Castro (D),2012,Construction Services,28113,9500,37613
C001091,N00033316,Joaquin Castro (D),2012,Public Sector Unions,0,35500,35500
C001091,N00033316,Joaquin Castro (D),2012,Industrial Unions,0,35000,35000
C001091,N00033316,Joaquin Castro (D),2012,Business Services,27950,5500,33450
C001091,N00033316,Joaquin Castro (D),2012,Retired,31200,0,31200
C001095,N00033363,Tom Cotton (R),2012,Republican/Conservative,265783,28750,294533
C001095,N00033363,Tom Cotton (R),2012,Securities & Investment,129900,6000,135900
C001095,N00033363,Tom Cotton (R),2012,Lawyers/Law Firms,117110,12740,129850
C001095,N00033363,Tom Cotton (R),2012,Health Professionals,50992,66750,117742
C001095,N00033363,Tom Cotton (R),2012,Oil & Gas,64775,37500,102275
C001095,N00033363,Tom Cotton (R),2012,Retired,82850,0,82850
C001095,N00033363,Tom Cotton (R),2012,Commercial Banks,47250,23500,70750
C001095,N00033363,Tom Cotton (R),2012,Leadership PACs,0,65750,65750
C001095,N00033363,Tom Cotton (R),2012,General Contractors,49375,11000,60375
C001095,N00033363,Tom Cotton (R),2012,Business Services,46700,0,46700
C001097,N00033373,Tony Cardenas (D),2012,Real Estate,37550,14500,52050
C001097,N00033373,Tony Cardenas (D),2012,Public Sector Unions,0,41500,41500
C001097,N00033373,Tony Cardenas (D),2012,Lawyers/Law Firms,34500,5477,39977
C001097,N00033373,Tony Cardenas (D),2012,Building Trade Unions,0,37000,37000
C001097,N00033373,Tony Cardenas (D),2012,Health Professionals,6500,28500,35000
C001097,N00033373,Tony Cardenas (D),2012,Lobbyists,29840,0,29840
C001097,N00033373,Tony Cardenas (D),2012,Casinos/Gambling,28000,0,28000
C001097,N00033373,Tony Cardenas (D),2012,Leadership PACs,0,23000,23000
C001097,N00033373,Tony Cardenas (D),2012,Pharmaceuticals/Health Products,0,19500,19500
C001097,N00033373,Tony Cardenas (D),2012,TV/Movies/Music,14000,4000,18000
B001286,N00033390,Cheri Bustos (D),2012,Women's Issues,171025,16500,187525
B001286,N00033390,Cheri Bustos (D),2012,Lawyers/Law Firms,155317,11250,166567
B001286,N00033390,Cheri Bustos (D),2012,Leadership PACs,1750,112750,114500
B001286,N00033390,Cheri Bustos (D),2012,Retired,91046,0,91046
B001286,N00033390,Cheri Bustos (D),2012,Public Sector Unions,1300,74500,75800
B001286,N00033390,Cheri Bustos (D),2012,Pro-Israel,67728,5000,72728
B001286,N00033390,Cheri Bustos (D),2012,Building Trade Unions,250,64000,64250
B001286,N00033390,Cheri Bustos (D),2012,Candidate Committees,0,55500,55500
B001286,N00033390,Cheri Bustos (D),2012,Industrial Unions,2700,49000,51700
B001286,N00033390,Cheri Bustos (D),2012,Education,38050,0,38050
H001065,N00033399,George Holding (R),2012,Retired,126240,0,126240
H001065,N00033399,George Holding (R),2012,Lawyers/Law Firms,113518,10750,124268
H001065,N00033399,George Holding (R),2012,Health Professionals,40664,27000,67664
H001065,N00033399,George Holding (R),2012,Real Estate,56180,5000,61180
H001065,N00033399,George Holding (R),2012,Commercial Banks,41845,13000,54845
H001065,N00033399,George Holding (R),2012,Leadership PACs,0,42250,42250
H001065,N00033399,George Holding (R),2012,Misc Business,33859,0,33859
H001065,N00033399,George Holding (R),2012,Crop Production & Basic Processing,32200,1000,33200
H001065,N00033399,George Holding (R),2012,Food & Beverage,15750,9500,25250
H001065,N00033399,George Holding (R),2012,Business Services,22850,0,22850
F000463,N00033443,Deb Fischer (R),2012,Retired,321767,0,321767
F000463,N00033443,Deb Fischer (R),2012,Leadership PACs,200,234750,234950
F000463,N00033443,Deb Fischer (R),2012,Republican/Conservative,148771,45500,194271
F000463,N00033443,Deb Fischer (R),2012,Commercial Banks,76500,69500,146000
F000463,N00033443,Deb Fischer (R),2012,Crop Production & Basic Processing,120660,19500,140160
F000463,N00033443,Deb Fischer (R),2012,Health Professionals,102299,33500,135799
F000463,N00033443,Deb Fischer (R),2012,Securities & Investment,121742,6500,128242
F000463,N00033443,Deb Fischer (R),2012,Insurance,72500,55000,127500
F000463,N00033443,Deb Fischer (R),2012,Oil & Gas,63034,49000,112034
F000463,N00033443,Deb Fischer (R),2012,Real Estate,94663,14500,109163
D000627,N00033449,Val Demings (D),2012,Women's Issues,163674,25420,189094
D000627,N00033449,Val Demings (D),2012,Lawyers/Law Firms,84879,10000,94879
D000627,N00033449,Val Demings (D),2012,Leadership PACs,0,94000,94000
D000627,N00033449,Val Demings (D),2012,Retired,78493,0,78493
D000627,N00033449,Val Demings (D),2012,Public Sector Unions,0,74750,74750
D000627,N00033449,Val Demings (D),2012,Democratic/Liberal,48506,14600,63106
D000627,N00033449,Val Demings (D),2012,Industrial Unions,0,48500,48500
D000627,N00033449,Val Demings (D),2012,Candidate Committees,0,46500,46500
D000627,N00033449,Val Demings (D),2012,Civil Servants/Public Officials,37655,0,37655
D000627,N00033449,Val Demings (D),2012,Building Trade Unions,0,37000,37000
B001278,N00033474,Suzanne Bonamici (D),2012,Lawyers/Law Firms,282580,24164,306744
B001278,N00033474,Suzanne Bonamici (D),2012,Retired,117325,0,117325
B001278,N00033474,Suzanne Bonamici (D),2012,Leadership PACs,0,105000,105000
B001278,N00033474,Suzanne Bonamici (D),2012,Public Sector Unions,0,102500,102500
B001278,N00033474,Suzanne Bonamici (D),2012,Women's Issues,79600,13000,92600
B001278,N00033474,Suzanne Bonamici (D),2012,Health Professionals,22850,36500,59350
B001278,N00033474,Suzanne Bonamici (D),2012,Candidate Committees,0,48500,48500
B001278,N00033474,Suzanne Bonamici (D),2012,Building Trade Unions,0,47500,47500
B001278,N00033474,Suzanne Bonamici (D),2012,Transportation Unions,500,43000,43500
B001278,N00033474,Suzanne Bonamici (D),2012,Education,42092,0,42092
B001284,N00033495,Susan Brooks (R),2012,Lawyers/Law Firms,148950,5000,153950
B001284,N00033495,Susan Brooks (R),2012,Retired,67100,0,67100
B001284,N00033495,Susan Brooks (R),2012,Real Estate,52500,8500,61000
B001284,N00033495,Susan Brooks (R),2012,Pharmaceuticals/Health Products,42803,12000,54803
B001284,N00033495,Susan Brooks (R),2012,Health Professionals,31550,14500,46050
B001284,N00033495,Susan Brooks (R),2012,Leadership PACs,0,41000,41000
B001284,N00033495,Susan Brooks (R),2012,Securities & Investment,36250,1000,37250
B001284,N00033495,Susan Brooks (R),2012,Insurance,20000,4500,24500
B001284,N00033495,Susan Brooks (R),2012,Construction Services,23750,0,23750
B001284,N00033495,Susan Brooks (R),2012,Accountants,13350,10000,23350
C001093,N00033518,Doug Collins (R),2012,Lawyers/Law Firms,49480,8500,57980
C001093,N00033518,Doug Collins (R),2012,Leadership PACs,0,50500,50500
C001093,N00033518,Doug Collins (R),2012,Health Professionals,25850,17000,42850
C001093,N00033518,Doug Collins (R),2012,Retired,34000,0,34000
C001093,N00033518,Doug Collins (R),2012,Automotive,5500,20500,26000
C001093,N00033518,Doug Collins (R),2012,Real Estate,5750,16000,21750
C001093,N00033518,Doug Collins (R),2012,Oil & Gas,5500,14500,20000
C001093,N00033518,Doug Collins (R),2012,Misc Finance,17500,1000,18500
C001093,N00033518,Doug Collins (R),2012,General Contractors,10250,7000,17250
C001093,N00033518,Doug Collins (R),2012,Misc Manufacturing & Distributing,16000,1000,17000
B001283,N00033532,James Bridenstine (R),2012,Health Professionals,97415,18000,115415
B001283,N00033532,James Bridenstine (R),2012,Oil & Gas,26000,49000,75000
B001283,N00033532,James Bridenstine (R),2012,Retired,68050,0,68050
B001283,N00033532,James Bridenstine (R),2012,Leadership PACs,0,46000,46000
B001283,N00033532,James Bridenstine (R),2012,Lawyers/Law Firms,20800,0,20800
B001283,N00033532,James Bridenstine (R),2012,Republican/Conservative,12750,1000,13750
B001283,N00033532,James Bridenstine (R),2012,Automotive,5250,7000,12250
B001283,N00033532,James Bridenstine (R),2012,Misc Manufacturing & Distributing,9250,2000,11250
B001283,N00033532,James Bridenstine (R),2012,Real Estate,11250,0,11250
B001283,N00033532,James Bridenstine (R),2012,Commercial Banks,2500,8500,11000
B001283,N00033532,James Bridenstine (R),2012,Insurance,2500,8500,11000
G000572,N00033541,Pete Gallego (D),2012,Lawyers/Law Firms,260844,18000,278844
G000572,N00033541,Pete Gallego (D),2012,Public Sector Unions,0,73000,73000
G000572,N00033541,Pete Gallego (D),2012,Leadership PACs,0,60500,60500
G000572,N00033541,Pete Gallego (D),2012,Candidate Committees,0,57000,57000
G000572,N00033541,Pete Gallego (D),2012,"Beer, Wine & Liquor",56500,0,56500
G000572,N00033541,Pete Gallego (D),2012,Real Estate,49150,0,49150
G000572,N00033541,Pete Gallego (D),2012,Misc Finance,48950,0,48950
G000572,N00033541,Pete Gallego (D),2012,Industrial Unions,250,38500,38750
G000572,N00033541,Pete Gallego (D),2012,Misc Business,37550,0,37550
G000572,N00033541,Pete Gallego (D),2012,Building Trade Unions,0,37500,37500
B001280,N00033625,Kerry Bentivolio (R),2012,Leadership PACs,0,83500,83500
B001280,N00033625,Kerry Bentivolio (R),2012,Republican/Conservative,1750,25300,27050
B001280,N00033625,Kerry Bentivolio (R),2012,Candidate Committees,0,23500,23500
B001280,N00033625,Kerry Bentivolio (R),2012,Automotive,7750,9500,17250
B001280,N00033625,Kerry Bentivolio (R),2012,Retired,14750,0,14750
B001280,N00033625,Kerry Bentivolio (R),2012,Real Estate,9750,4500,14250
B001280,N00033625,Kerry Bentivolio (R),2012,Lawyers/Law Firms,10500,3000,13500
B001280,N00033625,Kerry Bentivolio (R),2012,Oil & Gas,0,13500,13500
B001280,N00033625,Kerry Bentivolio (R),2012,Credit Unions,0,10000,10000
B001280,N00033625,Kerry Bentivolio (R),2012,Gun Rights,5000,1024,6024
D000620,N00033897,John K Delaney (D),2012,Securities & Investment,270000,0,270000
D000620,N00033897,John K Delaney (D),2012,Lawyers/Law Firms,198039,13000,211039
D000620,N00033897,John K Delaney (D),2012,Real Estate,136499,4500,140999
D000620,N00033897,John K Delaney (D),2012,Finance/Credit Companies,108450,0,108450
D000620,N00033897,John K Delaney (D),2012,Misc Finance,84750,0,84750
D000620,N00033897,John K Delaney (D),2012,Business Services,66250,5000,71250
D000620,N00033897,John K Delaney (D),2012,Leadership PACs,0,65000,65000
D000620,N00033897,John K Delaney (D),2012,Public Sector Unions,0,55500,55500
D000620,N00033897,John K Delaney (D),2012,Retired,53840,0,53840
D000620,N00033897,John K Delaney (D),2012,Commercial Banks,35400,12000,47400
B001281,N00033904,Joyce Beatty (D),2012,Lawyers/Law Firms,22200,22750,44950
B001281,N00033904,Joyce Beatty (D),2012,Commercial Banks,1900,37500,39400
B001281,N00033904,Joyce Beatty (D),2012,Public Sector Unions,1000,36000,37000
B001281,N00033904,Joyce Beatty (D),2012,Insurance,18750,17000,35750
B001281,N00033904,Joyce Beatty (D),2012,Retail Sales,7500,25750,33250
B001281,N00033904,Joyce Beatty (D),2012,Electric Utilities,10250,17000,27250
B001281,N00033904,Joyce Beatty (D),2012,Education,27100,0,27100
B001281,N00033904,Joyce Beatty (D),2012,Leadership PACs,0,26208,26208
B001281,N00033904,Joyce Beatty (D),2012,Industrial Unions,0,26000,26000
B001281,N00033904,Joyce Beatty (D),2012,Retired,24100,0,24100
B001279,N00033981,Ron Barber (D),2012,Retired,292573,0,292573
B001279,N00033981,Ron Barber (D),2012,Leadership PACs,0,162500,162500
B001279,N00033981,Ron Barber (D),2012,Public Sector Unions,1250,129500,130750
B001279,N00033981,Ron Barber (D),2012,Lawyers/Law Firms,66750,24000,90750
B001279,N00033981,Ron Barber (D),2012,Democratic/Liberal,60402,28000,88402
B001279,N00033981,Ron Barber (D),2012,Health Professionals,22100,65000,87100
B001279,N00033981,Ron Barber (D),2012,Building Trade Unions,0,83500,83500
B001279,N00033981,Ron Barber (D),2012,Candidate Committees,0,71496,71496
B001279,N00033981,Ron Barber (D),2012,Education,62865,0,62865
B001279,N00033981,Ron Barber (D),2012,Real Estate,34500,24000,58500
C001090,N00034128,Matt Cartwright (D),2012,Lawyers/Law Firms,360875,11500,372375
C001090,N00034128,Matt Cartwright (D),2012,Public Sector Unions,0,50000,50000
C001090,N00034128,Matt Cartwright (D),2012,Industrial Unions,0,27500,27500
C001090,N00034128,Matt Cartwright (D),2012,Transportation Unions,0,27500,27500
C001090,N00034128,Matt Cartwright (D),2012,Building Trade Unions,0,27500,27500
C001090,N00034128,Matt Cartwright (D),2012,Retired,21650,0,21650
C001090,N00034128,Matt Cartwright (D),2012,Misc Business,17500,0,17500
C001090,N00034128,Matt Cartwright (D),2012,Health Professionals,7750,7100,14850
C001090,N00034128,Matt Cartwright (D),2012,Misc Unions,0,12500,12500
C001090,N00034128,Matt Cartwright (D),2012,Education,10500,0,10500
C001094,N00034224,Paul Cook (R),2012,Casinos/Gambling,45316,0,45316
C001094,N00034224,Paul Cook (R),2012,Health Professionals,5350,23000,28350
C001094,N00034224,Paul Cook (R),2012,Leadership PACs,0,27500,27500
C001094,N00034224,Paul Cook (R),2012,Public Sector Unions,0,27500,27500
C001094,N00034224,Paul Cook (R),2012,Real Estate,21367,5000,26367
C001094,N00034224,Paul Cook (R),2012,Retired,22350,0,22350
C001094,N00034224,Paul Cook (R),2012,Accountants,21450,0,21450
C001094,N00034224,Paul Cook (R),2012,Home Builders,11500,3500,15000
C001094,N00034224,Paul Cook (R),2012,Electric Utilities,250,14000,14250
C001094,N00034224,Paul Cook (R),2012,Hospitals/Nursing Homes,9750,3000,12750
C001094,N00034224,Paul Cook (R),2012,General Contractors,11750,1000,12750
B001285,N00034254,Julia Brownley (D),2012,Retired,209945,0,209945
B001285,N00034254,Julia Brownley (D),2012,Women's Issues,184055,24250,208305
B001285,N00034254,Julia Brownley (D),2012,Lawyers/Law Firms,107815,11000,118815
B001285,N00034254,Julia Brownley (D),2012,Leadership PACs,0,89001,89001
B001285,N00034254,Julia Brownley (D),2012,Public Sector Unions,0,70000,70000
B001285,N00034254,Julia Brownley (D),2012,Democratic/Liberal,42460,23400,65860
B001285,N00034254,Julia Brownley (D),2012,Candidate Committees,0,62500,62500
B001285,N00034254,Julia Brownley (D),2012,Education,42655,0,42655
B001285,N00034254,Julia Brownley (D),2012,Building Trade Unions,0,39500,39500
B001285,N00034254,Julia Brownley (D),2012,Environment,23475,12883,36358
D000621,N00034746,Ron DeSantis (R),2012,Retired,147658,0,147658
D000621,N00034746,Ron DeSantis (R),2012,Real Estate,68755,8500,77255
D000621,N00034746,Ron DeSantis (R),2012,Republican/Conservative,37261,33750,71011
D000621,N00034746,Ron DeSantis (R),2012,Lawyers/Law Firms,52000,3500,55500
D000621,N00034746,Ron DeSantis (R),2012,Health Professionals,35400,13000,48400
D000621,N00034746,Ron DeSantis (R),2012,Securities & Investment,45000,0,45000
D000621,N00034746,Ron DeSantis (R),2012,Leadership PACs,0,36628,36628
D000621,N00034746,Ron DeSantis (R),2012,Insurance,20800,12500,33300
D000621,N00034746,Ron DeSantis (R),2012,Misc Finance,31280,1500,32780
D000621,N00034746,Ron DeSantis (R),2012,Oil & Gas,11250,18500,29750
D000619,N00034784,Rodney Davis (R),2012,Leadership PACs,0,148750,148750
D000619,N00034784,Rodney Davis (R),2012,Health Professionals,35316,44500,79816
D000619,N00034784,Rodney Davis (R),2012,Food & Beverage,55275,20000,75275
D000619,N00034784,Rodney Davis (R),2012,Candidate Committees,0,47000,47000
D000619,N00034784,Rodney Davis (R),2012,Agricultural Services/Products,27733,16443,44176
D000619,N00034784,Rodney Davis (R),2012,Insurance,18700,25000,43700
D000619,N00034784,Rodney Davis (R),2012,Retired,37697,0,37697
D000619,N00034784,Rodney Davis (R),2012,Real Estate,27950,8000,35950
D000619,N00034784,Rodney Davis (R),2012,Oil & Gas,1750,31000,32750
D000619,N00034784,Rodney Davis (R),2012,Commercial Banks,21250,9000,30250
E000292,N00034884,William Enyart (D),2012,Lawyers/Law Firms,133332,6500,139832
E000292,N00034884,William Enyart (D),2012,Leadership PACs,0,98500,98500
E000292,N00034884,William Enyart (D),2012,Public Sector Unions,0,50000,50000
E000292,N00034884,William Enyart (D),2012,Building Trade Unions,1500,48500,50000
E000292,N00034884,William Enyart (D),2012,Candidate Committees,0,42000,42000
E000292,N00034884,William Enyart (D),2012,Industrial Unions,0,33000,33000
E000292,N00034884,William Enyart (D),2012,Retired,27705,0,27705
E000292,N00034884,William Enyart (D),2012,Transportation Unions,300,26500,26800
E000292,N00034884,William Enyart (D),2012,Civil Servants/Public Officials,24100,0,24100
E000292,N00034884,William Enyart (D),2012,Education,15428,0,15428
C000380,N00000133,Donna Christian-Christensen (D),2014,Health Professionals,3800,26000,29800
C000380,N00000133,Donna Christian-Christensen (D),2014,Pharmaceuticals/Health Products,500,27848,28348
C000380,N00000133,Donna Christian-Christensen (D),2014,Lawyers/Law Firms,18500,9250,27750
C000380,N00000133,Donna Christian-Christensen (D),2014,Telecom Services,0,13000,13000
C000380,N00000133,Donna Christian-Christensen (D),2014,Leadership PACs,0,10500,10500
C000380,N00000133,Donna Christian-Christensen (D),2014,Telephone Utilities,0,10000,10000
C000380,N00000133,Donna Christian-Christensen (D),2014,Business Services,8850,0,8850
C000380,N00000133,Donna Christian-Christensen (D),2014,Health Services/HMOs,2000,5500,7500
C000380,N00000133,Donna Christian-Christensen (D),2014,Candidate Committees,0,7000,7000
C000380,N00000133,Donna Christian-Christensen (D),2014,Electronics Mfg & Equip,5100,1500,6600
C001037,N00000267,Michael E Capuano (D),2014,Insurance,2250,132000,134250
C001037,N00000267,Michael E Capuano (D),2014,Real Estate,42500,67000,109500
C001037,N00000267,Michael E Capuano (D),2014,Transportation Unions,0,60500,60500
C001037,N00000267,Michael E Capuano (D),2014,Securities & Investment,10600,45000,55600
C001037,N00000267,Michael E Capuano (D),2014,Lawyers/Law Firms,42500,10000,52500
C001037,N00000267,Michael E Capuano (D),2014,Public Sector Unions,0,35500,35500
C001037,N00000267,Michael E Capuano (D),2014,Oil & Gas,28250,2500,30750
C001037,N00000267,Michael E Capuano (D),2014,Construction Services,6250,23500,29750
C001037,N00000267,Michael E Capuano (D),2014,Hospitals/Nursing Homes,18450,7500,25950
C001037,N00000267,Michael E Capuano (D),2014,Building Trade Unions,0,20000,20000
C001035,N00000491,Susan Collins (R),2014,Retired,414200,0,414200
C001035,N00000491,Susan Collins (R),2014,Lawyers/Law Firms,243506,130750,374256
C001035,N00000491,Susan Collins (R),2014,Securities & Investment,305150,62600,367750
C001035,N00000491,Susan Collins (R),2014,Leadership PACs,0,327000,327000
C001035,N00000491,Susan Collins (R),2014,Lobbyists,306760,9500,316260
C001035,N00000491,Susan Collins (R),2014,Health Professionals,58150,230300,288450
C001035,N00000491,Susan Collins (R),2014,Insurance,36500,198500,235000
C001035,N00000491,Susan Collins (R),2014,Real Estate,121250,53000,174250
C001035,N00000491,Susan Collins (R),2014,Misc Manufacturing & Distributing,57150,64500,121650
C001035,N00000491,Susan Collins (R),2014,Business Services,94200,24000,118200
D000216,N00000615,Rosa L DeLauro (D),2014,Democratic/Liberal,189905,0,189905
D000216,N00000615,Rosa L DeLauro (D),2014,Health Professionals,10621,93499,104120
D000216,N00000615,Rosa L DeLauro (D),2014,Public Sector Unions,0,73500,73500
D000216,N00000615,Rosa L DeLauro (D),2014,Lawyers/Law Firms,38429,26500,64929
D000216,N00000615,Rosa L DeLauro (D),2014,Building Trade Unions,0,56000,56000
D000216,N00000615,Rosa L DeLauro (D),2014,Human Rights,36800,13600,50400
D000216,N00000615,Rosa L DeLauro (D),2014,Industrial Unions,0,44500,44500
D000216,N00000615,Rosa L DeLauro (D),2014,Lobbyists,43248,1128,44376
D000216,N00000615,Rosa L DeLauro (D),2014,Transportation Unions,0,33500,33500
D000216,N00000615,Rosa L DeLauro (D),2014,Misc Unions,0,33500,33500
F000372,N00000684,Rodney Frelinghuysen (R),2014,Defense Aerospace,101381,54500,155881
F000372,N00000684,Rodney Frelinghuysen (R),2014,Retired,88850,0,88850
F000372,N00000684,Rodney Frelinghuysen (R),2014,Defense Electronics,1000,70500,71500
F000372,N00000684,Rodney Frelinghuysen (R),2014,Lobbyists,63030,5125,68155
F000372,N00000684,Rodney Frelinghuysen (R),2014,Securities & Investment,51500,10000,61500
F000372,N00000684,Rodney Frelinghuysen (R),2014,Electric Utilities,2850,48979,51829
F000372,N00000684,Rodney Frelinghuysen (R),2014,Pharmaceuticals/Health Products,500,50500,51000
F000372,N00000684,Rodney Frelinghuysen (R),2014,Misc Defense,18500,26500,45000
F000372,N00000684,Rodney Frelinghuysen (R),2014,Real Estate,22250,20000,42250
F000372,N00000684,Rodney Frelinghuysen (R),2014,Lawyers/Law Firms,14250,27000,41250
G000548,N00000743,Scott Garrett (R),2014,Securities & Investment,250400,230600,481000
G000548,N00000743,Scott Garrett (R),2014,Insurance,32030,180500,212530
G000548,N00000743,Scott Garrett (R),2014,Commercial Banks,18200,118500,136700
G000548,N00000743,Scott Garrett (R),2014,Real Estate,43600,79000,122600
G000548,N00000743,Scott Garrett (R),2014,Retired,73300,0,73300
G000548,N00000743,Scott Garrett (R),2014,Finance/Credit Companies,5000,61500,66500
G000548,N00000743,Scott Garrett (R),2014,Misc Finance,37450,21100,58550
G000548,N00000743,Scott Garrett (R),2014,Lawyers/Law Firms,41290,16250,57540
G000548,N00000743,Scott Garrett (R),2014,Accountants,6500,49999,56499
G000548,N00000743,Scott Garrett (R),2014,Oil & Gas,16900,20500,37400
A000210,N00000826,Robert E Andrews (D),2014,Lawyers/Law Firms,29835,38000,67835
A000210,N00000826,Robert E Andrews (D),2014,Education,38900,26499,65399
A000210,N00000826,Robert E Andrews (D),2014,Lobbyists,32681,5500,38181
A000210,N00000826,Robert E Andrews (D),2014,Building Trade Unions,0,32000,32000
A000210,N00000826,Robert E Andrews (D),2014,Insurance,7550,22500,30050
A000210,N00000826,Robert E Andrews (D),2014,Health Professionals,10625,17000,27625
A000210,N00000826,Robert E Andrews (D),2014,Food Processing & Sales,16600,11000,27600
A000210,N00000826,Robert E Andrews (D),2014,Defense Aerospace,2600,22500,25100
A000210,N00000826,Robert E Andrews (D),2014,Public Sector Unions,0,24500,24500
A000210,N00000826,Robert E Andrews (D),2014,Pro-Israel,10400,5000,15400
H001032,N00000860,Rush Holt (D),2014,Retired,312602,0,312602
H001032,N00000860,Rush Holt (D),2014,Education,113925,0,113925
H001032,N00000860,Rush Holt (D),2014,Securities & Investment,51050,44000,95050
H001032,N00000860,Rush Holt (D),2014,Lawyers/Law Firms,55249,8500,63749
H001032,N00000860,Rush Holt (D),2014,Insurance,7500,33500,41000
H001032,N00000860,Rush Holt (D),2014,Pharmaceuticals/Health Products,17000,23500,40500
H001032,N00000860,Rush Holt (D),2014,Business Services,36150,2000,38150
H001032,N00000860,Rush Holt (D),2014,Democratic/Liberal,32350,2500,34850
H001032,N00000860,Rush Holt (D),2014,Non-Profit Institutions,28100,6500,34600
H001032,N00000860,Rush Holt (D),2014,Environment,25550,500,26050
E000179,N00001003,Eliot L Engel (D),2014,Pro-Israel,92200,46700,138900
E000179,N00001003,Eliot L Engel (D),2014,Health Professionals,43582,60500,104082
E000179,N00001003,Eliot L Engel (D),2014,Real Estate,78245,8000,86245
E000179,N00001003,Eliot L Engel (D),2014,Lawyers/Law Firms,43800,19500,63300
E000179,N00001003,Eliot L Engel (D),2014,Pharmaceuticals/Health Products,16300,36500,52800
E000179,N00001003,Eliot L Engel (D),2014,Retired,47300,0,47300
E000179,N00001003,Eliot L Engel (D),2014,Education,41750,1000,42750
E000179,N00001003,Eliot L Engel (D),2014,Securities & Investment,38600,3500,42100
E000179,N00001003,Eliot L Engel (D),2014,Building Trade Unions,0,38000,38000
E000179,N00001003,Eliot L Engel (D),2014,Defense Aerospace,0,33000,33000
C001038,N00001127,Joseph Crowley (D),2014,Real Estate,232360,71175,303535
C001038,N00001127,Joseph Crowley (D),2014,Securities & Investment,133848,167500,301348
C001038,N00001127,Joseph Crowley (D),2014,Insurance,35650,255100,290750
C001038,N00001127,Joseph Crowley (D),2014,Lawyers/Law Firms,165299,55750,221049
C001038,N00001127,Joseph Crowley (D),2014,Commercial Banks,51050,85500,136550
C001038,N00001127,Joseph Crowley (D),2014,Pharmaceuticals/Health Products,13200,103500,116700
C001038,N00001127,Joseph Crowley (D),2014,Health Professionals,14350,67500,81850
C001038,N00001127,Joseph Crowley (D),2014,Hospitals/Nursing Homes,33650,41000,74650
C001038,N00001127,Joseph Crowley (D),2014,Misc Finance,32950,30500,63450
C001038,N00001127,Joseph Crowley (D),2014,Lobbyists,55968,2550,58518
C001092,N00001285,Chris Collins (R),2014,Food & Beverage,42487,11500,53987
C001092,N00001285,Chris Collins (R),2014,Health Professionals,13000,30500,43500
C001092,N00001285,Chris Collins (R),2014,Misc Manufacturing & Distributing,24000,16999,40999
C001092,N00001285,Chris Collins (R),2014,Oil & Gas,31200,7000,38200
C001092,N00001285,Chris Collins (R),2014,Leadership PACs,0,31500,31500
C001092,N00001285,Chris Collins (R),2014,Lawyers/Law Firms,22750,5500,28250
C001092,N00001285,Chris Collins (R),2014,Automotive,12050,15500,27550
C001092,N00001285,Chris Collins (R),2014,Republican/Conservative,0,27500,27500
C001092,N00001285,Chris Collins (R),2014,Retired,27050,0,27050
C001092,N00001285,Chris Collins (R),2014,Real Estate,18950,7000,25950
D000482,N00001373,Mike Doyle (D),2014,Electric Utilities,0,88500,88500
D000482,N00001373,Mike Doyle (D),2014,Telecom Services,1000,65000,66000
D000482,N00001373,Mike Doyle (D),2014,Building Trade Unions,0,59000,59000
D000482,N00001373,Mike Doyle (D),2014,Industrial Unions,0,54500,54500
D000482,N00001373,Mike Doyle (D),2014,Lawyers/Law Firms,21350,32000,53350
D000482,N00001373,Mike Doyle (D),2014,Real Estate,14750,18000,32750
D000482,N00001373,Mike Doyle (D),2014,Health Professionals,7750,24000,31750
D000482,N00001373,Mike Doyle (D),2014,Transportation Unions,0,31500,31500
D000482,N00001373,Mike Doyle (D),2014,Telephone Utilities,0,31000,31000
D000482,N00001373,Mike Doyle (D),2014,Public Sector Unions,0,29000,29000
D000482,N00001373,Mike Doyle (D),2014,Oil & Gas,2500,26500,29000
B001227,N00001619,Robert A Brady (D),2014,Lawyers/Law Firms,59500,15600,75100
B001227,N00001619,Robert A Brady (D),2014,Building Trade Unions,0,74600,74600
B001227,N00001619,Robert A Brady (D),2014,Industrial Unions,0,50000,50000
B001227,N00001619,Robert A Brady (D),2014,Transportation Unions,0,37000,37000
B001227,N00001619,Robert A Brady (D),2014,Public Sector Unions,0,29000,29000
B001227,N00001619,Robert A Brady (D),2014,General Contractors,25700,0,25700
B001227,N00001619,Robert A Brady (D),2014,Real Estate,20300,5400,25700
B001227,N00001619,Robert A Brady (D),2014,Business Services,21100,0,21100
B001227,N00001619,Robert A Brady (D),2014,Telecom Services,5000,15000,20000
B001227,N00001619,Robert A Brady (D),2014,Oil & Gas,13025,5000,18025
F000043,N00001746,Chaka Fattah (D),2014,Lawyers/Law Firms,32200,32053,64253
F000043,N00001746,Chaka Fattah (D),2014,Public Sector Unions,0,39500,39500
F000043,N00001746,Chaka Fattah (D),2014,Building Trade Unions,0,35000,35000
F000043,N00001746,Chaka Fattah (D),2014,Defense Aerospace,0,33000,33000
F000043,N00001746,Chaka Fattah (D),2014,Telecom Services,9500,15000,24500
F000043,N00001746,Chaka Fattah (D),2014,Transportation Unions,0,23000,23000
F000043,N00001746,Chaka Fattah (D),2014,Industrial Unions,0,21000,21000
F000043,N00001746,Chaka Fattah (D),2014,Real Estate,10000,10000,20000
F000043,N00001746,Chaka Fattah (D),2014,Pharmaceuticals/Health Products,500,17500,18000
F000043,N00001746,Chaka Fattah (D),2014,Lobbyists,12500,0,12500
G000386,N00001758,Chuck Grassley (R),2014,Insurance,104402,235900,340302
G000386,N00001758,Chuck Grassley (R),2014,Lobbyists,299635,21606,321241
G000386,N00001758,Chuck Grassley (R),2014,Leadership PACs,0,315300,315300
G000386,N00001758,Chuck Grassley (R),2014,Health Professionals,80710,221210,301920
G000386,N00001758,Chuck Grassley (R),2014,Securities & Investment,124300,108250,232550
G000386,N00001758,Chuck Grassley (R),2014,Agricultural Services/Products,67750,153000,220750
G000386,N00001758,Chuck Grassley (R),2014,Retired,199957,0,199957
G000386,N00001758,Chuck Grassley (R),2014,Lawyers/Law Firms,81150,117373,198523
G000386,N00001758,Chuck Grassley (R),2014,Health Services/HMOs,49050,128100,177150
G000386,N00001758,Chuck Grassley (R),2014,Pharmaceuticals/Health Products,51000,123400,174400
D000355,N00001783,John D Dingell (D),2014,Electric Utilities,0,38100,38100
D000355,N00001783,John D Dingell (D),2014,Pharmaceuticals/Health Products,0,32500,32500
D000355,N00001783,John D Dingell (D),2014,Health Professionals,0,24350,24350
D000355,N00001783,John D Dingell (D),2014,Lawyers/Law Firms,6475,17070,23545
D000355,N00001783,John D Dingell (D),2014,Building Trade Unions,0,22100,22100
D000355,N00001783,John D Dingell (D),2014,Transportation Unions,0,21000,21000
D000355,N00001783,John D Dingell (D),2014,Telephone Utilities,1300,15500,16800
D000355,N00001783,John D Dingell (D),2014,TV/Movies/Music,0,15500,15500
D000355,N00001783,John D Dingell (D),2014,Telecom Services,0,15000,15000
D000355,N00001783,John D Dingell (D),2014,Industrial Unions,300,13600,13900
H000874,N00001821,Steny H Hoyer (D),2014,Electric Utilities,22250,195750,218000
H000874,N00001821,Steny H Hoyer (D),2014,Insurance,33800,170000,203800
H000874,N00001821,Steny H Hoyer (D),2014,Health Professionals,23720,179000,202720
H000874,N00001821,Steny H Hoyer (D),2014,Securities & Investment,63290,134500,197790
H000874,N00001821,Steny H Hoyer (D),2014,Lawyers/Law Firms,129150,54500,183650
H000874,N00001821,Steny H Hoyer (D),2014,Real Estate,108660,72000,180660
H000874,N00001821,Steny H Hoyer (D),2014,Pharmaceuticals/Health Products,19950,126500,146450
H000874,N00001821,Steny H Hoyer (D),2014,Public Sector Unions,0,138000,138000
H000874,N00001821,Steny H Hoyer (D),2014,Pro-Israel,99450,26000,125450
H000874,N00001821,Steny H Hoyer (D),2014,Commercial Banks,1750,82500,84250
C000141,N00001955,Ben Cardin (D),2014,Lawyers/Law Firms,380676,125650,506326
C000141,N00001955,Ben Cardin (D),2014,Securities & Investment,266233,143500,409733
C000141,N00001955,Ben Cardin (D),2014,Real Estate,344620,61500,406120
C000141,N00001955,Ben Cardin (D),2014,Health Professionals,138310,247047,385357
C000141,N00001955,Ben Cardin (D),2014,Insurance,77850,218000,295850
C000141,N00001955,Ben Cardin (D),2014,Lobbyists,243393,9366,252759
C000141,N00001955,Ben Cardin (D),2014,Retired,250760,0,250760
C000141,N00001955,Ben Cardin (D),2014,Pro-Israel,183413,60280,243693
C000141,N00001955,Ben Cardin (D),2014,Health Services/HMOs,74550,150359,224909
C000141,N00001955,Ben Cardin (D),2014,Leadership PACs,0,192000,192000
C000984,N00001971,Elijah E Cummings (D),2014,Public Sector Unions,0,103000,103000
C000984,N00001971,Elijah E Cummings (D),2014,Transportation Unions,0,80500,80500
C000984,N00001971,Elijah E Cummings (D),2014,Sea Transport,9700,39500,49200
C000984,N00001971,Elijah E Cummings (D),2014,Oil & Gas,37050,2000,39050
C000984,N00001971,Elijah E Cummings (D),2014,Building Trade Unions,400,34000,34400
C000984,N00001971,Elijah E Cummings (D),2014,Health Professionals,14300,18000,32300
C000984,N00001971,Elijah E Cummings (D),2014,Air Transport,0,32000,32000
C000984,N00001971,Elijah E Cummings (D),2014,Industrial Unions,0,31000,31000
C000984,N00001971,Elijah E Cummings (D),2014,Railroads,0,29500,29500
C000984,N00001971,Elijah E Cummings (D),2014,Lawyers/Law Firms,16000,12500,28500
B001135,N00002221,Richard Burr (R),2014,Retired,553156,0,553156
B001135,N00002221,Richard Burr (R),2014,Health Professionals,276839,201200,478039
B001135,N00002221,Richard Burr (R),2014,Pharmaceuticals/Health Products,100550,329720,430270
B001135,N00002221,Richard Burr (R),2014,Insurance,175751,235500,411251
B001135,N00002221,Richard Burr (R),2014,Lawyers/Law Firms,276751,120250,397001
B001135,N00002221,Richard Burr (R),2014,Securities & Investment,248152,120900,369052
B001135,N00002221,Richard Burr (R),2014,Leadership PACs,0,321241,321241
B001135,N00002221,Richard Burr (R),2014,Lobbyists,299093,16000,315093
B001135,N00002221,Richard Burr (R),2014,Real Estate,226429,46500,272929
B001135,N00002221,Richard Burr (R),2014,Electric Utilities,129831,139999,269830
C000556,N00002247,Howard Coble (R),2014,Air Transport,0,6500,6500
C000556,N00002247,Howard Coble (R),2014,Automotive,0,5000,5000
C000556,N00002247,Howard Coble (R),2014,TV/Movies/Music,0,4500,4500
C000556,N00002247,Howard Coble (R),2014,Crop Production & Basic Processing,500,3500,4000
C000556,N00002247,Howard Coble (R),2014,Retired,3600,0,3600
C000556,N00002247,Howard Coble (R),2014,Agricultural Services/Products,0,3500,3500
C000556,N00002247,Howard Coble (R),2014,Sea Transport,0,3000,3000
C000556,N00002247,Howard Coble (R),2014,Electric Utilities,0,3000,3000
C000556,N00002247,Howard Coble (R),2014,Telecom Services,0,3000,3000
C000556,N00002247,Howard Coble (R),2014,Real Estate,1000,2000,3000
C000556,N00002247,Howard Coble (R),2014,Health Professionals,0,3000,3000
C000556,N00002247,Howard Coble (R),2014,Pharmaceuticals/Health Products,0,3000,3000
C000556,N00002247,Howard Coble (R),2014,Trucking,0,3000,3000
C000537,N00002408,James E Clyburn (D),2014,Insurance,20250,108500,128750
C000537,N00002408,James E Clyburn (D),2014,Electric Utilities,4250,124000,128250
C000537,N00002408,James E Clyburn (D),2014,Lawyers/Law Firms,60443,57600,118043
C000537,N00002408,James E Clyburn (D),2014,Pharmaceuticals/Health Products,0,106110,106110
C000537,N00002408,James E Clyburn (D),2014,Health Professionals,8250,83500,91750
C000537,N00002408,James E Clyburn (D),2014,Public Sector Unions,0,84500,84500
C000537,N00002408,James E Clyburn (D),2014,Transportation Unions,0,81500,81500
C000537,N00002408,James E Clyburn (D),2014,Securities & Investment,9200,63500,72700
C000537,N00002408,James E Clyburn (D),2014,Commercial Banks,1000,69000,70000
C000537,N00002408,James E Clyburn (D),2014,Hospitals/Nursing Homes,14100,48600,62700
B000490,N00002674,Sanford Bishop (D),2014,Lawyers/Law Firms,31600,32444,64044
B000490,N00002674,Sanford Bishop (D),2014,Crop Production & Basic Processing,2750,60500,63250
B000490,N00002674,Sanford Bishop (D),2014,Industrial Unions,0,44000,44000
B000490,N00002674,Sanford Bishop (D),2014,Building Trade Unions,0,39500,39500
B000490,N00002674,Sanford Bishop (D),2014,Food & Beverage,14500,20500,35000
B000490,N00002674,Sanford Bishop (D),2014,Public Sector Unions,0,35000,35000
B000490,N00002674,Sanford Bishop (D),2014,Defense Aerospace,0,34000,34000
B000490,N00002674,Sanford Bishop (D),2014,Forestry & Forest Products,6500,25000,31500
B000490,N00002674,Sanford Bishop (D),2014,Health Professionals,8000,23500,31500
B000490,N00002674,Sanford Bishop (D),2014,Food Processing & Sales,2250,27988,30238
C000286,N00002685,Saxby Chambliss (R),2014,Crop Production & Basic Processing,63650,61341,124991
C000286,N00002685,Saxby Chambliss (R),2014,Retired,114875,0,114875
C000286,N00002685,Saxby Chambliss (R),2014,Insurance,39250,57000,96250
C000286,N00002685,Saxby Chambliss (R),2014,Lawyers/Law Firms,60700,29500,90200
C000286,N00002685,Saxby Chambliss (R),2014,Agricultural Services/Products,28050,47770,75820
C000286,N00002685,Saxby Chambliss (R),2014,Securities & Investment,44810,28500,73310
C000286,N00002685,Saxby Chambliss (R),2014,Lobbyists,66043,2500,68543
C000286,N00002685,Saxby Chambliss (R),2014,Real Estate,43970,10000,53970
C000286,N00002685,Saxby Chambliss (R),2014,Mining,43003,5000,48003
C000286,N00002685,Saxby Chambliss (R),2014,Health Services/HMOs,26500,19500,46000
B000911,N00002713,Corrine Brown (D),2014,Transportation Unions,0,56000,56000
B000911,N00002713,Corrine Brown (D),2014,Railroads,2500,53000,55500
B000911,N00002713,Corrine Brown (D),2014,Lawyers/Law Firms,33450,19600,53050
B000911,N00002713,Corrine Brown (D),2014,Real Estate,14800,6000,20800
B000911,N00002713,Corrine Brown (D),2014,Building Materials & Equipment,15200,4000,19200
B000911,N00002713,Corrine Brown (D),2014,Sea Transport,6700,12000,18700
B000911,N00002713,Corrine Brown (D),2014,Hospitals/Nursing Homes,12500,5000,17500
B000911,N00002713,Corrine Brown (D),2014,Air Transport,0,17500,17500
B000911,N00002713,Corrine Brown (D),2014,Building Trade Unions,0,15000,15000
B000911,N00002713,Corrine Brown (D),2014,Lobbyists,11200,0,11200
H000324,N00002884,Alcee L Hastings (D),2014,Education,33700,30500,64200
H000324,N00002884,Alcee L Hastings (D),2014,Lawyers/Law Firms,39960,14500,54460
H000324,N00002884,Alcee L Hastings (D),2014,Crop Production & Basic Processing,12050,31000,43050
H000324,N00002884,Alcee L Hastings (D),2014,Leadership PACs,0,39755,39755
H000324,N00002884,Alcee L Hastings (D),2014,Finance/Credit Companies,14000,22000,36000
H000324,N00002884,Alcee L Hastings (D),2014,Lobbyists,28400,500,28900
H000324,N00002884,Alcee L Hastings (D),2014,Transportation Unions,0,27500,27500
H000324,N00002884,Alcee L Hastings (D),2014,Industrial Unions,0,27500,27500
H000324,N00002884,Alcee L Hastings (D),2014,Telephone Utilities,0,21000,21000
H000324,N00002884,Alcee L Hastings (D),2014,Real Estate,11500,8000,19500
F000462,N00002893,Lois J Frankel (D),2014,Lawyers/Law Firms,91473,20500,111973
F000462,N00002893,Lois J Frankel (D),2014,Retired,93250,0,93250
F000462,N00002893,Lois J Frankel (D),2014,Real Estate,53550,8000,61550
F000462,N00002893,Lois J Frankel (D),2014,Building Trade Unions,0,60000,60000
F000462,N00002893,Lois J Frankel (D),2014,Securities & Investment,59850,0,59850
F000462,N00002893,Lois J Frankel (D),2014,Business Services,40000,11000,51000
F000462,N00002893,Lois J Frankel (D),2014,Transportation Unions,0,47500,47500
F000462,N00002893,Lois J Frankel (D),2014,Public Sector Unions,2000,34500,36500
F000462,N00002893,Lois J Frankel (D),2014,Crop Production & Basic Processing,17700,14000,31700
F000462,N00002893,Lois J Frankel (D),2014,Industrial Unions,0,30500,30500
A000055,N00003028,Robert B Aderholt (R),2014,Crop Production & Basic Processing,0,57500,57500
A000055,N00003028,Robert B Aderholt (R),2014,Agricultural Services/Products,2500,50500,53000
A000055,N00003028,Robert B Aderholt (R),2014,Defense Aerospace,6398,45000,51398
A000055,N00003028,Robert B Aderholt (R),2014,Commercial Banks,6000,38000,44000
A000055,N00003028,Robert B Aderholt (R),2014,Lawyers/Law Firms,13948,28000,41948
A000055,N00003028,Robert B Aderholt (R),2014,Misc Defense,28747,12000,40747
A000055,N00003028,Robert B Aderholt (R),2014,Defense Electronics,1000,39000,40000
A000055,N00003028,Robert B Aderholt (R),2014,Food Processing & Sales,1498,38000,39498
A000055,N00003028,Robert B Aderholt (R),2014,Lobbyists,36417,2119,38536
A000055,N00003028,Robert B Aderholt (R),2014,Pharmaceuticals/Health Products,0,34000,34000
B001243,N00003105,Marsha Blackburn (R),2014,Health Professionals,26000,205150,231150
B001243,N00003105,Marsha Blackburn (R),2014,Pharmaceuticals/Health Products,7750,155100,162850
B001243,N00003105,Marsha Blackburn (R),2014,Oil & Gas,22100,79500,101600
B001243,N00003105,Marsha Blackburn (R),2014,Automotive,27950,43000,70950
B001243,N00003105,Marsha Blackburn (R),2014,Health Services/HMOs,11500,50500,62000
B001243,N00003105,Marsha Blackburn (R),2014,Insurance,11750,49500,61250
B001243,N00003105,Marsha Blackburn (R),2014,Hospitals/Nursing Homes,16450,42000,58450
B001243,N00003105,Marsha Blackburn (R),2014,Lawyers/Law Firms,21250,35791,57041
B001243,N00003105,Marsha Blackburn (R),2014,TV/Movies/Music,24250,28600,52850
B001243,N00003105,Marsha Blackburn (R),2014,Telecom Services,0,49500,49500
C000754,N00003132,Jim Cooper (D),2014,Lawyers/Law Firms,64100,14500,78600
C000754,N00003132,Jim Cooper (D),2014,Real Estate,35100,5000,40100
C000754,N00003132,Jim Cooper (D),2014,Defense Aerospace,0,40000,40000
C000754,N00003132,Jim Cooper (D),2014,Securities & Investment,33900,6000,39900
C000754,N00003132,Jim Cooper (D),2014,Retired,32350,0,32350
C000754,N00003132,Jim Cooper (D),2014,Insurance,8700,22000,30700
C000754,N00003132,Jim Cooper (D),2014,Accountants,5250,24500,29750
C000754,N00003132,Jim Cooper (D),2014,Education,20200,5000,25200
C000754,N00003132,Jim Cooper (D),2014,"Beer, Wine & Liquor",14400,8500,22900
C000754,N00003132,Jim Cooper (D),2014,Building Trade Unions,0,20000,20000
D000533,N00003209,John J Duncan Jr (R),2014,Railroads,0,45000,45000
D000533,N00003209,John J Duncan Jr (R),2014,Air Transport,0,43000,43000
D000533,N00003209,John J Duncan Jr (R),2014,Lawyers/Law Firms,14150,14500,28650
D000533,N00003209,John J Duncan Jr (R),2014,Construction Services,0,25500,25500
D000533,N00003209,John J Duncan Jr (R),2014,Transportation Unions,0,25000,25000
D000533,N00003209,John J Duncan Jr (R),2014,Building Materials & Equipment,2500,21500,24000
D000533,N00003209,John J Duncan Jr (R),2014,Trucking,3000,21000,24000
D000533,N00003209,John J Duncan Jr (R),2014,Misc Transport,1500,20000,21500
D000533,N00003209,John J Duncan Jr (R),2014,Pharmaceuticals/Health Products,20800,0,20800
D000533,N00003209,John J Duncan Jr (R),2014,General Contractors,8500,11500,20000
C001068,N00003225,Steve Cohen (D),2014,Transportation Unions,0,50000,50000
C001068,N00003225,Steve Cohen (D),2014,Industrial Unions,0,42000,42000
C001068,N00003225,Steve Cohen (D),2014,Real Estate,30050,6000,36050
C001068,N00003225,Steve Cohen (D),2014,Lawyers/Law Firms,12050,23500,35550
C001068,N00003225,Steve Cohen (D),2014,Railroads,0,29000,29000
C001068,N00003225,Steve Cohen (D),2014,Public Sector Unions,0,27500,27500
C001068,N00003225,Steve Cohen (D),2014,Telecom Services,0,26000,26000
C001068,N00003225,Steve Cohen (D),2014,Retired,24650,0,24650
C001068,N00003225,Steve Cohen (D),2014,Health Professionals,11250,13000,24250
C001068,N00003225,Steve Cohen (D),2014,Misc Unions,0,21000,21000
C001068,N00003225,Steve Cohen (D),2014,Automotive,2000,19000,21000
C000567,N00003328,Thad Cochran (R),2014,Crop Production & Basic Processing,263925,239350,503275
C000567,N00003328,Thad Cochran (R),2014,Leadership PACs,0,463300,463300
C000567,N00003328,Thad Cochran (R),2014,Lawyers/Law Firms,151700,138500,290200
C000567,N00003328,Thad Cochran (R),2014,Agricultural Services/Products,21000,210500,231500
C000567,N00003328,Thad Cochran (R),2014,Lobbyists,220775,6001,226776
C000567,N00003328,Thad Cochran (R),2014,Oil & Gas,85505,141000,226505
C000567,N00003328,Thad Cochran (R),2014,Defense Aerospace,65800,151500,217300
C000567,N00003328,Thad Cochran (R),2014,Retired,182254,0,182254
C000567,N00003328,Thad Cochran (R),2014,Health Professionals,52509,107150,159659
C000567,N00003328,Thad Cochran (R),2014,Insurance,33200,121300,154500
B000944,N00003535,Sherrod Brown (D),2014,Lawyers/Law Firms,1791671,203123,1994794
B000944,N00003535,Sherrod Brown (D),2014,Retired,1264236,0,1264236
B000944,N00003535,Sherrod Brown (D),2014,Health Professionals,404777,259300,664077
B000944,N00003535,Sherrod Brown (D),2014,Education,607989,4000,611989
B000944,N00003535,Sherrod Brown (D),2014,Real Estate,510862,67000,577862
B000944,N00003535,Sherrod Brown (D),2014,Lobbyists,461581,21350,482931
B000944,N00003535,Sherrod Brown (D),2014,Women's Issues,402684,1500,404184
B000944,N00003535,Sherrod Brown (D),2014,Insurance,164608,228649,393257
B000944,N00003535,Sherrod Brown (D),2014,Hospitals/Nursing Homes,337188,46250,383438
B000944,N00003535,Sherrod Brown (D),2014,Leadership PACs,200,379000,379200
B000589,N00003675,John Boehner (R),2014,Securities & Investment,1102510,156000,1258510
B000589,N00003675,John Boehner (R),2014,Retired,1189700,0,1189700
B000589,N00003675,John Boehner (R),2014,Real Estate,669516,47500,717016
B000589,N00003675,John Boehner (R),2014,Oil & Gas,503339,174500,677839
B000589,N00003675,John Boehner (R),2014,Mining,511048,41150,552198
B000589,N00003675,John Boehner (R),2014,Insurance,302635,201500,504135
B000589,N00003675,John Boehner (R),2014,Lawyers/Law Firms,408256,43400,451656
B000589,N00003675,John Boehner (R),2014,Misc Manufacturing & Distributing,362807,55500,418307
B000589,N00003675,John Boehner (R),2014,Lobbyists,392126,5000,397126
B000589,N00003675,John Boehner (R),2014,Health Professionals,202245,190250,392495
C000266,N00003689,Steve Chabot (R),2014,Misc Manufacturing & Distributing,38400,16185,54585
C000266,N00003689,Steve Chabot (R),2014,Retired,47500,0,47500
C000266,N00003689,Steve Chabot (R),2014,Insurance,28950,8100,37050
C000266,N00003689,Steve Chabot (R),2014,Health Professionals,28500,8000,36500
C000266,N00003689,Steve Chabot (R),2014,Lawyers/Law Firms,24200,12221,36421
C000266,N00003689,Steve Chabot (R),2014,Real Estate,26300,7000,33300
C000266,N00003689,Steve Chabot (R),2014,Recreation/Live Entertainment,18800,11000,29800
C000266,N00003689,Steve Chabot (R),2014,Automotive,9000,16500,25500
C000266,N00003689,Steve Chabot (R),2014,Securities & Investment,8450,16000,24450
C000266,N00003689,Steve Chabot (R),2014,Food Processing & Sales,19200,4000,23200
C000542,N00003845,Dan Coats (R),2014,Securities & Investment,309481,11000,320481
C000542,N00003845,Dan Coats (R),2014,Leadership PACs,0,283854,283854
C000542,N00003845,Dan Coats (R),2014,Lawyers/Law Firms,185254,64350,249604
C000542,N00003845,Dan Coats (R),2014,Retired,195896,0,195896
C000542,N00003845,Dan Coats (R),2014,Real Estate,154199,25000,179199
C000542,N00003845,Dan Coats (R),2014,Oil & Gas,63283,114750,178033
C000542,N00003845,Dan Coats (R),2014,Insurance,36500,137900,174400
C000542,N00003845,Dan Coats (R),2014,Lobbyists,146933,16000,162933
C000542,N00003845,Dan Coats (R),2014,Pharmaceuticals/Health Products,28450,106899,135349
C000542,N00003845,Dan Coats (R),2014,Health Professionals,37300,81500,118800
C000714,N00004029,John Conyers Jr (D),2014,Telecom Services,16000,53000,69000
C000714,N00004029,John Conyers Jr (D),2014,Lawyers/Law Firms,21650,46392,68042
C000714,N00004029,John Conyers Jr (D),2014,TV/Movies/Music,13750,49000,62750
C000714,N00004029,John Conyers Jr (D),2014,Public Sector Unions,0,47000,47000
C000714,N00004029,John Conyers Jr (D),2014,Retail Sales,500,37000,37500
C000714,N00004029,John Conyers Jr (D),2014,Building Trade Unions,0,36500,36500
C000714,N00004029,John Conyers Jr (D),2014,Industrial Unions,0,33500,33500
C000714,N00004029,John Conyers Jr (D),2014,Misc Unions,0,30000,30000
C000714,N00004029,John Conyers Jr (D),2014,Telephone Utilities,0,27000,27000
C000714,N00004029,John Conyers Jr (D),2014,Leadership PACs,0,25000,25000
H000206,N00004207,Tom Harkin (D),2014,Health Professionals,35050,126000,161050
H000206,N00004207,Tom Harkin (D),2014,Pharmaceuticals/Health Products,29200,129884,159084
H000206,N00004207,Tom Harkin (D),2014,Lobbyists,143734,3207,146941
H000206,N00004207,Tom Harkin (D),2014,Hospitals/Nursing Homes,76200,34500,110700
H000206,N00004207,Tom Harkin (D),2014,Lawyers/Law Firms,47750,53000,100750
H000206,N00004207,Tom Harkin (D),2014,Retired,84528,0,84528
H000206,N00004207,Tom Harkin (D),2014,Health Services/HMOs,34700,31000,65700
H000206,N00004207,Tom Harkin (D),2014,Education,55143,4000,59143
H000206,N00004207,Tom Harkin (D),2014,Insurance,20050,39000,59050
H000206,N00004207,Tom Harkin (D),2014,Securities & Investment,46300,11000,57300
B001230,N00004367,Tammy Baldwin (D),2014,Women's Issues,882131,36972,919103
B001230,N00004367,Tammy Baldwin (D),2014,Retired,838964,0,838964
B001230,N00004367,Tammy Baldwin (D),2014,Lawyers/Law Firms,621807,27350,649157
B001230,N00004367,Tammy Baldwin (D),2014,Democratic/Liberal,388844,173765,562609
B001230,N00004367,Tammy Baldwin (D),2014,Education,328025,2500,330525
B001230,N00004367,Tammy Baldwin (D),2014,Leadership PACs,8750,300680,309430
B001230,N00004367,Tammy Baldwin (D),2014,Health Professionals,171254,56250,227504
B001230,N00004367,Tammy Baldwin (D),2014,Human Rights,187468,29993,217461
B001230,N00004367,Tammy Baldwin (D),2014,Business Services,192140,2000,194140
B001230,N00004367,Tammy Baldwin (D),2014,Pro-Israel,152265,24715,176980
C001096,N00004614,Kevin Cramer (R),2014,Oil & Gas,154850,87600,242450
C001096,N00004614,Kevin Cramer (R),2014,Crop Production & Basic Processing,78100,47250,125350
C001096,N00004614,Kevin Cramer (R),2014,Agricultural Services/Products,9050,46100,55150
C001096,N00004614,Kevin Cramer (R),2014,Retired,54820,0,54820
C001096,N00004614,Kevin Cramer (R),2014,Leadership PACs,2000,42100,44100
C001096,N00004614,Kevin Cramer (R),2014,Insurance,7550,32000,39550
C001096,N00004614,Kevin Cramer (R),2014,Real Estate,31400,8000,39400
C001096,N00004614,Kevin Cramer (R),2014,Commercial Banks,25050,13500,38550
C001096,N00004614,Kevin Cramer (R),2014,Mining,900,23500,24400
C001096,N00004614,Kevin Cramer (R),2014,Defense Aerospace,0,21000,21000
B000243,N00004643,Max Baucus (D),2014,Lobbyists,322627,8000,330627
B000243,N00004643,Max Baucus (D),2014,Insurance,145400,178500,323900
B000243,N00004643,Max Baucus (D),2014,Securities & Investment,204069,90000,294069
B000243,N00004643,Max Baucus (D),2014,Health Services/HMOs,114218,125450,239668
B000243,N00004643,Max Baucus (D),2014,Lawyers/Law Firms,114299,109049,223348
B000243,N00004643,Max Baucus (D),2014,Health Professionals,29412,188850,218262
B000243,N00004643,Max Baucus (D),2014,Hospitals/Nursing Homes,74548,116500,191048
B000243,N00004643,Max Baucus (D),2014,Real Estate,150779,28650,179429
B000243,N00004643,Max Baucus (D),2014,Pharmaceuticals/Health Products,35800,139268,175068
B000243,N00004643,Max Baucus (D),2014,Electric Utilities,9250,122750,132000
G000535,N00004874,Luis V Gutierrez (D),2014,Building Trade Unions,0,22500,22500
G000535,N00004874,Luis V Gutierrez (D),2014,Accountants,0,19440,19440
G000535,N00004874,Luis V Gutierrez (D),2014,Misc Unions,0,17500,17500
G000535,N00004874,Luis V Gutierrez (D),2014,Public Sector Unions,0,13500,13500
G000535,N00004874,Luis V Gutierrez (D),2014,Hospitals/Nursing Homes,0,12500,12500
G000535,N00004874,Luis V Gutierrez (D),2014,Insurance,0,11000,11000
G000535,N00004874,Luis V Gutierrez (D),2014,Telephone Utilities,0,10500,10500
G000535,N00004874,Luis V Gutierrez (D),2014,Real Estate,2000,8000,10000
G000535,N00004874,Luis V Gutierrez (D),2014,Candidate Committees,0,10000,10000
G000535,N00004874,Luis V Gutierrez (D),2014,Securities & Investment,0,9000,9000
D000096,N00004884,Danny K Davis (D),2014,Insurance,250,49500,49750
D000096,N00004884,Danny K Davis (D),2014,Public Sector Unions,0,43500,43500
D000096,N00004884,Danny K Davis (D),2014,Pharmaceuticals/Health Products,0,39500,39500
D000096,N00004884,Danny K Davis (D),2014,Securities & Investment,0,24000,24000
D000096,N00004884,Danny K Davis (D),2014,Building Trade Unions,0,23500,23500
D000096,N00004884,Danny K Davis (D),2014,"Beer, Wine & Liquor",1000,21500,22500
D000096,N00004884,Danny K Davis (D),2014,Health Professionals,0,21500,21500
D000096,N00004884,Danny K Davis (D),2014,Electric Utilities,0,19000,19000
D000096,N00004884,Danny K Davis (D),2014,Lawyers/Law Firms,4000,14000,18000
D000096,N00004884,Danny K Davis (D),2014,Real Estate,300,15000,15300
D000563,N00004981,Dick Durbin (D),2014,Lawyers/Law Firms,1255172,112920,1368092
D000563,N00004981,Dick Durbin (D),2014,Securities & Investment,344800,41000,385800
D000563,N00004981,Dick Durbin (D),2014,Retired,321306,0,321306
D000563,N00004981,Dick Durbin (D),2014,Real Estate,245117,42500,287617
D000563,N00004981,Dick Durbin (D),2014,Lobbyists,252031,14500,266531
D000563,N00004981,Dick Durbin (D),2014,Health Professionals,107011,145700,252711
D000563,N00004981,Dick Durbin (D),2014,Defense Aerospace,191050,54999,246049
D000563,N00004981,Dick Durbin (D),2014,Insurance,93459,123000,216459
D000563,N00004981,Dick Durbin (D),2014,Pro-Israel,182040,25650,207690
D000563,N00004981,Dick Durbin (D),2014,Leadership PACs,0,183600,183600
B000575,N00005195,Roy Blunt (R),2014,Securities & Investment,902805,133200,1036005
B000575,N00005195,Roy Blunt (R),2014,Retired,692499,0,692499
B000575,N00005195,Roy Blunt (R),2014,Leadership PACs,0,643269,643269
B000575,N00005195,Roy Blunt (R),2014,Lawyers/Law Firms,400744,173488,574232
B000575,N00005195,Roy Blunt (R),2014,Real Estate,523535,47400,570935
B000575,N00005195,Roy Blunt (R),2014,Health Professionals,318330,200500,518830
B000575,N00005195,Roy Blunt (R),2014,Lobbyists,473380,10550,483930
B000575,N00005195,Roy Blunt (R),2014,Insurance,228634,239900,468534
B000575,N00005195,Roy Blunt (R),2014,Misc Manufacturing & Distributing,353450,91900,445350
B000575,N00005195,Roy Blunt (R),2014,Oil & Gas,246385,170750,417135
A000373,N00005293,Brad Ashford (D),2014,Leadership PACs,1500,86336,87836
A000373,N00005293,Brad Ashford (D),2014,Lawyers/Law Firms,67485,16500,83985
A000373,N00005293,Brad Ashford (D),2014,Retired,75355,0,75355
A000373,N00005293,Brad Ashford (D),2014,Candidate Committees,0,36097,36097
A000373,N00005293,Brad Ashford (D),2014,Public Sector Unions,250,35000,35250
A000373,N00005293,Brad Ashford (D),2014,Building Trade Unions,0,29500,29500
A000373,N00005293,Brad Ashford (D),2014,Health Professionals,24050,2500,26550
A000373,N00005293,Brad Ashford (D),2014,Real Estate,25850,0,25850
A000373,N00005293,Brad Ashford (D),2014,Transportation Unions,0,25000,25000
A000373,N00005293,Brad Ashford (D),2014,Education,24954,0,24954
C000560,N00005601,Tom Coburn (R),2014,Health Professionals,85072,113000,198072
C000560,N00005601,Tom Coburn (R),2014,Oil & Gas,67800,103000,170800
C000560,N00005601,Tom Coburn (R),2014,Leadership PACs,200,123708,123908
C000560,N00005601,Tom Coburn (R),2014,Insurance,8150,98500,106650
C000560,N00005601,Tom Coburn (R),2014,Pharmaceuticals/Health Products,3601,101000,104601
C000560,N00005601,Tom Coburn (R),2014,Securities & Investment,62750,29000,91750
C000560,N00005601,Tom Coburn (R),2014,Retired,91300,0,91300
C000560,N00005601,Tom Coburn (R),2014,Republican/Conservative,80150,2693,82843
C000560,N00005601,Tom Coburn (R),2014,Lobbyists,70350,9303,79653
C000560,N00005601,Tom Coburn (R),2014,Lawyers/Law Firms,40800,37910,78710
H000067,N00005645,Ralph Hall (R),2014,Leadership PACs,0,115217,115217
H000067,N00005645,Ralph Hall (R),2014,Candidate Committees,0,57500,57500
H000067,N00005645,Ralph Hall (R),2014,Lawyers/Law Firms,36150,14750,50900
H000067,N00005645,Ralph Hall (R),2014,Health Professionals,15850,33000,48850
H000067,N00005645,Ralph Hall (R),2014,Oil & Gas,7100,39000,46100
H000067,N00005645,Ralph Hall (R),2014,Retired,38550,0,38550
H000067,N00005645,Ralph Hall (R),2014,Defense Aerospace,0,35500,35500
H000067,N00005645,Ralph Hall (R),2014,Lobbyists,23228,2441,25669
H000067,N00005645,Ralph Hall (R),2014,Electric Utilities,3850,21000,24850
H000067,N00005645,Ralph Hall (R),2014,Commercial Banks,11750,10500,22250
B000213,N00005656,Joe Barton (R),2014,Oil & Gas,39400,95000,134400
B000213,N00005656,Joe Barton (R),2014,Electric Utilities,6000,95500,101500
B000213,N00005656,Joe Barton (R),2014,Health Professionals,25400,31500,56900
B000213,N00005656,Joe Barton (R),2014,Misc Manufacturing & Distributing,36250,7500,43750
B000213,N00005656,Joe Barton (R),2014,Telecom Services,3000,31000,34000
B000213,N00005656,Joe Barton (R),2014,Retail Sales,2500,29000,31500
B000213,N00005656,Joe Barton (R),2014,Automotive,3000,27500,30500
B000213,N00005656,Joe Barton (R),2014,Lawyers/Law Firms,7325,23125,30450
B000213,N00005656,Joe Barton (R),2014,Insurance,1000,27500,28500
B000213,N00005656,Joe Barton (R),2014,Misc Finance,25150,0,25150
B001291,N00005736,Brian Babin (R),2014,Health Professionals,103826,79500,183326
B001291,N00005736,Brian Babin (R),2014,Leadership PACs,0,78076,78076
B001291,N00005736,Brian Babin (R),2014,Commercial Banks,39450,6750,46200
B001291,N00005736,Brian Babin (R),2014,Retired,43150,0,43150
B001291,N00005736,Brian Babin (R),2014,Oil & Gas,13050,25500,38550
B001291,N00005736,Brian Babin (R),2014,Real Estate,21550,11000,32550
B001291,N00005736,Brian Babin (R),2014,Food & Beverage,24600,2500,27100
B001291,N00005736,Brian Babin (R),2014,Lawyers/Law Firms,21800,3552,25352
B001291,N00005736,Brian Babin (R),2014,General Contractors,18000,5000,23000
B001291,N00005736,Brian Babin (R),2014,Construction Services,7615,15000,22615
G000410,N00005870,Gene Green (D),2014,Health Professionals,14600,118500,133100
G000410,N00005870,Gene Green (D),2014,Oil & Gas,250,102100,102350
G000410,N00005870,Gene Green (D),2014,Pharmaceuticals/Health Products,5000,67044,72044
G000410,N00005870,Gene Green (D),2014,Chemical & Related Manufacturing,2800,53000,55800
G000410,N00005870,Gene Green (D),2014,Building Trade Unions,0,48500,48500
G000410,N00005870,Gene Green (D),2014,Electric Utilities,200,41750,41950
G000410,N00005870,Gene Green (D),2014,Lawyers/Law Firms,20750,21000,41750
G000410,N00005870,Gene Green (D),2014,Transportation Unions,0,40500,40500
G000410,N00005870,Gene Green (D),2014,Industrial Unions,0,38000,38000
G000410,N00005870,Gene Green (D),2014,Telecom Services,750,31500,32250
B000755,N00005883,Kevin Brady (R),2014,Oil & Gas,144150,166100,310250
B000755,N00005883,Kevin Brady (R),2014,Health Professionals,54567,210500,265067
B000755,N00005883,Kevin Brady (R),2014,Health Services/HMOs,37378,121700,159078
B000755,N00005883,Kevin Brady (R),2014,Insurance,10200,135000,145200
B000755,N00005883,Kevin Brady (R),2014,Real Estate,70374,59500,129874
B000755,N00005883,Kevin Brady (R),2014,Pharmaceuticals/Health Products,23200,103132,126332
B000755,N00005883,Kevin Brady (R),2014,Hospitals/Nursing Homes,43100,68100,111200
B000755,N00005883,Kevin Brady (R),2014,Lawyers/Law Firms,28050,56900,84950
B000755,N00005883,Kevin Brady (R),2014,Securities & Investment,30232,49500,79732
B000755,N00005883,Kevin Brady (R),2014,Misc Issues,74875,500,75375
H000636,N00006008,Ruben Hinojosa (D),2014,Health Professionals,61700,13000,74700
H000636,N00006008,Ruben Hinojosa (D),2014,Insurance,300,33500,33800
H000636,N00006008,Ruben Hinojosa (D),2014,Public Sector Unions,0,30500,30500
H000636,N00006008,Ruben Hinojosa (D),2014,Securities & Investment,13000,12500,25500
H000636,N00006008,Ruben Hinojosa (D),2014,Building Trade Unions,0,25000,25000
H000636,N00006008,Ruben Hinojosa (D),2014,"Beer, Wine & Liquor",10200,13000,23200
H000636,N00006008,Ruben Hinojosa (D),2014,Real Estate,500,21000,21500
H000636,N00006008,Ruben Hinojosa (D),2014,Crop Production & Basic Processing,0,20500,20500
H000636,N00006008,Ruben Hinojosa (D),2014,Telephone Utilities,0,19000,19000
H000636,N00006008,Ruben Hinojosa (D),2014,Lawyers/Law Firms,8350,7500,15850
D000399,N00006023,Lloyd Doggett (D),2014,Lawyers/Law Firms,142850,35500,178350
D000399,N00006023,Lloyd Doggett (D),2014,Retired,101550,0,101550
D000399,N00006023,Lloyd Doggett (D),2014,Health Professionals,12850,53000,65850
D000399,N00006023,Lloyd Doggett (D),2014,Building Trade Unions,0,56000,56000
D000399,N00006023,Lloyd Doggett (D),2014,Real Estate,18350,22500,40850
D000399,N00006023,Lloyd Doggett (D),2014,Industrial Unions,0,39000,39000
D000399,N00006023,Lloyd Doggett (D),2014,Public Sector Unions,0,32000,32000
D000399,N00006023,Lloyd Doggett (D),2014,Transportation Unions,0,31000,31000
D000399,N00006023,Lloyd Doggett (D),2014,Securities & Investment,17650,2500,20150
D000399,N00006023,Lloyd Doggett (D),2014,Education,18050,0,18050
D000197,N00006134,Diana DeGette (D),2014,Pharmaceuticals/Health Products,1500,111449,112949
D000197,N00006134,Diana DeGette (D),2014,Health Professionals,4250,101500,105750
D000197,N00006134,Diana DeGette (D),2014,Democratic/Liberal,84450,0,84450
D000197,N00006134,Diana DeGette (D),2014,Lawyers/Law Firms,30646,27500,58146
D000197,N00006134,Diana DeGette (D),2014,Telecom Services,0,46000,46000
D000197,N00006134,Diana DeGette (D),2014,Retired,40150,0,40150
D000197,N00006134,Diana DeGette (D),2014,Telephone Utilities,500,30500,31000
D000197,N00006134,Diana DeGette (D),2014,Building Trade Unions,0,27500,27500
D000197,N00006134,Diana DeGette (D),2014,Public Sector Unions,0,25750,25750
D000197,N00006134,Diana DeGette (D),2014,TV/Movies/Music,5750,18000,23750
B001261,N00006236,John A Barrasso (R),2014,Health Professionals,322643,228750,551393
B001261,N00006236,John A Barrasso (R),2014,Oil & Gas,180266,228900,409166
B001261,N00006236,John A Barrasso (R),2014,Pharmaceuticals/Health Products,63250,191000,254250
B001261,N00006236,John A Barrasso (R),2014,Securities & Investment,180600,72071,252671
B001261,N00006236,John A Barrasso (R),2014,Mining,160706,78000,238706
B001261,N00006236,John A Barrasso (R),2014,Electric Utilities,13750,220000,233750
B001261,N00006236,John A Barrasso (R),2014,Lobbyists,223758,6500,230258
B001261,N00006236,John A Barrasso (R),2014,Leadership PACs,0,220336,220336
B001261,N00006236,John A Barrasso (R),2014,Insurance,41000,125375,166375
B001261,N00006236,John A Barrasso (R),2014,Retired,102399,0,102399
E000285,N00006249,Mike Enzi (R),2014,Leadership PACs,0,300572,300572
E000285,N00006249,Mike Enzi (R),2014,Pharmaceuticals/Health Products,29350,244750,274100
E000285,N00006249,Mike Enzi (R),2014,Health Professionals,30950,206000,236950
E000285,N00006249,Mike Enzi (R),2014,Oil & Gas,43450,154833,198283
E000285,N00006249,Mike Enzi (R),2014,Securities & Investment,93200,101394,194594
E000285,N00006249,Mike Enzi (R),2014,Insurance,28500,150500,179000
E000285,N00006249,Mike Enzi (R),2014,Retail Sales,3850,107000,110850
E000285,N00006249,Mike Enzi (R),2014,Real Estate,34550,60000,94550
E000285,N00006249,Mike Enzi (R),2014,Health Services/HMOs,32200,59500,91700
E000285,N00006249,Mike Enzi (R),2014,Lobbyists,90642,500,91142
C000880,N00006267,Mike Crapo (R),2014,Securities & Investment,185765,274750,460515
C000880,N00006267,Mike Crapo (R),2014,Insurance,56200,342500,398700
C000880,N00006267,Mike Crapo (R),2014,Leadership PACs,0,320984,320984
C000880,N00006267,Mike Crapo (R),2014,Lobbyists,189650,8500,198150
C000880,N00006267,Mike Crapo (R),2014,Finance/Credit Companies,43600,117700,161300
C000880,N00006267,Mike Crapo (R),2014,Real Estate,61525,98010,159535
C000880,N00006267,Mike Crapo (R),2014,Pharmaceuticals/Health Products,23200,134371,157571
C000880,N00006267,Mike Crapo (R),2014,Commercial Banks,28750,119500,148250
C000880,N00006267,Mike Crapo (R),2014,Health Services/HMOs,65550,73350,138900
C000880,N00006267,Mike Crapo (R),2014,Health Professionals,17894,104500,122394
F000448,N00006423,Trent Franks (R),2014,Defense Aerospace,750,35600,36350
F000448,N00006423,Trent Franks (R),2014,Telecom Services,2750,22600,25350
F000448,N00006423,Trent Franks (R),2014,Real Estate,16650,4000,20650
F000448,N00006423,Trent Franks (R),2014,Pro-Israel,11450,7100,18550
F000448,N00006423,Trent Franks (R),2014,Health Professionals,3000,15500,18500
F000448,N00006423,Trent Franks (R),2014,Defense Electronics,0,16000,16000
F000448,N00006423,Trent Franks (R),2014,Republican/Conservative,6750,8000,14750
F000448,N00006423,Trent Franks (R),2014,Retired,13850,0,13850
F000448,N00006423,Trent Franks (R),2014,Lawyers/Law Firms,10750,2500,13250
F000448,N00006423,Trent Franks (R),2014,Retail Sales,7850,5000,12850
B000711,N00006692,Barbara Boxer (D),2014,Lawyers/Law Firms,1550441,110072,1660513
B000711,N00006692,Barbara Boxer (D),2014,Retired,1284320,0,1284320
B000711,N00006692,Barbara Boxer (D),2014,Women's Issues,1048926,23895,1072821
B000711,N00006692,Barbara Boxer (D),2014,TV/Movies/Music,652627,49300,701927
B000711,N00006692,Barbara Boxer (D),2014,Real Estate,442405,19681,462086
B000711,N00006692,Barbara Boxer (D),2014,Securities & Investment,407074,21300,428374
B000711,N00006692,Barbara Boxer (D),2014,Education,409914,1000,410914
B000711,N00006692,Barbara Boxer (D),2014,Health Professionals,336935,62650,399585
B000711,N00006692,Barbara Boxer (D),2014,Business Services,372550,6000,378550
B000711,N00006692,Barbara Boxer (D),2014,Electronics Mfg & Equip,267671,64883,332554
H001063,N00006806,Janice Hahn (D),2014,Transportation Unions,0,92000,92000
H001063,N00006806,Janice Hahn (D),2014,Air Transport,0,49000,49000
H001063,N00006806,Janice Hahn (D),2014,Building Trade Unions,0,38500,38500
H001063,N00006806,Janice Hahn (D),2014,Lawyers/Law Firms,13500,21000,34500
H001063,N00006806,Janice Hahn (D),2014,Public Sector Unions,0,33000,33000
H001063,N00006806,Janice Hahn (D),2014,Sea Transport,8500,22500,31000
H001063,N00006806,Janice Hahn (D),2014,Railroads,0,29500,29500
H001063,N00006806,Janice Hahn (D),2014,Misc Unions,0,25750,25750
H001063,N00006806,Janice Hahn (D),2014,Lobbyists,23814,447,24261
H001063,N00006806,Janice Hahn (D),2014,Real Estate,9900,10000,19900
C000059,N00007099,Ken Calvert (R),2014,Casinos/Gambling,87450,0,87450
C000059,N00007099,Ken Calvert (R),2014,Lobbyists,59508,11988,71496
C000059,N00007099,Ken Calvert (R),2014,Defense Electronics,4500,46500,51000
C000059,N00007099,Ken Calvert (R),2014,Crop Production & Basic Processing,18200,25100,43300
C000059,N00007099,Ken Calvert (R),2014,Defense Aerospace,500,42000,42500
C000059,N00007099,Ken Calvert (R),2014,Electric Utilities,0,41500,41500
C000059,N00007099,Ken Calvert (R),2014,Building Materials & Equipment,23650,11500,35150
C000059,N00007099,Ken Calvert (R),2014,Real Estate,14550,20500,35050
C000059,N00007099,Ken Calvert (R),2014,Oil & Gas,1000,34000,35000
C000059,N00007099,Ken Calvert (R),2014,Construction Services,9375,24500,33875
C001036,N00007232,Lois Capps (D),2014,Health Professionals,43134,194100,237234
C001036,N00007232,Lois Capps (D),2014,Retired,204764,0,204764
C001036,N00007232,Lois Capps (D),2014,Leadership PACs,0,168300,168300
C001036,N00007232,Lois Capps (D),2014,Lawyers/Law Firms,56600,27750,84350
C001036,N00007232,Lois Capps (D),2014,Candidate Committees,0,79250,79250
C001036,N00007232,Lois Capps (D),2014,Women's Issues,72690,6250,78940
C001036,N00007232,Lois Capps (D),2014,Public Sector Unions,500,66120,66620
C001036,N00007232,Lois Capps (D),2014,Democratic/Liberal,51225,13850,65075
C001036,N00007232,Lois Capps (D),2014,Pharmaceuticals/Health Products,2250,51800,54050
C001036,N00007232,Lois Capps (D),2014,TV/Movies/Music,38900,13000,51900
F000030,N00007312,Sam Farr (D),2014,Crop Production & Basic Processing,42290,65100,107390
F000030,N00007312,Sam Farr (D),2014,Health Professionals,10250,41500,51750
F000030,N00007312,Sam Farr (D),2014,Retired,43451,0,43451
F000030,N00007312,Sam Farr (D),2014,Lodging/Tourism,1750,33500,35250
F000030,N00007312,Sam Farr (D),2014,Agricultural Services/Products,6444,25500,31944
F000030,N00007312,Sam Farr (D),2014,Public Sector Unions,0,30000,30000
F000030,N00007312,Sam Farr (D),2014,"Beer, Wine & Liquor",13476,9042,22518
F000030,N00007312,Sam Farr (D),2014,Building Trade Unions,0,22500,22500
F000030,N00007312,Sam Farr (D),2014,Lawyers/Law Firms,5250,15000,20250
F000030,N00007312,Sam Farr (D),2014,Environment,11800,8350,20150
E000215,N00007335,Anna Eshoo (D),2014,Pharmaceuticals/Health Products,35200,166409,201609
E000215,N00007335,Anna Eshoo (D),2014,Telecom Services,5000,99600,104600
E000215,N00007335,Anna Eshoo (D),2014,Electronics Mfg & Equip,43300,59733,103033
E000215,N00007335,Anna Eshoo (D),2014,Securities & Investment,82550,11000,93550
E000215,N00007335,Anna Eshoo (D),2014,Health Professionals,27000,66500,93500
E000215,N00007335,Anna Eshoo (D),2014,Retired,81800,0,81800
E000215,N00007335,Anna Eshoo (D),2014,Internet,36950,36000,72950
E000215,N00007335,Anna Eshoo (D),2014,Lawyers/Law Firms,33782,29000,62782
E000215,N00007335,Anna Eshoo (D),2014,Telephone Utilities,0,51000,51000
E000215,N00007335,Anna Eshoo (D),2014,Lobbyists,41343,6000,47343
F000062,N00007364,Dianne Feinstein (D),2014,Lawyers/Law Firms,436829,142500,579329
F000062,N00007364,Dianne Feinstein (D),2014,Retired,450058,0,450058
F000062,N00007364,Dianne Feinstein (D),2014,Crop Production & Basic Processing,262633,116499,379132
F000062,N00007364,Dianne Feinstein (D),2014,Securities & Investment,343057,26850,369907
F000062,N00007364,Dianne Feinstein (D),2014,Real Estate,325471,35000,360471
F000062,N00007364,Dianne Feinstein (D),2014,Lobbyists,315472,15874,331346
F000062,N00007364,Dianne Feinstein (D),2014,Electric Utilities,202800,91750,294550
F000062,N00007364,Dianne Feinstein (D),2014,TV/Movies/Music,197465,73400,270865
F000062,N00007364,Dianne Feinstein (D),2014,Women's Issues,201449,11000,212449
F000062,N00007364,Dianne Feinstein (D),2014,Electronics Mfg & Equip,87250,109789,197039
F000010,N00007632,Eni F H Faleomavaega (D),2014,Food & Beverage,6500,0,6500
F000010,N00007632,Eni F H Faleomavaega (D),2014,Transportation Unions,0,5000,5000
F000010,N00007632,Eni F H Faleomavaega (D),2014,Lawyers/Law Firms,3000,1500,4500
F000010,N00007632,Eni F H Faleomavaega (D),2014,Civil Servants/Public Officials,3000,0,3000
F000010,N00007632,Eni F H Faleomavaega (D),2014,Misc Finance,2600,0,2600
F000010,N00007632,Eni F H Faleomavaega (D),2014,Sea Transport,2500,0,2500
F000010,N00007632,Eni F H Faleomavaega (D),2014,Hospitals/Nursing Homes,2000,0,2000
F000010,N00007632,Eni F H Faleomavaega (D),2014,Health Professionals,1000,0,1000
B000574,N00007727,Earl Blumenauer (D),2014,Health Professionals,500,104750,105250
B000574,N00007727,Earl Blumenauer (D),2014,Construction Services,20500,53000,73500
B000574,N00007727,Earl Blumenauer (D),2014,Railroads,11350,53600,64950
B000574,N00007727,Earl Blumenauer (D),2014,Transportation Unions,0,58500,58500
B000574,N00007727,Earl Blumenauer (D),2014,Insurance,6525,50500,57025
B000574,N00007727,Earl Blumenauer (D),2014,Misc Manufacturing & Distributing,27375,27500,54875
B000574,N00007727,Earl Blumenauer (D),2014,Public Sector Unions,0,50125,50125
B000574,N00007727,Earl Blumenauer (D),2014,Real Estate,15600,27500,43100
B000574,N00007727,Earl Blumenauer (D),2014,Lobbyists,39500,2231,41731
B000574,N00007727,Earl Blumenauer (D),2014,Building Trade Unions,0,38500,38500
D000191,N00007781,Peter DeFazio (D),2014,Air Transport,9750,70000,79750
D000191,N00007781,Peter DeFazio (D),2014,Transportation Unions,0,79000,79000
D000191,N00007781,Peter DeFazio (D),2014,Casinos/Gambling,58800,0,58800
D000191,N00007781,Peter DeFazio (D),2014,Building Materials & Equipment,10700,41500,52200
D000191,N00007781,Peter DeFazio (D),2014,Railroads,5950,44000,49950
D000191,N00007781,Peter DeFazio (D),2014,Building Trade Unions,0,47000,47000
D000191,N00007781,Peter DeFazio (D),2014,Retired,46965,0,46965
D000191,N00007781,Peter DeFazio (D),2014,Public Sector Unions,0,40500,40500
D000191,N00007781,Peter DeFazio (D),2014,Lobbyists,30250,4500,34750
D000191,N00007781,Peter DeFazio (D),2014,Lawyers/Law Firms,12487,21888,34375
C000127,N00007836,Maria Cantwell (D),2014,Lawyers/Law Firms,759909,10500,770409
C000127,N00007836,Maria Cantwell (D),2014,Retired,696466,0,696466
C000127,N00007836,Maria Cantwell (D),2014,Lobbyists,580332,250,580582
C000127,N00007836,Maria Cantwell (D),2014,Securities & Investment,354237,0,354237
C000127,N00007836,Maria Cantwell (D),2014,Casinos/Gambling,260950,0,260950
C000127,N00007836,Maria Cantwell (D),2014,Real Estate,236685,2500,239185
C000127,N00007836,Maria Cantwell (D),2014,Electronics Mfg & Equip,192949,3512,196461
C000127,N00007836,Maria Cantwell (D),2014,Business Services,196027,0,196027
C000127,N00007836,Maria Cantwell (D),2014,Health Professionals,182862,6750,189612
C000127,N00007836,Maria Cantwell (D),2014,Electric Utilities,131539,3750,135289
C000071,N00008086,Dave Camp (R),2014,Insurance,28650,136460,165110
C000071,N00008086,Dave Camp (R),2014,Health Professionals,8000,149000,157000
C000071,N00008086,Dave Camp (R),2014,Hospitals/Nursing Homes,35750,85000,120750
C000071,N00008086,Dave Camp (R),2014,Pharmaceuticals/Health Products,0,115500,115500
C000071,N00008086,Dave Camp (R),2014,Health Services/HMOs,9950,86000,95950
C000071,N00008086,Dave Camp (R),2014,Oil & Gas,8500,82499,90999
C000071,N00008086,Dave Camp (R),2014,Securities & Investment,16500,71500,88000
C000071,N00008086,Dave Camp (R),2014,Lobbyists,80300,0,80300
C000071,N00008086,Dave Camp (R),2014,Misc Manufacturing & Distributing,15700,56000,71700
C000071,N00008086,Dave Camp (R),2014,Misc Issues,67250,0,67250
B000013,N00008091,Spencer Bachus (R),2014,Real Estate,500,23500,24000
B000013,N00008091,Spencer Bachus (R),2014,Insurance,0,23500,23500
B000013,N00008091,Spencer Bachus (R),2014,Accountants,0,23000,23000
B000013,N00008091,Spencer Bachus (R),2014,Commercial Banks,1000,20500,21500
B000013,N00008091,Spencer Bachus (R),2014,Securities & Investment,1000,20500,21500
B000013,N00008091,Spencer Bachus (R),2014,Railroads,0,21000,21000
B000013,N00008091,Spencer Bachus (R),2014,Lawyers/Law Firms,1500,18500,20000
B000013,N00008091,Spencer Bachus (R),2014,Finance/Credit Companies,2500,11000,13500
B000013,N00008091,Spencer Bachus (R),2014,Retail Sales,0,13000,13000
B000013,N00008091,Spencer Bachus (R),2014,Lobbyists,10250,0,10250
G000377,N00008799,Kay Granger (R),2014,Defense Aerospace,63350,59500,122850
G000377,N00008799,Kay Granger (R),2014,Real Estate,63750,23000,86750
G000377,N00008799,Kay Granger (R),2014,Oil & Gas,72700,11000,83700
G000377,N00008799,Kay Granger (R),2014,Retired,70150,0,70150
G000377,N00008799,Kay Granger (R),2014,Lawyers/Law Firms,28194,28000,56194
G000377,N00008799,Kay Granger (R),2014,Misc Manufacturing & Distributing,27150,19500,46650
G000377,N00008799,Kay Granger (R),2014,Defense Electronics,500,46000,46500
G000377,N00008799,Kay Granger (R),2014,Securities & Investment,35300,11000,46300
G000377,N00008799,Kay Granger (R),2014,Lobbyists,31599,3500,35099
G000377,N00008799,Kay Granger (R),2014,Air Transport,1000,33500,34500
G000289,N00009154,Bob Goodlatte (R),2014,TV/Movies/Music,105105,59504,164609
G000289,N00009154,Bob Goodlatte (R),2014,Lawyers/Law Firms,66200,60807,127007
G000289,N00009154,Bob Goodlatte (R),2014,Electronics Mfg & Equip,50800,75536,126336
G000289,N00009154,Bob Goodlatte (R),2014,Telecom Services,41700,77000,118700
G000289,N00009154,Bob Goodlatte (R),2014,Lobbyists,92649,2000,94649
G000289,N00009154,Bob Goodlatte (R),2014,Retired,72000,0,72000
G000289,N00009154,Bob Goodlatte (R),2014,Retail Sales,12200,59500,71700
G000289,N00009154,Bob Goodlatte (R),2014,Internet,20900,42300,63200
G000289,N00009154,Bob Goodlatte (R),2014,Food Processing & Sales,8250,46500,54750
G000289,N00009154,Bob Goodlatte (R),2014,Securities & Investment,25400,28000,53400
H000329,N00009157,Doc Hastings (R),2014,Oil & Gas,1500,53500,55000
H000329,N00009157,Doc Hastings (R),2014,Casinos/Gambling,28900,0,28900
H000329,N00009157,Doc Hastings (R),2014,Forestry & Forest Products,10750,12750,23500
H000329,N00009157,Doc Hastings (R),2014,Crop Production & Basic Processing,14350,8000,22350
H000329,N00009157,Doc Hastings (R),2014,Retired,20058,0,20058
H000329,N00009157,Doc Hastings (R),2014,Electronics Mfg & Equip,500,19500,20000
H000329,N00009157,Doc Hastings (R),2014,Lawyers/Law Firms,4500,12500,17000
H000329,N00009157,Doc Hastings (R),2014,Mining,3800,8000,11800
H000329,N00009157,Doc Hastings (R),2014,General Contractors,6750,4500,11250
H000329,N00009157,Doc Hastings (R),2014,Electric Utilities,1000,10100,11100
F000444,N00009573,Jeff Flake (R),2014,Republican/Conservative,1261837,61567,1323404
F000444,N00009573,Jeff Flake (R),2014,Retired,646343,0,646343
F000444,N00009573,Jeff Flake (R),2014,Securities & Investment,330129,15000,345129
F000444,N00009573,Jeff Flake (R),2014,Real Estate,311947,20500,332447
F000444,N00009573,Jeff Flake (R),2014,Leadership PACs,0,328868,328868
F000444,N00009573,Jeff Flake (R),2014,Misc Finance,215022,2500,217522
F000444,N00009573,Jeff Flake (R),2014,Lawyers/Law Firms,168452,42250,210702
F000444,N00009573,Jeff Flake (R),2014,Mining,129602,54000,183602
F000444,N00009573,Jeff Flake (R),2014,Health Professionals,135057,46500,181557
F000444,N00009573,Jeff Flake (R),2014,Oil & Gas,70860,98500,169360
D000598,N00009604,Susan A Davis (D),2014,Retired,41700,0,41700
D000598,N00009604,Susan A Davis (D),2014,Public Sector Unions,0,35250,35250
D000598,N00009604,Susan A Davis (D),2014,Electronics Mfg & Equip,9200,26000,35200
D000598,N00009604,Susan A Davis (D),2014,Pharmaceuticals/Health Products,2850,24500,27350
D000598,N00009604,Susan A Davis (D),2014,Misc Defense,9250,18000,27250
D000598,N00009604,Susan A Davis (D),2014,Defense Aerospace,0,26000,26000
D000598,N00009604,Susan A Davis (D),2014,Real Estate,10300,9500,19800
D000598,N00009604,Susan A Davis (D),2014,Defense Electronics,0,17500,17500
D000598,N00009604,Susan A Davis (D),2014,Lawyers/Law Firms,6600,10500,17100
D000598,N00009604,Susan A Davis (D),2014,Building Trade Unions,0,17000,17000
C001048,N00009738,John Culberson (R),2014,Oil & Gas,24550,63500,88050
C001048,N00009738,John Culberson (R),2014,Retired,69250,0,69250
C001048,N00009738,John Culberson (R),2014,Real Estate,33350,16000,49350
C001048,N00009738,John Culberson (R),2014,Defense Aerospace,0,28000,28000
C001048,N00009738,John Culberson (R),2014,Misc Manufacturing & Distributing,11450,13500,24950
C001048,N00009738,John Culberson (R),2014,Lawyers/Law Firms,18300,6250,24550
C001048,N00009738,John Culberson (R),2014,Construction Services,13650,9000,22650
C001048,N00009738,John Culberson (R),2014,Air Transport,6100,16000,22100
C001048,N00009738,John Culberson (R),2014,Automotive,7600,14000,21600
C001048,N00009738,John Culberson (R),2014,Defense Electronics,0,18000,18000
C001047,N00009771,Shelley Moore Capito (R),2014,Securities & Investment,384415,51400,435815
C001047,N00009771,Shelley Moore Capito (R),2014,Retired,410186,0,410186
C001047,N00009771,Shelley Moore Capito (R),2014,Lawyers/Law Firms,291500,44513,336013
C001047,N00009771,Shelley Moore Capito (R),2014,Leadership PACs,0,330100,330100
C001047,N00009771,Shelley Moore Capito (R),2014,Mining,218874,83375,302249
C001047,N00009771,Shelley Moore Capito (R),2014,Oil & Gas,102866,162500,265366
C001047,N00009771,Shelley Moore Capito (R),2014,Commercial Banks,127175,125000,252175
C001047,N00009771,Shelley Moore Capito (R),2014,Insurance,77338,173600,250938
C001047,N00009771,Shelley Moore Capito (R),2014,Health Professionals,117566,104500,222066
C001047,N00009771,Shelley Moore Capito (R),2014,Real Estate,134178,51500,185678
B000287,N00009774,Xavier Becerra (D),2014,Health Professionals,29250,162500,191750
B000287,N00009774,Xavier Becerra (D),2014,Securities & Investment,44700,81500,126200
B000287,N00009774,Xavier Becerra (D),2014,Insurance,10200,102500,112700
B000287,N00009774,Xavier Becerra (D),2014,Lawyers/Law Firms,56910,41000,97910
B000287,N00009774,Xavier Becerra (D),2014,Real Estate,40950,44000,84950
B000287,N00009774,Xavier Becerra (D),2014,Pharmaceuticals/Health Products,5500,62000,67500
B000287,N00009774,Xavier Becerra (D),2014,Public Sector Unions,0,57500,57500
B000287,N00009774,Xavier Becerra (D),2014,Misc Issues,48500,5000,53500
B000287,N00009774,Xavier Becerra (D),2014,TV/Movies/Music,13700,38000,51700
B000287,N00009774,Xavier Becerra (D),2014,Casinos/Gambling,48700,0,48700
H000338,N00009869,Orrin G Hatch (R),2014,Securities & Investment,1023375,215571,1238946
H000338,N00009869,Orrin G Hatch (R),2014,Pharmaceuticals/Health Products,282060,582941,865001
H000338,N00009869,Orrin G Hatch (R),2014,Insurance,142514,373674,516188
H000338,N00009869,Orrin G Hatch (R),2014,Lobbyists,492657,14154,506811
H000338,N00009869,Orrin G Hatch (R),2014,Lawyers/Law Firms,262975,222131,485106
H000338,N00009869,Orrin G Hatch (R),2014,Health Professionals,95465,359700,455165
H000338,N00009869,Orrin G Hatch (R),2014,Real Estate,325792,105900,431692
H000338,N00009869,Orrin G Hatch (R),2014,Oil & Gas,175650,236000,411650
H000338,N00009869,Orrin G Hatch (R),2014,Health Services/HMOs,161382,238500,399882
H000338,N00009869,Orrin G Hatch (R),2014,Leadership PACs,0,397378,397378
A000360,N00009888,Lamar Alexander (R),2014,Leadership PACs,0,307215,307215
A000360,N00009888,Lamar Alexander (R),2014,Pharmaceuticals/Health Products,32450,258100,290550
A000360,N00009888,Lamar Alexander (R),2014,Real Estate,218250,37000,255250
A000360,N00009888,Lamar Alexander (R),2014,Health Professionals,59150,193000,252150
A000360,N00009888,Lamar Alexander (R),2014,Securities & Investment,159150,89500,248650
A000360,N00009888,Lamar Alexander (R),2014,Retired,248065,0,248065
A000360,N00009888,Lamar Alexander (R),2014,Lawyers/Law Firms,125739,107488,233227
A000360,N00009888,Lamar Alexander (R),2014,Insurance,59600,150000,209600
A000360,N00009888,Lamar Alexander (R),2014,Hospitals/Nursing Homes,85000,109267,194267
A000360,N00009888,Lamar Alexander (R),2014,Education,112188,56400,168588
G000359,N00009975,Lindsey Graham (R),2014,Lawyers/Law Firms,955717,88250,1043967
G000359,N00009975,Lindsey Graham (R),2014,Securities & Investment,877001,48982,925983
G000359,N00009975,Lindsey Graham (R),2014,Retired,631405,0,631405
G000359,N00009975,Lindsey Graham (R),2014,Real Estate,506666,31750,538416
G000359,N00009975,Lindsey Graham (R),2014,Electric Utilities,158506,153250,311756
G000359,N00009975,Lindsey Graham (R),2014,Leadership PACs,0,305500,305500
G000359,N00009975,Lindsey Graham (R),2014,Pro-Israel,223150,61200,284350
G000359,N00009975,Lindsey Graham (R),2014,Health Professionals,186675,33000,219675
G000359,N00009975,Lindsey Graham (R),2014,Business Services,209310,8000,217310
G000359,N00009975,Lindsey Graham (R),2014,Lobbyists,205346,9500,214846
C001049,N00012460,William L Clay Jr (D),2014,Public Sector Unions,0,40500,40500
C001049,N00012460,William L Clay Jr (D),2014,Industrial Unions,0,35500,35500
C001049,N00012460,William L Clay Jr (D),2014,Lawyers/Law Firms,13330,17000,30330
C001049,N00012460,William L Clay Jr (D),2014,Insurance,0,30000,30000
C001049,N00012460,William L Clay Jr (D),2014,Real Estate,2000,27500,29500
C001049,N00012460,William L Clay Jr (D),2014,Building Trade Unions,0,29000,29000
C001049,N00012460,William L Clay Jr (D),2014,Securities & Investment,2000,21500,23500
C001049,N00012460,William L Clay Jr (D),2014,Health Professionals,5750,13500,19250
C001049,N00012460,William L Clay Jr (D),2014,Automotive,0,16500,16500
C001049,N00012460,William L Clay Jr (D),2014,Finance/Credit Companies,0,16000,16000
C001049,N00012460,William L Clay Jr (D),2014,Transportation Unions,0,16000,16000
C000174,N00012508,Tom Carper (D),2014,Insurance,106920,295740,402660
C000174,N00012508,Tom Carper (D),2014,Securities & Investment,137690,210500,348190
C000174,N00012508,Tom Carper (D),2014,Lawyers/Law Firms,184095,124621,308716
C000174,N00012508,Tom Carper (D),2014,Lobbyists,213812,9220,223032
C000174,N00012508,Tom Carper (D),2014,Pharmaceuticals/Health Products,50950,166410,217360
C000174,N00012508,Tom Carper (D),2014,Commercial Banks,76920,103490,180410
C000174,N00012508,Tom Carper (D),2014,Chemical & Related Manufacturing,58287,111060,169347
C000174,N00012508,Tom Carper (D),2014,Health Professionals,24950,138820,163770
C000174,N00012508,Tom Carper (D),2014,Leadership PACs,0,162500,162500
C000174,N00012508,Tom Carper (D),2014,Retired,133470,0,133470
H001034,N00012611,Mike Honda (D),2014,Retired,257802,0,257802
H001034,N00012611,Mike Honda (D),2014,Lawyers/Law Firms,138200,14950,153150
H001034,N00012611,Mike Honda (D),2014,Electronics Mfg & Equip,79950,50340,130290
H001034,N00012611,Mike Honda (D),2014,Leadership PACs,0,124100,124100
H001034,N00012611,Mike Honda (D),2014,Real Estate,110608,11000,121608
H001034,N00012611,Mike Honda (D),2014,Health Professionals,71160,42750,113910
H001034,N00012611,Mike Honda (D),2014,Human Rights,50351,41942,92293
H001034,N00012611,Mike Honda (D),2014,Public Sector Unions,1050,81500,82550
H001034,N00012611,Mike Honda (D),2014,Education,68140,0,68140
H001034,N00012611,Mike Honda (D),2014,Securities & Investment,66100,0,66100
C001045,N00012739,Ander Crenshaw (R),2014,Defense Aerospace,33200,55500,88700
C001045,N00012739,Ander Crenshaw (R),2014,Defense Electronics,10100,68000,78100
C001045,N00012739,Ander Crenshaw (R),2014,Securities & Investment,14000,51500,65500
C001045,N00012739,Ander Crenshaw (R),2014,Insurance,7450,56000,63450
C001045,N00012739,Ander Crenshaw (R),2014,Lobbyists,56400,2070,58470
C001045,N00012739,Ander Crenshaw (R),2014,Real Estate,31700,21500,53200
C001045,N00012739,Ander Crenshaw (R),2014,Commercial Banks,750,48500,49250
C001045,N00012739,Ander Crenshaw (R),2014,Misc Defense,13600,29418,43018
C001045,N00012739,Ander Crenshaw (R),2014,Lawyers/Law Firms,8200,32250,40450
C001045,N00012739,Ander Crenshaw (R),2014,Misc Manufacturing & Distributing,2500,34100,36600
C001046,N00013131,Eric Cantor (R),2014,Securities & Investment,573725,73197,646922
C001046,N00013131,Eric Cantor (R),2014,Real Estate,355651,53000,408651
C001046,N00013131,Eric Cantor (R),2014,Insurance,80241,161900,242141
C001046,N00013131,Eric Cantor (R),2014,Leadership PACs,0,213397,213397
C001046,N00013131,Eric Cantor (R),2014,Lawyers/Law Firms,159131,52250,211381
C001046,N00013131,Eric Cantor (R),2014,Retired,203826,0,203826
C001046,N00013131,Eric Cantor (R),2014,Pro-Israel,174156,21625,195781
C001046,N00013131,Eric Cantor (R),2014,Health Professionals,45370,149525,194895
C001046,N00013131,Eric Cantor (R),2014,Lobbyists,162625,9500,172125
C001046,N00013131,Eric Cantor (R),2014,Oil & Gas,29065,118600,147665
G000546,N00013323,Sam Graves (R),2014,Air Transport,4850,99750,104600
G000546,N00013323,Sam Graves (R),2014,Trucking,6100,73000,79100
G000546,N00013323,Sam Graves (R),2014,Crop Production & Basic Processing,3550,49500,53050
G000546,N00013323,Sam Graves (R),2014,Agricultural Services/Products,7700,38500,46200
G000546,N00013323,Sam Graves (R),2014,Public Sector Unions,0,42500,42500
G000546,N00013323,Sam Graves (R),2014,Railroads,0,42000,42000
G000546,N00013323,Sam Graves (R),2014,Transportation Unions,0,40500,40500
G000546,N00013323,Sam Graves (R),2014,Building Materials & Equipment,5200,32500,37700
G000546,N00013323,Sam Graves (R),2014,Construction Services,750,32500,33250
G000546,N00013323,Sam Graves (R),2014,Automotive,3500,29500,33000
F000445,N00013799,Randy Forbes (R),2014,Retired,85220,0,85220
F000445,N00013799,Randy Forbes (R),2014,Misc Defense,40006,39500,79506
F000445,N00013799,Randy Forbes (R),2014,Real Estate,62375,8000,70375
F000445,N00013799,Randy Forbes (R),2014,Defense Aerospace,3000,61000,64000
F000445,N00013799,Randy Forbes (R),2014,Defense Electronics,7700,52000,59700
F000445,N00013799,Randy Forbes (R),2014,Lawyers/Law Firms,41953,2000,43953
F000445,N00013799,Randy Forbes (R),2014,General Contractors,31450,5000,36450
F000445,N00013799,Randy Forbes (R),2014,Health Professionals,30701,4500,35201
F000445,N00013799,Randy Forbes (R),2014,Electronics Mfg & Equip,18400,12680,31080
F000445,N00013799,Randy Forbes (R),2014,Commercial Banks,12650,18000,30650
B001236,N00013873,John Boozman (R),2014,Retired,317326,0,317326
B001236,N00013873,John Boozman (R),2014,Health Professionals,219714,64000,283714
B001236,N00013873,John Boozman (R),2014,Leadership PACs,0,247536,247536
B001236,N00013873,John Boozman (R),2014,Securities & Investment,210729,20000,230729
B001236,N00013873,John Boozman (R),2014,Real Estate,94748,9500,104248
B001236,N00013873,John Boozman (R),2014,Retail Sales,77900,26000,103900
B001236,N00013873,John Boozman (R),2014,Oil & Gas,67502,30000,97502
B001236,N00013873,John Boozman (R),2014,Commercial Banks,65230,30500,95730
B001236,N00013873,John Boozman (R),2014,Lawyers/Law Firms,65541,26798,92339
B001236,N00013873,John Boozman (R),2014,Lobbyists,85443,918,86361
C001077,N00024753,Mike Coffman (R),2014,Retired,515142,0,515142
C001077,N00024753,Mike Coffman (R),2014,Leadership PACs,0,396930,396930
C001077,N00024753,Mike Coffman (R),2014,Oil & Gas,190650,116600,307250
C001077,N00024753,Mike Coffman (R),2014,Real Estate,227246,26000,253246
C001077,N00024753,Mike Coffman (R),2014,Securities & Investment,148872,16500,165372
C001077,N00024753,Mike Coffman (R),2014,Lawyers/Law Firms,127511,13680,141191
C001077,N00024753,Mike Coffman (R),2014,Health Professionals,34300,76500,110800
C001077,N00024753,Mike Coffman (R),2014,Candidate Committees,0,93619,93619
C001077,N00024753,Mike Coffman (R),2014,Republican/Conservative,66518,24600,91118
C001077,N00024753,Mike Coffman (R),2014,Commercial Banks,59882,23500,83382
G000550,N00024760,Phil Gingrey (R),2014,Health Professionals,331850,93500,425350
G000550,N00024760,Phil Gingrey (R),2014,Retired,173325,0,173325
G000550,N00024760,Phil Gingrey (R),2014,Real Estate,66158,4890,71048
G000550,N00024760,Phil Gingrey (R),2014,Lawyers/Law Firms,60374,5000,65374
G000550,N00024760,Phil Gingrey (R),2014,Insurance,40150,14000,54150
G000550,N00024760,Phil Gingrey (R),2014,Securities & Investment,52000,0,52000
G000550,N00024760,Phil Gingrey (R),2014,Hospitals/Nursing Homes,45310,2500,47810
G000550,N00024760,Phil Gingrey (R),2014,Pharmaceuticals/Health Products,7450,38200,45650
G000550,N00024760,Phil Gingrey (R),2014,Automotive,32200,6000,38200
G000550,N00024760,Phil Gingrey (R),2014,Special Trade Contractors,34252,1000,35252
C001069,N00024842,Joe Courtney (D),2014,Lawyers/Law Firms,71837,13000,84837
C001069,N00024842,Joe Courtney (D),2014,Health Professionals,13151,71250,84401
C001069,N00024842,Joe Courtney (D),2014,Building Trade Unions,0,64000,64000
C001069,N00024842,Joe Courtney (D),2014,Public Sector Unions,0,63500,63500
C001069,N00024842,Joe Courtney (D),2014,Defense Aerospace,500,61500,62000
C001069,N00024842,Joe Courtney (D),2014,Insurance,2350,53000,55350
C001069,N00024842,Joe Courtney (D),2014,Misc Defense,20400,32500,52900
C001069,N00024842,Joe Courtney (D),2014,Retired,48950,0,48950
C001069,N00024842,Joe Courtney (D),2014,Industrial Unions,0,48000,48000
C001069,N00024842,Joe Courtney (D),2014,Defense Electronics,7250,30500,37750
C001056,N00024852,John Cornyn (R),2014,Oil & Gas,971181,283900,1255081
C001056,N00024852,John Cornyn (R),2014,Securities & Investment,1024463,166500,1190963
C001056,N00024852,John Cornyn (R),2014,Health Professionals,627550,240546,868096
C001056,N00024852,John Cornyn (R),2014,Retired,720767,0,720767
C001056,N00024852,John Cornyn (R),2014,Lawyers/Law Firms,547132,172300,719432
C001056,N00024852,John Cornyn (R),2014,Real Estate,498424,90000,588424
C001056,N00024852,John Cornyn (R),2014,Insurance,218025,246353,464378
C001056,N00024852,John Cornyn (R),2014,Misc Finance,406245,32600,438845
C001056,N00024852,John Cornyn (R),2014,Commercial Banks,230590,109400,339990
C001056,N00024852,John Cornyn (R),2014,Leadership PACs,0,327358,327358
B001245,N00024866,Madeleine Z Bordallo (D),2014,Defense Aerospace,0,12000,12000
B001245,N00024866,Madeleine Z Bordallo (D),2014,Food Processing & Sales,9400,0,9400
B001245,N00024866,Madeleine Z Bordallo (D),2014,Retail Sales,8500,0,8500
B001245,N00024866,Madeleine Z Bordallo (D),2014,Lobbyists,7400,0,7400
B001245,N00024866,Madeleine Z Bordallo (D),2014,Sea Transport,1800,4000,5800
B001245,N00024866,Madeleine Z Bordallo (D),2014,Misc Defense,2500,2000,4500
B001245,N00024866,Madeleine Z Bordallo (D),2014,Candidate Committees,0,4000,4000
B001245,N00024866,Madeleine Z Bordallo (D),2014,Insurance,3250,0,3250
B001245,N00024866,Madeleine Z Bordallo (D),2014,Retired,3090,0,3090
B001245,N00024866,Madeleine Z Bordallo (D),2014,Securities & Investment,3000,0,3000
B001245,N00024866,Madeleine Z Bordallo (D),2014,Real Estate,1000,2000,3000
H001036,N00024922,Jeb Hensarling (R),2014,Insurance,65014,280000,345014
H001036,N00024922,Jeb Hensarling (R),2014,Securities & Investment,113204,199500,312704
H001036,N00024922,Jeb Hensarling (R),2014,Commercial Banks,104652,201200,305852
H001036,N00024922,Jeb Hensarling (R),2014,Real Estate,108700,105500,214200
H001036,N00024922,Jeb Hensarling (R),2014,Finance/Credit Companies,69650,118500,188150
H001036,N00024922,Jeb Hensarling (R),2014,Misc Finance,105267,69000,174267
H001036,N00024922,Jeb Hensarling (R),2014,Retired,98530,0,98530
H001036,N00024922,Jeb Hensarling (R),2014,Lawyers/Law Firms,45500,51000,96500
H001036,N00024922,Jeb Hensarling (R),2014,Oil & Gas,37400,43500,80900
H001036,N00024922,Jeb Hensarling (R),2014,Lobbyists,70299,7000,77299
C001063,N00024978,Henry Cuellar (D),2014,Oil & Gas,35800,89000,124800
C001063,N00024978,Henry Cuellar (D),2014,Health Professionals,32150,30500,62650
C001063,N00024978,Henry Cuellar (D),2014,Lawyers/Law Firms,34825,18625,53450
C001063,N00024978,Henry Cuellar (D),2014,Automotive,9200,39000,48200
C001063,N00024978,Henry Cuellar (D),2014,Construction Services,32300,14000,46300
C001063,N00024978,Henry Cuellar (D),2014,Crop Production & Basic Processing,7000,35850,42850
C001063,N00024978,Henry Cuellar (D),2014,"Beer, Wine & Liquor",20200,17500,37700
C001063,N00024978,Henry Cuellar (D),2014,Retail Sales,26158,11000,37158
C001063,N00024978,Henry Cuellar (D),2014,Defense Aerospace,1250,30000,31250
C001063,N00024978,Henry Cuellar (D),2014,Insurance,1500,25500,27000
G000549,N00025025,Jim Gerlach (R),2014,Insurance,7050,91500,98550
G000549,N00025025,Jim Gerlach (R),2014,Pharmaceuticals/Health Products,8950,77100,86050
G000549,N00025025,Jim Gerlach (R),2014,Health Professionals,3000,80500,83500
G000549,N00025025,Jim Gerlach (R),2014,Securities & Investment,26799,25000,51799
G000549,N00025025,Jim Gerlach (R),2014,Lawyers/Law Firms,25150,23700,48850
G000549,N00025025,Jim Gerlach (R),2014,Retired,30300,0,30300
G000549,N00025025,Jim Gerlach (R),2014,Real Estate,17300,13000,30300
G000549,N00025025,Jim Gerlach (R),2014,Electric Utilities,1250,24500,25750
G000549,N00025025,Jim Gerlach (R),2014,Oil & Gas,2500,21500,24000
G000549,N00025025,Jim Gerlach (R),2014,Health Services/HMOs,3950,20000,23950
C001051,N00025095,John Carter (R),2014,Defense Aerospace,0,50500,50500
C001051,N00025095,John Carter (R),2014,Real Estate,37600,9000,46600
C001051,N00025095,John Carter (R),2014,Oil & Gas,10600,36000,46600
C001051,N00025095,John Carter (R),2014,Lawyers/Law Firms,32100,13250,45350
C001051,N00025095,John Carter (R),2014,Air Transport,250,41000,41250
C001051,N00025095,John Carter (R),2014,Health Professionals,28965,12000,40965
C001051,N00025095,John Carter (R),2014,Commercial Banks,18000,15500,33500
C001051,N00025095,John Carter (R),2014,Lobbyists,32200,1000,33200
C001051,N00025095,John Carter (R),2014,Retired,28600,0,28600
C001051,N00025095,John Carter (R),2014,Construction Services,15200,12500,27700
B001248,N00025219,Michael Burgess (R),2014,Health Professionals,53396,322093,375489
B001248,N00025219,Michael Burgess (R),2014,Pharmaceuticals/Health Products,1500,122550,124050
B001248,N00025219,Michael Burgess (R),2014,Health Services/HMOs,10750,74500,85250
B001248,N00025219,Michael Burgess (R),2014,Oil & Gas,1650,63500,65150
B001248,N00025219,Michael Burgess (R),2014,Insurance,1750,38250,40000
B001248,N00025219,Michael Burgess (R),2014,Lawyers/Law Firms,6450,26000,32450
B001248,N00025219,Michael Burgess (R),2014,Electric Utilities,0,30000,30000
B001248,N00025219,Michael Burgess (R),2014,Lobbyists,23925,1000,24925
B001248,N00025219,Michael Burgess (R),2014,Hospitals/Nursing Homes,3050,19500,22550
B001248,N00025219,Michael Burgess (R),2014,Telecom Services,0,20000,20000
G000551,N00025284,Raul M Grijalva (D),2014,Public Sector Unions,0,47000,47000
G000551,N00025284,Raul M Grijalva (D),2014,Casinos/Gambling,41050,1000,42050
G000551,N00025284,Raul M Grijalva (D),2014,Transportation Unions,0,31500,31500
G000551,N00025284,Raul M Grijalva (D),2014,Industrial Unions,0,28000,28000
G000551,N00025284,Raul M Grijalva (D),2014,Misc Unions,0,27250,27250
G000551,N00025284,Raul M Grijalva (D),2014,Lawyers/Law Firms,17400,6000,23400
G000551,N00025284,Raul M Grijalva (D),2014,Crop Production & Basic Processing,11650,11000,22650
G000551,N00025284,Raul M Grijalva (D),2014,Lobbyists,20692,0,20692
G000551,N00025284,Raul M Grijalva (D),2014,Retired,20180,0,20180
G000551,N00025284,Raul M Grijalva (D),2014,Credit Unions,0,15000,15000
B001250,N00025292,Rob Bishop (R),2014,Oil & Gas,14500,95600,110100
B001250,N00025292,Rob Bishop (R),2014,Defense Aerospace,0,50500,50500
B001250,N00025292,Rob Bishop (R),2014,Casinos/Gambling,31800,0,31800
B001250,N00025292,Rob Bishop (R),2014,Defense Electronics,0,23000,23000
B001250,N00025292,Rob Bishop (R),2014,Lobbyists,20448,2500,22948
B001250,N00025292,Rob Bishop (R),2014,Lawyers/Law Firms,11850,8750,20600
B001250,N00025292,Rob Bishop (R),2014,Mining,250,17500,17750
B001250,N00025292,Rob Bishop (R),2014,Misc Defense,0,17500,17500
B001250,N00025292,Rob Bishop (R),2014,Real Estate,4100,10000,14100
B001250,N00025292,Rob Bishop (R),2014,Electric Utilities,0,14000,14000
B001244,N00025330,Jo Bonner (R),2014,Retired,10500,0,10500
B001244,N00025330,Jo Bonner (R),2014,Defense Aerospace,0,9000,9000
B001244,N00025330,Jo Bonner (R),2014,Lawyers/Law Firms,2700,4000,6700
B001244,N00025330,Jo Bonner (R),2014,Crop Production & Basic Processing,0,5500,5500
B001244,N00025330,Jo Bonner (R),2014,Air Transport,0,5000,5000
B001244,N00025330,Jo Bonner (R),2014,Misc Manufacturing & Distributing,500,3500,4000
B001244,N00025330,Jo Bonner (R),2014,Real Estate,3000,0,3000
B001244,N00025330,Jo Bonner (R),2014,Building Materials & Equipment,2500,0,2500
B001244,N00025330,Jo Bonner (R),2014,"Beer, Wine & Liquor",2500,0,2500
B001244,N00025330,Jo Bonner (R),2014,Candidate Committees,0,2000,2000
B001244,N00025330,Jo Bonner (R),2014,Telephone Utilities,0,2000,2000
B001244,N00025330,Jo Bonner (R),2014,Misc Defense,0,2000,2000
B001244,N00025330,Jo Bonner (R),2014,Defense Electronics,0,2000,2000
D000600,N00025337,Mario Diaz-Balart (R),2014,Real Estate,28923,24500,53423
D000600,N00025337,Mario Diaz-Balart (R),2014,Building Trade Unions,0,49500,49500
D000600,N00025337,Mario Diaz-Balart (R),2014,Transportation Unions,0,36500,36500
D000600,N00025337,Mario Diaz-Balart (R),2014,Pro-Israel,19950,16000,35950
D000600,N00025337,Mario Diaz-Balart (R),2014,Crop Production & Basic Processing,11350,24500,35850
D000600,N00025337,Mario Diaz-Balart (R),2014,Lobbyists,33000,0,33000
D000600,N00025337,Mario Diaz-Balart (R),2014,Lawyers/Law Firms,24250,7250,31500
D000600,N00025337,Mario Diaz-Balart (R),2014,Railroads,500,29000,29500
D000600,N00025337,Mario Diaz-Balart (R),2014,Air Transport,5200,24000,29200
D000600,N00025337,Mario Diaz-Balart (R),2014,Securities & Investment,25100,3500,28600
B001242,N00025413,Timothy H Bishop (D),2014,Leadership PACs,5700,232850,238550
B001242,N00025413,Timothy H Bishop (D),2014,Retired,136915,0,136915
B001242,N00025413,Timothy H Bishop (D),2014,Securities & Investment,100099,34000,134099
B001242,N00025413,Timothy H Bishop (D),2014,Transportation Unions,200,113500,113700
B001242,N00025413,Timothy H Bishop (D),2014,Public Sector Unions,250,96000,96250
B001242,N00025413,Timothy H Bishop (D),2014,Lawyers/Law Firms,72260,23750,96010
B001242,N00025413,Timothy H Bishop (D),2014,Candidate Committees,0,88000,88000
B001242,N00025413,Timothy H Bishop (D),2014,Health Professionals,31650,54000,85650
B001242,N00025413,Timothy H Bishop (D),2014,Education,79375,1000,80375
B001242,N00025413,Timothy H Bishop (D),2014,Building Trade Unions,0,69250,69250
A000361,N00025464,Rodney Alexander (R),2014,General Contractors,14000,2500,16500
A000361,N00025464,Rodney Alexander (R),2014,Crop Production & Basic Processing,12549,1000,13549
A000361,N00025464,Rodney Alexander (R),2014,Oil & Gas,6750,6500,13250
A000361,N00025464,Rodney Alexander (R),2014,Commercial Banks,9000,3500,12500
A000361,N00025464,Rodney Alexander (R),2014,Lawyers/Law Firms,8860,2500,11360
A000361,N00025464,Rodney Alexander (R),2014,Hospitals/Nursing Homes,5250,3500,8750
A000361,N00025464,Rodney Alexander (R),2014,Real Estate,7500,1000,8500
A000361,N00025464,Rodney Alexander (R),2014,Trucking,7500,1000,8500
A000361,N00025464,Rodney Alexander (R),2014,Automotive,5850,2500,8350
A000361,N00025464,Rodney Alexander (R),2014,Health Professionals,7250,1000,8250
B001269,N00025495,Lou Barletta (R),2014,Railroads,10000,79950,89950
B001269,N00025495,Lou Barletta (R),2014,Real Estate,70908,8000,78908
B001269,N00025495,Lou Barletta (R),2014,Building Materials & Equipment,11000,25750,36750
B001269,N00025495,Lou Barletta (R),2014,Transportation Unions,0,34000,34000
B001269,N00025495,Lou Barletta (R),2014,Air Transport,2200,31000,33200
B001269,N00025495,Lou Barletta (R),2014,Oil & Gas,1800,31000,32800
B001269,N00025495,Lou Barletta (R),2014,Construction Services,12900,18500,31400
B001269,N00025495,Lou Barletta (R),2014,Retired,30208,0,30208
B001269,N00025495,Lou Barletta (R),2014,Lawyers/Law Firms,21678,8250,29928
B001269,N00025495,Lou Barletta (R),2014,General Contractors,12275,16500,28775
C001053,N00025726,Tom Cole (R),2014,Human Rights,156025,2000,158025
C001053,N00025726,Tom Cole (R),2014,Oil & Gas,45500,74000,119500
C001053,N00025726,Tom Cole (R),2014,Lobbyists,53048,2000,55048
C001053,N00025726,Tom Cole (R),2014,Defense Aerospace,500,50000,50500
C001053,N00025726,Tom Cole (R),2014,Commercial Banks,33900,14500,48400
C001053,N00025726,Tom Cole (R),2014,Real Estate,16900,27000,43900
C001053,N00025726,Tom Cole (R),2014,Lawyers/Law Firms,25700,10750,36450
C001053,N00025726,Tom Cole (R),2014,Health Professionals,4850,28500,33350
C001053,N00025726,Tom Cole (R),2014,Defense Electronics,0,33000,33000
C001053,N00025726,Tom Cole (R),2014,Insurance,8600,24100,32700
H001050,N00025881,Colleen Hanabusa (D),2014,Retired,244621,0,244621
H001050,N00025881,Colleen Hanabusa (D),2014,Women's Issues,133845,14500,148345
H001050,N00025881,Colleen Hanabusa (D),2014,Lawyers/Law Firms,126351,7500,133851
H001050,N00025881,Colleen Hanabusa (D),2014,Real Estate,101863,2000,103863
H001050,N00025881,Colleen Hanabusa (D),2014,Pro-Israel,78068,25000,103068
H001050,N00025881,Colleen Hanabusa (D),2014,Securities & Investment,70536,0,70536
H001050,N00025881,Colleen Hanabusa (D),2014,Sea Transport,46850,16500,63350
H001050,N00025881,Colleen Hanabusa (D),2014,Health Professionals,52100,9500,61600
H001050,N00025881,Colleen Hanabusa (D),2014,Construction Services,45895,0,45895
H001050,N00025881,Colleen Hanabusa (D),2014,Education,45801,0,45801
C001062,N00026041,Mike Conaway (R),2014,Crop Production & Basic Processing,112350,173750,286100
C001062,N00026041,Mike Conaway (R),2014,Oil & Gas,177250,63000,240250
C001062,N00026041,Mike Conaway (R),2014,Agricultural Services/Products,2700,125132,127832
C001062,N00026041,Mike Conaway (R),2014,Securities & Investment,20450,80500,100950
C001062,N00026041,Mike Conaway (R),2014,Livestock,58600,29500,88100
C001062,N00026041,Mike Conaway (R),2014,Accountants,22750,45000,67750
C001062,N00026041,Mike Conaway (R),2014,Retired,59650,0,59650
C001062,N00026041,Mike Conaway (R),2014,Commercial Banks,18650,39000,57650
C001062,N00026041,Mike Conaway (R),2014,Lawyers/Law Firms,35750,17500,53250
C001062,N00026041,Mike Conaway (R),2014,Defense Aerospace,0,44000,44000
B001252,N00026080,John Barrow (D),2014,Lawyers/Law Firms,371330,46750,418080
B001252,N00026080,John Barrow (D),2014,Leadership PACs,9300,211700,221000
B001252,N00026080,John Barrow (D),2014,Health Professionals,34650,182500,217150
B001252,N00026080,John Barrow (D),2014,Pharmaceuticals/Health Products,1750,133500,135250
B001252,N00026080,John Barrow (D),2014,Oil & Gas,11150,120500,131650
B001252,N00026080,John Barrow (D),2014,Insurance,25650,102000,127650
B001252,N00026080,John Barrow (D),2014,Electric Utilities,11300,105500,116800
B001252,N00026080,John Barrow (D),2014,Retired,95998,0,95998
B001252,N00026080,John Barrow (D),2014,Real Estate,33555,50000,83555
B001252,N00026080,John Barrow (D),2014,Candidate Committees,0,80000,80000
G000552,N00026148,Louis B Gohmert Jr (R),2014,Retired,73400,0,73400
G000552,N00026148,Louis B Gohmert Jr (R),2014,Republican/Conservative,16750,31500,48250
G000552,N00026148,Louis B Gohmert Jr (R),2014,Oil & Gas,26500,17500,44000
G000552,N00026148,Louis B Gohmert Jr (R),2014,Health Professionals,37450,4000,41450
G000552,N00026148,Louis B Gohmert Jr (R),2014,Misc Finance,32950,0,32950
G000552,N00026148,Louis B Gohmert Jr (R),2014,Real Estate,26088,5000,31088
G000552,N00026148,Louis B Gohmert Jr (R),2014,Forestry & Forest Products,9350,11500,20850
G000552,N00026148,Louis B Gohmert Jr (R),2014,Commercial Banks,19250,1000,20250
G000552,N00026148,Louis B Gohmert Jr (R),2014,Construction Services,20000,0,20000
G000552,N00026148,Louis B Gohmert Jr (R),2014,Lawyers/Law Firms,13550,4000,17550
F000450,N00026166,Virginia Foxx (R),2014,Retired,131100,0,131100
F000450,N00026166,Virginia Foxx (R),2014,Education,87730,37500,125230
F000450,N00026166,Virginia Foxx (R),2014,Lawyers/Law Firms,16850,27051,43901
F000450,N00026166,Virginia Foxx (R),2014,Commercial Banks,9350,24000,33350
F000450,N00026166,Virginia Foxx (R),2014,Misc Manufacturing & Distributing,19900,13000,32900
F000450,N00026166,Virginia Foxx (R),2014,Food & Beverage,11700,20000,31700
F000450,N00026166,Virginia Foxx (R),2014,Insurance,5700,25000,30700
F000450,N00026166,Virginia Foxx (R),2014,Health Professionals,14250,16000,30250
F000450,N00026166,Virginia Foxx (R),2014,Lobbyists,25700,2500,28200
F000450,N00026166,Virginia Foxx (R),2014,Pharmaceuticals/Health Products,10500,15500,26000
D000604,N00026171,Charlie Dent (R),2014,Health Professionals,21800,109500,131300
D000604,N00026171,Charlie Dent (R),2014,Pharmaceuticals/Health Products,11300,86000,97300
D000604,N00026171,Charlie Dent (R),2014,Electric Utilities,35299,51500,86799
D000604,N00026171,Charlie Dent (R),2014,Chemical & Related Manufacturing,38900,43250,82150
D000604,N00026171,Charlie Dent (R),2014,Misc Issues,79500,0,79500
D000604,N00026171,Charlie Dent (R),2014,Retired,77016,0,77016
D000604,N00026171,Charlie Dent (R),2014,Lawyers/Law Firms,43300,20500,63800
D000604,N00026171,Charlie Dent (R),2014,Oil & Gas,11400,45250,56650
D000604,N00026171,Charlie Dent (R),2014,Insurance,22200,32100,54300
D000604,N00026171,Charlie Dent (R),2014,Misc Manufacturing & Distributing,27050,21999,49049
C001059,N00026341,Jim Costa (D),2014,Crop Production & Basic Processing,130900,94650,225550
C001059,N00026341,Jim Costa (D),2014,Oil & Gas,0,98499,98499
C001059,N00026341,Jim Costa (D),2014,Dairy,33350,30500,63850
C001059,N00026341,Jim Costa (D),2014,Real Estate,49605,9990,59595
C001059,N00026341,Jim Costa (D),2014,Agricultural Services/Products,4300,53500,57800
C001059,N00026341,Jim Costa (D),2014,Livestock,20650,26500,47150
C001059,N00026341,Jim Costa (D),2014,Lawyers/Law Firms,38400,7750,46150
C001059,N00026341,Jim Costa (D),2014,Health Professionals,33950,2000,35950
C001059,N00026341,Jim Costa (D),2014,Electric Utilities,6750,28750,35500
C001059,N00026341,Jim Costa (D),2014,Public Sector Unions,0,35500,35500
D000607,N00026586,Joe Donnelly (D),2014,Lawyers/Law Firms,719995,39500,759495
D000607,N00026586,Joe Donnelly (D),2014,Leadership PACs,2750,347750,350500
D000607,N00026586,Joe Donnelly (D),2014,Retired,294618,0,294618
D000607,N00026586,Joe Donnelly (D),2014,Securities & Investment,182005,50000,232005
D000607,N00026586,Joe Donnelly (D),2014,Lobbyists,150391,26000,176391
D000607,N00026586,Joe Donnelly (D),2014,Pharmaceuticals/Health Products,63612,97571,161183
D000607,N00026586,Joe Donnelly (D),2014,Real Estate,121118,30000,151118
D000607,N00026586,Joe Donnelly (D),2014,Education,139113,2500,141613
D000607,N00026586,Joe Donnelly (D),2014,Building Trade Unions,3690,107000,110690
D000607,N00026586,Joe Donnelly (D),2014,Health Professionals,87688,20000,107688
B001255,N00026595,Charles W Boustany Jr (R),2014,Oil & Gas,67450,168100,235550
B001255,N00026595,Charles W Boustany Jr (R),2014,Health Professionals,78450,147750,226200
B001255,N00026595,Charles W Boustany Jr (R),2014,Insurance,13707,130000,143707
B001255,N00026595,Charles W Boustany Jr (R),2014,Securities & Investment,25250,64500,89750
B001255,N00026595,Charles W Boustany Jr (R),2014,Pharmaceuticals/Health Products,500,85300,85800
B001255,N00026595,Charles W Boustany Jr (R),2014,Health Services/HMOs,7200,58890,66090
B001255,N00026595,Charles W Boustany Jr (R),2014,Lobbyists,61949,2123,64072
B001255,N00026595,Charles W Boustany Jr (R),2014,Crop Production & Basic Processing,24760,31000,55760
B001255,N00026595,Charles W Boustany Jr (R),2014,Real Estate,33150,18000,51150
B001255,N00026595,Charles W Boustany Jr (R),2014,Retired,48992,0,48992
F000449,N00026631,Jeff Fortenberry (R),2014,Health Professionals,37663,15000,52663
F000449,N00026631,Jeff Fortenberry (R),2014,Commercial Banks,11150,27750,38900
F000449,N00026631,Jeff Fortenberry (R),2014,Insurance,6850,31500,38350
F000449,N00026631,Jeff Fortenberry (R),2014,Crop Production & Basic Processing,8950,27500,36450
F000449,N00026631,Jeff Fortenberry (R),2014,Real Estate,21950,9500,31450
F000449,N00026631,Jeff Fortenberry (R),2014,Defense Aerospace,0,27500,27500
F000449,N00026631,Jeff Fortenberry (R),2014,Lawyers/Law Firms,14950,12500,27450
F000449,N00026631,Jeff Fortenberry (R),2014,Retired,24500,0,24500
F000449,N00026631,Jeff Fortenberry (R),2014,Securities & Investment,23350,1000,24350
F000449,N00026631,Jeff Fortenberry (R),2014,Agricultural Services/Products,4700,17000,21700
G000553,N00026686,Al Green (D),2014,Lawyers/Law Firms,92118,9500,101618
G000553,N00026686,Al Green (D),2014,Real Estate,20750,18500,39250
G000553,N00026686,Al Green (D),2014,Industrial Unions,0,27000,27000
G000553,N00026686,Al Green (D),2014,Building Trade Unions,0,25000,25000
G000553,N00026686,Al Green (D),2014,Commercial Banks,6775,17000,23775
G000553,N00026686,Al Green (D),2014,Transportation Unions,0,21500,21500
G000553,N00026686,Al Green (D),2014,Education,17500,0,17500
G000553,N00026686,Al Green (D),2014,Insurance,3850,7500,11350
G000553,N00026686,Al Green (D),2014,Public Sector Unions,0,11000,11000
G000553,N00026686,Al Green (D),2014,Oil & Gas,4000,5000,9000
C001061,N00026790,Emanuel Cleaver (D),2014,Lawyers/Law Firms,53150,36500,89650
C001061,N00026790,Emanuel Cleaver (D),2014,Building Trade Unions,250,55000,55250
C001061,N00026790,Emanuel Cleaver (D),2014,Insurance,0,52000,52000
C001061,N00026790,Emanuel Cleaver (D),2014,Public Sector Unions,0,49516,49516
C001061,N00026790,Emanuel Cleaver (D),2014,Industrial Unions,0,49000,49000
C001061,N00026790,Emanuel Cleaver (D),2014,Real Estate,9350,39500,48850
C001061,N00026790,Emanuel Cleaver (D),2014,Securities & Investment,1950,31500,33450
C001061,N00026790,Emanuel Cleaver (D),2014,Accountants,0,31500,31500
C001061,N00026790,Emanuel Cleaver (D),2014,Finance/Credit Companies,0,25500,25500
C001061,N00026790,Emanuel Cleaver (D),2014,Retired,25100,0,25100
C001067,N00026961,Yvette D Clarke (D),2014,Building Trade Unions,0,54350,54350
C001067,N00026961,Yvette D Clarke (D),2014,Public Sector Unions,0,34465,34465
C001067,N00026961,Yvette D Clarke (D),2014,Transportation Unions,0,26000,26000
C001067,N00026961,Yvette D Clarke (D),2014,Industrial Unions,0,19500,19500
C001067,N00026961,Yvette D Clarke (D),2014,Real Estate,14200,4000,18200
C001067,N00026961,Yvette D Clarke (D),2014,Defense Aerospace,0,18000,18000
C001067,N00026961,Yvette D Clarke (D),2014,Lawyers/Law Firms,8700,9250,17950
C001067,N00026961,Yvette D Clarke (D),2014,Health Professionals,12840,4500,17340
C001067,N00026961,Yvette D Clarke (D),2014,Food & Beverage,5500,11500,17000
C001067,N00026961,Yvette D Clarke (D),2014,Telecom Services,0,16000,16000
B001251,N00027035,G K Butterfield (D),2014,Pharmaceuticals/Health Products,2950,79500,82450
B001251,N00027035,G K Butterfield (D),2014,Health Professionals,6966,60000,66966
B001251,N00027035,G K Butterfield (D),2014,Telecom Services,5500,44000,49500
B001251,N00027035,G K Butterfield (D),2014,Lawyers/Law Firms,12900,25536,38436
B001251,N00027035,G K Butterfield (D),2014,Electric Utilities,3000,29250,32250
B001251,N00027035,G K Butterfield (D),2014,Telephone Utilities,250,30000,30250
B001251,N00027035,G K Butterfield (D),2014,Building Trade Unions,0,25000,25000
B001251,N00027035,G K Butterfield (D),2014,Automotive,1000,23500,24500
B001251,N00027035,G K Butterfield (D),2014,Insurance,5916,18000,23916
B001251,N00027035,G K Butterfield (D),2014,TV/Movies/Music,750,22004,22754
H001038,N00027060,Brian M Higgins (D),2014,Lawyers/Law Firms,79073,11000,90073
H001038,N00027060,Brian M Higgins (D),2014,Transportation Unions,0,46500,46500
H001038,N00027060,Brian M Higgins (D),2014,Building Trade Unions,0,42000,42000
H001038,N00027060,Brian M Higgins (D),2014,Industrial Unions,0,35500,35500
H001038,N00027060,Brian M Higgins (D),2014,Public Sector Unions,0,26000,26000
H001038,N00027060,Brian M Higgins (D),2014,Hospitals/Nursing Homes,21500,2250,23750
H001038,N00027060,Brian M Higgins (D),2014,Real Estate,14500,8000,22500
H001038,N00027060,Brian M Higgins (D),2014,Commercial Banks,12250,9500,21750
H001038,N00027060,Brian M Higgins (D),2014,Health Professionals,17100,3000,20100
H001038,N00027060,Brian M Higgins (D),2014,Misc Manufacturing & Distributing,4500,14000,18500
F000451,N00027229,Michael G Fitzpatrick (R),2014,Insurance,72592,115250,187842
F000451,N00027229,Michael G Fitzpatrick (R),2014,Securities & Investment,116394,56000,172394
F000451,N00027229,Michael G Fitzpatrick (R),2014,Leadership PACs,0,163135,163135
F000451,N00027229,Michael G Fitzpatrick (R),2014,Lawyers/Law Firms,106703,34300,141003
F000451,N00027229,Michael G Fitzpatrick (R),2014,Real Estate,68254,65240,133494
F000451,N00027229,Michael G Fitzpatrick (R),2014,Commercial Banks,20455,83500,103955
F000451,N00027229,Michael G Fitzpatrick (R),2014,Retired,86886,0,86886
F000451,N00027229,Michael G Fitzpatrick (R),2014,Health Professionals,24075,54000,78075
F000451,N00027229,Michael G Fitzpatrick (R),2014,Construction Services,62136,8600,70736
F000451,N00027229,Michael G Fitzpatrick (R),2014,Misc Issues,56000,6000,62000
C001071,N00027441,Bob Corker (R),2014,Securities & Investment,898114,212070,1110184
C001071,N00027441,Bob Corker (R),2014,Real Estate,544050,115600,659650
C001071,N00027441,Bob Corker (R),2014,Insurance,198383,297300,495683
C001071,N00027441,Bob Corker (R),2014,Retired,484394,0,484394
C001071,N00027441,Bob Corker (R),2014,Lawyers/Law Firms,375213,107500,482713
C001071,N00027441,Bob Corker (R),2014,Health Professionals,365329,90000,455329
C001071,N00027441,Bob Corker (R),2014,Misc Finance,389545,38500,428045
C001071,N00027441,Bob Corker (R),2014,Commercial Banks,254690,161300,415990
C001071,N00027441,Bob Corker (R),2014,Lobbyists,269950,8265,278215
C001071,N00027441,Bob Corker (R),2014,Oil & Gas,115627,139000,254627
B001257,N00027462,Gus Bilirakis (R),2014,Health Professionals,46529,127500,174029
B001257,N00027462,Gus Bilirakis (R),2014,Pharmaceuticals/Health Products,2000,62850,64850
B001257,N00027462,Gus Bilirakis (R),2014,Health Services/HMOs,3100,50600,53700
B001257,N00027462,Gus Bilirakis (R),2014,Real Estate,23297,19000,42297
B001257,N00027462,Gus Bilirakis (R),2014,Insurance,3150,38000,41150
B001257,N00027462,Gus Bilirakis (R),2014,Telecom Services,1250,36000,37250
B001257,N00027462,Gus Bilirakis (R),2014,Lobbyists,30485,2500,32985
B001257,N00027462,Gus Bilirakis (R),2014,Lodging/Tourism,1750,31000,32750
B001257,N00027462,Gus Bilirakis (R),2014,Oil & Gas,5000,27500,32500
B001257,N00027462,Gus Bilirakis (R),2014,Electric Utilities,0,28000,28000
B001259,N00027464,Bruce Braley (D),2014,Lawyers/Law Firms,1615522,45000,1660522
B001259,N00027464,Bruce Braley (D),2014,Leadership PACs,0,486100,486100
B001259,N00027464,Bruce Braley (D),2014,Health Professionals,92600,138500,231100
B001259,N00027464,Bruce Braley (D),2014,Retired,208557,0,208557
B001259,N00027464,Bruce Braley (D),2014,Environment,96094,37305,133399
B001259,N00027464,Bruce Braley (D),2014,Public Sector Unions,450,103500,103950
B001259,N00027464,Bruce Braley (D),2014,Pro-Israel,63860,30999,94859
B001259,N00027464,Bruce Braley (D),2014,Real Estate,76250,15000,91250
B001259,N00027464,Bruce Braley (D),2014,Democratic/Liberal,59138,28701,87839
B001259,N00027464,Bruce Braley (D),2014,Education,87037,0,87037
B001256,N00027493,Michele Bachmann (R),2014,Retired,85367,0,85367
B001256,N00027493,Michele Bachmann (R),2014,Misc Issues,12876,-200,12676
B001256,N00027493,Michele Bachmann (R),2014,Oil & Gas,11900,0,11900
B001256,N00027493,Michele Bachmann (R),2014,Real Estate,9452,1000,10452
B001256,N00027493,Michele Bachmann (R),2014,Misc Finance,7800,0,7800
B001256,N00027493,Michele Bachmann (R),2014,Leadership PACs,0,7500,7500
B001256,N00027493,Michele Bachmann (R),2014,General Contractors,7450,0,7450
B001256,N00027493,Michele Bachmann (R),2014,Food & Beverage,4251,0,4251
B001256,N00027493,Michele Bachmann (R),2014,Pro-Israel,3550,500,4050
B001256,N00027493,Michele Bachmann (R),2014,Agricultural Services/Products,3250,0,3250
C001070,N00027503,Bob Casey (D),2014,Lawyers/Law Firms,1901201,237008,2138209
C001070,N00027503,Bob Casey (D),2014,Securities & Investment,325962,131100,457062
C001070,N00027503,Bob Casey (D),2014,Pharmaceuticals/Health Products,121000,297979,418979
C001070,N00027503,Bob Casey (D),2014,Real Estate,351158,50500,401658
C001070,N00027503,Bob Casey (D),2014,Lobbyists,376170,8300,384470
C001070,N00027503,Bob Casey (D),2014,Health Professionals,212985,162250,375235
C001070,N00027503,Bob Casey (D),2014,Retired,362371,0,362371
C001070,N00027503,Bob Casey (D),2014,Insurance,149050,172750,321800
C001070,N00027503,Bob Casey (D),2014,Hospitals/Nursing Homes,197297,112250,309547
C001070,N00027503,Bob Casey (D),2014,Leadership PACs,1000,258364,259364
C001066,N00027514,Kathy Castor (D),2014,Health Professionals,9950,64000,73950
C001066,N00027514,Kathy Castor (D),2014,Lawyers/Law Firms,23450,17000,40450
C001066,N00027514,Kathy Castor (D),2014,Telecom Services,500,37500,38000
C001066,N00027514,Kathy Castor (D),2014,Insurance,9250,18000,27250
C001066,N00027514,Kathy Castor (D),2014,Hospitals/Nursing Homes,10000,14000,24000
C001066,N00027514,Kathy Castor (D),2014,Retired,20800,0,20800
C001066,N00027514,Kathy Castor (D),2014,Transportation Unions,0,20500,20500
C001066,N00027514,Kathy Castor (D),2014,Real Estate,11200,8000,19200
C001066,N00027514,Kathy Castor (D),2014,Building Trade Unions,500,15000,15500
C001066,N00027514,Kathy Castor (D),2014,Public Sector Unions,0,15500,15500
H001041,N00027522,Dean Heller (R),2014,Retired,526892,0,526892
H001041,N00027522,Dean Heller (R),2014,Securities & Investment,337865,113000,450865
H001041,N00027522,Dean Heller (R),2014,Leadership PACs,500,448092,448592
H001041,N00027522,Dean Heller (R),2014,Casinos/Gambling,234632,89000,323632
H001041,N00027522,Dean Heller (R),2014,Real Estate,259990,47500,307490
H001041,N00027522,Dean Heller (R),2014,Insurance,84405,215000,299405
H001041,N00027522,Dean Heller (R),2014,Mining,155275,104825,260100
H001041,N00027522,Dean Heller (R),2014,Health Professionals,132734,123000,255734
H001041,N00027522,Dean Heller (R),2014,Oil & Gas,106200,147750,253950
H001041,N00027522,Dean Heller (R),2014,Lobbyists,199512,10500,210012
C001064,N00027565,John Campbell (R),2014,Accountants,0,22500,22500
C001064,N00027565,John Campbell (R),2014,Securities & Investment,6800,15600,22400
C001064,N00027565,John Campbell (R),2014,Credit Unions,6150,10000,16150
C001064,N00027565,John Campbell (R),2014,Insurance,0,13500,13500
C001064,N00027565,John Campbell (R),2014,Real Estate,5000,8000,13000
C001064,N00027565,John Campbell (R),2014,Automotive,6200,5000,11200
C001064,N00027565,John Campbell (R),2014,Misc Finance,3200,3250,6450
C001064,N00027565,John Campbell (R),2014,Retired,6250,0,6250
C001064,N00027565,John Campbell (R),2014,Finance/Credit Companies,0,6000,6000
C001064,N00027565,John Campbell (R),2014,Commercial Banks,0,5000,5000
B001260,N00027626,Vernon Buchanan (R),2014,Health Professionals,174100,101218,275318
B001260,N00027626,Vernon Buchanan (R),2014,Retired,130275,0,130275
B001260,N00027626,Vernon Buchanan (R),2014,Real Estate,67000,20000,87000
B001260,N00027626,Vernon Buchanan (R),2014,Food & Beverage,42400,24000,66400
B001260,N00027626,Vernon Buchanan (R),2014,Insurance,2500,51000,53500
B001260,N00027626,Vernon Buchanan (R),2014,Health Services/HMOs,8550,41200,49750
B001260,N00027626,Vernon Buchanan (R),2014,Lobbyists,42000,1000,43000
B001260,N00027626,Vernon Buchanan (R),2014,Pharmaceuticals/Health Products,14150,28000,42150
B001260,N00027626,Vernon Buchanan (R),2014,Retail Sales,23150,15000,38150
B001260,N00027626,Vernon Buchanan (R),2014,Commercial Banks,2250,35500,37750
H001057,N00027649,Tim Huelskamp (R),2014,Oil & Gas,46750,19500,66250
H001057,N00027649,Tim Huelskamp (R),2014,Republican/Conservative,12300,25025,37325
H001057,N00027649,Tim Huelskamp (R),2014,Retired,30550,0,30550
H001057,N00027649,Tim Huelskamp (R),2014,Health Professionals,12550,17500,30050
H001057,N00027649,Tim Huelskamp (R),2014,Crop Production & Basic Processing,27525,2000,29525
H001057,N00027649,Tim Huelskamp (R),2014,Misc Manufacturing & Distributing,20900,0,20900
H001057,N00027649,Tim Huelskamp (R),2014,Leadership PACs,0,19500,19500
H001057,N00027649,Tim Huelskamp (R),2014,Commercial Banks,5300,12000,17300
H001057,N00027649,Tim Huelskamp (R),2014,Railroads,7800,9498,17298
H001057,N00027649,Tim Huelskamp (R),2014,Real Estate,11700,4500,16200
G000555,N00027658,Kirsten Gillibrand (D),2014,Lawyers/Law Firms,3998631,319942,4318573
G000555,N00027658,Kirsten Gillibrand (D),2014,Securities & Investment,2879148,315300,3194448
G000555,N00027658,Kirsten Gillibrand (D),2014,Real Estate,1262052,123000,1385052
G000555,N00027658,Kirsten Gillibrand (D),2014,Women's Issues,968246,27500,995746
G000555,N00027658,Kirsten Gillibrand (D),2014,Retired,963266,0,963266
G000555,N00027658,Kirsten Gillibrand (D),2014,Lobbyists,757472,33674,791146
G000555,N00027658,Kirsten Gillibrand (D),2014,TV/Movies/Music,694117,80500,774617
G000555,N00027658,Kirsten Gillibrand (D),2014,Business Services,618902,45400,664302
G000555,N00027658,Kirsten Gillibrand (D),2014,Misc Finance,601753,16600,618353
G000555,N00027658,Kirsten Gillibrand (D),2014,Insurance,292850,310416,603266
D000622,N00027860,Tammy Duckworth (D),2014,Lawyers/Law Firms,142567,21000,163567
D000622,N00027860,Tammy Duckworth (D),2014,Women's Issues,106125,3000,109125
D000622,N00027860,Tammy Duckworth (D),2014,Health Professionals,22250,78500,100750
D000622,N00027860,Tammy Duckworth (D),2014,Retired,87993,0,87993
D000622,N00027860,Tammy Duckworth (D),2014,Insurance,24506,53500,78006
D000622,N00027860,Tammy Duckworth (D),2014,Pro-Israel,69451,5200,74651
D000622,N00027860,Tammy Duckworth (D),2014,Securities & Investment,54200,18000,72200
D000622,N00027860,Tammy Duckworth (D),2014,Public Sector Unions,250,68000,68250
D000622,N00027860,Tammy Duckworth (D),2014,Building Trade Unions,500,65000,65500
D000622,N00027860,Tammy Duckworth (D),2014,Real Estate,48100,12500,60600
H001042,N00028139,Mazie K Hirono (D),2014,Lawyers/Law Firms,586619,44250,630869
H001042,N00028139,Mazie K Hirono (D),2014,Women's Issues,310272,29500,339772
H001042,N00028139,Mazie K Hirono (D),2014,Retired,209907,0,209907
H001042,N00028139,Mazie K Hirono (D),2014,Leadership PACs,1000,198000,199000
H001042,N00028139,Mazie K Hirono (D),2014,Real Estate,135098,14500,149598
H001042,N00028139,Mazie K Hirono (D),2014,Lobbyists,140894,6750,147644
H001042,N00028139,Mazie K Hirono (D),2014,Transportation Unions,1400,115500,116900
H001042,N00028139,Mazie K Hirono (D),2014,Sea Transport,66885,50000,116885
H001042,N00028139,Mazie K Hirono (D),2014,Public Sector Unions,300,112500,112800
H001042,N00028139,Mazie K Hirono (D),2014,Construction Services,73849,16500,90349
E000290,N00028249,Donna Edwards (D),2014,Public Sector Unions,0,57250,57250
E000290,N00028249,Donna Edwards (D),2014,Air Transport,2500,40500,43000
E000290,N00028249,Donna Edwards (D),2014,Transportation Unions,0,41000,41000
E000290,N00028249,Donna Edwards (D),2014,Building Trade Unions,0,35500,35500
E000290,N00028249,Donna Edwards (D),2014,Non-Profit Institutions,30950,0,30950
E000290,N00028249,Donna Edwards (D),2014,Industrial Unions,0,30000,30000
E000290,N00028249,Donna Edwards (D),2014,Lawyers/Law Firms,16000,12000,28000
E000290,N00028249,Donna Edwards (D),2014,Railroads,0,26500,26500
E000290,N00028249,Donna Edwards (D),2014,Misc Unions,250,18500,18750
E000290,N00028249,Donna Edwards (D),2014,Defense Electronics,0,16000,16000
E000288,N00028257,Keith Ellison (D),2014,Health Professionals,106812,7000,113812
E000288,N00028257,Keith Ellison (D),2014,Lawyers/Law Firms,47350,27730,75080
E000288,N00028257,Keith Ellison (D),2014,Retired,59365,0,59365
E000288,N00028257,Keith Ellison (D),2014,Industrial Unions,0,51000,51000
E000288,N00028257,Keith Ellison (D),2014,Real Estate,30700,16000,46700
E000288,N00028257,Keith Ellison (D),2014,Public Sector Unions,0,45000,45000
E000288,N00028257,Keith Ellison (D),2014,Insurance,9100,27500,36600
E000288,N00028257,Keith Ellison (D),2014,Misc Unions,0,35750,35750
E000288,N00028257,Keith Ellison (D),2014,Securities & Investment,26300,1000,27300
E000288,N00028257,Keith Ellison (D),2014,Building Trade Unions,0,25000,25000
G000556,N00028418,Alan Grayson (D),2014,Retired,89424,0,89424
G000556,N00028418,Alan Grayson (D),2014,Lawyers/Law Firms,28550,21500,50050
G000556,N00028418,Alan Grayson (D),2014,Transportation Unions,0,45000,45000
G000556,N00028418,Alan Grayson (D),2014,Public Sector Unions,0,43500,43500
G000556,N00028418,Alan Grayson (D),2014,Industrial Unions,0,38500,38500
G000556,N00028418,Alan Grayson (D),2014,Education,37100,1000,38100
G000556,N00028418,Alan Grayson (D),2014,Building Trade Unions,0,37500,37500
G000556,N00028418,Alan Grayson (D),2014,Securities & Investment,32750,0,32750
G000556,N00028418,Alan Grayson (D),2014,Real Estate,14957,9000,23957
G000556,N00028418,Alan Grayson (D),2014,Misc Unions,0,21500,21500
C001076,N00028958,Jason Chaffetz (R),2014,Retail Sales,8100,62500,70600
C001076,N00028958,Jason Chaffetz (R),2014,Electronics Mfg & Equip,5100,45988,51088
C001076,N00028958,Jason Chaffetz (R),2014,Misc Manufacturing & Distributing,25600,20999,46599
C001076,N00028958,Jason Chaffetz (R),2014,Lobbyists,41796,1000,42796
C001076,N00028958,Jason Chaffetz (R),2014,Commercial Banks,13650,28000,41650
C001076,N00028958,Jason Chaffetz (R),2014,Pharmaceuticals/Health Products,5250,34514,39764
C001076,N00028958,Jason Chaffetz (R),2014,Oil & Gas,7850,29000,36850
C001076,N00028958,Jason Chaffetz (R),2014,Securities & Investment,23600,13000,36600
C001076,N00028958,Jason Chaffetz (R),2014,Lawyers/Law Firms,12850,17500,30350
C001076,N00028958,Jason Chaffetz (R),2014,Hospitals/Nursing Homes,26900,2000,28900
B001262,N00028986,Paul Broun (R),2014,Retired,142900,0,142900
B001262,N00028986,Paul Broun (R),2014,Republican/Conservative,112754,19025,131779
B001262,N00028986,Paul Broun (R),2014,Health Professionals,63756,5500,69256
B001262,N00028986,Paul Broun (R),2014,Securities & Investment,42768,0,42768
B001262,N00028986,Paul Broun (R),2014,Real Estate,40300,0,40300
B001262,N00028986,Paul Broun (R),2014,Misc Finance,36445,0,36445
B001262,N00028986,Paul Broun (R),2014,Oil & Gas,29200,0,29200
B001262,N00028986,Paul Broun (R),2014,Lawyers/Law Firms,22700,5000,27700
B001262,N00028986,Paul Broun (R),2014,Chemical & Related Manufacturing,22100,0,22100
B001262,N00028986,Paul Broun (R),2014,Business Services,19700,0,19700
F000457,N00029016,Al Franken (D),2014,Lawyers/Law Firms,1393991,93938,1487929
F000457,N00029016,Al Franken (D),2014,Retired,1346859,0,1346859
F000457,N00029016,Al Franken (D),2014,TV/Movies/Music,586096,22004,608100
F000457,N00029016,Al Franken (D),2014,Securities & Investment,480291,11000,491291
F000457,N00029016,Al Franken (D),2014,Leadership PACs,750,386450,387200
F000457,N00029016,Al Franken (D),2014,Real Estate,330413,15010,345423
F000457,N00029016,Al Franken (D),2014,Health Professionals,190931,72400,263331
F000457,N00029016,Al Franken (D),2014,Democratic/Liberal,236905,20867,257772
F000457,N00029016,Al Franken (D),2014,Printing & Publishing,247094,2000,249094
F000457,N00029016,Al Franken (D),2014,Education,238100,2000,240100
H001047,N00029070,Jim Himes (D),2014,Securities & Investment,324238,178000,502238
H001047,N00029070,Jim Himes (D),2014,Insurance,10750,187500,198250
H001047,N00029070,Jim Himes (D),2014,Retired,195100,0,195100
H001047,N00029070,Jim Himes (D),2014,Lawyers/Law Firms,110761,22000,132761
H001047,N00029070,Jim Himes (D),2014,Real Estate,71000,58000,129000
H001047,N00029070,Jim Himes (D),2014,Commercial Banks,36450,86000,122450
H001047,N00029070,Jim Himes (D),2014,Business Services,68100,2500,70600
H001047,N00029070,Jim Himes (D),2014,Misc Finance,52400,16500,68900
H001047,N00029070,Jim Himes (D),2014,Accountants,9000,50000,59000
H001047,N00029070,Jim Himes (D),2014,Misc Manufacturing & Distributing,27800,28500,56300
F000454,N00029139,Bill Foster (D),2014,Education,316900,0,316900
F000454,N00029139,Bill Foster (D),2014,Lawyers/Law Firms,166852,26499,193351
F000454,N00029139,Bill Foster (D),2014,Retired,177624,0,177624
F000454,N00029139,Bill Foster (D),2014,Securities & Investment,96700,71000,167700
F000454,N00029139,Bill Foster (D),2014,Civil Servants/Public Officials,102815,0,102815
F000454,N00029139,Bill Foster (D),2014,Real Estate,55250,41000,96250
F000454,N00029139,Bill Foster (D),2014,Insurance,6900,78400,85300
F000454,N00029139,Bill Foster (D),2014,Pro-Israel,68350,4700,73050
F000454,N00029139,Bill Foster (D),2014,Building Trade Unions,400,59500,59900
F000454,N00029139,Bill Foster (D),2014,Leadership PACs,0,58100,58100
H001052,N00029147,Andy Harris (R),2014,Health Professionals,192915,130000,322915
H001052,N00029147,Andy Harris (R),2014,Retired,64915,0,64915
H001052,N00029147,Andy Harris (R),2014,Securities & Investment,37750,1000,38750
H001052,N00029147,Andy Harris (R),2014,Oil & Gas,2000,36000,38000
H001052,N00029147,Andy Harris (R),2014,Real Estate,26996,9000,35996
H001052,N00029147,Andy Harris (R),2014,Education,32650,1000,33650
H001052,N00029147,Andy Harris (R),2014,Food & Beverage,20880,12600,33480
H001052,N00029147,Andy Harris (R),2014,Hospitals/Nursing Homes,17400,10500,27900
H001052,N00029147,Andy Harris (R),2014,Lawyers/Law Firms,18250,2500,20750
H001052,N00029147,Andy Harris (R),2014,Electric Utilities,1000,17500,18500
H001048,N00029258,Duncan D Hunter (R),2014,Sea Transport,44600,67000,111600
H001048,N00029258,Duncan D Hunter (R),2014,Defense Aerospace,2000,70500,72500
H001048,N00029258,Duncan D Hunter (R),2014,Misc Defense,1500,66365,67865
H001048,N00029258,Duncan D Hunter (R),2014,Air Transport,1500,58250,59750
H001048,N00029258,Duncan D Hunter (R),2014,Defense Electronics,2000,56500,58500
H001048,N00029258,Duncan D Hunter (R),2014,Transportation Unions,0,57000,57000
H001048,N00029258,Duncan D Hunter (R),2014,Oil & Gas,35200,7500,42700
H001048,N00029258,Duncan D Hunter (R),2014,Trucking,13500,28500,42000
H001048,N00029258,Duncan D Hunter (R),2014,Real Estate,14600,27000,41600
H001048,N00029258,Duncan D Hunter (R),2014,Lobbyists,32641,2823,35464
C001072,N00029513,Andre Carson (D),2014,Lawyers/Law Firms,73071,18800,91871
C001072,N00029513,Andre Carson (D),2014,Health Professionals,73380,13000,86380
C001072,N00029513,Andre Carson (D),2014,Building Trade Unions,400,51750,52150
C001072,N00029513,Andre Carson (D),2014,Transportation Unions,0,47000,47000
C001072,N00029513,Andre Carson (D),2014,Industrial Unions,0,45000,45000
C001072,N00029513,Andre Carson (D),2014,Defense Aerospace,250,43000,43250
C001072,N00029513,Andre Carson (D),2014,Real Estate,28800,14000,42800
C001072,N00029513,Andre Carson (D),2014,Air Transport,500,34000,34500
C001072,N00029513,Andre Carson (D),2014,Construction Services,24550,6000,30550
C001072,N00029513,Andre Carson (D),2014,Pharmaceuticals/Health Products,12700,15500,28200
H001049,N00029617,Kay R Hagan (D),2014,Retired,1306854,0,1306854
H001049,N00029617,Kay R Hagan (D),2014,Lawyers/Law Firms,785810,169350,955160
H001049,N00029617,Kay R Hagan (D),2014,Women's Issues,761762,34607,796369
H001049,N00029617,Kay R Hagan (D),2014,Securities & Investment,349393,233833,583226
H001049,N00029617,Kay R Hagan (D),2014,Pharmaceuticals/Health Products,128949,391559,520508
H001049,N00029617,Kay R Hagan (D),2014,Leadership PACs,2600,504100,506700
H001049,N00029617,Kay R Hagan (D),2014,Education,397943,8500,406443
H001049,N00029617,Kay R Hagan (D),2014,Insurance,85510,274500,360010
H001049,N00029617,Kay R Hagan (D),2014,Real Estate,209376,96800,306176
H001049,N00029617,Kay R Hagan (D),2014,Commercial Banks,122680,153000,275680
H001045,N00029632,Gregg Harper (R),2014,Oil & Gas,73050,60500,133550
H001045,N00029632,Gregg Harper (R),2014,Health Professionals,66150,53000,119150
H001045,N00029632,Gregg Harper (R),2014,Lawyers/Law Firms,45550,15000,60550
H001045,N00029632,Gregg Harper (R),2014,Electric Utilities,1250,54000,55250
H001045,N00029632,Gregg Harper (R),2014,Real Estate,40550,8000,48550
H001045,N00029632,Gregg Harper (R),2014,Retired,44150,0,44150
H001045,N00029632,Gregg Harper (R),2014,Commercial Banks,11750,30500,42250
H001045,N00029632,Gregg Harper (R),2014,General Contractors,31250,1000,32250
H001045,N00029632,Gregg Harper (R),2014,Defense Aerospace,5000,26500,31500
H001045,N00029632,Gregg Harper (R),2014,Telephone Utilities,6750,21000,27750
G000558,N00029675,Brett Guthrie (R),2014,Health Professionals,19950,210500,230450
G000558,N00029675,Brett Guthrie (R),2014,Pharmaceuticals/Health Products,18382,152700,171082
G000558,N00029675,Brett Guthrie (R),2014,Telecom Services,2250,65000,67250
G000558,N00029675,Brett Guthrie (R),2014,Oil & Gas,2250,62500,64750
G000558,N00029675,Brett Guthrie (R),2014,Health Services/HMOs,6250,55000,61250
G000558,N00029675,Brett Guthrie (R),2014,Lobbyists,59700,500,60200
G000558,N00029675,Brett Guthrie (R),2014,Insurance,5250,54500,59750
G000558,N00029675,Brett Guthrie (R),2014,Retail Sales,21250,29500,50750
G000558,N00029675,Brett Guthrie (R),2014,Retired,50230,0,50230
G000558,N00029675,Brett Guthrie (R),2014,Telephone Utilities,1500,39000,40500
F000456,N00029679,John Fleming (R),2014,Health Professionals,123027,66000,189027
F000456,N00029679,John Fleming (R),2014,Oil & Gas,138950,38500,177450
F000456,N00029679,John Fleming (R),2014,Hospitals/Nursing Homes,60650,0,60650
F000456,N00029679,John Fleming (R),2014,Real Estate,51700,4000,55700
F000456,N00029679,John Fleming (R),2014,Retired,54300,0,54300
F000456,N00029679,John Fleming (R),2014,Insurance,39296,15000,54296
F000456,N00029679,John Fleming (R),2014,Crop Production & Basic Processing,24850,17500,42350
F000456,N00029679,John Fleming (R),2014,General Contractors,26950,5500,32450
F000456,N00029679,John Fleming (R),2014,Lawyers/Law Firms,29900,2000,31900
F000456,N00029679,John Fleming (R),2014,Forestry & Forest Products,29400,0,29400
H001046,N00029835,Martin Heinrich (D),2014,Lawyers/Law Firms,577566,58925,636491
H001046,N00029835,Martin Heinrich (D),2014,Retired,508275,0,508275
H001046,N00029835,Martin Heinrich (D),2014,Lobbyists,291718,1474,293192
H001046,N00029835,Martin Heinrich (D),2014,Environment,217603,29666,247269
H001046,N00029835,Martin Heinrich (D),2014,Leadership PACs,0,222500,222500
H001046,N00029835,Martin Heinrich (D),2014,Health Professionals,108166,78500,186666
H001046,N00029835,Martin Heinrich (D),2014,Pro-Israel,134380,23993,158373
H001046,N00029835,Martin Heinrich (D),2014,Education,141243,3500,144743
H001046,N00029835,Martin Heinrich (D),2014,Casinos/Gambling,130850,8500,139350
H001046,N00029835,Martin Heinrich (D),2014,Real Estate,97465,18260,115725
C001078,N00029891,Gerry Connolly (D),2014,Electronics Mfg & Equip,30550,79500,110050
C001078,N00029891,Gerry Connolly (D),2014,Public Sector Unions,250,108500,108750
C001078,N00029891,Gerry Connolly (D),2014,Retired,84221,0,84221
C001078,N00029891,Gerry Connolly (D),2014,Business Services,62250,14000,76250
C001078,N00029891,Gerry Connolly (D),2014,Real Estate,55450,15500,70950
C001078,N00029891,Gerry Connolly (D),2014,Lobbyists,58151,1000,59151
C001078,N00029891,Gerry Connolly (D),2014,Lawyers/Law Firms,28866,24750,53616
C001078,N00029891,Gerry Connolly (D),2014,Defense Electronics,5330,46000,51330
C001078,N00029891,Gerry Connolly (D),2014,Defense Aerospace,8650,40000,48650
C001078,N00029891,Gerry Connolly (D),2014,Transportation Unions,250,47000,47250
B001265,N00029901,Mark Begich (D),2014,Lawyers/Law Firms,801884,180843,982727
B001265,N00029901,Mark Begich (D),2014,Leadership PACs,2600,477200,479800
B001265,N00029901,Mark Begich (D),2014,Lobbyists,417646,12500,430146
B001265,N00029901,Mark Begich (D),2014,Oil & Gas,198597,196000,394597
B001265,N00029901,Mark Begich (D),2014,Real Estate,287425,68471,355896
B001265,N00029901,Mark Begich (D),2014,Retired,345833,0,345833
B001265,N00029901,Mark Begich (D),2014,Securities & Investment,263450,44000,307450
B001265,N00029901,Mark Begich (D),2014,Health Professionals,137100,88400,225500
B001265,N00029901,Mark Begich (D),2014,TV/Movies/Music,166650,43000,209650
B001265,N00029901,Mark Begich (D),2014,Democratic/Liberal,151757,37313,189070
G000573,N00029908,Joe Garcia (D),2014,Lawyers/Law Firms,381460,43345,424805
G000573,N00029908,Joe Garcia (D),2014,Leadership PACs,15600,195792,211392
G000573,N00029908,Joe Garcia (D),2014,Retired,193649,0,193649
G000573,N00029908,Joe Garcia (D),2014,Real Estate,172063,12000,184063
G000573,N00029908,Joe Garcia (D),2014,Securities & Investment,117000,7000,124000
G000573,N00029908,Joe Garcia (D),2014,Candidate Committees,0,95000,95000
G000573,N00029908,Joe Garcia (D),2014,Pro-Israel,70638,9665,80303
G000573,N00029908,Joe Garcia (D),2014,Health Professionals,60875,11500,72375
G000573,N00029908,Joe Garcia (D),2014,Public Sector Unions,0,71000,71000
G000573,N00029908,Joe Garcia (D),2014,General Contractors,68544,0,68544
H001051,N00030197,Richard Hanna (R),2014,Leadership PACs,0,75000,75000
H001051,N00030197,Richard Hanna (R),2014,Securities & Investment,48550,7500,56050
H001051,N00030197,Richard Hanna (R),2014,Air Transport,750,50000,50750
H001051,N00030197,Richard Hanna (R),2014,General Contractors,31690,17500,49190
H001051,N00030197,Richard Hanna (R),2014,Health Professionals,5000,30000,35000
H001051,N00030197,Richard Hanna (R),2014,Construction Services,500,31500,32000
H001051,N00030197,Richard Hanna (R),2014,Building Trade Unions,0,28500,28500
H001051,N00030197,Richard Hanna (R),2014,Insurance,4300,21750,26050
H001051,N00030197,Richard Hanna (R),2014,Transportation Unions,0,26000,26000
H001051,N00030197,Richard Hanna (R),2014,Lobbyists,24850,500,25350
C001075,N00030245,Bill Cassidy (R),2014,Health Professionals,812165,320600,1132765
C001075,N00030245,Bill Cassidy (R),2014,Retired,1091541,0,1091541
C001075,N00030245,Bill Cassidy (R),2014,Securities & Investment,937076,2500,939576
C001075,N00030245,Bill Cassidy (R),2014,Oil & Gas,641170,106500,747670
C001075,N00030245,Bill Cassidy (R),2014,Leadership PACs,0,614162,614162
C001075,N00030245,Bill Cassidy (R),2014,Real Estate,402150,5400,407550
C001075,N00030245,Bill Cassidy (R),2014,Republican/Conservative,195208,109714,304922
C001075,N00030245,Bill Cassidy (R),2014,Lawyers/Law Firms,240585,10500,251085
C001075,N00030245,Bill Cassidy (R),2014,General Contractors,211200,33500,244700
C001075,N00030245,Bill Cassidy (R),2014,Misc Finance,241467,1000,242467
F000455,N00030490,Marcia L Fudge (D),2014,Food & Beverage,4400,43000,47400
F000455,N00030490,Marcia L Fudge (D),2014,Pro-Israel,35452,9200,44652
F000455,N00030490,Marcia L Fudge (D),2014,Lawyers/Law Firms,15719,27850,43569
F000455,N00030490,Marcia L Fudge (D),2014,Pharmaceuticals/Health Products,0,43000,43000
F000455,N00030490,Marcia L Fudge (D),2014,Agricultural Services/Products,0,42000,42000
F000455,N00030490,Marcia L Fudge (D),2014,Public Sector Unions,0,42000,42000
F000455,N00030490,Marcia L Fudge (D),2014,Electric Utilities,500,41000,41500
F000455,N00030490,Marcia L Fudge (D),2014,Industrial Unions,0,41000,41000
F000455,N00030490,Marcia L Fudge (D),2014,Transportation Unions,0,36000,36000
F000455,N00030490,Marcia L Fudge (D),2014,Food Processing & Sales,1250,34000,35250
C001080,N00030600,Judy Chu (D),2014,Lawyers/Law Firms,38290,16000,54290
C001080,N00030600,Judy Chu (D),2014,Health Professionals,34708,10500,45208
C001080,N00030600,Judy Chu (D),2014,Misc Unions,250,44750,45000
C001080,N00030600,Judy Chu (D),2014,Real Estate,35000,6000,41000
C001080,N00030600,Judy Chu (D),2014,TV/Movies/Music,8700,32000,40700
C001080,N00030600,Judy Chu (D),2014,Building Trade Unions,0,38100,38100
C001080,N00030600,Judy Chu (D),2014,Retired,36461,0,36461
C001080,N00030600,Judy Chu (D),2014,Public Sector Unions,0,34750,34750
C001080,N00030600,Judy Chu (D),2014,Pharmaceuticals/Health Products,14000,9000,23000
C001080,N00030600,Judy Chu (D),2014,Insurance,14450,8000,22450
B001267,N00030608,Michael F Bennet (D),2014,Securities & Investment,1470924,161500,1632424
B001267,N00030608,Michael F Bennet (D),2014,Lawyers/Law Firms,1348113,195551,1543664
B001267,N00030608,Michael F Bennet (D),2014,Retired,702514,0,702514
B001267,N00030608,Michael F Bennet (D),2014,Real Estate,533070,98000,631070
B001267,N00030608,Michael F Bennet (D),2014,Lobbyists,392907,19650,412557
B001267,N00030608,Michael F Bennet (D),2014,Misc Finance,343607,19000,362607
B001267,N00030608,Michael F Bennet (D),2014,Education,317805,38100,355905
B001267,N00030608,Michael F Bennet (D),2014,Leadership PACs,250,355262,355512
B001267,N00030608,Michael F Bennet (D),2014,Business Services,332951,17000,349951
B001267,N00030608,Michael F Bennet (D),2014,TV/Movies/Music,288216,35500,323716
H001058,N00030673,Bill Huizenga (R),2014,Insurance,4250,142000,146250
H001058,N00030673,Bill Huizenga (R),2014,Misc Manufacturing & Distributing,97200,11054,108254
H001058,N00030673,Bill Huizenga (R),2014,Securities & Investment,31950,65000,96950
H001058,N00030673,Bill Huizenga (R),2014,Real Estate,28300,60000,88300
H001058,N00030673,Bill Huizenga (R),2014,Commercial Banks,3750,83100,86850
H001058,N00030673,Bill Huizenga (R),2014,Retired,47480,0,47480
H001058,N00030673,Bill Huizenga (R),2014,Accountants,0,40911,40911
H001058,N00030673,Bill Huizenga (R),2014,Finance/Credit Companies,0,40000,40000
H001058,N00030673,Bill Huizenga (R),2014,Leadership PACs,500,38200,38700
H001058,N00030673,Bill Huizenga (R),2014,Retail Sales,21600,13500,35100
D000617,N00030693,Suzan DelBene (D),2014,Leadership PACs,20700,155354,176054
D000617,N00030693,Suzan DelBene (D),2014,Electronics Mfg & Equip,108600,46635,155235
D000617,N00030693,Suzan DelBene (D),2014,Retired,151900,0,151900
D000617,N00030693,Suzan DelBene (D),2014,Lawyers/Law Firms,49650,23750,73400
D000617,N00030693,Suzan DelBene (D),2014,Retail Sales,19650,46000,65650
D000617,N00030693,Suzan DelBene (D),2014,Public Sector Unions,0,64500,64500
D000617,N00030693,Suzan DelBene (D),2014,Securities & Investment,28725,35000,63725
D000617,N00030693,Suzan DelBene (D),2014,Building Trade Unions,0,57000,57000
D000617,N00030693,Suzan DelBene (D),2014,Business Services,50669,5500,56169
D000617,N00030693,Suzan DelBene (D),2014,Lobbyists,53850,1000,54850
D000623,N00030709,Mark Desaulnier (D),2014,Public Sector Unions,0,53000,53000
D000623,N00030709,Mark Desaulnier (D),2014,Building Trade Unions,0,49600,49600
D000623,N00030709,Mark Desaulnier (D),2014,Lawyers/Law Firms,20800,11000,31800
D000623,N00030709,Mark Desaulnier (D),2014,Industrial Unions,0,31000,31000
D000623,N00030709,Mark Desaulnier (D),2014,Health Professionals,1750,20000,21750
D000623,N00030709,Mark Desaulnier (D),2014,Transportation Unions,0,21500,21500
D000623,N00030709,Mark Desaulnier (D),2014,Retired,19650,0,19650
D000623,N00030709,Mark Desaulnier (D),2014,Leadership PACs,0,19100,19100
D000623,N00030709,Mark Desaulnier (D),2014,Real Estate,7450,10000,17450
D000623,N00030709,Mark Desaulnier (D),2014,Misc Unions,0,16600,16600
B001287,N00030717,Ami Bera (D),2014,Retired,358032,0,358032
B001287,N00030717,Ami Bera (D),2014,Health Professionals,100081,230500,330581
B001287,N00030717,Ami Bera (D),2014,Leadership PACs,21200,268952,290152
B001287,N00030717,Ami Bera (D),2014,Lawyers/Law Firms,129958,18750,148708
B001287,N00030717,Ami Bera (D),2014,Securities & Investment,128269,7500,135769
B001287,N00030717,Ami Bera (D),2014,Education,120151,0,120151
B001287,N00030717,Ami Bera (D),2014,Candidate Committees,2000,117500,119500
B001287,N00030717,Ami Bera (D),2014,Electronics Mfg & Equip,83930,25090,109020
B001287,N00030717,Ami Bera (D),2014,Public Sector Unions,500,106490,106990
B001287,N00030717,Ami Bera (D),2014,Democratic/Liberal,84096,12702,96798
C001083,N00030736,John Carney (D),2014,Securities & Investment,22820,134000,156820
C001083,N00030736,John Carney (D),2014,Insurance,4070,151200,155270
C001083,N00030736,John Carney (D),2014,Lawyers/Law Firms,89385,21750,111135
C001083,N00030736,John Carney (D),2014,Commercial Banks,11850,96250,108100
C001083,N00030736,John Carney (D),2014,Real Estate,15869,52000,67869
C001083,N00030736,John Carney (D),2014,Finance/Credit Companies,7750,51500,59250
C001083,N00030736,John Carney (D),2014,Pharmaceuticals/Health Products,1550,51448,52998
C001083,N00030736,John Carney (D),2014,Accountants,1750,47499,49249
C001083,N00030736,John Carney (D),2014,Business Services,15800,4000,19800
C001083,N00030736,John Carney (D),2014,Defense Aerospace,275,19000,19275
D000615,N00030752,Jeff Duncan (R),2014,Oil & Gas,3100,46500,49600
D000615,N00030752,Jeff Duncan (R),2014,Hospitals/Nursing Homes,6250,25000,31250
D000615,N00030752,Jeff Duncan (R),2014,Health Professionals,6450,23000,29450
D000615,N00030752,Jeff Duncan (R),2014,Real Estate,11925,7500,19425
D000615,N00030752,Jeff Duncan (R),2014,Retired,18850,0,18850
D000615,N00030752,Jeff Duncan (R),2014,Crop Production & Basic Processing,7505,11000,18505
D000615,N00030752,Jeff Duncan (R),2014,Insurance,2850,14500,17350
D000615,N00030752,Jeff Duncan (R),2014,General Contractors,4100,12500,16600
D000615,N00030752,Jeff Duncan (R),2014,Electric Utilities,2050,14000,16050
D000615,N00030752,Jeff Duncan (R),2014,Securities & Investment,13600,0,13600
C001087,N00030770,Rick Crawford (R),2014,Crop Production & Basic Processing,51000,77330,128330
C001087,N00030770,Rick Crawford (R),2014,Agricultural Services/Products,1966,48500,50466
C001087,N00030770,Rick Crawford (R),2014,Health Professionals,29702,16500,46202
C001087,N00030770,Rick Crawford (R),2014,Leadership PACs,0,39500,39500
C001087,N00030770,Rick Crawford (R),2014,Retail Sales,9350,18500,27850
C001087,N00030770,Rick Crawford (R),2014,Air Transport,1050,26554,27604
C001087,N00030770,Rick Crawford (R),2014,Securities & Investment,19100,6500,25600
C001087,N00030770,Rick Crawford (R),2014,Poultry & Eggs,7700,16500,24200
C001087,N00030770,Rick Crawford (R),2014,Commercial Banks,4773,18250,23023
C001087,N00030770,Rick Crawford (R),2014,Real Estate,9050,11000,20050
G000565,N00030771,Paul Gosar (R),2014,Health Professionals,75900,69000,144900
G000565,N00030771,Paul Gosar (R),2014,Electric Utilities,7350,21500,28850
G000565,N00030771,Paul Gosar (R),2014,Casinos/Gambling,25000,1000,26000
G000565,N00030771,Paul Gosar (R),2014,Mining,0,14000,14000
G000565,N00030771,Paul Gosar (R),2014,Lawyers/Law Firms,10750,2750,13500
G000565,N00030771,Paul Gosar (R),2014,Leadership PACs,0,13500,13500
G000565,N00030771,Paul Gosar (R),2014,Health Services/HMOs,0,13000,13000
G000565,N00030771,Paul Gosar (R),2014,Oil & Gas,0,12500,12500
G000565,N00030771,Paul Gosar (R),2014,Real Estate,5950,4000,9950
G000565,N00030771,Paul Gosar (R),2014,Retired,9350,0,9350
G000562,N00030780,Cory Gardner (R),2014,Retired,1361896,0,1361896
G000562,N00030780,Cory Gardner (R),2014,Securities & Investment,788945,14000,802945
G000562,N00030780,Cory Gardner (R),2014,Oil & Gas,437249,258700,695949
G000562,N00030780,Cory Gardner (R),2014,Real Estate,479106,28500,507606
G000562,N00030780,Cory Gardner (R),2014,Leadership PACs,0,406194,406194
G000562,N00030780,Cory Gardner (R),2014,Republican/Conservative,302833,61775,364608
G000562,N00030780,Cory Gardner (R),2014,Misc Finance,246436,11100,257536
G000562,N00030780,Cory Gardner (R),2014,Commercial Banks,139906,87500,227406
G000562,N00030780,Cory Gardner (R),2014,Lawyers/Law Firms,204548,13500,218048
G000562,N00030780,Cory Gardner (R),2014,Misc Manufacturing & Distributing,176883,29100,205983
G000560,N00030788,Tom Graves (R),2014,Real Estate,39150,22500,61650
G000560,N00030788,Tom Graves (R),2014,Insurance,15250,38500,53750
G000560,N00030788,Tom Graves (R),2014,Misc Manufacturing & Distributing,23900,19250,43150
G000560,N00030788,Tom Graves (R),2014,Retired,38500,0,38500
G000560,N00030788,Tom Graves (R),2014,Textiles,30200,7000,37200
G000560,N00030788,Tom Graves (R),2014,Health Professionals,17250,16000,33250
G000560,N00030788,Tom Graves (R),2014,Commercial Banks,2850,25500,28350
G000560,N00030788,Tom Graves (R),2014,Crop Production & Basic Processing,6350,16500,22850
G000560,N00030788,Tom Graves (R),2014,Oil & Gas,7200,15000,22200
G000560,N00030788,Tom Graves (R),2014,Air Transport,0,20500,20500
G000560,N00030788,Tom Graves (R),2014,Leadership PACs,0,20500,20500
G000570,N00030801,Frank Guinta (R),2014,Leadership PACs,0,237900,237900
G000570,N00030801,Frank Guinta (R),2014,Retired,70200,0,70200
G000570,N00030801,Frank Guinta (R),2014,Real Estate,56650,11500,68150
G000570,N00030801,Frank Guinta (R),2014,Insurance,36750,30000,66750
G000570,N00030801,Frank Guinta (R),2014,Securities & Investment,51450,5500,56950
G000570,N00030801,Frank Guinta (R),2014,Candidate Committees,0,54500,54500
G000570,N00030801,Frank Guinta (R),2014,Republican/Conservative,11100,29234,40334
G000570,N00030801,Frank Guinta (R),2014,Health Professionals,10050,22500,32550
G000570,N00030801,Frank Guinta (R),2014,Lawyers/Law Firms,28425,1000,29425
G000570,N00030801,Frank Guinta (R),2014,Oil & Gas,10450,18000,28450
F000459,N00030815,Chuck Fleischmann (R),2014,Leadership PACs,0,120499,120499
F000459,N00030815,Chuck Fleischmann (R),2014,General Contractors,68400,25500,93900
F000459,N00030815,Chuck Fleischmann (R),2014,Real Estate,53200,9000,62200
F000459,N00030815,Chuck Fleischmann (R),2014,Health Professionals,35500,23000,58500
F000459,N00030815,Chuck Fleischmann (R),2014,Lawyers/Law Firms,41000,16500,57500
F000459,N00030815,Chuck Fleischmann (R),2014,Hospitals/Nursing Homes,13350,38000,51350
F000459,N00030815,Chuck Fleischmann (R),2014,Insurance,11900,36400,48300
F000459,N00030815,Chuck Fleischmann (R),2014,Pharmaceuticals/Health Products,32200,10500,42700
F000459,N00030815,Chuck Fleischmann (R),2014,Retired,37400,0,37400
F000459,N00030815,Chuck Fleischmann (R),2014,Accountants,22450,12000,34450
B001297,N00030829,Ken Buck (R),2014,Retired,138750,0,138750
B001297,N00030829,Ken Buck (R),2014,Oil & Gas,63650,52800,116450
B001297,N00030829,Ken Buck (R),2014,Leadership PACs,0,66000,66000
B001297,N00030829,Ken Buck (R),2014,Real Estate,57050,5000,62050
B001297,N00030829,Ken Buck (R),2014,General Contractors,41600,7000,48600
B001297,N00030829,Ken Buck (R),2014,Business Services,44425,0,44425
B001297,N00030829,Ken Buck (R),2014,Gun Rights,28800,13058,41858
B001297,N00030829,Ken Buck (R),2014,Automotive,33200,8000,41200
B001297,N00030829,Ken Buck (R),2014,Health Professionals,24430,16000,40430
B001297,N00030829,Ken Buck (R),2014,Misc Finance,35100,2500,37600
G000559,N00030856,John Garamendi (D),2014,Transportation Unions,250,100000,100250
G000559,N00030856,John Garamendi (D),2014,Lawyers/Law Firms,46100,23500,69600
G000559,N00030856,John Garamendi (D),2014,Sea Transport,7300,57306,64606
G000559,N00030856,John Garamendi (D),2014,Crop Production & Basic Processing,22475,39124,61599
G000559,N00030856,John Garamendi (D),2014,Building Trade Unions,0,61050,61050
G000559,N00030856,John Garamendi (D),2014,Public Sector Unions,270,58100,58370
G000559,N00030856,John Garamendi (D),2014,Insurance,22100,31487,53587
G000559,N00030856,John Garamendi (D),2014,Real Estate,37435,11000,48435
G000559,N00030856,John Garamendi (D),2014,Industrial Unions,0,40000,40000
G000559,N00030856,John Garamendi (D),2014,Defense Aerospace,0,32000,32000
G000566,N00030880,Trey Gowdy (R),2014,Securities & Investment,19450,14000,33450
G000566,N00030880,Trey Gowdy (R),2014,Real Estate,14550,17000,31550
G000566,N00030880,Trey Gowdy (R),2014,Insurance,5850,23000,28850
G000566,N00030880,Trey Gowdy (R),2014,Electronics Mfg & Equip,5700,21750,27450
G000566,N00030880,Trey Gowdy (R),2014,Accountants,1750,25000,26750
G000566,N00030880,Trey Gowdy (R),2014,Telecom Services,1000,24000,25000
G000566,N00030880,Trey Gowdy (R),2014,Crop Production & Basic Processing,8600,15500,24100
G000566,N00030880,Trey Gowdy (R),2014,Electric Utilities,2000,21500,23500
G000566,N00030880,Trey Gowdy (R),2014,Lawyers/Law Firms,18250,5000,23250
G000566,N00030880,Trey Gowdy (R),2014,Health Professionals,7950,14000,21950
B001274,N00030910,Mo Brooks (R),2014,Defense Aerospace,4500,63500,68000
B001274,N00030910,Mo Brooks (R),2014,Misc Defense,33150,9100,42250
B001274,N00030910,Mo Brooks (R),2014,Health Professionals,20000,19000,39000
B001274,N00030910,Mo Brooks (R),2014,Defense Electronics,2250,33000,35250
B001274,N00030910,Mo Brooks (R),2014,Lawyers/Law Firms,17760,15000,32760
B001274,N00030910,Mo Brooks (R),2014,Retired,26742,0,26742
B001274,N00030910,Mo Brooks (R),2014,Real Estate,17500,8000,25500
B001274,N00030910,Mo Brooks (R),2014,Electronics Mfg & Equip,16500,5200,21700
B001274,N00030910,Mo Brooks (R),2014,Electric Utilities,0,18500,18500
B001274,N00030910,Mo Brooks (R),2014,Insurance,1000,14500,15500
D000616,N00030957,Scott Desjarlais (R),2014,Leadership PACs,0,64750,64750
D000616,N00030957,Scott Desjarlais (R),2014,Health Professionals,50300,2500,52800
D000616,N00030957,Scott Desjarlais (R),2014,Retired,44901,0,44901
D000616,N00030957,Scott Desjarlais (R),2014,Misc Manufacturing & Distributing,20850,500,21350
D000616,N00030957,Scott Desjarlais (R),2014,Lawyers/Law Firms,20840,0,20840
D000616,N00030957,Scott Desjarlais (R),2014,Republican/Conservative,8550,10000,18550
D000616,N00030957,Scott Desjarlais (R),2014,Food Processing & Sales,16100,1500,17600
D000616,N00030957,Scott Desjarlais (R),2014,Pharmaceuticals/Health Products,15600,0,15600
D000616,N00030957,Scott Desjarlais (R),2014,Hospitals/Nursing Homes,10150,5000,15150
D000616,N00030957,Scott Desjarlais (R),2014,Building Materials & Equipment,12500,0,12500
D000614,N00030967,Sean P Duffy (R),2014,Insurance,23292,161200,184492
D000614,N00030967,Sean P Duffy (R),2014,Securities & Investment,65450,85500,150950
D000614,N00030967,Sean P Duffy (R),2014,Retired,147975,0,147975
D000614,N00030967,Sean P Duffy (R),2014,Commercial Banks,36862,90500,127362
D000614,N00030967,Sean P Duffy (R),2014,Real Estate,34450,77250,111700
D000614,N00030967,Sean P Duffy (R),2014,Leadership PACs,0,98589,98589
D000614,N00030967,Sean P Duffy (R),2014,Misc Manufacturing & Distributing,73350,15054,88404
D000614,N00030967,Sean P Duffy (R),2014,Health Professionals,52206,29300,81506
D000614,N00030967,Sean P Duffy (R),2014,Finance/Credit Companies,16100,43650,59750
D000614,N00030967,Sean P Duffy (R),2014,Accountants,6000,44000,50000
A000368,N00030980,Kelly Ayotte (R),2014,Securities & Investment,796364,55000,851364
A000368,N00030980,Kelly Ayotte (R),2014,Retired,476944,0,476944
A000368,N00030980,Kelly Ayotte (R),2014,Lobbyists,385833,9587,395420
A000368,N00030980,Kelly Ayotte (R),2014,Insurance,134816,220000,354816
A000368,N00030980,Kelly Ayotte (R),2014,Leadership PACs,4149,305150,309299
A000368,N00030980,Kelly Ayotte (R),2014,Lawyers/Law Firms,224465,68500,292965
A000368,N00030980,Kelly Ayotte (R),2014,Real Estate,232178,30810,262988
A000368,N00030980,Kelly Ayotte (R),2014,Oil & Gas,102818,107650,210468
A000368,N00030980,Kelly Ayotte (R),2014,Pharmaceuticals/Health Products,53850,143399,197249
A000368,N00030980,Kelly Ayotte (R),2014,Health Professionals,72585,116000,188585
H001053,N00031005,Vicky Hartzler (R),2014,Real Estate,53050,4000,57050
H001053,N00031005,Vicky Hartzler (R),2014,Retired,49000,0,49000
H001053,N00031005,Vicky Hartzler (R),2014,Crop Production & Basic Processing,25050,21000,46050
H001053,N00031005,Vicky Hartzler (R),2014,Agricultural Services/Products,20500,24750,45250
H001053,N00031005,Vicky Hartzler (R),2014,Defense Aerospace,0,45000,45000
H001053,N00031005,Vicky Hartzler (R),2014,Health Professionals,29750,13000,42750
H001053,N00031005,Vicky Hartzler (R),2014,Lawyers/Law Firms,18800,10000,28800
H001053,N00031005,Vicky Hartzler (R),2014,Dairy,10000,15800,25800
H001053,N00031005,Vicky Hartzler (R),2014,Misc Manufacturing & Distributing,14300,11000,25300
H001053,N00031005,Vicky Hartzler (R),2014,Food & Beverage,24350,0,24350
C001106,N00031064,Ryan Costello (R),2014,Leadership PACs,0,161550,161550
C001106,N00031064,Ryan Costello (R),2014,Lawyers/Law Firms,81716,36999,118715
C001106,N00031064,Ryan Costello (R),2014,Retired,70956,0,70956
C001106,N00031064,Ryan Costello (R),2014,Real Estate,50900,18500,69400
C001106,N00031064,Ryan Costello (R),2014,Pharmaceuticals/Health Products,15550,50350,65900
C001106,N00031064,Ryan Costello (R),2014,Health Professionals,6250,54500,60750
C001106,N00031064,Ryan Costello (R),2014,Securities & Investment,59600,1000,60600
C001106,N00031064,Ryan Costello (R),2014,Insurance,15500,26500,42000
C001106,N00031064,Ryan Costello (R),2014,Republican/Conservative,19750,21500,41250
C001106,N00031064,Ryan Costello (R),2014,Construction Services,31604,7500,39104
D000613,N00031103,Bob Dold (R),2014,Securities & Investment,518290,10500,528790
D000613,N00031103,Bob Dold (R),2014,Leadership PACs,0,299400,299400
D000613,N00031103,Bob Dold (R),2014,Retired,293379,0,293379
D000613,N00031103,Bob Dold (R),2014,Lawyers/Law Firms,249393,1500,250893
D000613,N00031103,Bob Dold (R),2014,Real Estate,120260,14500,134760
D000613,N00031103,Bob Dold (R),2014,Pro-Israel,109070,9250,118320
D000613,N00031103,Bob Dold (R),2014,Pharmaceuticals/Health Products,85750,19500,105250
D000613,N00031103,Bob Dold (R),2014,Business Services,79253,4000,83253
D000613,N00031103,Bob Dold (R),2014,Misc Manufacturing & Distributing,61950,13500,75450
D000613,N00031103,Bob Dold (R),2014,Insurance,42000,32900,74900
H001059,N00031104,Randy Hultgren (R),2014,Securities & Investment,54500,98000,152500
H001059,N00031104,Randy Hultgren (R),2014,Insurance,3950,115500,119450
H001059,N00031104,Randy Hultgren (R),2014,Commercial Banks,9220,74500,83720
H001059,N00031104,Randy Hultgren (R),2014,Real Estate,16907,40000,56907
H001059,N00031104,Randy Hultgren (R),2014,Accountants,250,40000,40250
H001059,N00031104,Randy Hultgren (R),2014,Health Professionals,15600,24500,40100
H001059,N00031104,Randy Hultgren (R),2014,Leadership PACs,0,36788,36788
H001059,N00031104,Randy Hultgren (R),2014,Building Trade Unions,0,36000,36000
H001059,N00031104,Randy Hultgren (R),2014,Electric Utilities,2500,27500,30000
H001059,N00031104,Randy Hultgren (R),2014,Retired,29400,0,29400
G000563,N00031128,Bob Gibbs (R),2014,Leadership PACs,0,85545,85545
G000563,N00031128,Bob Gibbs (R),2014,Oil & Gas,29400,36500,65900
G000563,N00031128,Bob Gibbs (R),2014,Agricultural Services/Products,3600,59024,62624
G000563,N00031128,Bob Gibbs (R),2014,Crop Production & Basic Processing,2300,50500,52800
G000563,N00031128,Bob Gibbs (R),2014,Misc Manufacturing & Distributing,33550,14000,47550
G000563,N00031128,Bob Gibbs (R),2014,Electric Utilities,4250,31000,35250
G000563,N00031128,Bob Gibbs (R),2014,Railroads,0,33000,33000
G000563,N00031128,Bob Gibbs (R),2014,Building Materials & Equipment,20250,12500,32750
G000563,N00031128,Bob Gibbs (R),2014,Construction Services,1000,31000,32000
G000563,N00031128,Bob Gibbs (R),2014,Sea Transport,4000,27000,31000
F000458,N00031141,Steve Fincher (R),2014,Crop Production & Basic Processing,182665,53000,235665
F000458,N00031141,Steve Fincher (R),2014,Insurance,20000,102500,122500
F000458,N00031141,Steve Fincher (R),2014,Commercial Banks,33250,76500,109750
F000458,N00031141,Steve Fincher (R),2014,Real Estate,33400,58500,91900
F000458,N00031141,Steve Fincher (R),2014,General Contractors,75400,1000,76400
F000458,N00031141,Steve Fincher (R),2014,Securities & Investment,4050,64000,68050
F000458,N00031141,Steve Fincher (R),2014,Agricultural Services/Products,19700,39000,58700
F000458,N00031141,Steve Fincher (R),2014,Health Professionals,29850,16500,46350
F000458,N00031141,Steve Fincher (R),2014,Food & Beverage,22700,17000,39700
F000458,N00031141,Steve Fincher (R),2014,Retired,37800,0,37800
A000369,N00031177,Mark Amodei (R),2014,Casinos/Gambling,18950,28500,47450
A000369,N00031177,Mark Amodei (R),2014,Retired,31550,0,31550
A000369,N00031177,Mark Amodei (R),2014,Health Professionals,4000,26500,30500
A000369,N00031177,Mark Amodei (R),2014,Lawyers/Law Firms,22750,7000,29750
A000369,N00031177,Mark Amodei (R),2014,Mining,1500,25000,26500
A000369,N00031177,Mark Amodei (R),2014,Real Estate,19550,5000,24550
A000369,N00031177,Mark Amodei (R),2014,Lobbyists,22500,2000,24500
A000369,N00031177,Mark Amodei (R),2014,"Beer, Wine & Liquor",2600,16500,19100
A000369,N00031177,Mark Amodei (R),2014,General Contractors,13750,5000,18750
A000369,N00031177,Mark Amodei (R),2014,Automotive,7950,10000,17950
B001275,N00031227,Larry Bucshon (R),2014,Health Professionals,9450,143000,152450
B001275,N00031227,Larry Bucshon (R),2014,Mining,59500,26000,85500
B001275,N00031227,Larry Bucshon (R),2014,Building Materials & Equipment,38950,13000,51950
B001275,N00031227,Larry Bucshon (R),2014,Real Estate,26192,12500,38692
B001275,N00031227,Larry Bucshon (R),2014,Insurance,18900,18000,36900
B001275,N00031227,Larry Bucshon (R),2014,Leadership PACs,0,33678,33678
B001275,N00031227,Larry Bucshon (R),2014,Construction Services,24000,7000,31000
B001275,N00031227,Larry Bucshon (R),2014,Railroads,3500,27000,30500
B001275,N00031227,Larry Bucshon (R),2014,Misc Manufacturing & Distributing,24550,5500,30050
B001275,N00031227,Larry Bucshon (R),2014,Electric Utilities,3500,23250,26750
B001282,N00031233,Andy Barr (R),2014,Mining,151960,64500,216460
B001282,N00031233,Andy Barr (R),2014,Securities & Investment,106650,70500,177150
B001282,N00031233,Andy Barr (R),2014,Insurance,32242,122400,154642
B001282,N00031233,Andy Barr (R),2014,Retired,149420,0,149420
B001282,N00031233,Andy Barr (R),2014,Commercial Banks,41450,103250,144700
B001282,N00031233,Andy Barr (R),2014,Health Professionals,56005,84750,140755
B001282,N00031233,Andy Barr (R),2014,Real Estate,57150,56240,113390
B001282,N00031233,Andy Barr (R),2014,Leadership PACs,0,103058,103058
B001282,N00031233,Andy Barr (R),2014,Lawyers/Law Firms,62236,15250,77486
B001282,N00031233,Andy Barr (R),2014,Crop Production & Basic Processing,49530,5500,55030
H001055,N00031244,Joe Heck (R),2014,Health Professionals,150445,179099,329544
H001055,N00031244,Joe Heck (R),2014,Leadership PACs,0,183944,183944
H001055,N00031244,Joe Heck (R),2014,Casinos/Gambling,115918,49772,165690
H001055,N00031244,Joe Heck (R),2014,Retired,109435,0,109435
H001055,N00031244,Joe Heck (R),2014,Real Estate,55359,31890,87249
H001055,N00031244,Joe Heck (R),2014,Misc Issues,62750,1000,63750
H001055,N00031244,Joe Heck (R),2014,Defense Aerospace,500,54998,55498
H001055,N00031244,Joe Heck (R),2014,Insurance,6067,44500,50567
H001055,N00031244,Joe Heck (R),2014,Lawyers/Law Firms,29210,21000,50210
H001055,N00031244,Joe Heck (R),2014,General Contractors,34200,15500,49700
H001060,N00031265,Robert Hurt (R),2014,Insurance,2500,103000,105500
H001060,N00031265,Robert Hurt (R),2014,Securities & Investment,13100,87500,100600
H001060,N00031265,Robert Hurt (R),2014,Commercial Banks,10100,71000,81100
H001060,N00031265,Robert Hurt (R),2014,Retired,77252,0,77252
H001060,N00031265,Robert Hurt (R),2014,Real Estate,23750,51000,74750
H001060,N00031265,Robert Hurt (R),2014,Leadership PACs,0,45352,45352
H001060,N00031265,Robert Hurt (R),2014,Accountants,1250,41499,42749
H001060,N00031265,Robert Hurt (R),2014,Finance/Credit Companies,2000,28500,30500
H001060,N00031265,Robert Hurt (R),2014,Lawyers/Law Firms,18150,11750,29900
H001060,N00031265,Robert Hurt (R),2014,Electric Utilities,0,29000,29000
G000567,N00031297,Tim Griffin (R),2014,Oil & Gas,12450,34000,46450
G000567,N00031297,Tim Griffin (R),2014,Health Professionals,13825,30000,43825
G000567,N00031297,Tim Griffin (R),2014,Securities & Investment,22850,19500,42350
G000567,N00031297,Tim Griffin (R),2014,Commercial Banks,13800,17000,30800
G000567,N00031297,Tim Griffin (R),2014,Leadership PACs,0,25588,25588
G000567,N00031297,Tim Griffin (R),2014,Insurance,2750,22000,24750
G000567,N00031297,Tim Griffin (R),2014,Retail Sales,7600,11500,19100
G000567,N00031297,Tim Griffin (R),2014,Real Estate,5000,13500,18500
G000567,N00031297,Tim Griffin (R),2014,Pharmaceuticals/Health Products,0,18000,18000
G000567,N00031297,Tim Griffin (R),2014,Lobbyists,17900,0,17900
D000610,N00031317,Ted Deutch (D),2014,Lawyers/Law Firms,85300,25333,110633
D000610,N00031317,Ted Deutch (D),2014,Pro-Israel,75170,27700,102870
D000610,N00031317,Ted Deutch (D),2014,Securities & Investment,100110,2500,102610
D000610,N00031317,Ted Deutch (D),2014,Real Estate,53787,12000,65787
D000610,N00031317,Ted Deutch (D),2014,TV/Movies/Music,23600,38000,61600
D000610,N00031317,Ted Deutch (D),2014,Retired,47518,0,47518
D000610,N00031317,Ted Deutch (D),2014,Industrial Unions,0,32000,32000
D000610,N00031317,Ted Deutch (D),2014,Misc Finance,29200,0,29200
D000610,N00031317,Ted Deutch (D),2014,Health Professionals,12000,11500,23500
D000610,N00031317,Ted Deutch (D),2014,Retail Sales,6400,15500,21900
G000569,N00031401,Michael Grimm (R),2014,Real Estate,161731,71500,233231
G000569,N00031401,Michael Grimm (R),2014,Leadership PACs,0,123000,123000
G000569,N00031401,Michael Grimm (R),2014,Securities & Investment,78700,39000,117700
G000569,N00031401,Michael Grimm (R),2014,Transportation Unions,0,103500,103500
G000569,N00031401,Michael Grimm (R),2014,Insurance,6642,90000,96642
G000569,N00031401,Michael Grimm (R),2014,Building Trade Unions,0,62000,62000
G000569,N00031401,Michael Grimm (R),2014,Accountants,8064,45000,53064
G000569,N00031401,Michael Grimm (R),2014,Commercial Banks,9564,41000,50564
G000569,N00031401,Michael Grimm (R),2014,Lawyers/Law Firms,34325,10900,45225
G000569,N00031401,Michael Grimm (R),2014,Retired,44066,0,44066
E000291,N00031513,Renee Ellmers (R),2014,Health Professionals,21600,202450,224050
E000291,N00031513,Renee Ellmers (R),2014,Pharmaceuticals/Health Products,0,150783,150783
E000291,N00031513,Renee Ellmers (R),2014,Leadership PACs,0,89250,89250
E000291,N00031513,Renee Ellmers (R),2014,Insurance,7650,55000,62650
E000291,N00031513,Renee Ellmers (R),2014,Oil & Gas,750,61000,61750
E000291,N00031513,Renee Ellmers (R),2014,Retail Sales,4300,48000,52300
E000291,N00031513,Renee Ellmers (R),2014,Lobbyists,43400,2000,45400
E000291,N00031513,Renee Ellmers (R),2014,Health Services/HMOs,0,45000,45000
E000291,N00031513,Renee Ellmers (R),2014,Electric Utilities,1000,43000,44000
E000291,N00031513,Renee Ellmers (R),2014,Lawyers/Law Firms,12500,31150,43650
B001273,N00031539,Diane Black (R),2014,Health Professionals,10000,112500,122500
B001273,N00031539,Diane Black (R),2014,Insurance,27650,91999,119649
B001273,N00031539,Diane Black (R),2014,Pharmaceuticals/Health Products,2971,88598,91569
B001273,N00031539,Diane Black (R),2014,Oil & Gas,2375,56000,58375
B001273,N00031539,Diane Black (R),2014,Health Services/HMOs,11200,40000,51200
B001273,N00031539,Diane Black (R),2014,Real Estate,2950,39490,42440
B001273,N00031539,Diane Black (R),2014,Special Trade Contractors,38400,3000,41400
B001273,N00031539,Diane Black (R),2014,Retail Sales,1000,34500,35500
B001273,N00031539,Diane Black (R),2014,"Beer, Wine & Liquor",8550,26500,35050
B001273,N00031539,Diane Black (R),2014,Lawyers/Law Firms,24600,10275,34875
F000461,N00031545,Bill Flores (R),2014,Oil & Gas,73539,117000,190539
F000461,N00031545,Bill Flores (R),2014,Health Professionals,15800,89100,104900
F000461,N00031545,Bill Flores (R),2014,Retired,75750,0,75750
F000461,N00031545,Bill Flores (R),2014,Accountants,250,46000,46250
F000461,N00031545,Bill Flores (R),2014,Electric Utilities,10800,32499,43299
F000461,N00031545,Bill Flores (R),2014,Insurance,15840,23500,39340
F000461,N00031545,Bill Flores (R),2014,Lawyers/Law Firms,27600,9500,37100
F000461,N00031545,Bill Flores (R),2014,Misc Energy,31850,0,31850
F000461,N00031545,Bill Flores (R),2014,Air Transport,500,30500,31000
F000461,N00031545,Bill Flores (R),2014,Real Estate,12300,18000,30300
H001064,N00031557,Dennis Heck (D),2014,Securities & Investment,30650,75000,105650
H001064,N00031557,Dennis Heck (D),2014,Retired,92265,0,92265
H001064,N00031557,Dennis Heck (D),2014,Lobbyists,86393,2000,88393
H001064,N00031557,Dennis Heck (D),2014,Real Estate,22250,63000,85250
H001064,N00031557,Dennis Heck (D),2014,Lawyers/Law Firms,53362,19500,72862
H001064,N00031557,Dennis Heck (D),2014,Commercial Banks,4800,60500,65300
H001064,N00031557,Dennis Heck (D),2014,Building Trade Unions,0,58000,58000
H001064,N00031557,Dennis Heck (D),2014,Insurance,2500,55500,58000
H001064,N00031557,Dennis Heck (D),2014,Health Professionals,17401,37500,54901
H001064,N00031557,Dennis Heck (D),2014,Public Sector Unions,500,49000,49500
H001056,N00031559,Jaime Herrera Beutler (R),2014,Retired,126475,0,126475
H001056,N00031559,Jaime Herrera Beutler (R),2014,Leadership PACs,0,102857,102857
H001056,N00031559,Jaime Herrera Beutler (R),2014,Securities & Investment,63550,6500,70050
H001056,N00031559,Jaime Herrera Beutler (R),2014,Real Estate,48750,14000,62750
H001056,N00031559,Jaime Herrera Beutler (R),2014,Forestry & Forest Products,29933,28500,58433
H001056,N00031559,Jaime Herrera Beutler (R),2014,General Contractors,29000,12000,41000
H001056,N00031559,Jaime Herrera Beutler (R),2014,Republican/Conservative,26650,10000,36650
H001056,N00031559,Jaime Herrera Beutler (R),2014,Health Professionals,12500,20000,32500
H001056,N00031559,Jaime Herrera Beutler (R),2014,Defense Aerospace,0,31000,31000
H001056,N00031559,Jaime Herrera Beutler (R),2014,Candidate Committees,0,31000,31000
D000612,N00031593,Jeff Denham (R),2014,Crop Production & Basic Processing,204417,92100,296517
D000612,N00031593,Jeff Denham (R),2014,Leadership PACs,0,208045,208045
D000612,N00031593,Jeff Denham (R),2014,Casinos/Gambling,103300,9500,112800
D000612,N00031593,Jeff Denham (R),2014,Dairy,56962,32133,89095
D000612,N00031593,Jeff Denham (R),2014,Railroads,27050,61000,88050
D000612,N00031593,Jeff Denham (R),2014,Real Estate,56509,31500,88009
D000612,N00031593,Jeff Denham (R),2014,Agricultural Services/Products,19650,59357,79007
D000612,N00031593,Jeff Denham (R),2014,Air Transport,1000,67500,68500
D000612,N00031593,Jeff Denham (R),2014,Oil & Gas,9200,55598,64798
D000612,N00031593,Jeff Denham (R),2014,Securities & Investment,37672,26000,63672
F000460,N00031672,Blake Farenthold (R),2014,Oil & Gas,41375,50000,91375
F000460,N00031672,Blake Farenthold (R),2014,Retired,52810,0,52810
F000460,N00031672,Blake Farenthold (R),2014,Health Professionals,35698,16500,52198
F000460,N00031672,Blake Farenthold (R),2014,Air Transport,500,50000,50500
F000460,N00031672,Blake Farenthold (R),2014,General Contractors,39700,7500,47200
F000460,N00031672,Blake Farenthold (R),2014,"Beer, Wine & Liquor",24700,13899,38599
F000460,N00031672,Blake Farenthold (R),2014,Automotive,15800,15000,30800
F000460,N00031672,Blake Farenthold (R),2014,Insurance,9700,20500,30200
F000460,N00031672,Blake Farenthold (R),2014,Real Estate,15400,13000,28400
F000460,N00031672,Blake Farenthold (R),2014,Crop Production & Basic Processing,3300,24750,28050
B001277,N00031685,Richard Blumenthal (D),2014,Lawyers/Law Firms,674426,66500,740926
B001277,N00031685,Richard Blumenthal (D),2014,Securities & Investment,678897,36100,714997
B001277,N00031685,Richard Blumenthal (D),2014,Retired,585841,0,585841
B001277,N00031685,Richard Blumenthal (D),2014,Real Estate,493005,21000,514005
B001277,N00031685,Richard Blumenthal (D),2014,Health Professionals,139239,131250,270489
B001277,N00031685,Richard Blumenthal (D),2014,Leadership PACs,0,210400,210400
B001277,N00031685,Richard Blumenthal (D),2014,Lobbyists,164100,14000,178100
B001277,N00031685,Richard Blumenthal (D),2014,Education,175950,0,175950
B001277,N00031685,Richard Blumenthal (D),2014,Telecom Services,89750,81250,171000
B001277,N00031685,Richard Blumenthal (D),2014,Misc Finance,149800,1000,150800
H001061,N00031688,John Hoeven (R),2014,Oil & Gas,198389,143998,342387
H001061,N00031688,John Hoeven (R),2014,Retired,240160,0,240160
H001061,N00031688,John Hoeven (R),2014,Leadership PACs,1000,212521,213521
H001061,N00031688,John Hoeven (R),2014,Mining,124881,71875,196756
H001061,N00031688,John Hoeven (R),2014,Insurance,62800,113050,175850
H001061,N00031688,John Hoeven (R),2014,Misc Manufacturing & Distributing,114900,31500,146400
H001061,N00031688,John Hoeven (R),2014,Securities & Investment,126300,16000,142300
H001061,N00031688,John Hoeven (R),2014,Real Estate,96310,32000,128310
H001061,N00031688,John Hoeven (R),2014,Health Professionals,50500,73000,123500
H001061,N00031688,John Hoeven (R),2014,Electric Utilities,40126,79500,119626
C001088,N00031820,Chris Coons (D),2014,Lawyers/Law Firms,1565340,188390,1753730
C001088,N00031820,Chris Coons (D),2014,Leadership PACs,0,587900,587900
C001088,N00031820,Chris Coons (D),2014,Securities & Investment,394199,88000,482199
C001088,N00031820,Chris Coons (D),2014,Lobbyists,373197,24330,397527
C001088,N00031820,Chris Coons (D),2014,Real Estate,211100,62500,273600
C001088,N00031820,Chris Coons (D),2014,Pharmaceuticals/Health Products,75200,189000,264200
C001088,N00031820,Chris Coons (D),2014,Commercial Banks,103200,122050,225250
C001088,N00031820,Chris Coons (D),2014,Retired,219749,0,219749
C001088,N00031820,Chris Coons (D),2014,Insurance,42477,169000,211477
C001088,N00031820,Chris Coons (D),2014,Health Professionals,131500,78000,209500
B001270,N00031877,Karen Bass (D),2014,TV/Movies/Music,103150,38499,141649
B001270,N00031877,Karen Bass (D),2014,Lawyers/Law Firms,54700,25000,79700
B001270,N00031877,Karen Bass (D),2014,Business Services,38150,2000,40150
B001270,N00031877,Karen Bass (D),2014,Retired,40150,0,40150
B001270,N00031877,Karen Bass (D),2014,Real Estate,31300,8000,39300
B001270,N00031877,Karen Bass (D),2014,Health Professionals,14010,22500,36510
B001270,N00031877,Karen Bass (D),2014,Industrial Unions,0,35000,35000
B001270,N00031877,Karen Bass (D),2014,Public Sector Unions,0,34500,34500
B001270,N00031877,Karen Bass (D),2014,Securities & Investment,24950,8000,32950
B001270,N00031877,Karen Bass (D),2014,Building Trade Unions,0,32500,32500
B001271,N00031934,Dan Benishek (R),2014,Leadership PACs,500,220447,220947
B001271,N00031934,Dan Benishek (R),2014,Health Professionals,58800,144500,203300
B001271,N00031934,Dan Benishek (R),2014,Oil & Gas,42200,59500,101700
B001271,N00031934,Dan Benishek (R),2014,Real Estate,46250,16600,62850
B001271,N00031934,Dan Benishek (R),2014,Casinos/Gambling,60100,0,60100
B001271,N00031934,Dan Benishek (R),2014,Retired,57681,0,57681
B001271,N00031934,Dan Benishek (R),2014,Electric Utilities,10877,46500,57377
B001271,N00031934,Dan Benishek (R),2014,Securities & Investment,45050,11000,56050
B001271,N00031934,Dan Benishek (R),2014,Forestry & Forest Products,1500,48200,49700
B001271,N00031934,Dan Benishek (R),2014,Retail Sales,35050,9000,44050
A000367,N00031938,Justin Amash (R),2014,Republican/Conservative,246515,33500,280015
A000367,N00031938,Justin Amash (R),2014,Misc Manufacturing & Distributing,90765,1000,91765
A000367,N00031938,Justin Amash (R),2014,Retired,83882,0,83882
A000367,N00031938,Justin Amash (R),2014,Securities & Investment,72700,0,72700
A000367,N00031938,Justin Amash (R),2014,Health Professionals,51209,0,51209
A000367,N00031938,Justin Amash (R),2014,Retail Sales,46770,0,46770
A000367,N00031938,Justin Amash (R),2014,Real Estate,43300,2000,45300
A000367,N00031938,Justin Amash (R),2014,Food Processing & Sales,33400,1000,34400
A000367,N00031938,Justin Amash (R),2014,Lawyers/Law Firms,29550,2750,32300
A000367,N00031938,Justin Amash (R),2014,Leadership PACs,0,29400,29400
G000564,N00031998,Chris Gibson (R),2014,Securities & Investment,236258,41000,277258
G000564,N00031998,Chris Gibson (R),2014,Leadership PACs,0,247545,247545
G000564,N00031998,Chris Gibson (R),2014,Retired,143969,0,143969
G000564,N00031998,Chris Gibson (R),2014,Insurance,34373,72500,106873
G000564,N00031998,Chris Gibson (R),2014,Health Professionals,27600,72000,99600
G000564,N00031998,Chris Gibson (R),2014,Lawyers/Law Firms,71337,16599,87936
G000564,N00031998,Chris Gibson (R),2014,Lobbyists,75541,2000,77541
G000564,N00031998,Chris Gibson (R),2014,Crop Production & Basic Processing,39850,36000,75850
G000564,N00031998,Chris Gibson (R),2014,Defense Aerospace,1000,71000,72000
G000564,N00031998,Chris Gibson (R),2014,Real Estate,44334,26000,70334
C001084,N00032019,David Cicilline (D),2014,Lawyers/Law Firms,112000,13000,125000
C001084,N00032019,David Cicilline (D),2014,Retired,107050,0,107050
C001084,N00032019,David Cicilline (D),2014,Real Estate,59700,10500,70200
C001084,N00032019,David Cicilline (D),2014,Securities & Investment,48600,1000,49600
C001084,N00032019,David Cicilline (D),2014,Building Trade Unions,0,45500,45500
C001084,N00032019,David Cicilline (D),2014,TV/Movies/Music,30600,7000,37600
C001084,N00032019,David Cicilline (D),2014,Lobbyists,34250,0,34250
C001084,N00032019,David Cicilline (D),2014,Business Services,30500,2500,33000
C001084,N00032019,David Cicilline (D),2014,Public Sector Unions,1500,29000,30500
C001084,N00032019,David Cicilline (D),2014,Misc Manufacturing & Distributing,18400,12000,30400
G000568,N00032029,Morgan Griffith (R),2014,Health Professionals,8200,59000,67200
G000568,N00032029,Morgan Griffith (R),2014,Electric Utilities,5000,57000,62000
G000568,N00032029,Morgan Griffith (R),2014,Oil & Gas,2000,54000,56000
G000568,N00032029,Morgan Griffith (R),2014,Retired,52708,0,52708
G000568,N00032029,Morgan Griffith (R),2014,Telecom Services,1750,37000,38750
G000568,N00032029,Morgan Griffith (R),2014,Mining,8150,29000,37150
G000568,N00032029,Morgan Griffith (R),2014,Lawyers/Law Firms,23850,9753,33603
G000568,N00032029,Morgan Griffith (R),2014,Retail Sales,11593,18000,29593
G000568,N00032029,Morgan Griffith (R),2014,Misc Manufacturing & Distributing,7850,18500,26350
G000568,N00032029,Morgan Griffith (R),2014,Chemical & Related Manufacturing,3800,21500,25300
D000618,N00033054,Steven Daines (R),2014,Retired,575579,0,575579
D000618,N00033054,Steven Daines (R),2014,Securities & Investment,476725,35000,511725
D000618,N00033054,Steven Daines (R),2014,Oil & Gas,242569,167500,410069
D000618,N00033054,Steven Daines (R),2014,Leadership PACs,0,327267,327267
D000618,N00033054,Steven Daines (R),2014,Real Estate,229825,22500,252325
D000618,N00033054,Steven Daines (R),2014,Republican/Conservative,131675,52851,184526
D000618,N00033054,Steven Daines (R),2014,General Contractors,151250,22500,173750
D000618,N00033054,Steven Daines (R),2014,Commercial Banks,69950,86100,156050
D000618,N00033054,Steven Daines (R),2014,Livestock,126425,18500,144925
D000618,N00033054,Steven Daines (R),2014,Mining,81550,59750,141300
C001098,N00033085,Ted Cruz (R),2014,Republican/Conservative,1498270,115331,1613601
C001098,N00033085,Ted Cruz (R),2014,Oil & Gas,833982,181000,1014982
C001098,N00033085,Ted Cruz (R),2014,Lawyers/Law Firms,879995,57249,937244
C001098,N00033085,Ted Cruz (R),2014,Retired,824750,0,824750
C001098,N00033085,Ted Cruz (R),2014,Securities & Investment,751867,24500,776367
C001098,N00033085,Ted Cruz (R),2014,Real Estate,584165,24000,608165
C001098,N00033085,Ted Cruz (R),2014,Misc Finance,486739,3500,490239
C001098,N00033085,Ted Cruz (R),2014,Health Professionals,326121,38000,364121
C001098,N00033085,Ted Cruz (R),2014,Business Services,308022,8000,316022
C001098,N00033085,Ted Cruz (R),2014,Misc Business,295827,10500,306327
E000293,N00033217,Elizabeth Esty (D),2014,Lawyers/Law Firms,226350,27033,253383
E000293,N00033217,Elizabeth Esty (D),2014,Leadership PACs,8800,191636,200436
E000293,N00033217,Elizabeth Esty (D),2014,Retired,171300,0,171300
E000293,N00033217,Elizabeth Esty (D),2014,Securities & Investment,156100,4500,160600
E000293,N00033217,Elizabeth Esty (D),2014,Women's Issues,108810,15000,123810
E000293,N00033217,Elizabeth Esty (D),2014,Health Professionals,31331,61500,92831
E000293,N00033217,Elizabeth Esty (D),2014,Education,84026,0,84026
E000293,N00033217,Elizabeth Esty (D),2014,Business Services,77700,2500,80200
E000293,N00033217,Elizabeth Esty (D),2014,Candidate Committees,0,74226,74226
E000293,N00033217,Elizabeth Esty (D),2014,Transportation Unions,0,68550,68550
G000571,N00033281,Tulsi Gabbard (D),2014,Securities & Investment,85057,0,85057
G000571,N00033281,Tulsi Gabbard (D),2014,Health Professionals,60609,6500,67109
G000571,N00033281,Tulsi Gabbard (D),2014,Real Estate,50435,14000,64435
G000571,N00033281,Tulsi Gabbard (D),2014,Lawyers/Law Firms,43207,14500,57707
G000571,N00033281,Tulsi Gabbard (D),2014,Retired,56003,0,56003
G000571,N00033281,Tulsi Gabbard (D),2014,Building Trade Unions,0,48500,48500
G000571,N00033281,Tulsi Gabbard (D),2014,Public Sector Unions,0,43000,43000
G000571,N00033281,Tulsi Gabbard (D),2014,Women's Issues,36050,3107,39157
G000571,N00033281,Tulsi Gabbard (D),2014,Sea Transport,26900,10000,36900
G000571,N00033281,Tulsi Gabbard (D),2014,TV/Movies/Music,34550,2000,36550
C001091,N00033316,Joaquin Castro (D),2014,Lawyers/Law Firms,111500,31500,143000
C001091,N00033316,Joaquin Castro (D),2014,Real Estate,29867,21500,51367
C001091,N00033316,Joaquin Castro (D),2014,Health Professionals,20800,24500,45300
C001091,N00033316,Joaquin Castro (D),2014,Oil & Gas,11500,29000,40500
C001091,N00033316,Joaquin Castro (D),2014,Defense Aerospace,1000,38500,39500
C001091,N00033316,Joaquin Castro (D),2014,Insurance,1250,37500,38750
C001091,N00033316,Joaquin Castro (D),2014,Retail Sales,12500,19000,31500
C001091,N00033316,Joaquin Castro (D),2014,Automotive,3750,26500,30250
C001091,N00033316,Joaquin Castro (D),2014,Securities & Investment,17170,12500,29670
C001091,N00033316,Joaquin Castro (D),2014,Lobbyists,26250,500,26750
C001095,N00033363,Tom Cotton (R),2014,Securities & Investment,1044900,58750,1103650
C001095,N00033363,Tom Cotton (R),2014,Retired,1032476,0,1032476
C001095,N00033363,Tom Cotton (R),2014,Republican/Conservative,817817,80433,898250
C001095,N00033363,Tom Cotton (R),2014,Leadership PACs,22300,416671,438971
C001095,N00033363,Tom Cotton (R),2014,Oil & Gas,348005,84600,432605
C001095,N00033363,Tom Cotton (R),2014,Real Estate,392855,25000,417855
C001095,N00033363,Tom Cotton (R),2014,Lawyers/Law Firms,331422,40365,371787
C001095,N00033363,Tom Cotton (R),2014,Health Professionals,263001,53000,316001
C001095,N00033363,Tom Cotton (R),2014,Commercial Banks,163735,139000,302735
C001095,N00033363,Tom Cotton (R),2014,Misc Finance,269750,7000,276750
C001097,N00033373,Tony Cardenas (D),2014,Casinos/Gambling,96000,2000,98000
C001097,N00033373,Tony Cardenas (D),2014,Real Estate,48150,11500,59650
C001097,N00033373,Tony Cardenas (D),2014,Democratic/Liberal,46130,10000,56130
C001097,N00033373,Tony Cardenas (D),2014,Health Professionals,22600,18000,40600
C001097,N00033373,Tony Cardenas (D),2014,Public Sector Unions,0,38500,38500
C001097,N00033373,Tony Cardenas (D),2014,Building Trade Unions,0,37500,37500
C001097,N00033373,Tony Cardenas (D),2014,TV/Movies/Music,19000,17833,36833
C001097,N00033373,Tony Cardenas (D),2014,Pharmaceuticals/Health Products,3100,29500,32600
C001097,N00033373,Tony Cardenas (D),2014,Lawyers/Law Firms,20150,7000,27150
C001097,N00033373,Tony Cardenas (D),2014,Accountants,7750,17952,25702
B001286,N00033390,Cheri Bustos (D),2014,Leadership PACs,14100,224543,238643
B001286,N00033390,Cheri Bustos (D),2014,Lawyers/Law Firms,147214,27000,174214
B001286,N00033390,Cheri Bustos (D),2014,Women's Issues,100360,24500,124860
B001286,N00033390,Cheri Bustos (D),2014,Retired,117507,0,117507
B001286,N00033390,Cheri Bustos (D),2014,Candidate Committees,0,85000,85000
B001286,N00033390,Cheri Bustos (D),2014,Pro-Israel,71753,10797,82550
B001286,N00033390,Cheri Bustos (D),2014,Transportation Unions,0,82000,82000
B001286,N00033390,Cheri Bustos (D),2014,Securities & Investment,46922,29000,75922
B001286,N00033390,Cheri Bustos (D),2014,Building Trade Unions,800,73900,74700
B001286,N00033390,Cheri Bustos (D),2014,Air Transport,1550,70498,72048
H001065,N00033399,George Holding (R),2014,Lawyers/Law Firms,89742,21750,111492
H001065,N00033399,George Holding (R),2014,Health Professionals,66713,26500,93213
H001065,N00033399,George Holding (R),2014,Retired,78550,0,78550
H001065,N00033399,George Holding (R),2014,Real Estate,43800,17000,60800
H001065,N00033399,George Holding (R),2014,Commercial Banks,29480,24500,53980
H001065,N00033399,George Holding (R),2014,Insurance,10950,31600,42550
H001065,N00033399,George Holding (R),2014,Electronics Mfg & Equip,6250,32500,38750
H001065,N00033399,George Holding (R),2014,Automotive,23050,14500,37550
H001065,N00033399,George Holding (R),2014,TV/Movies/Music,6500,31000,37500
H001065,N00033399,George Holding (R),2014,Lobbyists,34650,1000,35650
F000463,N00033443,Deb Fischer (R),2014,Retired,334917,0,334917
F000463,N00033443,Deb Fischer (R),2014,Leadership PACs,200,259482,259682
F000463,N00033443,Deb Fischer (R),2014,Republican/Conservative,148771,45500,194271
F000463,N00033443,Deb Fischer (R),2014,Crop Production & Basic Processing,127860,49552,177412
F000463,N00033443,Deb Fischer (R),2014,Insurance,74250,83500,157750
F000463,N00033443,Deb Fischer (R),2014,Commercial Banks,81250,75500,156750
F000463,N00033443,Deb Fischer (R),2014,Health Professionals,104799,37000,141799
F000463,N00033443,Deb Fischer (R),2014,Securities & Investment,121542,9500,131042
F000463,N00033443,Deb Fischer (R),2014,Agricultural Services/Products,67200,59500,126700
F000463,N00033443,Deb Fischer (R),2014,Oil & Gas,68034,57000,125034
B001278,N00033474,Suzanne Bonamici (D),2014,Lawyers/Law Firms,80600,18500,99100
B001278,N00033474,Suzanne Bonamici (D),2014,Public Sector Unions,0,56750,56750
B001278,N00033474,Suzanne Bonamici (D),2014,Health Professionals,7350,41500,48850
B001278,N00033474,Suzanne Bonamici (D),2014,Retired,46800,0,46800
B001278,N00033474,Suzanne Bonamici (D),2014,Building Trade Unions,0,41500,41500
B001278,N00033474,Suzanne Bonamici (D),2014,Misc Manufacturing & Distributing,8350,25000,33350
B001278,N00033474,Suzanne Bonamici (D),2014,Transportation Unions,0,30500,30500
B001278,N00033474,Suzanne Bonamici (D),2014,Industrial Unions,0,29500,29500
B001278,N00033474,Suzanne Bonamici (D),2014,Electronics Mfg & Equip,7200,17000,24200
B001278,N00033474,Suzanne Bonamici (D),2014,Railroads,8050,15500,23550
B001284,N00033495,Susan Brooks (R),2014,Lawyers/Law Firms,75850,20500,96350
B001284,N00033495,Susan Brooks (R),2014,Securities & Investment,37925,35000,72925
B001284,N00033495,Susan Brooks (R),2014,Real Estate,32250,33200,65450
B001284,N00033495,Susan Brooks (R),2014,Health Professionals,27050,37500,64550
B001284,N00033495,Susan Brooks (R),2014,Leadership PACs,0,63698,63698
B001284,N00033495,Susan Brooks (R),2014,Insurance,10550,44600,55150
B001284,N00033495,Susan Brooks (R),2014,Pharmaceuticals/Health Products,26900,24500,51400
B001284,N00033495,Susan Brooks (R),2014,Retired,47350,0,47350
B001284,N00033495,Susan Brooks (R),2014,Lobbyists,31975,9500,41475
B001284,N00033495,Susan Brooks (R),2014,Retail Sales,8500,30500,39000
C001093,N00033518,Doug Collins (R),2014,Health Professionals,21950,25500,47450
C001093,N00033518,Doug Collins (R),2014,TV/Movies/Music,10000,24000,34000
C001093,N00033518,Doug Collins (R),2014,Insurance,5800,26000,31800
C001093,N00033518,Doug Collins (R),2014,Lawyers/Law Firms,17450,11750,29200
C001093,N00033518,Doug Collins (R),2014,Retail Sales,6850,22000,28850
C001093,N00033518,Doug Collins (R),2014,Retired,27318,0,27318
C001093,N00033518,Doug Collins (R),2014,Leadership PACs,0,24707,24707
C001093,N00033518,Doug Collins (R),2014,Food & Beverage,250,23491,23741
C001093,N00033518,Doug Collins (R),2014,Real Estate,14200,8000,22200
C001093,N00033518,Doug Collins (R),2014,Telecom Services,1500,20000,21500
B001283,N00033532,James Bridenstine (R),2014,Oil & Gas,29000,38500,67500
B001283,N00033532,James Bridenstine (R),2014,Health Professionals,30950,23000,53950
B001283,N00033532,James Bridenstine (R),2014,Defense Aerospace,1250,40000,41250
B001283,N00033532,James Bridenstine (R),2014,Retired,36350,0,36350
B001283,N00033532,James Bridenstine (R),2014,Republican/Conservative,10750,20738,31488
B001283,N00033532,James Bridenstine (R),2014,Defense Electronics,0,21000,21000
B001283,N00033532,James Bridenstine (R),2014,Leadership PACs,0,18000,18000
B001283,N00033532,James Bridenstine (R),2014,Education,17815,0,17815
B001283,N00033532,James Bridenstine (R),2014,Lawyers/Law Firms,13550,3403,16953
B001283,N00033532,James Bridenstine (R),2014,Misc Defense,6250,10500,16750
G000572,N00033541,Pete Gallego (D),2014,Leadership PACs,0,191100,191100
G000572,N00033541,Pete Gallego (D),2014,Lawyers/Law Firms,154248,27100,181348
G000572,N00033541,Pete Gallego (D),2014,Candidate Committees,0,80966,80966
G000572,N00033541,Pete Gallego (D),2014,"Beer, Wine & Liquor",52600,23000,75600
G000572,N00033541,Pete Gallego (D),2014,Public Sector Unions,0,71000,71000
G000572,N00033541,Pete Gallego (D),2014,Health Professionals,32350,30500,62850
G000572,N00033541,Pete Gallego (D),2014,Building Trade Unions,0,53500,53500
G000572,N00033541,Pete Gallego (D),2014,Securities & Investment,28250,23500,51750
G000572,N00033541,Pete Gallego (D),2014,Democratic/Liberal,29817,20150,49967
G000572,N00033541,Pete Gallego (D),2014,Real Estate,36689,13000,49689
B001280,N00033625,Kerry Bentivolio (R),2014,Republican/Conservative,28476,36780,65256
B001280,N00033625,Kerry Bentivolio (R),2014,Retired,37250,0,37250
B001280,N00033625,Kerry Bentivolio (R),2014,Leadership PACs,0,33500,33500
B001280,N00033625,Kerry Bentivolio (R),2014,Real Estate,19550,2000,21550
B001280,N00033625,Kerry Bentivolio (R),2014,Automotive,14450,5000,19450
B001280,N00033625,Kerry Bentivolio (R),2014,Building Materials & Equipment,15200,0,15200
B001280,N00033625,Kerry Bentivolio (R),2014,Misc Finance,15150,0,15150
B001280,N00033625,Kerry Bentivolio (R),2014,Electric Utilities,500,13000,13500
B001280,N00033625,Kerry Bentivolio (R),2014,Candidate Committees,0,12000,12000
B001280,N00033625,Kerry Bentivolio (R),2014,Misc Manufacturing & Distributing,9450,2000,11450
A000372,N00033720,Richard W Allen (R),2014,Retired,117450,0,117450
A000372,N00033720,Richard W Allen (R),2014,Leadership PACs,0,103000,103000
A000372,N00033720,Richard W Allen (R),2014,Health Professionals,88000,1000,89000
A000372,N00033720,Richard W Allen (R),2014,Real Estate,80675,0,80675
A000372,N00033720,Richard W Allen (R),2014,General Contractors,55250,17500,72750
A000372,N00033720,Richard W Allen (R),2014,Oil & Gas,31750,2500,34250
A000372,N00033720,Richard W Allen (R),2014,Candidate Committees,0,31500,31500
A000372,N00033720,Richard W Allen (R),2014,Lawyers/Law Firms,27950,1000,28950
A000372,N00033720,Richard W Allen (R),2014,Automotive,22700,4500,27200
A000372,N00033720,Richard W Allen (R),2014,Securities & Investment,26950,0,26950
B001294,N00033744,Rod Blum (R),2014,Leadership PACs,0,93700,93700
B001294,N00033744,Rod Blum (R),2014,Retired,71831,0,71831
B001294,N00033744,Rod Blum (R),2014,Real Estate,35637,5000,40637
B001294,N00033744,Rod Blum (R),2014,Republican/Conservative,13320,22000,35320
B001294,N00033744,Rod Blum (R),2014,General Contractors,19350,8000,27350
B001294,N00033744,Rod Blum (R),2014,Trucking,25300,0,25300
B001294,N00033744,Rod Blum (R),2014,Commercial Banks,17849,6000,23849
B001294,N00033744,Rod Blum (R),2014,Crop Production & Basic Processing,20880,2000,22880
B001294,N00033744,Rod Blum (R),2014,Insurance,19050,0,19050
B001294,N00033744,Rod Blum (R),2014,Building Materials & Equipment,19000,0,19000
D000620,N00033897,John K Delaney (D),2014,Securities & Investment,187500,81000,268500
D000620,N00033897,John K Delaney (D),2014,Real Estate,119454,57500,176954
D000620,N00033897,John K Delaney (D),2014,Lawyers/Law Firms,91050,16500,107550
D000620,N00033897,John K Delaney (D),2014,Commercial Banks,39250,61000,100250
D000620,N00033897,John K Delaney (D),2014,Insurance,5250,68000,73250
D000620,N00033897,John K Delaney (D),2014,Misc Finance,60000,13000,73000
D000620,N00033897,John K Delaney (D),2014,Electric Utilities,17000,29500,46500
D000620,N00033897,John K Delaney (D),2014,Accountants,8300,30999,39299
D000620,N00033897,John K Delaney (D),2014,Retired,38050,0,38050
D000620,N00033897,John K Delaney (D),2014,Building Trade Unions,0,36000,36000
B001281,N00033904,Joyce Beatty (D),2014,Insurance,24400,82750,107150
B001281,N00033904,Joyce Beatty (D),2014,Commercial Banks,5050,56500,61550
B001281,N00033904,Joyce Beatty (D),2014,Electric Utilities,7100,47500,54600
B001281,N00033904,Joyce Beatty (D),2014,Lawyers/Law Firms,18950,32500,51450
B001281,N00033904,Joyce Beatty (D),2014,Retail Sales,16500,27500,44000
B001281,N00033904,Joyce Beatty (D),2014,Building Trade Unions,0,40100,40100
B001281,N00033904,Joyce Beatty (D),2014,Real Estate,6500,32000,38500
B001281,N00033904,Joyce Beatty (D),2014,Securities & Investment,4500,31000,35500
B001281,N00033904,Joyce Beatty (D),2014,Pharmaceuticals/Health Products,1000,31750,32750
B001281,N00033904,Joyce Beatty (D),2014,Industrial Unions,0,31000,31000
B001279,N00033981,Ron Barber (D),2014,Retired,293650,0,293650
B001279,N00033981,Ron Barber (D),2014,Leadership PACs,9550,270864,280414
B001279,N00033981,Ron Barber (D),2014,Candidate Committees,0,170764,170764
B001279,N00033981,Ron Barber (D),2014,Health Professionals,18350,117650,136000
B001279,N00033981,Ron Barber (D),2014,Lawyers/Law Firms,85766,27750,113516
B001279,N00033981,Ron Barber (D),2014,Public Sector Unions,250,90500,90750
B001279,N00033981,Ron Barber (D),2014,Democratic/Liberal,42226,39100,81326
B001279,N00033981,Ron Barber (D),2014,Real Estate,59900,16000,75900
B001279,N00033981,Ron Barber (D),2014,Transportation Unions,0,60500,60500
B001279,N00033981,Ron Barber (D),2014,Business Services,59339,500,59839
A000371,N00033997,Pete Aguilar (D),2014,Leadership PACs,4100,141200,145300
A000371,N00033997,Pete Aguilar (D),2014,Lawyers/Law Firms,111269,11250,122519
A000371,N00033997,Pete Aguilar (D),2014,Public Sector Unions,700,84500,85200
A000371,N00033997,Pete Aguilar (D),2014,Real Estate,74496,9000,83496
A000371,N00033997,Pete Aguilar (D),2014,Building Trade Unions,0,73000,73000
A000371,N00033997,Pete Aguilar (D),2014,Retired,65928,0,65928
A000371,N00033997,Pete Aguilar (D),2014,Candidate Committees,0,65500,65500
A000371,N00033997,Pete Aguilar (D),2014,Credit Unions,34050,26000,60050
A000371,N00033997,Pete Aguilar (D),2014,Pro-Israel,54405,5636,60041
A000371,N00033997,Pete Aguilar (D),2014,Democratic/Liberal,35511,13250,48761
C001090,N00034128,Matt Cartwright (D),2014,Lawyers/Law Firms,487740,14000,501740
C001090,N00034128,Matt Cartwright (D),2014,Building Trade Unions,0,65500,65500
C001090,N00034128,Matt Cartwright (D),2014,Public Sector Unions,0,55750,55750
C001090,N00034128,Matt Cartwright (D),2014,Industrial Unions,0,54000,54000
C001090,N00034128,Matt Cartwright (D),2014,Transportation Unions,0,25500,25500
C001090,N00034128,Matt Cartwright (D),2014,Health Professionals,18100,4250,22350
C001090,N00034128,Matt Cartwright (D),2014,Defense Aerospace,0,20000,20000
C001090,N00034128,Matt Cartwright (D),2014,Real Estate,10400,8000,18400
C001090,N00034128,Matt Cartwright (D),2014,Retired,16720,0,16720
C001090,N00034128,Matt Cartwright (D),2014,Insurance,12750,1250,14000
C001094,N00034224,Paul Cook (R),2014,Casinos/Gambling,67400,0,67400
C001094,N00034224,Paul Cook (R),2014,Leadership PACs,0,54700,54700
C001094,N00034224,Paul Cook (R),2014,Defense Aerospace,0,41000,41000
C001094,N00034224,Paul Cook (R),2014,Building Materials & Equipment,15200,25000,40200
C001094,N00034224,Paul Cook (R),2014,Health Professionals,7050,32000,39050
C001094,N00034224,Paul Cook (R),2014,Building Trade Unions,0,37500,37500
C001094,N00034224,Paul Cook (R),2014,Real Estate,26050,6000,32050
C001094,N00034224,Paul Cook (R),2014,Transportation Unions,0,25000,25000
C001094,N00034224,Paul Cook (R),2014,Public Sector Unions,0,24000,24000
C001094,N00034224,Paul Cook (R),2014,Republican/Conservative,0,23500,23500
B001285,N00034254,Julia Brownley (D),2014,Leadership PACs,8600,258588,267188
B001285,N00034254,Julia Brownley (D),2014,Women's Issues,227692,36500,264192
B001285,N00034254,Julia Brownley (D),2014,Retired,243480,0,243480
B001285,N00034254,Julia Brownley (D),2014,Lawyers/Law Firms,136680,15000,151680
B001285,N00034254,Julia Brownley (D),2014,Candidate Committees,0,138500,138500
B001285,N00034254,Julia Brownley (D),2014,Public Sector Unions,0,108800,108800
B001285,N00034254,Julia Brownley (D),2014,Democratic/Liberal,70999,14200,85199
B001285,N00034254,Julia Brownley (D),2014,Environment,55915,20946,76861
B001285,N00034254,Julia Brownley (D),2014,Real Estate,62649,11000,73649
B001285,N00034254,Julia Brownley (D),2014,Transportation Unions,0,68500,68500
D000621,N00034746,Ron DeSantis (R),2014,Retired,94325,0,94325
D000621,N00034746,Ron DeSantis (R),2014,Insurance,28450,55200,83650
D000621,N00034746,Ron DeSantis (R),2014,Health Professionals,45500,8000,53500
D000621,N00034746,Ron DeSantis (R),2014,Lawyers/Law Firms,40312,7250,47562
D000621,N00034746,Ron DeSantis (R),2014,Real Estate,36500,5000,41500
D000621,N00034746,Ron DeSantis (R),2014,Recreation/Live Entertainment,27000,7000,34000
D000621,N00034746,Ron DeSantis (R),2014,Telecom Services,0,33500,33500
D000621,N00034746,Ron DeSantis (R),2014,Misc Manufacturing & Distributing,11450,20500,31950
D000621,N00034746,Ron DeSantis (R),2014,Republican/Conservative,10050,20500,30550
D000621,N00034746,Ron DeSantis (R),2014,TV/Movies/Music,3000,27000,30000
D000619,N00034784,Rodney Davis (R),2014,Leadership PACs,0,278986,278986
D000619,N00034784,Rodney Davis (R),2014,Health Professionals,56700,90750,147450
D000619,N00034784,Rodney Davis (R),2014,Insurance,48450,89500,137950
D000619,N00034784,Rodney Davis (R),2014,Agricultural Services/Products,25949,101908,127857
D000619,N00034784,Rodney Davis (R),2014,Securities & Investment,77100,38500,115600
D000619,N00034784,Rodney Davis (R),2014,Mining,64945,37867,102812
D000619,N00034784,Rodney Davis (R),2014,Food & Beverage,39500,60000,99500
D000619,N00034784,Rodney Davis (R),2014,Crop Production & Basic Processing,33450,60500,93950
D000619,N00034784,Rodney Davis (R),2014,Lawyers/Law Firms,55609,31500,87109
D000619,N00034784,Rodney Davis (R),2014,Oil & Gas,21090,59500,80590
E000292,N00034884,William Enyart (D),2014,Lawyers/Law Firms,273294,27000,300294
E000292,N00034884,William Enyart (D),2014,Leadership PACs,0,194250,194250
E000292,N00034884,William Enyart (D),2014,Candidate Committees,0,81000,81000
E000292,N00034884,William Enyart (D),2014,Public Sector Unions,0,75250,75250
E000292,N00034884,William Enyart (D),2014,Building Trade Unions,3750,67250,71000
E000292,N00034884,William Enyart (D),2014,Industrial Unions,0,58000,58000
E000292,N00034884,William Enyart (D),2014,Pro-Israel,43000,12736,55736
E000292,N00034884,William Enyart (D),2014,Defense Aerospace,0,54498,54498
E000292,N00034884,William Enyart (D),2014,Transportation Unions,0,47000,47000
E000292,N00034884,William Enyart (D),2014,Crop Production & Basic Processing,3950,33000,36950
B001288,N00035267,Cory Booker (D),2014,Lawyers/Law Firms,2165809,150800,2316609
B001288,N00035267,Cory Booker (D),2014,Securities & Investment,2132520,51500,2184020
B001288,N00035267,Cory Booker (D),2014,Real Estate,1043920,26000,1069920
B001288,N00035267,Cory Booker (D),2014,TV/Movies/Music,699880,20500,720380
B001288,N00035267,Cory Booker (D),2014,Misc Finance,443950,13500,457450
B001288,N00035267,Cory Booker (D),2014,Business Services,449435,5000,454435
B001288,N00035267,Cory Booker (D),2014,Pro-Israel,397599,36527,434126
B001288,N00035267,Cory Booker (D),2014,Insurance,236200,103500,339700
B001288,N00035267,Cory Booker (D),2014,Pharmaceuticals/Health Products,167000,161000,328000
B001288,N00035267,Cory Booker (D),2014,Misc Manufacturing & Distributing,295125,20600,315725
C001101,N00035278,Katherine Clark (D),2014,Lawyers/Law Firms,191795,19750,211545
C001101,N00035278,Katherine Clark (D),2014,Women's Issues,119450,11500,130950
C001101,N00035278,Katherine Clark (D),2014,Retired,121570,0,121570
C001101,N00035278,Katherine Clark (D),2014,Securities & Investment,92139,5000,97139
C001101,N00035278,Katherine Clark (D),2014,Real Estate,73300,11000,84300
C001101,N00035278,Katherine Clark (D),2014,Pharmaceuticals/Health Products,13650,55100,68750
C001101,N00035278,Katherine Clark (D),2014,Business Services,65371,0,65371
C001101,N00035278,Katherine Clark (D),2014,Building Trade Unions,0,62500,62500
C001101,N00035278,Katherine Clark (D),2014,Education,52594,0,52594
C001101,N00035278,Katherine Clark (D),2014,Health Services/HMOs,44300,0,44300
B001296,N00035307,Brendan Boyle (D),2014,Lawyers/Law Firms,73669,28613,102282
B001296,N00035307,Brendan Boyle (D),2014,Leadership PACs,1000,58100,59100
B001296,N00035307,Brendan Boyle (D),2014,Transportation Unions,0,51000,51000
B001296,N00035307,Brendan Boyle (D),2014,Building Trade Unions,1000,50000,51000
B001296,N00035307,Brendan Boyle (D),2014,Industrial Unions,1000,49875,50875
B001296,N00035307,Brendan Boyle (D),2014,Public Sector Unions,0,47000,47000
B001296,N00035307,Brendan Boyle (D),2014,Health Professionals,5000,34500,39500
B001296,N00035307,Brendan Boyle (D),2014,Real Estate,25650,8500,34150
B001296,N00035307,Brendan Boyle (D),2014,Democratic/Liberal,21279,6750,28029
B001296,N00035307,Brendan Boyle (D),2014,Education,25101,0,25101
C001103,N00035346,Buddy Carter (R),2014,Retail Sales,110400,30000,140400
C001103,N00035346,Buddy Carter (R),2014,Health Professionals,57700,80000,137700
C001103,N00035346,Buddy Carter (R),2014,Leadership PACs,0,57992,57992
C001103,N00035346,Buddy Carter (R),2014,Pharmaceuticals/Health Products,18350,26500,44850
C001103,N00035346,Buddy Carter (R),2014,Retired,43866,0,43866
C001103,N00035346,Buddy Carter (R),2014,Lawyers/Law Firms,30625,7500,38125
C001103,N00035346,Buddy Carter (R),2014,Real Estate,14400,19500,33900
C001103,N00035346,Buddy Carter (R),2014,Oil & Gas,26750,4500,31250
C001103,N00035346,Buddy Carter (R),2014,Automotive,15500,15000,30500
C001103,N00035346,Buddy Carter (R),2014,Commercial Banks,3500,24500,28000
B001289,N00035380,Bradley Byrne (R),2014,Leadership PACs,0,157000,157000
B001289,N00035380,Bradley Byrne (R),2014,Lawyers/Law Firms,109250,38000,147250
B001289,N00035380,Bradley Byrne (R),2014,Insurance,32600,69100,101700
B001289,N00035380,Bradley Byrne (R),2014,Retired,95832,0,95832
B001289,N00035380,Bradley Byrne (R),2014,Health Professionals,28250,48500,76750
B001289,N00035380,Bradley Byrne (R),2014,Real Estate,38600,31000,69600
B001289,N00035380,Bradley Byrne (R),2014,Defense Aerospace,2000,47000,49000
B001289,N00035380,Bradley Byrne (R),2014,General Contractors,28400,15000,43400
B001289,N00035380,Bradley Byrne (R),2014,Commercial Banks,5750,34000,39750
B001289,N00035380,Bradley Byrne (R),2014,Electric Utilities,750,39000,39750
C001107,N00035403,Carlos Curbelo (R),2014,Leadership PACs,0,229200,229200
C001107,N00035403,Carlos Curbelo (R),2014,Retired,149380,0,149380
C001107,N00035403,Carlos Curbelo (R),2014,Real Estate,123850,5000,128850
C001107,N00035403,Carlos Curbelo (R),2014,Foreign & Defense Policy,122600,5000,127600
C001107,N00035403,Carlos Curbelo (R),2014,General Contractors,103805,11500,115305
C001107,N00035403,Carlos Curbelo (R),2014,Lawyers/Law Firms,98295,2000,100295
C001107,N00035403,Carlos Curbelo (R),2014,Health Professionals,83541,10500,94041
C001107,N00035403,Carlos Curbelo (R),2014,Pro-Israel,65150,16250,81400
C001107,N00035403,Carlos Curbelo (R),2014,Securities & Investment,65128,0,65128
C001107,N00035403,Carlos Curbelo (R),2014,Candidate Committees,0,61750,61750
B001295,N00035420,Mike Bost (R),2014,Leadership PACs,0,210825,210825
B001295,N00035420,Mike Bost (R),2014,Retired,68180,0,68180
B001295,N00035420,Mike Bost (R),2014,Candidate Committees,0,55500,55500
B001295,N00035420,Mike Bost (R),2014,Health Professionals,34050,20250,54300
B001295,N00035420,Mike Bost (R),2014,Securities & Investment,38600,0,38600
B001295,N00035420,Mike Bost (R),2014,Misc Manufacturing & Distributing,31350,2000,33350
B001295,N00035420,Mike Bost (R),2014,Food & Beverage,17800,9500,27300
B001295,N00035420,Mike Bost (R),2014,Crop Production & Basic Processing,25964,0,25964
B001295,N00035420,Mike Bost (R),2014,Lawyers/Law Firms,24675,500,25175
B001295,N00035420,Mike Bost (R),2014,Insurance,15700,9000,24700
E000294,N00035440,Tom Emmer (R),2014,Retired,194237,0,194237
E000294,N00035440,Tom Emmer (R),2014,Republican/Conservative,110636,23500,134136
E000294,N00035440,Tom Emmer (R),2014,Leadership PACs,0,65500,65500
E000294,N00035440,Tom Emmer (R),2014,Real Estate,40939,5000,45939
E000294,N00035440,Tom Emmer (R),2014,Health Professionals,17600,22000,39600
E000294,N00035440,Tom Emmer (R),2014,Securities & Investment,38600,0,38600
E000294,N00035440,Tom Emmer (R),2014,Oil & Gas,31900,5000,36900
E000294,N00035440,Tom Emmer (R),2014,Lawyers/Law Firms,20650,12000,32650
E000294,N00035440,Tom Emmer (R),2014,Automotive,18550,12500,31050
E000294,N00035440,Tom Emmer (R),2014,Misc Finance,29850,1000,30850
A000370,N00035451,Alma Adams (D),2014,Health Professionals,23900,53500,77400
A000370,N00035451,Alma Adams (D),2014,Women's Issues,50445,25501,75946
A000370,N00035451,Alma Adams (D),2014,Leadership PACs,0,43500,43500
A000370,N00035451,Alma Adams (D),2014,Public Sector Unions,1000,33000,34000
A000370,N00035451,Alma Adams (D),2014,Retired,30725,0,30725
A000370,N00035451,Alma Adams (D),2014,Industrial Unions,0,25000,25000
A000370,N00035451,Alma Adams (D),2014,Education,16150,3000,19150
A000370,N00035451,Alma Adams (D),2014,Lawyers/Law Firms,9186,7500,16686
A000370,N00035451,Alma Adams (D),2014,Building Trade Unions,0,15000,15000
A000370,N00035451,Alma Adams (D),2014,Human Rights,400,10750,11150
E000295,N00035483,Joni Ernst (R),2014,Leadership PACs,2000,354100,356100
E000295,N00035483,Joni Ernst (R),2014,Retired,182537,0,182537
E000295,N00035483,Joni Ernst (R),2014,Republican/Conservative,87041,84900,171941
E000295,N00035483,Joni Ernst (R),2014,Securities & Investment,134020,5000,139020
E000295,N00035483,Joni Ernst (R),2014,Oil & Gas,43900,91500,135400
E000295,N00035483,Joni Ernst (R),2014,Commercial Banks,16850,57000,73850
E000295,N00035483,Joni Ernst (R),2014,Insurance,26515,44500,71015
E000295,N00035483,Joni Ernst (R),2014,Food & Beverage,10200,60100,70300
E000295,N00035483,Joni Ernst (R),2014,Real Estate,49190,15000,64190
E000295,N00035483,Joni Ernst (R),2014,Pro-Israel,24900,34200,59100
G000575,N00035688,Gwen Graham (D),2014,Lawyers/Law Firms,399730,12341,412071
G000575,N00035688,Gwen Graham (D),2014,Retired,337368,0,337368
G000575,N00035688,Gwen Graham (D),2014,Leadership PACs,17100,203163,220263
G000575,N00035688,Gwen Graham (D),2014,Women's Issues,163340,20000,183340
G000575,N00035688,Gwen Graham (D),2014,Real Estate,145663,0,145663
G000575,N00035688,Gwen Graham (D),2014,Education,96776,0,96776
G000575,N00035688,Gwen Graham (D),2014,Democratic/Liberal,48075,20000,68075
G000575,N00035688,Gwen Graham (D),2014,Public Sector Unions,250,66000,66250
G000575,N00035688,Gwen Graham (D),2014,Candidate Committees,0,64500,64500
G000575,N00035688,Gwen Graham (D),2014,Lobbyists,63150,0,63150
C001102,N00035854,Curt Clawson (R),2014,Retired,173078,0,173078
C001102,N00035854,Curt Clawson (R),2014,Lawyers/Law Firms,55518,0,55518
C001102,N00035854,Curt Clawson (R),2014,Securities & Investment,44100,0,44100
C001102,N00035854,Curt Clawson (R),2014,Republican/Conservative,32746,2750,35496
C001102,N00035854,Curt Clawson (R),2014,Leadership PACs,0,23750,23750
C001102,N00035854,Curt Clawson (R),2014,Misc Manufacturing & Distributing,18750,0,18750
C001102,N00035854,Curt Clawson (R),2014,Real Estate,16493,1000,17493
C001102,N00035854,Curt Clawson (R),2014,Health Professionals,12610,0,12610
C001102,N00035854,Curt Clawson (R),2014,Misc Finance,9600,0,9600
C001102,N00035854,Curt Clawson (R),2014,Automotive,9021,0,9021
B001290,N00036013,Dave Brat (R),2014,Retired,190807,0,190807
B001290,N00036013,Dave Brat (R),2014,Republican/Conservative,68122,26345,94467
B001290,N00036013,Dave Brat (R),2014,Leadership PACs,0,63600,63600
B001290,N00036013,Dave Brat (R),2014,Real Estate,46300,0,46300
B001290,N00036013,Dave Brat (R),2014,Oil & Gas,15750,8500,24250
B001290,N00036013,Dave Brat (R),2014,Securities & Investment,23880,0,23880
B001290,N00036013,Dave Brat (R),2014,Lawyers/Law Firms,22500,1360,23860
B001290,N00036013,Dave Brat (R),2014,Tobacco,5850,12250,18100
B001290,N00036013,Dave Brat (R),2014,Health Professionals,15400,2500,17900
B001290,N00036013,Dave Brat (R),2014,General Contractors,10756,4000,14756
B001292,N00036018,Don Beyer (D),2014,Lawyers/Law Firms,184353,25500,209853
B001292,N00036018,Don Beyer (D),2014,Retired,196805,0,196805
B001292,N00036018,Don Beyer (D),2014,Real Estate,143450,22000,165450
B001292,N00036018,Don Beyer (D),2014,Automotive,84000,30000,114000
B001292,N00036018,Don Beyer (D),2014,Securities & Investment,58710,5000,63710
B001292,N00036018,Don Beyer (D),2014,Lobbyists,59191,984,60175
B001292,N00036018,Don Beyer (D),2014,Leadership PACs,0,54000,54000
B001292,N00036018,Don Beyer (D),2014,Public Sector Unions,500,51000,51500
B001292,N00036018,Don Beyer (D),2014,Non-Profit Institutions,48350,1250,49600
B001292,N00036018,Don Beyer (D),2014,Business Services,44450,4000,48450
C001105,N00036023,Barbara Comstock (R),2014,Leadership PACs,3900,241350,245250
C001105,N00036023,Barbara Comstock (R),2014,Lawyers/Law Firms,179752,21600,201352
C001105,N00036023,Barbara Comstock (R),2014,Retired,172738,0,172738
C001105,N00036023,Barbara Comstock (R),2014,Lobbyists,166559,4906,171465
C001105,N00036023,Barbara Comstock (R),2014,Business Services,145020,16350,161370
C001105,N00036023,Barbara Comstock (R),2014,Securities & Investment,151549,1000,152549
C001105,N00036023,Barbara Comstock (R),2014,Real Estate,103600,15000,118600
C001105,N00036023,Barbara Comstock (R),2014,Republican/Conservative,60583,41700,102283
C001105,N00036023,Barbara Comstock (R),2014,Oil & Gas,25350,40500,65850
C001105,N00036023,Barbara Comstock (R),2014,Candidate Committees,0,64000,64000
G000574,N00036097,Ruben Gallego (D),2014,Lawyers/Law Firms,69750,6000,75750
G000574,N00036097,Ruben Gallego (D),2014,Real Estate,40025,7500,47525
G000574,N00036097,Ruben Gallego (D),2014,Leadership PACs,0,43500,43500
G000574,N00036097,Ruben Gallego (D),2014,Public Sector Unions,0,34000,34000
G000574,N00036097,Ruben Gallego (D),2014,Lobbyists,26741,0,26741
G000574,N00036097,Ruben Gallego (D),2014,Transportation Unions,0,26000,26000
G000574,N00036097,Ruben Gallego (D),2014,Business Services,23410,0,23410
G000574,N00036097,Ruben Gallego (D),2014,Securities & Investment,22950,0,22950
G000574,N00036097,Ruben Gallego (D),2014,Building Trade Unions,0,22500,22500
G000574,N00036097,Ruben Gallego (D),2014,Retired,21339,0,21339
G000577,N00036135,Garret Graves (R),2014,Construction Services,108606,17459,126065
G000577,N00036135,Garret Graves (R),2014,Lawyers/Law Firms,84627,29500,114127
G000577,N00036135,Garret Graves (R),2014,Oil & Gas,45385,68600,113985
G000577,N00036135,Garret Graves (R),2014,General Contractors,77300,10000,87300
G000577,N00036135,Garret Graves (R),2014,Retired,77513,0,77513
G000577,N00036135,Garret Graves (R),2014,Leadership PACs,0,67500,67500
G000577,N00036135,Garret Graves (R),2014,Lobbyists,60261,7000,67261
G000577,N00036135,Garret Graves (R),2014,Sea Transport,41900,22200,64100
G000577,N00036135,Garret Graves (R),2014,Insurance,33500,29500,63000
G000577,N00036135,Garret Graves (R),2014,Food & Beverage,52410,6500,58910
D000624,N00036149,Debbie Dingell (D),2014,Retired,91198,0,91198
D000624,N00036149,Debbie Dingell (D),2014,Automotive,43150,44241,87391
D000624,N00036149,Debbie Dingell (D),2014,Lawyers/Law Firms,64134,22108,86242
D000624,N00036149,Debbie Dingell (D),2014,Real Estate,47750,17500,65250
D000624,N00036149,Debbie Dingell (D),2014,Lobbyists,62550,1500,64050
D000624,N00036149,Debbie Dingell (D),2014,Women's Issues,51700,11000,62700
D000624,N00036149,Debbie Dingell (D),2014,Leadership PACs,0,60500,60500
D000624,N00036149,Debbie Dingell (D),2014,Electric Utilities,5500,43498,48998
D000624,N00036149,Debbie Dingell (D),2014,Public Sector Unions,250,42500,42750
D000624,N00036149,Debbie Dingell (D),2014,Education,38850,707,39557
G000576,N00036409,Glenn S Grothman (R),2014,Leadership PACs,0,122200,122200
G000576,N00036409,Glenn S Grothman (R),2014,Retired,118192,0,118192
G000576,N00036409,Glenn S Grothman (R),2014,Misc Manufacturing & Distributing,23900,9000,32900
G000576,N00036409,Glenn S Grothman (R),2014,Securities & Investment,30650,0,30650
G000576,N00036409,Glenn S Grothman (R),2014,General Contractors,19650,9100,28750
G000576,N00036409,Glenn S Grothman (R),2014,Insurance,12276,15000,27276
G000576,N00036409,Glenn S Grothman (R),2014,Republican/Conservative,8900,15250,24150
G000576,N00036409,Glenn S Grothman (R),2014,Candidate Committees,0,22000,22000
G000576,N00036409,Glenn S Grothman (R),2014,Real Estate,12507,5000,17507
G000576,N00036409,Glenn S Grothman (R),2014,Building Materials & Equipment,9800,6500,16300
B001293,N00036449,Mike Bishop (R),2014,Leadership PACs,0,110600,110600
B001293,N00036449,Mike Bishop (R),2014,Real Estate,68850,19100,87950
B001293,N00036449,Mike Bishop (R),2014,Automotive,26200,36000,62200
B001293,N00036449,Mike Bishop (R),2014,Insurance,4400,41500,45900
B001293,N00036449,Mike Bishop (R),2014,Pro-Israel,31525,14000,45525
B001293,N00036449,Mike Bishop (R),2014,Health Professionals,5450,39000,44450
B001293,N00036449,Mike Bishop (R),2014,Electric Utilities,0,32999,32999
B001293,N00036449,Mike Bishop (R),2014,Misc Manufacturing & Distributing,26300,5000,31300
B001293,N00036449,Mike Bishop (R),2014,Lawyers/Law Firms,22347,8200,30547
B001293,N00036449,Mike Bishop (R),2014,Securities & Investment,29050,0,29050
A000374,N00036633,Ralph Abraham (R),2014,Health Professionals,78950,14000,92950
A000374,N00036633,Ralph Abraham (R),2014,Crop Production & Basic Processing,64350,7000,71350
A000374,N00036633,Ralph Abraham (R),2014,Leadership PACs,0,59000,59000
A000374,N00036633,Ralph Abraham (R),2014,Retired,48455,0,48455
A000374,N00036633,Ralph Abraham (R),2014,Hospitals/Nursing Homes,35950,0,35950
A000374,N00036633,Ralph Abraham (R),2014,Oil & Gas,13253,10500,23753
A000374,N00036633,Ralph Abraham (R),2014,General Contractors,20250,0,20250
A000374,N00036633,Ralph Abraham (R),2014,Misc Business,18650,0,18650
A000374,N00036633,Ralph Abraham (R),2014,Commercial Banks,10450,7000,17450
A000374,N00036633,Ralph Abraham (R),2014,Candidate Committees,0,12000,12000
C001037,N00000267,Michael E Capuano (D),2016,Insurance,2750,88750,91500
C001037,N00000267,Michael E Capuano (D),2016,Real Estate,14850,49500,64350
C001037,N00000267,Michael E Capuano (D),2016,Transportation Unions,0,48500,48500
C001037,N00000267,Michael E Capuano (D),2016,Securities & Investment,9000,35500,44500
C001037,N00000267,Michael E Capuano (D),2016,Railroads,0,42000,42000
C001037,N00000267,Michael E Capuano (D),2016,Pharmaceuticals/Health Products,2000,31500,33500
C001037,N00000267,Michael E Capuano (D),2016,Building Trade Unions,0,32500,32500
C001037,N00000267,Michael E Capuano (D),2016,Lawyers/Law Firms,17500,14750,32250
C001037,N00000267,Michael E Capuano (D),2016,Oil & Gas,27000,2000,29000
C001037,N00000267,Michael E Capuano (D),2016,Air Transport,0,26500,26500
C001035,N00000491,Susan Collins (R),2016,Retired,409300,0,409300
C001035,N00000491,Susan Collins (R),2016,Lawyers/Law Firms,250256,129750,380006
C001035,N00000491,Susan Collins (R),2016,Securities & Investment,296500,65600,362100
C001035,N00000491,Susan Collins (R),2016,Leadership PACs,0,325000,325000
C001035,N00000491,Susan Collins (R),2016,Health Professionals,58150,228300,286450
C001035,N00000491,Susan Collins (R),2016,Lobbyists,275913,10500,286413
C001035,N00000491,Susan Collins (R),2016,Insurance,36000,195500,231500
C001035,N00000491,Susan Collins (R),2016,Real Estate,121125,53000,174125
C001035,N00000491,Susan Collins (R),2016,Misc Manufacturing & Distributing,56900,63500,120400
C001035,N00000491,Susan Collins (R),2016,Business Services,94950,23000,117950
D000216,N00000615,Rosa L DeLauro (D),2016,Health Professionals,26893,94000,120893
D000216,N00000615,Rosa L DeLauro (D),2016,Lawyers/Law Firms,56531,22000,78531
D000216,N00000615,Rosa L DeLauro (D),2016,Public Sector Unions,0,76000,76000
D000216,N00000615,Rosa L DeLauro (D),2016,Lobbyists,55054,10263,65317
D000216,N00000615,Rosa L DeLauro (D),2016,Building Trade Unions,0,51500,51500
D000216,N00000615,Rosa L DeLauro (D),2016,Retired,43953,0,43953
D000216,N00000615,Rosa L DeLauro (D),2016,Industrial Unions,0,42000,42000
D000216,N00000615,Rosa L DeLauro (D),2016,Real Estate,26300,12000,38300
D000216,N00000615,Rosa L DeLauro (D),2016,Misc Unions,500,36500,37000
D000216,N00000615,Rosa L DeLauro (D),2016,Education,31390,0,31390
F000372,N00000684,Rodney Frelinghuysen (R),2016,Defense Aerospace,124400,52500,176900
F000372,N00000684,Rodney Frelinghuysen (R),2016,Lobbyists,113593,5764,119357
F000372,N00000684,Rodney Frelinghuysen (R),2016,Pharmaceuticals/Health Products,19300,94000,113300
F000372,N00000684,Rodney Frelinghuysen (R),2016,Retired,109414,0,109414
F000372,N00000684,Rodney Frelinghuysen (R),2016,Real Estate,69000,21000,90000
F000372,N00000684,Rodney Frelinghuysen (R),2016,Securities & Investment,83600,5000,88600
F000372,N00000684,Rodney Frelinghuysen (R),2016,Electric Utilities,2700,72778,75478
F000372,N00000684,Rodney Frelinghuysen (R),2016,Misc Defense,20700,48500,69200
F000372,N00000684,Rodney Frelinghuysen (R),2016,Defense Electronics,2000,62500,64500
F000372,N00000684,Rodney Frelinghuysen (R),2016,Lawyers/Law Firms,23475,34957,58432
G000548,N00000743,Scott Garrett (R),2016,Securities & Investment,243305,117500,360805
G000548,N00000743,Scott Garrett (R),2016,Retired,244983,0,244983
G000548,N00000743,Scott Garrett (R),2016,Leadership PACs,23315,139500,162815
G000548,N00000743,Scott Garrett (R),2016,Republican/Conservative,78843,43921,122764
G000548,N00000743,Scott Garrett (R),2016,Insurance,22250,87000,109250
G000548,N00000743,Scott Garrett (R),2016,Real Estate,42235,29000,71235
G000548,N00000743,Scott Garrett (R),2016,Commercial Banks,11250,55500,66750
G000548,N00000743,Scott Garrett (R),2016,Lawyers/Law Firms,57435,8450,65885
G000548,N00000743,Scott Garrett (R),2016,Candidate Committees,0,60686,60686
G000548,N00000743,Scott Garrett (R),2016,Misc Finance,38975,15200,54175
E000179,N00001003,Eliot L Engel (D),2016,Pro-Israel,132950,57200,190150
E000179,N00001003,Eliot L Engel (D),2016,Real Estate,127200,8000,135200
E000179,N00001003,Eliot L Engel (D),2016,Health Professionals,56825,55000,111825
E000179,N00001003,Eliot L Engel (D),2016,Retired,107100,0,107100
E000179,N00001003,Eliot L Engel (D),2016,Lawyers/Law Firms,81886,19000,100886
E000179,N00001003,Eliot L Engel (D),2016,Securities & Investment,74950,6000,80950
E000179,N00001003,Eliot L Engel (D),2016,Pharmaceuticals/Health Products,16700,37500,54200
E000179,N00001003,Eliot L Engel (D),2016,Hospitals/Nursing Homes,30350,7000,37350
E000179,N00001003,Eliot L Engel (D),2016,Education,34800,0,34800
E000179,N00001003,Eliot L Engel (D),2016,Building Trade Unions,0,34000,34000
C001038,N00001127,Joseph Crowley (D),2016,Real Estate,261278,82000,343278
C001038,N00001127,Joseph Crowley (D),2016,Insurance,56750,231500,288250
C001038,N00001127,Joseph Crowley (D),2016,Securities & Investment,79050,155000,234050
C001038,N00001127,Joseph Crowley (D),2016,Lawyers/Law Firms,133245,52200,185445
C001038,N00001127,Joseph Crowley (D),2016,Misc Issues,120570,0,120570
C001038,N00001127,Joseph Crowley (D),2016,Pharmaceuticals/Health Products,250,107300,107550
C001038,N00001127,Joseph Crowley (D),2016,Hospitals/Nursing Homes,49875,47500,97375
C001038,N00001127,Joseph Crowley (D),2016,Commercial Banks,11850,79500,91350
C001038,N00001127,Joseph Crowley (D),2016,Health Professionals,14950,62500,77450
C001038,N00001127,Joseph Crowley (D),2016,Electric Utilities,3000,66000,69000
C001092,N00001285,Chris Collins (R),2016,Health Professionals,14570,96500,111070
C001092,N00001285,Chris Collins (R),2016,Pharmaceuticals/Health Products,2905,93400,96305
C001092,N00001285,Chris Collins (R),2016,Oil & Gas,12550,47200,59750
C001092,N00001285,Chris Collins (R),2016,Health Services/HMOs,28300,20500,48800
C001092,N00001285,Chris Collins (R),2016,Telecom Services,0,48000,48000
C001092,N00001285,Chris Collins (R),2016,Electric Utilities,0,37500,37500
C001092,N00001285,Chris Collins (R),2016,Lawyers/Law Firms,21870,9250,31120
C001092,N00001285,Chris Collins (R),2016,Republican/Conservative,3050,25000,28050
C001092,N00001285,Chris Collins (R),2016,TV/Movies/Music,5505,22500,28005
C001092,N00001285,Chris Collins (R),2016,Retired,27230,0,27230
D000482,N00001373,Mike Doyle (D),2016,Electric Utilities,500,86000,86500
D000482,N00001373,Mike Doyle (D),2016,Industrial Unions,0,61500,61500
D000482,N00001373,Mike Doyle (D),2016,Telecom Services,1750,52000,53750
D000482,N00001373,Mike Doyle (D),2016,Building Trade Unions,0,52500,52500
D000482,N00001373,Mike Doyle (D),2016,Lawyers/Law Firms,16250,23000,39250
D000482,N00001373,Mike Doyle (D),2016,Real Estate,13950,23000,36950
D000482,N00001373,Mike Doyle (D),2016,Oil & Gas,0,32000,32000
D000482,N00001373,Mike Doyle (D),2016,Public Sector Unions,0,31000,31000
D000482,N00001373,Mike Doyle (D),2016,Chemical & Related Manufacturing,0,30500,30500
D000482,N00001373,Mike Doyle (D),2016,Health Professionals,260,24500,24760
B001227,N00001619,Robert A Brady (D),2016,Lawyers/Law Firms,61300,25500,86800
B001227,N00001619,Robert A Brady (D),2016,Building Trade Unions,0,80500,80500
B001227,N00001619,Robert A Brady (D),2016,Industrial Unions,0,50700,50700
B001227,N00001619,Robert A Brady (D),2016,Telecom Services,24750,15000,39750
B001227,N00001619,Robert A Brady (D),2016,Public Sector Unions,0,38500,38500
B001227,N00001619,Robert A Brady (D),2016,Transportation Unions,0,37000,37000
B001227,N00001619,Robert A Brady (D),2016,General Contractors,33200,0,33200
B001227,N00001619,Robert A Brady (D),2016,Real Estate,24650,8000,32650
B001227,N00001619,Robert A Brady (D),2016,Oil & Gas,20875,6000,26875
B001227,N00001619,Robert A Brady (D),2016,Misc Unions,0,16000,16000
F000043,N00001746,Chaka Fattah (D),2016,Leadership PACs,0,21000,21000
F000043,N00001746,Chaka Fattah (D),2016,Public Sector Unions,500,18500,19000
F000043,N00001746,Chaka Fattah (D),2016,Building Trade Unions,0,15000,15000
F000043,N00001746,Chaka Fattah (D),2016,Industrial Unions,0,8500,8500
F000043,N00001746,Chaka Fattah (D),2016,Misc Unions,0,8500,8500
F000043,N00001746,Chaka Fattah (D),2016,Civil Servants/Public Officials,8400,0,8400
F000043,N00001746,Chaka Fattah (D),2016,Securities & Investment,8100,0,8100
F000043,N00001746,Chaka Fattah (D),2016,Real Estate,6500,1000,7500
F000043,N00001746,Chaka Fattah (D),2016,Lawyers/Law Firms,2400,5000,7400
F000043,N00001746,Chaka Fattah (D),2016,"Beer, Wine & Liquor",3600,2500,6100
G000386,N00001758,Chuck Grassley (R),2016,Retired,879737,0,879737
G000386,N00001758,Chuck Grassley (R),2016,Securities & Investment,491157,58000,549157
G000386,N00001758,Chuck Grassley (R),2016,Lawyers/Law Firms,344841,119950,464791
G000386,N00001758,Chuck Grassley (R),2016,Leadership PACs,0,453299,453299
G000386,N00001758,Chuck Grassley (R),2016,Health Professionals,113485,235000,348485
G000386,N00001758,Chuck Grassley (R),2016,Insurance,75725,233100,308825
G000386,N00001758,Chuck Grassley (R),2016,Lobbyists,278276,26487,304763
G000386,N00001758,Chuck Grassley (R),2016,Real Estate,225986,58500,284486
G000386,N00001758,Chuck Grassley (R),2016,Agricultural Services/Products,90450,164619,255069
G000386,N00001758,Chuck Grassley (R),2016,Crop Production & Basic Processing,162802,64000,226802
H000874,N00001821,Steny H Hoyer (D),2016,Electric Utilities,24200,197500,221700
H000874,N00001821,Steny H Hoyer (D),2016,Insurance,31000,186750,217750
H000874,N00001821,Steny H Hoyer (D),2016,Securities & Investment,62350,155000,217350
H000874,N00001821,Steny H Hoyer (D),2016,Health Professionals,25100,188500,213600
H000874,N00001821,Steny H Hoyer (D),2016,Lawyers/Law Firms,104612,45500,150112
H000874,N00001821,Steny H Hoyer (D),2016,Pharmaceuticals/Health Products,13000,128500,141500
H000874,N00001821,Steny H Hoyer (D),2016,Real Estate,70036,70000,140036
H000874,N00001821,Steny H Hoyer (D),2016,Public Sector Unions,0,126500,126500
H000874,N00001821,Steny H Hoyer (D),2016,Pro-Israel,77800,21700,99500
H000874,N00001821,Steny H Hoyer (D),2016,Retired,95510,0,95510
C000141,N00001955,Ben Cardin (D),2016,Lawyers/Law Firms,337061,117000,454061
C000141,N00001955,Ben Cardin (D),2016,Securities & Investment,246183,182500,428683
C000141,N00001955,Ben Cardin (D),2016,Health Professionals,127203,268547,395750
C000141,N00001955,Ben Cardin (D),2016,Real Estate,303671,60000,363671
C000141,N00001955,Ben Cardin (D),2016,Insurance,94850,267500,362350
C000141,N00001955,Ben Cardin (D),2016,Lobbyists,223450,10366,233816
C000141,N00001955,Ben Cardin (D),2016,Health Services/HMOs,71716,152109,223825
C000141,N00001955,Ben Cardin (D),2016,Retired,222010,0,222010
C000141,N00001955,Ben Cardin (D),2016,Pro-Israel,159513,59280,218793
C000141,N00001955,Ben Cardin (D),2016,Leadership PACs,0,187000,187000
C000984,N00001971,Elijah E Cummings (D),2016,Public Sector Unions,750,93300,94050
C000984,N00001971,Elijah E Cummings (D),2016,Transportation Unions,0,81700,81700
C000984,N00001971,Elijah E Cummings (D),2016,Lawyers/Law Firms,30850,25500,56350
C000984,N00001971,Elijah E Cummings (D),2016,Real Estate,40100,10000,50100
C000984,N00001971,Elijah E Cummings (D),2016,Health Professionals,20425,26900,47325
C000984,N00001971,Elijah E Cummings (D),2016,Railroads,2500,32000,34500
C000984,N00001971,Elijah E Cummings (D),2016,Oil & Gas,28000,4000,32000
C000984,N00001971,Elijah E Cummings (D),2016,Industrial Unions,0,31000,31000
C000984,N00001971,Elijah E Cummings (D),2016,Sea Transport,1250,29000,30250
C000984,N00001971,Elijah E Cummings (D),2016,Air Transport,0,27500,27500
B001135,N00002221,Richard Burr (R),2016,Retired,1028271,0,1028271
B001135,N00002221,Richard Burr (R),2016,Securities & Investment,613599,174000,787599
B001135,N00002221,Richard Burr (R),2016,Lawyers/Law Firms,425758,155995,581753
B001135,N00002221,Richard Burr (R),2016,Insurance,291077,244500,535577
B001135,N00002221,Richard Burr (R),2016,Pharmaceuticals/Health Products,100466,419852,520318
B001135,N00002221,Richard Burr (R),2016,Leadership PACs,0,514160,514160
B001135,N00002221,Richard Burr (R),2016,Real Estate,415629,74500,490129
B001135,N00002221,Richard Burr (R),2016,Health Professionals,206244,242050,448294
B001135,N00002221,Richard Burr (R),2016,Lobbyists,347429,6977,354406
B001135,N00002221,Richard Burr (R),2016,Oil & Gas,94457,202450,296907
C000537,N00002408,James E Clyburn (D),2016,Electric Utilities,8350,130500,138850
C000537,N00002408,James E Clyburn (D),2016,Health Professionals,7760,107000,114760
C000537,N00002408,James E Clyburn (D),2016,Insurance,3200,106500,109700
C000537,N00002408,James E Clyburn (D),2016,Lawyers/Law Firms,53160,47500,100660
C000537,N00002408,James E Clyburn (D),2016,Pharmaceuticals/Health Products,3200,81262,84462
C000537,N00002408,James E Clyburn (D),2016,Public Sector Unions,0,81000,81000
C000537,N00002408,James E Clyburn (D),2016,Securities & Investment,4700,74750,79450
C000537,N00002408,James E Clyburn (D),2016,Transportation Unions,0,70340,70340
C000537,N00002408,James E Clyburn (D),2016,Commercial Banks,1250,59000,60250
C000537,N00002408,James E Clyburn (D),2016,Electronics Mfg & Equip,2950,52000,54950
B000490,N00002674,Sanford Bishop (D),2016,Crop Production & Basic Processing,15000,51500,66500
B000490,N00002674,Sanford Bishop (D),2016,Lawyers/Law Firms,28584,24750,53334
B000490,N00002674,Sanford Bishop (D),2016,Industrial Unions,0,42000,42000
B000490,N00002674,Sanford Bishop (D),2016,Public Sector Unions,0,39000,39000
B000490,N00002674,Sanford Bishop (D),2016,Agricultural Services/Products,0,33500,33500
B000490,N00002674,Sanford Bishop (D),2016,Health Professionals,5150,27000,32150
B000490,N00002674,Sanford Bishop (D),2016,Insurance,0,32000,32000
B000490,N00002674,Sanford Bishop (D),2016,Defense Aerospace,0,30500,30500
B000490,N00002674,Sanford Bishop (D),2016,Forestry & Forest Products,3334,27000,30334
B000490,N00002674,Sanford Bishop (D),2016,Food & Beverage,10500,18000,28500
B000911,N00002713,Corrine Brown (D),2016,Transportation Unions,0,40500,40500
B000911,N00002713,Corrine Brown (D),2016,Leadership PACs,0,40000,40000
B000911,N00002713,Corrine Brown (D),2016,Trucking,3200,35000,38200
B000911,N00002713,Corrine Brown (D),2016,Railroads,0,33000,33000
B000911,N00002713,Corrine Brown (D),2016,Candidate Committees,0,26500,26500
B000911,N00002713,Corrine Brown (D),2016,Lawyers/Law Firms,6950,16000,22950
B000911,N00002713,Corrine Brown (D),2016,Real Estate,17150,3000,20150
B000911,N00002713,Corrine Brown (D),2016,Industrial Unions,0,20000,20000
B000911,N00002713,Corrine Brown (D),2016,Sea Transport,11100,6000,17100
B000911,N00002713,Corrine Brown (D),2016,Air Transport,0,13000,13000
H000324,N00002884,Alcee L Hastings (D),2016,Lawyers/Law Firms,63700,13000,76700
H000324,N00002884,Alcee L Hastings (D),2016,Pro-Israel,56050,17200,73250
H000324,N00002884,Alcee L Hastings (D),2016,Finance/Credit Companies,30200,35250,65450
H000324,N00002884,Alcee L Hastings (D),2016,Education,37600,19900,57500
H000324,N00002884,Alcee L Hastings (D),2016,Crop Production & Basic Processing,14250,22500,36750
H000324,N00002884,Alcee L Hastings (D),2016,Industrial Unions,0,35000,35000
H000324,N00002884,Alcee L Hastings (D),2016,Transportation Unions,0,25500,25500
H000324,N00002884,Alcee L Hastings (D),2016,Lobbyists,25150,0,25150
H000324,N00002884,Alcee L Hastings (D),2016,Telephone Utilities,0,24500,24500
H000324,N00002884,Alcee L Hastings (D),2016,Real Estate,16450,8000,24450
F000462,N00002893,Lois J Frankel (D),2016,Real Estate,135150,8000,143150
F000462,N00002893,Lois J Frankel (D),2016,Lawyers/Law Firms,86817,18500,105317
F000462,N00002893,Lois J Frankel (D),2016,Retired,102269,0,102269
F000462,N00002893,Lois J Frankel (D),2016,Securities & Investment,84100,0,84100
F000462,N00002893,Lois J Frankel (D),2016,Pro-Israel,40725,15500,56225
F000462,N00002893,Lois J Frankel (D),2016,Building Trade Unions,0,49000,49000
F000462,N00002893,Lois J Frankel (D),2016,Business Services,38505,10000,48505
F000462,N00002893,Lois J Frankel (D),2016,Public Sector Unions,0,48500,48500
F000462,N00002893,Lois J Frankel (D),2016,Transportation Unions,0,47000,47000
F000462,N00002893,Lois J Frankel (D),2016,Health Professionals,29922,13500,43422
C001111,N00002942,Charlie Crist (D),2016,Lawyers/Law Firms,364656,16500,381156
C001111,N00002942,Charlie Crist (D),2016,Leadership PACs,5500,101600,107100
C001111,N00002942,Charlie Crist (D),2016,Retired,95505,0,95505
C001111,N00002942,Charlie Crist (D),2016,Real Estate,90255,5000,95255
C001111,N00002942,Charlie Crist (D),2016,Building Trade Unions,0,67500,67500
C001111,N00002942,Charlie Crist (D),2016,Health Professionals,47750,6000,53750
C001111,N00002942,Charlie Crist (D),2016,Public Sector Unions,250,49000,49250
C001111,N00002942,Charlie Crist (D),2016,Industrial Unions,0,46500,46500
C001111,N00002942,Charlie Crist (D),2016,Securities & Investment,41000,2500,43500
C001111,N00002942,Charlie Crist (D),2016,Business Services,35318,0,35318
A000055,N00003028,Robert B Aderholt (R),2016,Crop Production & Basic Processing,14053,81500,95553
A000055,N00003028,Robert B Aderholt (R),2016,Agricultural Services/Products,3950,90000,93950
A000055,N00003028,Robert B Aderholt (R),2016,Lawyers/Law Firms,25402,44000,69402
A000055,N00003028,Robert B Aderholt (R),2016,Misc Defense,31200,27177,58377
A000055,N00003028,Robert B Aderholt (R),2016,Defense Electronics,500,56700,57200
A000055,N00003028,Robert B Aderholt (R),2016,Defense Aerospace,3651,45000,48651
A000055,N00003028,Robert B Aderholt (R),2016,Food Processing & Sales,2601,41500,44101
A000055,N00003028,Robert B Aderholt (R),2016,Health Professionals,28904,14932,43836
A000055,N00003028,Robert B Aderholt (R),2016,Building Materials & Equipment,31500,12000,43500
A000055,N00003028,Robert B Aderholt (R),2016,Insurance,1401,35950,37351
B001243,N00003105,Marsha Blackburn (R),2016,Health Professionals,32105,189750,221855
B001243,N00003105,Marsha Blackburn (R),2016,Pharmaceuticals/Health Products,28200,136899,165099
B001243,N00003105,Marsha Blackburn (R),2016,Oil & Gas,14900,71000,85900
B001243,N00003105,Marsha Blackburn (R),2016,Health Services/HMOs,6500,70700,77200
B001243,N00003105,Marsha Blackburn (R),2016,Insurance,8800,67500,76300
B001243,N00003105,Marsha Blackburn (R),2016,Automotive,28600,42500,71100
B001243,N00003105,Marsha Blackburn (R),2016,Retired,67545,0,67545
B001243,N00003105,Marsha Blackburn (R),2016,Hospitals/Nursing Homes,5250,52000,57250
B001243,N00003105,Marsha Blackburn (R),2016,Real Estate,23775,32500,56275
B001243,N00003105,Marsha Blackburn (R),2016,Lawyers/Law Firms,20150,36000,56150
C000754,N00003132,Jim Cooper (D),2016,Lawyers/Law Firms,39300,15500,54800
C000754,N00003132,Jim Cooper (D),2016,Defense Aerospace,0,39500,39500
C000754,N00003132,Jim Cooper (D),2016,Retired,30600,0,30600
C000754,N00003132,Jim Cooper (D),2016,Securities & Investment,13100,15000,28100
C000754,N00003132,Jim Cooper (D),2016,Insurance,2250,22500,24750
C000754,N00003132,Jim Cooper (D),2016,"Beer, Wine & Liquor",6900,16500,23400
C000754,N00003132,Jim Cooper (D),2016,Democratic/Liberal,3125,20000,23125
C000754,N00003132,Jim Cooper (D),2016,Accountants,2000,19000,21000
C000754,N00003132,Jim Cooper (D),2016,Hospitals/Nursing Homes,13980,6500,20480
C000754,N00003132,Jim Cooper (D),2016,Real Estate,15000,4000,19000
D000533,N00003209,John J Duncan Jr (R),2016,Railroads,2250,45500,47750
D000533,N00003209,John J Duncan Jr (R),2016,Lawyers/Law Firms,11450,18000,29450
D000533,N00003209,John J Duncan Jr (R),2016,Misc Transport,0,27631,27631
D000533,N00003209,John J Duncan Jr (R),2016,Building Materials & Equipment,2000,23500,25500
D000533,N00003209,John J Duncan Jr (R),2016,Construction Services,1000,22500,23500
D000533,N00003209,John J Duncan Jr (R),2016,Lobbyists,17500,1500,19000
D000533,N00003209,John J Duncan Jr (R),2016,Air Transport,500,16000,16500
D000533,N00003209,John J Duncan Jr (R),2016,Pharmaceuticals/Health Products,15800,100,15900
D000533,N00003209,John J Duncan Jr (R),2016,Trucking,1500,14000,15500
D000533,N00003209,John J Duncan Jr (R),2016,Transportation Unions,0,13000,13000
C001068,N00003225,Steve Cohen (D),2016,Real Estate,38350,9500,47850
C001068,N00003225,Steve Cohen (D),2016,Transportation Unions,0,45500,45500
C001068,N00003225,Steve Cohen (D),2016,Industrial Unions,0,38500,38500
C001068,N00003225,Steve Cohen (D),2016,Railroads,0,31000,31000
C001068,N00003225,Steve Cohen (D),2016,Lawyers/Law Firms,10170,19750,29920
C001068,N00003225,Steve Cohen (D),2016,Air Transport,3950,25500,29450
C001068,N00003225,Steve Cohen (D),2016,Automotive,3000,23000,26000
C001068,N00003225,Steve Cohen (D),2016,Health Professionals,5750,17500,23250
C001068,N00003225,Steve Cohen (D),2016,Public Sector Unions,0,23000,23000
C001068,N00003225,Steve Cohen (D),2016,Lodging/Tourism,500,20000,20500
C000567,N00003328,Thad Cochran (R),2016,Crop Production & Basic Processing,323875,262350,586225
C000567,N00003328,Thad Cochran (R),2016,Leadership PACs,0,496800,496800
C000567,N00003328,Thad Cochran (R),2016,Lawyers/Law Firms,195600,158250,353850
C000567,N00003328,Thad Cochran (R),2016,Oil & Gas,133405,143500,276905
C000567,N00003328,Thad Cochran (R),2016,Lobbyists,254175,7001,261176
C000567,N00003328,Thad Cochran (R),2016,Agricultural Services/Products,26800,226500,253300
C000567,N00003328,Thad Cochran (R),2016,Defense Aerospace,78500,164500,243000
C000567,N00003328,Thad Cochran (R),2016,Retired,201704,0,201704
C000567,N00003328,Thad Cochran (R),2016,Health Professionals,56509,114650,171159
C000567,N00003328,Thad Cochran (R),2016,Insurance,38200,123800,162000
B000944,N00003535,Sherrod Brown (D),2016,Lawyers/Law Firms,1919513,218623,2138136
B000944,N00003535,Sherrod Brown (D),2016,Retired,1342432,0,1342432
B000944,N00003535,Sherrod Brown (D),2016,Education,678358,1000,679358
B000944,N00003535,Sherrod Brown (D),2016,Real Estate,552106,90000,642106
B000944,N00003535,Sherrod Brown (D),2016,Health Professionals,365472,222300,587772
B000944,N00003535,Sherrod Brown (D),2016,Democratic/Liberal,502243,37565,539808
B000944,N00003535,Sherrod Brown (D),2016,Insurance,211364,308000,519364
B000944,N00003535,Sherrod Brown (D),2016,Lobbyists,437500,21100,458600
B000944,N00003535,Sherrod Brown (D),2016,Securities & Investment,297807,133850,431657
B000944,N00003535,Sherrod Brown (D),2016,Women's Issues,402684,1500,404184
B000589,N00003675,John Boehner (R),2016,Retired,339968,0,339968
B000589,N00003675,John Boehner (R),2016,Securities & Investment,186200,0,186200
B000589,N00003675,John Boehner (R),2016,Real Estate,178650,0,178650
B000589,N00003675,John Boehner (R),2016,Lobbyists,164850,0,164850
B000589,N00003675,John Boehner (R),2016,Insurance,138500,0,138500
B000589,N00003675,John Boehner (R),2016,Lawyers/Law Firms,130450,0,130450
B000589,N00003675,John Boehner (R),2016,Hospitals/Nursing Homes,96600,0,96600
B000589,N00003675,John Boehner (R),2016,Oil & Gas,87650,0,87650
B000589,N00003675,John Boehner (R),2016,Electric Utilities,87600,0,87600
B000589,N00003675,John Boehner (R),2016,Misc Finance,85465,0,85465
C000266,N00003689,Steve Chabot (R),2016,Insurance,42750,17250,60000
C000266,N00003689,Steve Chabot (R),2016,Retired,48315,0,48315
C000266,N00003689,Steve Chabot (R),2016,Misc Manufacturing & Distributing,35100,13000,48100
C000266,N00003689,Steve Chabot (R),2016,Recreation/Live Entertainment,24650,18500,43150
C000266,N00003689,Steve Chabot (R),2016,Automotive,15550,23500,39050
C000266,N00003689,Steve Chabot (R),2016,Lawyers/Law Firms,23350,15000,38350
C000266,N00003689,Steve Chabot (R),2016,Health Professionals,21950,10500,32450
C000266,N00003689,Steve Chabot (R),2016,Real Estate,20311,8000,28311
C000266,N00003689,Steve Chabot (R),2016,Food Processing & Sales,19900,7000,26900
C000266,N00003689,Steve Chabot (R),2016,Securities & Investment,5900,20500,26400
C000542,N00003845,Dan Coats (R),2016,Lawyers/Law Firms,48800,23350,72150
C000542,N00003845,Dan Coats (R),2016,Leadership PACs,0,65000,65000
C000542,N00003845,Dan Coats (R),2016,Pharmaceuticals/Health Products,11850,43950,55800
C000542,N00003845,Dan Coats (R),2016,Oil & Gas,22000,31750,53750
C000542,N00003845,Dan Coats (R),2016,Insurance,10350,36500,46850
C000542,N00003845,Dan Coats (R),2016,Securities & Investment,41650,3500,45150
C000542,N00003845,Dan Coats (R),2016,Retired,43450,0,43450
C000542,N00003845,Dan Coats (R),2016,Real Estate,29050,8500,37550
C000542,N00003845,Dan Coats (R),2016,Misc Manufacturing & Distributing,9850,24500,34350
C000542,N00003845,Dan Coats (R),2016,Electric Utilities,3750,30000,33750
C000714,N00004029,John Conyers Jr (D),2016,Lawyers/Law Firms,39878,15000,54878
C000714,N00004029,John Conyers Jr (D),2016,TV/Movies/Music,6675,47500,54175
C000714,N00004029,John Conyers Jr (D),2016,Telecom Services,2000,37000,39000
C000714,N00004029,John Conyers Jr (D),2016,Industrial Unions,0,36000,36000
C000714,N00004029,John Conyers Jr (D),2016,Public Sector Unions,0,31500,31500
C000714,N00004029,John Conyers Jr (D),2016,Building Trade Unions,0,30000,30000
C000714,N00004029,John Conyers Jr (D),2016,Health Professionals,1010,19500,20510
C000714,N00004029,John Conyers Jr (D),2016,Retail Sales,33,20000,20033
C000714,N00004029,John Conyers Jr (D),2016,Automotive,1755,14000,15755
C000714,N00004029,John Conyers Jr (D),2016,Misc Unions,0,15500,15500
B001230,N00004367,Tammy Baldwin (D),2016,Retired,1179590,0,1179590
B001230,N00004367,Tammy Baldwin (D),2016,Women's Issues,882563,36972,919535
B001230,N00004367,Tammy Baldwin (D),2016,Lawyers/Law Firms,699099,45350,744449
B001230,N00004367,Tammy Baldwin (D),2016,Democratic/Liberal,393047,173765,566812
B001230,N00004367,Tammy Baldwin (D),2016,Education,387784,3500,391284
B001230,N00004367,Tammy Baldwin (D),2016,Leadership PACs,8750,348180,356930
B001230,N00004367,Tammy Baldwin (D),2016,Health Professionals,202114,79000,281114
B001230,N00004367,Tammy Baldwin (D),2016,Human Rights,197358,35493,232851
B001230,N00004367,Tammy Baldwin (D),2016,Business Services,210223,4000,214223
B001230,N00004367,Tammy Baldwin (D),2016,TV/Movies/Music,183100,2000,185100
C001096,N00004614,Kevin Cramer (R),2016,Oil & Gas,50200,148200,198400
C001096,N00004614,Kevin Cramer (R),2016,Electric Utilities,2700,73600,76300
C001096,N00004614,Kevin Cramer (R),2016,Crop Production & Basic Processing,22900,41500,64400
C001096,N00004614,Kevin Cramer (R),2016,Telecom Services,4500,51000,55500
C001096,N00004614,Kevin Cramer (R),2016,Agricultural Services/Products,2700,48000,50700
C001096,N00004614,Kevin Cramer (R),2016,Health Professionals,2050,43000,45050
C001096,N00004614,Kevin Cramer (R),2016,Telephone Utilities,1000,31000,32000
C001096,N00004614,Kevin Cramer (R),2016,Retired,31275,0,31275
C001096,N00004614,Kevin Cramer (R),2016,Insurance,500,30000,30500
C001096,N00004614,Kevin Cramer (R),2016,Mining,0,30000,30000
G000535,N00004874,Luis V Gutierrez (D),2016,Leadership PACs,0,38500,38500
G000535,N00004874,Luis V Gutierrez (D),2016,Accountants,2700,35000,37700
G000535,N00004874,Luis V Gutierrez (D),2016,Misc Unions,0,30000,30000
G000535,N00004874,Luis V Gutierrez (D),2016,Building Trade Unions,0,25000,25000
G000535,N00004874,Luis V Gutierrez (D),2016,Real Estate,12500,8000,20500
G000535,N00004874,Luis V Gutierrez (D),2016,Lawyers/Law Firms,13400,6750,20150
G000535,N00004874,Luis V Gutierrez (D),2016,Human Rights,140,16000,16140
G000535,N00004874,Luis V Gutierrez (D),2016,Transportation Unions,0,16000,16000
G000535,N00004874,Luis V Gutierrez (D),2016,Business Services,15400,0,15400
G000535,N00004874,Luis V Gutierrez (D),2016,Industrial Unions,0,15000,15000
G000535,N00004874,Luis V Gutierrez (D),2016,Telephone Utilities,0,15000,15000
D000096,N00004884,Danny K Davis (D),2016,Public Sector Unions,0,45500,45500
D000096,N00004884,Danny K Davis (D),2016,Pharmaceuticals/Health Products,826,40000,40826
D000096,N00004884,Danny K Davis (D),2016,Insurance,0,39500,39500
D000096,N00004884,Danny K Davis (D),2016,Industrial Unions,0,36000,36000
D000096,N00004884,Danny K Davis (D),2016,"Beer, Wine & Liquor",0,34000,34000
D000096,N00004884,Danny K Davis (D),2016,Building Trade Unions,0,24500,24500
D000096,N00004884,Danny K Davis (D),2016,Health Professionals,500,22500,23000
D000096,N00004884,Danny K Davis (D),2016,Lawyers/Law Firms,6950,15250,22200
D000096,N00004884,Danny K Davis (D),2016,Securities & Investment,0,21000,21000
D000096,N00004884,Danny K Davis (D),2016,Electric Utilities,0,20500,20500
D000563,N00004981,Dick Durbin (D),2016,Lawyers/Law Firms,1279981,110670,1390651
D000563,N00004981,Dick Durbin (D),2016,Retired,389909,0,389909
D000563,N00004981,Dick Durbin (D),2016,Securities & Investment,319675,48240,367915
D000563,N00004981,Dick Durbin (D),2016,Real Estate,269447,40500,309947
D000563,N00004981,Dick Durbin (D),2016,Defense Aerospace,223228,61499,284727
D000563,N00004981,Dick Durbin (D),2016,Health Professionals,106609,149200,255809
D000563,N00004981,Dick Durbin (D),2016,Lobbyists,231002,14500,245502
D000563,N00004981,Dick Durbin (D),2016,Insurance,94201,121000,215201
D000563,N00004981,Dick Durbin (D),2016,Pro-Israel,183040,24650,207690
D000563,N00004981,Dick Durbin (D),2016,Leadership PACs,0,178600,178600
B000575,N00005195,Roy Blunt (R),2016,Securities & Investment,716557,154200,870757
B000575,N00005195,Roy Blunt (R),2016,Retired,815283,0,815283
B000575,N00005195,Roy Blunt (R),2016,Real Estate,612532,91000,703532
B000575,N00005195,Roy Blunt (R),2016,Leadership PACs,16200,643865,660065
B000575,N00005195,Roy Blunt (R),2016,Lawyers/Law Firms,423333,211738,635071
B000575,N00005195,Roy Blunt (R),2016,Lobbyists,531770,7550,539320
B000575,N00005195,Roy Blunt (R),2016,Health Professionals,230500,231000,461500
B000575,N00005195,Roy Blunt (R),2016,Insurance,147257,288100,435357
B000575,N00005195,Roy Blunt (R),2016,Misc Manufacturing & Distributing,279975,102000,381975
B000575,N00005195,Roy Blunt (R),2016,Pharmaceuticals/Health Products,121584,256050,377634
A000373,N00005293,Brad Ashford (D),2016,Leadership PACs,2700,245051,247751
A000373,N00005293,Brad Ashford (D),2016,Lawyers/Law Firms,111470,20750,132220
A000373,N00005293,Brad Ashford (D),2016,Retired,119748,0,119748
A000373,N00005293,Brad Ashford (D),2016,Securities & Investment,67150,30500,97650
A000373,N00005293,Brad Ashford (D),2016,Insurance,18500,77500,96000
A000373,N00005293,Brad Ashford (D),2016,Real Estate,69950,25000,94950
A000373,N00005293,Brad Ashford (D),2016,Health Professionals,39300,51500,90800
A000373,N00005293,Brad Ashford (D),2016,Democratic/Liberal,48145,22552,70697
A000373,N00005293,Brad Ashford (D),2016,Candidate Committees,0,64285,64285
A000373,N00005293,Brad Ashford (D),2016,Agricultural Services/Products,1075,55750,56825
B000213,N00005656,Joe Barton (R),2016,Oil & Gas,78600,130650,209250
B000213,N00005656,Joe Barton (R),2016,Electric Utilities,8900,86500,95400
B000213,N00005656,Joe Barton (R),2016,Health Professionals,9280,47250,56530
B000213,N00005656,Joe Barton (R),2016,Misc Manufacturing & Distributing,42600,13000,55600
B000213,N00005656,Joe Barton (R),2016,Pharmaceuticals/Health Products,0,40000,40000
B000213,N00005656,Joe Barton (R),2016,Misc Finance,37950,0,37950
B000213,N00005656,Joe Barton (R),2016,Automotive,6600,29000,35600
B000213,N00005656,Joe Barton (R),2016,Retired,33940,0,33940
B000213,N00005656,Joe Barton (R),2016,Telecom Services,0,33500,33500
B000213,N00005656,Joe Barton (R),2016,Lobbyists,31450,2000,33450
B001291,N00005736,Brian Babin (R),2016,Health Professionals,115790,84500,200290
B001291,N00005736,Brian Babin (R),2016,Air Transport,8200,52750,60950
B001291,N00005736,Brian Babin (R),2016,Retired,52747,0,52747
B001291,N00005736,Brian Babin (R),2016,Oil & Gas,11700,40700,52400
B001291,N00005736,Brian Babin (R),2016,Construction Services,19357,18000,37357
B001291,N00005736,Brian Babin (R),2016,Railroads,500,34999,35499
B001291,N00005736,Brian Babin (R),2016,Real Estate,22375,11500,33875
B001291,N00005736,Brian Babin (R),2016,Chemical & Related Manufacturing,500,32700,33200
B001291,N00005736,Brian Babin (R),2016,Lawyers/Law Firms,20950,10750,31700
B001291,N00005736,Brian Babin (R),2016,Automotive,7300,23000,30300
G000410,N00005870,Gene Green (D),2016,Health Professionals,27100,161000,188100
G000410,N00005870,Gene Green (D),2016,Pharmaceuticals/Health Products,6925,136650,143575
G000410,N00005870,Gene Green (D),2016,Lawyers/Law Firms,70850,39999,110849
G000410,N00005870,Gene Green (D),2016,Oil & Gas,5200,98500,103700
G000410,N00005870,Gene Green (D),2016,Chemical & Related Manufacturing,0,69000,69000
G000410,N00005870,Gene Green (D),2016,Electric Utilities,0,65750,65750
G000410,N00005870,Gene Green (D),2016,Health Services/HMOs,3200,54000,57200
G000410,N00005870,Gene Green (D),2016,Industrial Unions,0,53500,53500
G000410,N00005870,Gene Green (D),2016,Transportation Unions,0,53000,53000
G000410,N00005870,Gene Green (D),2016,Hospitals/Nursing Homes,16800,32152,48952
B000755,N00005883,Kevin Brady (R),2016,Oil & Gas,164150,246600,410750
B000755,N00005883,Kevin Brady (R),2016,Health Professionals,93650,255750,349400
B000755,N00005883,Kevin Brady (R),2016,Insurance,51800,254650,306450
B000755,N00005883,Kevin Brady (R),2016,Pharmaceuticals/Health Products,11700,245850,257550
B000755,N00005883,Kevin Brady (R),2016,Securities & Investment,124300,122000,246300
B000755,N00005883,Kevin Brady (R),2016,Lawyers/Law Firms,84843,125000,209843
B000755,N00005883,Kevin Brady (R),2016,Real Estate,110300,86000,196300
B000755,N00005883,Kevin Brady (R),2016,Hospitals/Nursing Homes,80700,112500,193200
B000755,N00005883,Kevin Brady (R),2016,Lobbyists,156416,3000,159416
B000755,N00005883,Kevin Brady (R),2016,Health Services/HMOs,47300,110000,157300
H000636,N00006008,Ruben Hinojosa (D),2016,Health Professionals,76200,1000,77200
H000636,N00006008,Ruben Hinojosa (D),2016,Lawyers/Law Firms,2600,6000,8600
H000636,N00006008,Ruben Hinojosa (D),2016,Insurance,0,6500,6500
H000636,N00006008,Ruben Hinojosa (D),2016,General Contractors,5200,0,5200
H000636,N00006008,Ruben Hinojosa (D),2016,Building Trade Unions,0,5000,5000
H000636,N00006008,Ruben Hinojosa (D),2016,Misc Manufacturing & Distributing,0,5000,5000
H000636,N00006008,Ruben Hinojosa (D),2016,Hospitals/Nursing Homes,0,5000,5000
H000636,N00006008,Ruben Hinojosa (D),2016,Electronics Mfg & Equip,2700,1000,3700
H000636,N00006008,Ruben Hinojosa (D),2016,Real Estate,2600,1000,3600
H000636,N00006008,Ruben Hinojosa (D),2016,Securities & Investment,2600,0,2600
H000636,N00006008,Ruben Hinojosa (D),2016,Retail Sales,2600,0,2600
D000399,N00006023,Lloyd Doggett (D),2016,Lawyers/Law Firms,125381,21500,146881
D000399,N00006023,Lloyd Doggett (D),2016,Retired,112635,0,112635
D000399,N00006023,Lloyd Doggett (D),2016,Building Trade Unions,0,59000,59000
D000399,N00006023,Lloyd Doggett (D),2016,Health Professionals,10050,38500,48550
D000399,N00006023,Lloyd Doggett (D),2016,Industrial Unions,0,43000,43000
D000399,N00006023,Lloyd Doggett (D),2016,Real Estate,13300,23000,36300
D000399,N00006023,Lloyd Doggett (D),2016,Securities & Investment,32300,0,32300
D000399,N00006023,Lloyd Doggett (D),2016,Transportation Unions,0,32000,32000
D000399,N00006023,Lloyd Doggett (D),2016,Public Sector Unions,0,26000,26000
D000399,N00006023,Lloyd Doggett (D),2016,Misc Finance,16750,1000,17750
D000197,N00006134,Diana DeGette (D),2016,Pharmaceuticals/Health Products,0,142968,142968
D000197,N00006134,Diana DeGette (D),2016,Democratic/Liberal,136825,0,136825
D000197,N00006134,Diana DeGette (D),2016,Health Professionals,7251,120594,127845
D000197,N00006134,Diana DeGette (D),2016,Lawyers/Law Firms,48425,35875,84300
D000197,N00006134,Diana DeGette (D),2016,Retired,65299,0,65299
D000197,N00006134,Diana DeGette (D),2016,Telecom Services,7900,43900,51800
D000197,N00006134,Diana DeGette (D),2016,Real Estate,37850,10500,48350
D000197,N00006134,Diana DeGette (D),2016,Misc Finance,35400,1000,36400
D000197,N00006134,Diana DeGette (D),2016,Industrial Unions,0,32100,32100
D000197,N00006134,Diana DeGette (D),2016,TV/Movies/Music,10650,18900,29550
B001261,N00006236,John A Barrasso (R),2016,Health Professionals,347293,215350,562643
B001261,N00006236,John A Barrasso (R),2016,Oil & Gas,207566,250900,458466
B001261,N00006236,John A Barrasso (R),2016,Securities & Investment,209000,91571,300571
B001261,N00006236,John A Barrasso (R),2016,Leadership PACs,0,272740,272740
B001261,N00006236,John A Barrasso (R),2016,Lobbyists,246706,7000,253706
B001261,N00006236,John A Barrasso (R),2016,Pharmaceuticals/Health Products,64500,187000,251500
B001261,N00006236,John A Barrasso (R),2016,Mining,161206,80500,241706
B001261,N00006236,John A Barrasso (R),2016,Electric Utilities,19200,210750,229950
B001261,N00006236,John A Barrasso (R),2016,Insurance,41000,135875,176875
B001261,N00006236,John A Barrasso (R),2016,Retired,118799,0,118799
E000285,N00006249,Mike Enzi (R),2016,Leadership PACs,0,300572,300572
E000285,N00006249,Mike Enzi (R),2016,Pharmaceuticals/Health Products,22950,227500,250450
E000285,N00006249,Mike Enzi (R),2016,Oil & Gas,54250,156833,211083
E000285,N00006249,Mike Enzi (R),2016,Health Professionals,29950,180000,209950
E000285,N00006249,Mike Enzi (R),2016,Securities & Investment,90700,102494,193194
E000285,N00006249,Mike Enzi (R),2016,Insurance,28500,146000,174500
E000285,N00006249,Mike Enzi (R),2016,Retail Sales,3850,102000,105850
E000285,N00006249,Mike Enzi (R),2016,Real Estate,34550,58000,92550
E000285,N00006249,Mike Enzi (R),2016,Lobbyists,89892,500,90392
E000285,N00006249,Mike Enzi (R),2016,Health Services/HMOs,31200,52000,83200
C000880,N00006267,Mike Crapo (R),2016,Securities & Investment,538850,332350,871200
C000880,N00006267,Mike Crapo (R),2016,Insurance,81250,405200,486450
C000880,N00006267,Mike Crapo (R),2016,Leadership PACs,0,434600,434600
C000880,N00006267,Mike Crapo (R),2016,Commercial Banks,116450,215800,332250
C000880,N00006267,Mike Crapo (R),2016,Real Estate,138150,124420,262570
C000880,N00006267,Mike Crapo (R),2016,Health Services/HMOs,114500,102250,216750
C000880,N00006267,Mike Crapo (R),2016,Lobbyists,197052,13000,210052
C000880,N00006267,Mike Crapo (R),2016,Finance/Credit Companies,62700,140000,202700
C000880,N00006267,Mike Crapo (R),2016,Lawyers/Law Firms,120104,77600,197704
C000880,N00006267,Mike Crapo (R),2016,Misc Finance,119202,73500,192702
F000448,N00006423,Trent Franks (R),2016,Telecom Services,10800,21500,32300
F000448,N00006423,Trent Franks (R),2016,Defense Electronics,0,26500,26500
F000448,N00006423,Trent Franks (R),2016,Defense Aerospace,0,22500,22500
F000448,N00006423,Trent Franks (R),2016,Leadership PACs,0,20000,20000
F000448,N00006423,Trent Franks (R),2016,Lawyers/Law Firms,11500,5750,17250
F000448,N00006423,Trent Franks (R),2016,Republican/Conservative,2435,11553,13988
F000448,N00006423,Trent Franks (R),2016,Retired,13650,0,13650
F000448,N00006423,Trent Franks (R),2016,Electric Utilities,250,13000,13250
F000448,N00006423,Trent Franks (R),2016,Business Services,13200,0,13200
F000448,N00006423,Trent Franks (R),2016,Construction Services,8000,5000,13000
B000711,N00006692,Barbara Boxer (D),2016,TV/Movies/Music,47050,1000,48050
B000711,N00006692,Barbara Boxer (D),2016,Lawyers/Law Firms,37550,2500,40050
B000711,N00006692,Barbara Boxer (D),2016,Retired,23825,0,23825
B000711,N00006692,Barbara Boxer (D),2016,Railroads,0,21000,21000
B000711,N00006692,Barbara Boxer (D),2016,Business Services,20575,0,20575
B000711,N00006692,Barbara Boxer (D),2016,Real Estate,14350,1010,15360
B000711,N00006692,Barbara Boxer (D),2016,Building Materials & Equipment,0,13500,13500
B000711,N00006692,Barbara Boxer (D),2016,Printing & Publishing,10500,0,10500
B000711,N00006692,Barbara Boxer (D),2016,Building Trade Unions,0,10000,10000
B000711,N00006692,Barbara Boxer (D),2016,Electronics Mfg & Equip,7050,2000,9050
H001063,N00006806,Janice Hahn (D),2016,Candidate Committees,0,1000,1000
C000059,N00007099,Ken Calvert (R),2016,Casinos/Gambling,88950,0,88950
C000059,N00007099,Ken Calvert (R),2016,Lobbyists,68793,8539,77332
C000059,N00007099,Ken Calvert (R),2016,Real Estate,39716,34250,73966
C000059,N00007099,Ken Calvert (R),2016,Oil & Gas,8900,59000,67900
C000059,N00007099,Ken Calvert (R),2016,Electric Utilities,0,48000,48000
C000059,N00007099,Ken Calvert (R),2016,Defense Aerospace,2500,43000,45500
C000059,N00007099,Ken Calvert (R),2016,Defense Electronics,5000,39500,44500
C000059,N00007099,Ken Calvert (R),2016,Construction Services,18400,24750,43150
C000059,N00007099,Ken Calvert (R),2016,Misc Manufacturing & Distributing,7750,34511,42261
C000059,N00007099,Ken Calvert (R),2016,Crop Production & Basic Processing,17049,23850,40899
C001036,N00007232,Lois Capps (D),2016,Health Professionals,0,9000,9000
C001036,N00007232,Lois Capps (D),2016,Defense Aerospace,0,3500,3500
C001036,N00007232,Lois Capps (D),2016,"Beer, Wine & Liquor",0,2500,2500
C001036,N00007232,Lois Capps (D),2016,Public Sector Unions,0,2000,2000
C001036,N00007232,Lois Capps (D),2016,Real Estate,1000,0,1000
C001036,N00007232,Lois Capps (D),2016,Industrial Unions,0,1000,1000
C001036,N00007232,Lois Capps (D),2016,Leadership PACs,0,1000,1000
C001036,N00007232,Lois Capps (D),2016,Lawyers/Law Firms,0,1000,1000
C001036,N00007232,Lois Capps (D),2016,Pharmaceuticals/Health Products,0,1000,1000
C001036,N00007232,Lois Capps (D),2016,Hospitals/Nursing Homes,0,1000,1000
F000030,N00007312,Sam Farr (D),2016,Crop Production & Basic Processing,4500,26200,30700
F000030,N00007312,Sam Farr (D),2016,Health Professionals,2000,14500,16500
F000030,N00007312,Sam Farr (D),2016,Agricultural Services/Products,0,12500,12500
F000030,N00007312,Sam Farr (D),2016,Lodging/Tourism,0,11000,11000
F000030,N00007312,Sam Farr (D),2016,Retired,10851,0,10851
F000030,N00007312,Sam Farr (D),2016,Lawyers/Law Firms,2200,4000,6200
F000030,N00007312,Sam Farr (D),2016,"Beer, Wine & Liquor",5580,500,6080
F000030,N00007312,Sam Farr (D),2016,Air Transport,0,5500,5500
F000030,N00007312,Sam Farr (D),2016,Automotive,1000,4500,5500
F000030,N00007312,Sam Farr (D),2016,Lobbyists,4500,0,4500
E000215,N00007335,Anna Eshoo (D),2016,Pharmaceuticals/Health Products,58170,141790,199960
E000215,N00007335,Anna Eshoo (D),2016,Electronics Mfg & Equip,73075,55512,128587
E000215,N00007335,Anna Eshoo (D),2016,Retired,91875,0,91875
E000215,N00007335,Anna Eshoo (D),2016,Telecom Services,2000,72500,74500
E000215,N00007335,Anna Eshoo (D),2016,Securities & Investment,68900,2500,71400
E000215,N00007335,Anna Eshoo (D),2016,Internet,24750,42200,66950
E000215,N00007335,Anna Eshoo (D),2016,Lawyers/Law Firms,44680,15500,60180
E000215,N00007335,Anna Eshoo (D),2016,Health Professionals,20100,39500,59600
E000215,N00007335,Anna Eshoo (D),2016,Real Estate,23350,14000,37350
E000215,N00007335,Anna Eshoo (D),2016,Telephone Utilities,0,29000,29000
F000062,N00007364,Dianne Feinstein (D),2016,Lawyers/Law Firms,374044,134500,508544
F000062,N00007364,Dianne Feinstein (D),2016,Retired,331189,0,331189
F000062,N00007364,Dianne Feinstein (D),2016,Lobbyists,281503,15651,297154
F000062,N00007364,Dianne Feinstein (D),2016,Electric Utilities,199850,96600,296450
F000062,N00007364,Dianne Feinstein (D),2016,Crop Production & Basic Processing,224333,72000,296333
F000062,N00007364,Dianne Feinstein (D),2016,Securities & Investment,234959,28850,263809
F000062,N00007364,Dianne Feinstein (D),2016,Real Estate,220722,33000,253722
F000062,N00007364,Dianne Feinstein (D),2016,TV/Movies/Music,168015,84500,252515
F000062,N00007364,Dianne Feinstein (D),2016,Women's Issues,201449,11000,212449
F000062,N00007364,Dianne Feinstein (D),2016,Electronics Mfg & Equip,75350,105789,181139
B000574,N00007727,Earl Blumenauer (D),2016,Health Professionals,2500,138900,141400
B000574,N00007727,Earl Blumenauer (D),2016,Insurance,10650,86500,97150
B000574,N00007727,Earl Blumenauer (D),2016,Construction Services,18050,67500,85550
B000574,N00007727,Earl Blumenauer (D),2016,Railroads,24375,56000,80375
B000574,N00007727,Earl Blumenauer (D),2016,Misc Manufacturing & Distributing,30700,49000,79700
B000574,N00007727,Earl Blumenauer (D),2016,Real Estate,34650,23500,58150
B000574,N00007727,Earl Blumenauer (D),2016,Lawyers/Law Firms,24892,26500,51392
B000574,N00007727,Earl Blumenauer (D),2016,Health Services/HMOs,9267,34500,43767
B000574,N00007727,Earl Blumenauer (D),2016,Lobbyists,40827,1500,42327
B000574,N00007727,Earl Blumenauer (D),2016,Misc Issues,18250,24000,42250
D000191,N00007781,Peter DeFazio (D),2016,Air Transport,20010,114000,134010
D000191,N00007781,Peter DeFazio (D),2016,Transportation Unions,500,119255,119755
D000191,N00007781,Peter DeFazio (D),2016,Building Materials & Equipment,4502,63500,68002
D000191,N00007781,Peter DeFazio (D),2016,Retired,61728,0,61728
D000191,N00007781,Peter DeFazio (D),2016,Trucking,0,47500,47500
D000191,N00007781,Peter DeFazio (D),2016,Railroads,3000,44000,47000
D000191,N00007781,Peter DeFazio (D),2016,Lobbyists,33380,2000,35380
D000191,N00007781,Peter DeFazio (D),2016,Forestry & Forest Products,17679,17000,34679
D000191,N00007781,Peter DeFazio (D),2016,Public Sector Unions,35,34500,34535
D000191,N00007781,Peter DeFazio (D),2016,"Beer, Wine & Liquor",16800,17700,34500
C000127,N00007836,Maria Cantwell (D),2016,Lawyers/Law Firms,704701,10750,715451
C000127,N00007836,Maria Cantwell (D),2016,Retired,705780,0,705780
C000127,N00007836,Maria Cantwell (D),2016,Lobbyists,471190,0,471190
C000127,N00007836,Maria Cantwell (D),2016,Securities & Investment,320564,0,320564
C000127,N00007836,Maria Cantwell (D),2016,Casinos/Gambling,253300,0,253300
C000127,N00007836,Maria Cantwell (D),2016,Real Estate,238363,2500,240863
C000127,N00007836,Maria Cantwell (D),2016,Electronics Mfg & Equip,178477,3500,181977
C000127,N00007836,Maria Cantwell (D),2016,Business Services,164067,0,164067
C000127,N00007836,Maria Cantwell (D),2016,Health Professionals,152611,6750,159361
C000127,N00007836,Maria Cantwell (D),2016,Environment,136106,0,136106
G000377,N00008799,Kay Granger (R),2016,Defense Aerospace,116800,61000,177800
G000377,N00008799,Kay Granger (R),2016,Real Estate,58280,26500,84780
G000377,N00008799,Kay Granger (R),2016,Oil & Gas,59400,16000,75400
G000377,N00008799,Kay Granger (R),2016,Retired,61035,0,61035
G000377,N00008799,Kay Granger (R),2016,Defense Electronics,500,57500,58000
G000377,N00008799,Kay Granger (R),2016,Lobbyists,45850,3661,49511
G000377,N00008799,Kay Granger (R),2016,Air Transport,2250,45000,47250
G000377,N00008799,Kay Granger (R),2016,Misc Manufacturing & Distributing,18000,23000,41000
G000377,N00008799,Kay Granger (R),2016,Lawyers/Law Firms,28394,12000,40394
G000377,N00008799,Kay Granger (R),2016,Misc Defense,0,38000,38000
G000289,N00009154,Bob Goodlatte (R),2016,Lawyers/Law Firms,63258,41500,104758
G000289,N00009154,Bob Goodlatte (R),2016,Retired,95325,0,95325
G000289,N00009154,Bob Goodlatte (R),2016,TV/Movies/Music,15500,72633,88133
G000289,N00009154,Bob Goodlatte (R),2016,Telecom Services,15200,59500,74700
G000289,N00009154,Bob Goodlatte (R),2016,Electronics Mfg & Equip,22800,49500,72300
G000289,N00009154,Bob Goodlatte (R),2016,Securities & Investment,42900,21000,63900
G000289,N00009154,Bob Goodlatte (R),2016,Internet,14750,41000,55750
G000289,N00009154,Bob Goodlatte (R),2016,Lobbyists,54250,1000,55250
G000289,N00009154,Bob Goodlatte (R),2016,Real Estate,35050,18500,53550
G000289,N00009154,Bob Goodlatte (R),2016,Commercial Banks,1000,49000,50000
F000444,N00009573,Jeff Flake (R),2016,Republican/Conservative,1279677,64067,1343744
F000444,N00009573,Jeff Flake (R),2016,Retired,700483,0,700483
F000444,N00009573,Jeff Flake (R),2016,Real Estate,404530,26500,431030
F000444,N00009573,Jeff Flake (R),2016,Securities & Investment,391929,18000,409929
F000444,N00009573,Jeff Flake (R),2016,Leadership PACs,0,371368,371368
F000444,N00009573,Jeff Flake (R),2016,Lawyers/Law Firms,207862,68450,276312
F000444,N00009573,Jeff Flake (R),2016,Misc Finance,234072,4500,238572
F000444,N00009573,Jeff Flake (R),2016,Health Professionals,142567,53500,196067
F000444,N00009573,Jeff Flake (R),2016,Mining,134902,59000,193902
F000444,N00009573,Jeff Flake (R),2016,Oil & Gas,76510,102500,179010
D000598,N00009604,Susan A Davis (D),2016,Misc Defense,10900,36500,47400
D000598,N00009604,Susan A Davis (D),2016,Defense Electronics,0,29500,29500
D000598,N00009604,Susan A Davis (D),2016,Defense Aerospace,0,29500,29500
D000598,N00009604,Susan A Davis (D),2016,Real Estate,6750,21000,27750
D000598,N00009604,Susan A Davis (D),2016,Democratic/Liberal,11200,12000,23200
D000598,N00009604,Susan A Davis (D),2016,Electronics Mfg & Equip,3900,17500,21400
D000598,N00009604,Susan A Davis (D),2016,Health Services/HMOs,0,18000,18000
D000598,N00009604,Susan A Davis (D),2016,Public Sector Unions,0,17750,17750
D000598,N00009604,Susan A Davis (D),2016,Retired,17425,0,17425
D000598,N00009604,Susan A Davis (D),2016,Lawyers/Law Firms,5700,10000,15700
C001048,N00009738,John Culberson (R),2016,Oil & Gas,53400,69500,122900
C001048,N00009738,John Culberson (R),2016,Real Estate,84943,20500,105443
C001048,N00009738,John Culberson (R),2016,Retired,86900,0,86900
C001048,N00009738,John Culberson (R),2016,Leadership PACs,0,68500,68500
C001048,N00009738,John Culberson (R),2016,Lawyers/Law Firms,28049,17700,45749
C001048,N00009738,John Culberson (R),2016,Defense Aerospace,2250,42000,44250
C001048,N00009738,John Culberson (R),2016,Construction Services,30325,10500,40825
C001048,N00009738,John Culberson (R),2016,Misc Manufacturing & Distributing,15500,19500,35000
C001048,N00009738,John Culberson (R),2016,Lobbyists,31000,3141,34141
C001048,N00009738,John Culberson (R),2016,Defense Electronics,0,34000,34000
C001047,N00009771,Shelley Moore Capito (R),2016,Securities & Investment,385415,58400,443815
C001047,N00009771,Shelley Moore Capito (R),2016,Retired,412786,0,412786
C001047,N00009771,Shelley Moore Capito (R),2016,Lawyers/Law Firms,293700,48763,342463
C001047,N00009771,Shelley Moore Capito (R),2016,Leadership PACs,0,331100,331100
C001047,N00009771,Shelley Moore Capito (R),2016,Mining,218874,84875,303749
C001047,N00009771,Shelley Moore Capito (R),2016,Oil & Gas,102866,163500,266366
C001047,N00009771,Shelley Moore Capito (R),2016,Insurance,77338,182600,259938
C001047,N00009771,Shelley Moore Capito (R),2016,Commercial Banks,127175,126000,253175
C001047,N00009771,Shelley Moore Capito (R),2016,Health Professionals,117566,107000,224566
C001047,N00009771,Shelley Moore Capito (R),2016,Real Estate,134678,52500,187178
B000287,N00009774,Xavier Becerra (D),2016,Health Professionals,9199,134200,143399
B000287,N00009774,Xavier Becerra (D),2016,Real Estate,75925,50000,125925
B000287,N00009774,Xavier Becerra (D),2016,Securities & Investment,64226,61500,125726
B000287,N00009774,Xavier Becerra (D),2016,Insurance,2500,95500,98000
B000287,N00009774,Xavier Becerra (D),2016,Hospitals/Nursing Homes,34755,61500,96255
B000287,N00009774,Xavier Becerra (D),2016,Lawyers/Law Firms,49907,34100,84007
B000287,N00009774,Xavier Becerra (D),2016,TV/Movies/Music,37525,34900,72425
B000287,N00009774,Xavier Becerra (D),2016,Public Sector Unions,0,70500,70500
B000287,N00009774,Xavier Becerra (D),2016,Casinos/Gambling,64200,0,64200
B000287,N00009774,Xavier Becerra (D),2016,Pharmaceuticals/Health Products,0,49000,49000
H000338,N00009869,Orrin G Hatch (R),2016,Securities & Investment,1093175,232071,1325246
H000338,N00009869,Orrin G Hatch (R),2016,Pharmaceuticals/Health Products,319170,500827,819997
H000338,N00009869,Orrin G Hatch (R),2016,Lobbyists,611777,14427,626204
H000338,N00009869,Orrin G Hatch (R),2016,Health Professionals,195079,382950,578029
H000338,N00009869,Orrin G Hatch (R),2016,Insurance,160000,412674,572674
H000338,N00009869,Orrin G Hatch (R),2016,Real Estate,412392,117900,530292
H000338,N00009869,Orrin G Hatch (R),2016,Lawyers/Law Firms,283495,238116,521611
H000338,N00009869,Orrin G Hatch (R),2016,Oil & Gas,215050,255900,470950
H000338,N00009869,Orrin G Hatch (R),2016,Leadership PACs,0,432378,432378
H000338,N00009869,Orrin G Hatch (R),2016,Health Services/HMOs,159916,251898,411814
A000360,N00009888,Lamar Alexander (R),2016,Pharmaceuticals/Health Products,32450,308600,341050
A000360,N00009888,Lamar Alexander (R),2016,Leadership PACs,0,307215,307215
A000360,N00009888,Lamar Alexander (R),2016,Securities & Investment,175300,97500,272800
A000360,N00009888,Lamar Alexander (R),2016,Health Professionals,54900,208500,263400
A000360,N00009888,Lamar Alexander (R),2016,Real Estate,213050,37000,250050
A000360,N00009888,Lamar Alexander (R),2016,Retired,231415,0,231415
A000360,N00009888,Lamar Alexander (R),2016,Lawyers/Law Firms,123239,105488,228727
A000360,N00009888,Lamar Alexander (R),2016,Insurance,60350,142000,202350
A000360,N00009888,Lamar Alexander (R),2016,Hospitals/Nursing Homes,85000,116767,201767
A000360,N00009888,Lamar Alexander (R),2016,Oil & Gas,49853,102933,152786
G000359,N00009975,Lindsey Graham (R),2016,Lawyers/Law Firms,882639,82250,964889
G000359,N00009975,Lindsey Graham (R),2016,Securities & Investment,844678,47982,892660
G000359,N00009975,Lindsey Graham (R),2016,Retired,649413,0,649413
G000359,N00009975,Lindsey Graham (R),2016,Real Estate,530316,31750,562066
G000359,N00009975,Lindsey Graham (R),2016,Leadership PACs,0,309500,309500
G000359,N00009975,Lindsey Graham (R),2016,Pro-Israel,228550,61700,290250
G000359,N00009975,Lindsey Graham (R),2016,Health Professionals,201930,33000,234930
G000359,N00009975,Lindsey Graham (R),2016,Electric Utilities,123784,100000,223784
G000359,N00009975,Lindsey Graham (R),2016,Business Services,207310,8000,215310
G000359,N00009975,Lindsey Graham (R),2016,Lobbyists,196988,9500,206488
C001049,N00012460,William L Clay Jr (D),2016,Insurance,0,56000,56000
C001049,N00012460,William L Clay Jr (D),2016,Public Sector Unions,0,52000,52000
C001049,N00012460,William L Clay Jr (D),2016,Building Trade Unions,0,49200,49200
C001049,N00012460,William L Clay Jr (D),2016,Industrial Unions,0,45500,45500
C001049,N00012460,William L Clay Jr (D),2016,Lawyers/Law Firms,8500,23248,31748
C001049,N00012460,William L Clay Jr (D),2016,Commercial Banks,0,30400,30400
C001049,N00012460,William L Clay Jr (D),2016,Securities & Investment,2523,27200,29723
C001049,N00012460,William L Clay Jr (D),2016,Real Estate,250,28500,28750
C001049,N00012460,William L Clay Jr (D),2016,Pharmaceuticals/Health Products,0,22500,22500
C001049,N00012460,William L Clay Jr (D),2016,Finance/Credit Companies,0,21500,21500
C000174,N00012508,Tom Carper (D),2016,Insurance,79150,276000,355150
C000174,N00012508,Tom Carper (D),2016,Securities & Investment,131040,207380,338420
C000174,N00012508,Tom Carper (D),2016,Lawyers/Law Firms,159791,118551,278342
C000174,N00012508,Tom Carper (D),2016,Pharmaceuticals/Health Products,30800,189410,220210
C000174,N00012508,Tom Carper (D),2016,Lobbyists,189241,8600,197841
C000174,N00012508,Tom Carper (D),2016,Commercial Banks,78764,109090,187854
C000174,N00012508,Tom Carper (D),2016,Chemical & Related Manufacturing,54775,104040,158815
C000174,N00012508,Tom Carper (D),2016,Health Professionals,19359,119500,138859
C000174,N00012508,Tom Carper (D),2016,Leadership PACs,0,137500,137500
C000174,N00012508,Tom Carper (D),2016,Retired,127603,0,127603
H001034,N00012611,Mike Honda (D),2016,Retired,244314,0,244314
H001034,N00012611,Mike Honda (D),2016,Human Rights,92575,48400,140975
H001034,N00012611,Mike Honda (D),2016,Lawyers/Law Firms,121535,14250,135785
H001034,N00012611,Mike Honda (D),2016,Leadership PACs,2700,118950,121650
H001034,N00012611,Mike Honda (D),2016,Real Estate,104944,11000,115944
H001034,N00012611,Mike Honda (D),2016,Democratic/Liberal,75113,30606,105719
H001034,N00012611,Mike Honda (D),2016,Electronics Mfg & Equip,59931,38840,98771
H001034,N00012611,Mike Honda (D),2016,Public Sector Unions,550,87250,87800
H001034,N00012611,Mike Honda (D),2016,Health Professionals,52143,28000,80143
H001034,N00012611,Mike Honda (D),2016,Securities & Investment,63450,0,63450
C001045,N00012739,Ander Crenshaw (R),2016,Misc Issues,87500,0,87500
C001045,N00012739,Ander Crenshaw (R),2016,Insurance,2000,69250,71250
C001045,N00012739,Ander Crenshaw (R),2016,Securities & Investment,4700,60000,64700
C001045,N00012739,Ander Crenshaw (R),2016,Commercial Banks,7250,55500,62750
C001045,N00012739,Ander Crenshaw (R),2016,Lobbyists,49450,3459,52909
C001045,N00012739,Ander Crenshaw (R),2016,Real Estate,17450,29500,46950
C001045,N00012739,Ander Crenshaw (R),2016,Finance/Credit Companies,11200,32000,43200
C001045,N00012739,Ander Crenshaw (R),2016,Telecom Services,0,42125,42125
C001045,N00012739,Ander Crenshaw (R),2016,Misc Defense,10250,27000,37250
C001045,N00012739,Ander Crenshaw (R),2016,Defense Electronics,500,33000,33500
G000546,N00013323,Sam Graves (R),2016,Air Transport,10000,104000,114000
G000546,N00013323,Sam Graves (R),2016,Building Materials & Equipment,18900,62750,81650
G000546,N00013323,Sam Graves (R),2016,Trucking,15052,57400,72452
G000546,N00013323,Sam Graves (R),2016,Defense Aerospace,0,54000,54000
G000546,N00013323,Sam Graves (R),2016,Construction Services,1250,51000,52250
G000546,N00013323,Sam Graves (R),2016,Crop Production & Basic Processing,9450,40500,49950
G000546,N00013323,Sam Graves (R),2016,Transportation Unions,0,48500,48500
G000546,N00013323,Sam Graves (R),2016,Public Sector Unions,0,47000,47000
G000546,N00013323,Sam Graves (R),2016,Railroads,0,44000,44000
G000546,N00013323,Sam Graves (R),2016,Automotive,3000,40000,43000
F000445,N00013799,Randy Forbes (R),2016,Misc Defense,55400,55700,111100
F000445,N00013799,Randy Forbes (R),2016,Retired,83347,0,83347
F000445,N00013799,Randy Forbes (R),2016,Real Estate,76834,2000,78834
F000445,N00013799,Randy Forbes (R),2016,Defense Aerospace,8145,42500,50645
F000445,N00013799,Randy Forbes (R),2016,Lawyers/Law Firms,37109,9500,46609
F000445,N00013799,Randy Forbes (R),2016,Defense Electronics,13600,33000,46600
F000445,N00013799,Randy Forbes (R),2016,Lobbyists,36050,2162,38212
F000445,N00013799,Randy Forbes (R),2016,Leadership PACs,0,33400,33400
F000445,N00013799,Randy Forbes (R),2016,Health Professionals,25575,7000,32575
F000445,N00013799,Randy Forbes (R),2016,Education,27647,0,27647
B001236,N00013873,John Boozman (R),2016,Health Professionals,216815,113500,330315
B001236,N00013873,John Boozman (R),2016,Leadership PACs,0,316034,316034
B001236,N00013873,John Boozman (R),2016,Retired,288674,0,288674
B001236,N00013873,John Boozman (R),2016,Securities & Investment,202950,66500,269450
B001236,N00013873,John Boozman (R),2016,Commercial Banks,87300,107250,194550
B001236,N00013873,John Boozman (R),2016,Real Estate,131891,53000,184891
B001236,N00013873,John Boozman (R),2016,Oil & Gas,60230,92000,152230
B001236,N00013873,John Boozman (R),2016,Insurance,47700,79000,126700
B001236,N00013873,John Boozman (R),2016,Crop Production & Basic Processing,61250,63937,125187
B001236,N00013873,John Boozman (R),2016,Retail Sales,67165,56375,123540
C001077,N00024753,Mike Coffman (R),2016,Retired,451059,0,451059
C001077,N00024753,Mike Coffman (R),2016,Leadership PACs,0,353900,353900
C001077,N00024753,Mike Coffman (R),2016,Real Estate,173293,30000,203293
C001077,N00024753,Mike Coffman (R),2016,Securities & Investment,125100,20500,145600
C001077,N00024753,Mike Coffman (R),2016,Oil & Gas,51394,84500,135894
C001077,N00024753,Mike Coffman (R),2016,Lawyers/Law Firms,76635,14000,90635
C001077,N00024753,Mike Coffman (R),2016,Republican/Conservative,48040,39000,87040
C001077,N00024753,Mike Coffman (R),2016,Health Professionals,30075,47500,77575
C001077,N00024753,Mike Coffman (R),2016,Insurance,3950,72500,76450
C001077,N00024753,Mike Coffman (R),2016,Commercial Banks,51750,18200,69950
C001069,N00024842,Joe Courtney (D),2016,Insurance,2150,85000,87150
C001069,N00024842,Joe Courtney (D),2016,Health Professionals,12125,61250,73375
C001069,N00024842,Joe Courtney (D),2016,Defense Aerospace,150,56500,56650
C001069,N00024842,Joe Courtney (D),2016,Building Trade Unions,0,55500,55500
C001069,N00024842,Joe Courtney (D),2016,Public Sector Unions,0,50500,50500
C001069,N00024842,Joe Courtney (D),2016,Lawyers/Law Firms,28575,18000,46575
C001069,N00024842,Joe Courtney (D),2016,Retired,44475,0,44475
C001069,N00024842,Joe Courtney (D),2016,Industrial Unions,0,41000,41000
C001069,N00024842,Joe Courtney (D),2016,Defense Electronics,9850,31000,40850
C001069,N00024842,Joe Courtney (D),2016,Pharmaceuticals/Health Products,8000,28900,36900
C001056,N00024852,John Cornyn (R),2016,Securities & Investment,1006193,181000,1187193
C001056,N00024852,John Cornyn (R),2016,Oil & Gas,807956,293500,1101456
C001056,N00024852,John Cornyn (R),2016,Health Professionals,615200,222949,838149
C001056,N00024852,John Cornyn (R),2016,Lawyers/Law Firms,470857,188050,658907
C001056,N00024852,John Cornyn (R),2016,Real Estate,494249,87000,581249
C001056,N00024852,John Cornyn (R),2016,Retired,562799,0,562799
C001056,N00024852,John Cornyn (R),2016,Insurance,162750,255853,418603
C001056,N00024852,John Cornyn (R),2016,Commercial Banks,229215,124000,353215
C001056,N00024852,John Cornyn (R),2016,Leadership PACs,0,332358,332358
C001056,N00024852,John Cornyn (R),2016,Pharmaceuticals/Health Products,102350,224250,326600
B001245,N00024866,Madeleine Z Bordallo (D),2016,Retail Sales,12800,0,12800
B001245,N00024866,Madeleine Z Bordallo (D),2016,Defense Aerospace,0,12000,12000
B001245,N00024866,Madeleine Z Bordallo (D),2016,Real Estate,5450,3000,8450
B001245,N00024866,Madeleine Z Bordallo (D),2016,Transportation Unions,0,7000,7000
B001245,N00024866,Madeleine Z Bordallo (D),2016,Defense Electronics,1000,6000,7000
B001245,N00024866,Madeleine Z Bordallo (D),2016,Misc Defense,6000,500,6500
B001245,N00024866,Madeleine Z Bordallo (D),2016,Retired,6260,0,6260
B001245,N00024866,Madeleine Z Bordallo (D),2016,Commercial Banks,5350,0,5350
B001245,N00024866,Madeleine Z Bordallo (D),2016,Food Processing & Sales,5050,0,5050
B001245,N00024866,Madeleine Z Bordallo (D),2016,Human Rights,0,5000,5000
B001245,N00024866,Madeleine Z Bordallo (D),2016,Sea Transport,500,4500,5000
H001036,N00024922,Jeb Hensarling (R),2016,Securities & Investment,113745,185000,298745
H001036,N00024922,Jeb Hensarling (R),2016,Insurance,41700,240000,281700
H001036,N00024922,Jeb Hensarling (R),2016,Commercial Banks,72700,199600,272300
H001036,N00024922,Jeb Hensarling (R),2016,Real Estate,46750,112500,159250
H001036,N00024922,Jeb Hensarling (R),2016,Misc Finance,65850,42000,107850
H001036,N00024922,Jeb Hensarling (R),2016,Retired,93581,0,93581
H001036,N00024922,Jeb Hensarling (R),2016,Finance/Credit Companies,15700,67500,83200
H001036,N00024922,Jeb Hensarling (R),2016,Lawyers/Law Firms,40700,39650,80350
H001036,N00024922,Jeb Hensarling (R),2016,Oil & Gas,15400,44000,59400
H001036,N00024922,Jeb Hensarling (R),2016,Accountants,2300,55000,57300
C001063,N00024978,Henry Cuellar (D),2016,Oil & Gas,20650,131202,151852
C001063,N00024978,Henry Cuellar (D),2016,Lawyers/Law Firms,59841,22450,82291
C001063,N00024978,Henry Cuellar (D),2016,Crop Production & Basic Processing,16600,48000,64600
C001063,N00024978,Henry Cuellar (D),2016,Health Professionals,37097,22500,59597
C001063,N00024978,Henry Cuellar (D),2016,Insurance,2250,53000,55250
C001063,N00024978,Henry Cuellar (D),2016,Retail Sales,21178,27000,48178
C001063,N00024978,Henry Cuellar (D),2016,Real Estate,31200,16500,47700
C001063,N00024978,Henry Cuellar (D),2016,Automotive,11350,31995,43345
C001063,N00024978,Henry Cuellar (D),2016,Construction Services,26300,16000,42300
C001063,N00024978,Henry Cuellar (D),2016,Trucking,6900,27122,34022
C001051,N00025095,John Carter (R),2016,Defense Electronics,0,55500,55500
C001051,N00025095,John Carter (R),2016,Defense Aerospace,0,54000,54000
C001051,N00025095,John Carter (R),2016,Air Transport,750,47500,48250
C001051,N00025095,John Carter (R),2016,Oil & Gas,31900,11000,42900
C001051,N00025095,John Carter (R),2016,Real Estate,28694,13000,41694
C001051,N00025095,John Carter (R),2016,Misc Defense,6250,35000,41250
C001051,N00025095,John Carter (R),2016,Lawyers/Law Firms,23981,15249,39230
C001051,N00025095,John Carter (R),2016,Lobbyists,38225,0,38225
C001051,N00025095,John Carter (R),2016,Sea Transport,28299,2500,30799
C001051,N00025095,John Carter (R),2016,Automotive,17300,13000,30300
B001248,N00025219,Michael Burgess (R),2016,Health Professionals,83215,277666,360881
B001248,N00025219,Michael Burgess (R),2016,Pharmaceuticals/Health Products,250,128350,128600
B001248,N00025219,Michael Burgess (R),2016,Health Services/HMOs,11950,65500,77450
B001248,N00025219,Michael Burgess (R),2016,Automotive,1500,46500,48000
B001248,N00025219,Michael Burgess (R),2016,Oil & Gas,8100,35000,43100
B001248,N00025219,Michael Burgess (R),2016,Lawyers/Law Firms,15394,23000,38394
B001248,N00025219,Michael Burgess (R),2016,Insurance,1594,34500,36094
B001248,N00025219,Michael Burgess (R),2016,Lobbyists,34985,500,35485
B001248,N00025219,Michael Burgess (R),2016,Retired,30850,0,30850
B001248,N00025219,Michael Burgess (R),2016,Telecom Services,0,28500,28500
G000551,N00025284,Raul M Grijalva (D),2016,Public Sector Unions,1,62000,62001
G000551,N00025284,Raul M Grijalva (D),2016,Casinos/Gambling,55400,0,55400
G000551,N00025284,Raul M Grijalva (D),2016,Transportation Unions,0,38500,38500
G000551,N00025284,Raul M Grijalva (D),2016,Misc Unions,0,35250,35250
G000551,N00025284,Raul M Grijalva (D),2016,Lawyers/Law Firms,9314,19050,28364
G000551,N00025284,Raul M Grijalva (D),2016,Industrial Unions,0,26000,26000
G000551,N00025284,Raul M Grijalva (D),2016,Retired,25435,0,25435
G000551,N00025284,Raul M Grijalva (D),2016,Democratic/Liberal,18968,5500,24468
G000551,N00025284,Raul M Grijalva (D),2016,Environment,3875,13453,17328
G000551,N00025284,Raul M Grijalva (D),2016,Crop Production & Basic Processing,3100,12000,15100
B001250,N00025292,Rob Bishop (R),2016,Oil & Gas,11516,139000,150516
B001250,N00025292,Rob Bishop (R),2016,Casinos/Gambling,78700,10000,88700
B001250,N00025292,Rob Bishop (R),2016,Lawyers/Law Firms,24700,38250,62950
B001250,N00025292,Rob Bishop (R),2016,Lobbyists,49099,1000,50099
B001250,N00025292,Rob Bishop (R),2016,Electric Utilities,1750,40000,41750
B001250,N00025292,Rob Bishop (R),2016,Real Estate,17850,20500,38350
B001250,N00025292,Rob Bishop (R),2016,Defense Aerospace,0,33000,33000
B001250,N00025292,Rob Bishop (R),2016,Forestry & Forest Products,8000,21398,29398
B001250,N00025292,Rob Bishop (R),2016,Mining,250,28500,28750
B001250,N00025292,Rob Bishop (R),2016,Retired,26400,0,26400
D000600,N00025337,Mario Diaz-Balart (R),2016,Transportation Unions,0,85125,85125
D000600,N00025337,Mario Diaz-Balart (R),2016,Real Estate,36800,44000,80800
D000600,N00025337,Mario Diaz-Balart (R),2016,Lawyers/Law Firms,40000,39500,79500
D000600,N00025337,Mario Diaz-Balart (R),2016,Air Transport,4200,63000,67200
D000600,N00025337,Mario Diaz-Balart (R),2016,Railroads,2500,41500,44000
D000600,N00025337,Mario Diaz-Balart (R),2016,Lobbyists,43150,0,43150
D000600,N00025337,Mario Diaz-Balart (R),2016,Trucking,3500,38500,42000
D000600,N00025337,Mario Diaz-Balart (R),2016,Automotive,32465,6500,38965
D000600,N00025337,Mario Diaz-Balart (R),2016,Defense Aerospace,0,38500,38500
D000600,N00025337,Mario Diaz-Balart (R),2016,Building Materials & Equipment,0,38000,38000
B001269,N00025495,Lou Barletta (R),2016,Railroads,2550,55775,58325
B001269,N00025495,Lou Barletta (R),2016,Construction Services,18519,34000,52519
B001269,N00025495,Lou Barletta (R),2016,Air Transport,1000,48500,49500
B001269,N00025495,Lou Barletta (R),2016,Trucking,15200,33500,48700
B001269,N00025495,Lou Barletta (R),2016,Building Materials & Equipment,12000,33500,45500
B001269,N00025495,Lou Barletta (R),2016,Insurance,3606,40000,43606
B001269,N00025495,Lou Barletta (R),2016,Lawyers/Law Firms,23310,11500,34810
B001269,N00025495,Lou Barletta (R),2016,Oil & Gas,2300,32000,34300
B001269,N00025495,Lou Barletta (R),2016,Transportation Unions,0,33000,33000
B001269,N00025495,Lou Barletta (R),2016,Retired,32745,0,32745
C001053,N00025726,Tom Cole (R),2016,Human Rights,169600,9500,179100
C001053,N00025726,Tom Cole (R),2016,Oil & Gas,28850,80500,109350
C001053,N00025726,Tom Cole (R),2016,Lobbyists,76374,669,77043
C001053,N00025726,Tom Cole (R),2016,Retired,72150,0,72150
C001053,N00025726,Tom Cole (R),2016,Lawyers/Law Firms,34000,33000,67000
C001053,N00025726,Tom Cole (R),2016,Insurance,9200,57700,66900
C001053,N00025726,Tom Cole (R),2016,Health Professionals,4922,61000,65922
C001053,N00025726,Tom Cole (R),2016,Real Estate,31000,22500,53500
C001053,N00025726,Tom Cole (R),2016,Defense Aerospace,0,49000,49000
C001053,N00025726,Tom Cole (R),2016,Commercial Banks,25650,17400,43050
H001050,N00025881,Colleen Hanabusa (D),2016,Retired,81200,0,81200
H001050,N00025881,Colleen Hanabusa (D),2016,Real Estate,49650,12700,62350
H001050,N00025881,Colleen Hanabusa (D),2016,Building Trade Unions,0,45000,45000
H001050,N00025881,Colleen Hanabusa (D),2016,General Contractors,37800,0,37800
H001050,N00025881,Colleen Hanabusa (D),2016,Commercial Banks,21700,8400,30100
H001050,N00025881,Colleen Hanabusa (D),2016,Sea Transport,14700,13500,28200
H001050,N00025881,Colleen Hanabusa (D),2016,Public Sector Unions,0,26500,26500
H001050,N00025881,Colleen Hanabusa (D),2016,Leadership PACs,0,25500,25500
H001050,N00025881,Colleen Hanabusa (D),2016,Industrial Unions,0,24500,24500
H001050,N00025881,Colleen Hanabusa (D),2016,Construction Services,23750,500,24250
C001062,N00026041,Mike Conaway (R),2016,Crop Production & Basic Processing,73970,149000,222970
C001062,N00026041,Mike Conaway (R),2016,Agricultural Services/Products,2700,195610,198310
C001062,N00026041,Mike Conaway (R),2016,Securities & Investment,16200,113000,129200
C001062,N00026041,Mike Conaway (R),2016,Oil & Gas,61591,66833,128424
C001062,N00026041,Mike Conaway (R),2016,Dairy,41200,44750,85950
C001062,N00026041,Mike Conaway (R),2016,Livestock,39450,44000,83450
C001062,N00026041,Mike Conaway (R),2016,Commercial Banks,18400,52000,70400
C001062,N00026041,Mike Conaway (R),2016,Food Processing & Sales,8000,61000,69000
C001062,N00026041,Mike Conaway (R),2016,Accountants,21350,47500,68850
C001062,N00026041,Mike Conaway (R),2016,Lawyers/Law Firms,29350,13200,42550
G000552,N00026148,Louis B Gohmert Jr (R),2016,Retired,110703,0,110703
G000552,N00026148,Louis B Gohmert Jr (R),2016,Health Professionals,29450,250,29700
G000552,N00026148,Louis B Gohmert Jr (R),2016,Oil & Gas,21200,6500,27700
G000552,N00026148,Louis B Gohmert Jr (R),2016,Real Estate,19090,6000,25090
G000552,N00026148,Louis B Gohmert Jr (R),2016,Republican/Conservative,9300,14390,23690
G000552,N00026148,Louis B Gohmert Jr (R),2016,Misc Finance,21750,0,21750
G000552,N00026148,Louis B Gohmert Jr (R),2016,Forestry & Forest Products,8600,12000,20600
G000552,N00026148,Louis B Gohmert Jr (R),2016,Construction Services,14000,0,14000
G000552,N00026148,Louis B Gohmert Jr (R),2016,Insurance,10600,2500,13100
G000552,N00026148,Louis B Gohmert Jr (R),2016,Commercial Banks,10700,500,11200
F000450,N00026166,Virginia Foxx (R),2016,Retired,152745,0,152745
F000450,N00026166,Virginia Foxx (R),2016,Education,99625,28000,127625
F000450,N00026166,Virginia Foxx (R),2016,Lawyers/Law Firms,31800,30750,62550
F000450,N00026166,Virginia Foxx (R),2016,Health Professionals,20229,37100,57329
F000450,N00026166,Virginia Foxx (R),2016,Securities & Investment,28700,27000,55700
F000450,N00026166,Virginia Foxx (R),2016,Food & Beverage,8500,36000,44500
F000450,N00026166,Virginia Foxx (R),2016,Misc Manufacturing & Distributing,32550,11000,43550
F000450,N00026166,Virginia Foxx (R),2016,Retail Sales,8750,32000,40750
F000450,N00026166,Virginia Foxx (R),2016,Insurance,3300,33200,36500
F000450,N00026166,Virginia Foxx (R),2016,Real Estate,26550,9000,35550
D000604,N00026171,Charlie Dent (R),2016,Health Professionals,22150,122000,144150
D000604,N00026171,Charlie Dent (R),2016,Pharmaceuticals/Health Products,9900,127650,137550
D000604,N00026171,Charlie Dent (R),2016,Retired,65175,0,65175
D000604,N00026171,Charlie Dent (R),2016,Lawyers/Law Firms,34300,26750,61050
D000604,N00026171,Charlie Dent (R),2016,Chemical & Related Manufacturing,13500,46500,60000
D000604,N00026171,Charlie Dent (R),2016,Insurance,10500,42300,52800
D000604,N00026171,Charlie Dent (R),2016,Misc Manufacturing & Distributing,18140,31500,49640
D000604,N00026171,Charlie Dent (R),2016,Electric Utilities,3000,43500,46500
D000604,N00026171,Charlie Dent (R),2016,Lobbyists,45150,0,45150
D000604,N00026171,Charlie Dent (R),2016,Building Materials & Equipment,2700,40000,42700
C001059,N00026341,Jim Costa (D),2016,Crop Production & Basic Processing,111000,82100,193100
C001059,N00026341,Jim Costa (D),2016,Oil & Gas,3000,92525,95525
C001059,N00026341,Jim Costa (D),2016,Agricultural Services/Products,2750,80500,83250
C001059,N00026341,Jim Costa (D),2016,Livestock,34999,26700,61699
C001059,N00026341,Jim Costa (D),2016,Real Estate,49000,12500,61500
C001059,N00026341,Jim Costa (D),2016,Misc Issues,53000,2500,55500
C001059,N00026341,Jim Costa (D),2016,Health Professionals,43700,7500,51200
C001059,N00026341,Jim Costa (D),2016,Lawyers/Law Firms,34250,13000,47250
C001059,N00026341,Jim Costa (D),2016,Leadership PACs,0,47250,47250
C001059,N00026341,Jim Costa (D),2016,Electric Utilities,2650,42250,44900
D000607,N00026586,Joe Donnelly (D),2016,Lawyers/Law Firms,800739,74594,875333
D000607,N00026586,Joe Donnelly (D),2016,Leadership PACs,2750,387750,390500
D000607,N00026586,Joe Donnelly (D),2016,Securities & Investment,213335,140000,353335
D000607,N00026586,Joe Donnelly (D),2016,Retired,312382,0,312382
D000607,N00026586,Joe Donnelly (D),2016,Pharmaceuticals/Health Products,87312,163571,250883
D000607,N00026586,Joe Donnelly (D),2016,Insurance,30601,210000,240601
D000607,N00026586,Joe Donnelly (D),2016,Lobbyists,191910,35500,227410
D000607,N00026586,Joe Donnelly (D),2016,Real Estate,145869,46000,191869
D000607,N00026586,Joe Donnelly (D),2016,Education,151879,2500,154379
D000607,N00026586,Joe Donnelly (D),2016,Commercial Banks,56731,94250,150981
B001255,N00026595,Charles W Boustany Jr (R),2016,Health Professionals,274914,159200,434114
B001255,N00026595,Charles W Boustany Jr (R),2016,Oil & Gas,218037,192000,410037
B001255,N00026595,Charles W Boustany Jr (R),2016,Insurance,90164,162200,252364
B001255,N00026595,Charles W Boustany Jr (R),2016,Lobbyists,236582,9263,245845
B001255,N00026595,Charles W Boustany Jr (R),2016,Lawyers/Law Firms,156705,60900,217605
B001255,N00026595,Charles W Boustany Jr (R),2016,Retired,183025,0,183025
B001255,N00026595,Charles W Boustany Jr (R),2016,Securities & Investment,98850,74000,172850
B001255,N00026595,Charles W Boustany Jr (R),2016,Crop Production & Basic Processing,112866,44500,157366
B001255,N00026595,Charles W Boustany Jr (R),2016,Leadership PACs,0,144999,144999
B001255,N00026595,Charles W Boustany Jr (R),2016,Hospitals/Nursing Homes,64398,79000,143398
F000449,N00026631,Jeff Fortenberry (R),2016,Health Professionals,59450,11500,70950
F000449,N00026631,Jeff Fortenberry (R),2016,Insurance,11050,41500,52550
F000449,N00026631,Jeff Fortenberry (R),2016,Real Estate,27450,12000,39450
F000449,N00026631,Jeff Fortenberry (R),2016,Lawyers/Law Firms,17200,13000,30200
F000449,N00026631,Jeff Fortenberry (R),2016,Crop Production & Basic Processing,3250,26500,29750
F000449,N00026631,Jeff Fortenberry (R),2016,Defense Aerospace,0,25000,25000
F000449,N00026631,Jeff Fortenberry (R),2016,Agricultural Services/Products,3450,20500,23950
F000449,N00026631,Jeff Fortenberry (R),2016,Commercial Banks,3250,20500,23750
F000449,N00026631,Jeff Fortenberry (R),2016,Securities & Investment,21300,0,21300
F000449,N00026631,Jeff Fortenberry (R),2016,Republican/Conservative,2000,18500,20500
G000553,N00026686,Al Green (D),2016,Lawyers/Law Firms,82286,13100,95386
G000553,N00026686,Al Green (D),2016,Real Estate,58107,14000,72107
G000553,N00026686,Al Green (D),2016,Industrial Unions,0,40000,40000
G000553,N00026686,Al Green (D),2016,Construction Services,33600,2700,36300
G000553,N00026686,Al Green (D),2016,Building Trade Unions,0,33500,33500
G000553,N00026686,Al Green (D),2016,Education,26950,0,26950
G000553,N00026686,Al Green (D),2016,Transportation Unions,0,25500,25500
G000553,N00026686,Al Green (D),2016,Health Professionals,24800,0,24800
G000553,N00026686,Al Green (D),2016,Public Sector Unions,0,21500,21500
G000553,N00026686,Al Green (D),2016,Oil & Gas,14600,5500,20100
C001061,N00026790,Emanuel Cleaver (D),2016,Insurance,0,174000,174000
C001061,N00026790,Emanuel Cleaver (D),2016,Real Estate,45800,49500,95300
C001061,N00026790,Emanuel Cleaver (D),2016,Lawyers/Law Firms,40700,27000,67700
C001061,N00026790,Emanuel Cleaver (D),2016,Securities & Investment,3200,55250,58450
C001061,N00026790,Emanuel Cleaver (D),2016,Industrial Unions,0,52000,52000
C001061,N00026790,Emanuel Cleaver (D),2016,Accountants,0,37500,37500
C001061,N00026790,Emanuel Cleaver (D),2016,Public Sector Unions,0,35000,35000
C001061,N00026790,Emanuel Cleaver (D),2016,Building Trade Unions,0,34000,34000
C001061,N00026790,Emanuel Cleaver (D),2016,Commercial Banks,0,33700,33700
C001061,N00026790,Emanuel Cleaver (D),2016,Misc Unions,1000,32500,33500
C001067,N00026961,Yvette D Clarke (D),2016,Telecom Services,10000,51000,61000
C001067,N00026961,Yvette D Clarke (D),2016,Health Professionals,8940,35000,43940
C001067,N00026961,Yvette D Clarke (D),2016,Building Trade Unions,0,37500,37500
C001067,N00026961,Yvette D Clarke (D),2016,TV/Movies/Music,4350,28000,32350
C001067,N00026961,Yvette D Clarke (D),2016,Public Sector Unions,0,31000,31000
C001067,N00026961,Yvette D Clarke (D),2016,Misc Unions,0,25500,25500
C001067,N00026961,Yvette D Clarke (D),2016,Industrial Unions,0,25500,25500
C001067,N00026961,Yvette D Clarke (D),2016,Hospitals/Nursing Homes,6110,15500,21610
C001067,N00026961,Yvette D Clarke (D),2016,Lawyers/Law Firms,8350,13000,21350
C001067,N00026961,Yvette D Clarke (D),2016,Electric Utilities,500,20000,20500
B001251,N00027035,G K Butterfield (D),2016,Pharmaceuticals/Health Products,1050,124460,125510
B001251,N00027035,G K Butterfield (D),2016,Health Professionals,20650,77500,98150
B001251,N00027035,G K Butterfield (D),2016,Telecom Services,0,43500,43500
B001251,N00027035,G K Butterfield (D),2016,Insurance,3500,38500,42000
B001251,N00027035,G K Butterfield (D),2016,Industrial Unions,0,41000,41000
B001251,N00027035,G K Butterfield (D),2016,Lawyers/Law Firms,13500,27500,41000
B001251,N00027035,G K Butterfield (D),2016,Public Sector Unions,0,39000,39000
B001251,N00027035,G K Butterfield (D),2016,TV/Movies/Music,8400,27500,35900
B001251,N00027035,G K Butterfield (D),2016,Retail Sales,0,32500,32500
B001251,N00027035,G K Butterfield (D),2016,Food Processing & Sales,4500,27681,32181
H001038,N00027060,Brian M Higgins (D),2016,Lawyers/Law Firms,67352,8250,75602
H001038,N00027060,Brian M Higgins (D),2016,Industrial Unions,0,48000,48000
H001038,N00027060,Brian M Higgins (D),2016,Real Estate,27485,16500,43985
H001038,N00027060,Brian M Higgins (D),2016,Building Trade Unions,0,36000,36000
H001038,N00027060,Brian M Higgins (D),2016,Public Sector Unions,0,33000,33000
H001038,N00027060,Brian M Higgins (D),2016,Transportation Unions,0,28875,28875
H001038,N00027060,Brian M Higgins (D),2016,Hospitals/Nursing Homes,12985,5250,18235
H001038,N00027060,Brian M Higgins (D),2016,Retired,17700,0,17700
H001038,N00027060,Brian M Higgins (D),2016,Misc Unions,0,16700,16700
H001038,N00027060,Brian M Higgins (D),2016,Defense Aerospace,0,16500,16500
F000451,N00027229,Michael G Fitzpatrick (R),2016,Leadership PACs,0,11500,11500
F000451,N00027229,Michael G Fitzpatrick (R),2016,Home Builders,0,5000,5000
F000451,N00027229,Michael G Fitzpatrick (R),2016,Lodging/Tourism,0,3000,3000
F000451,N00027229,Michael G Fitzpatrick (R),2016,Oil & Gas,0,3000,3000
F000451,N00027229,Michael G Fitzpatrick (R),2016,Retail Sales,0,2000,2000
F000451,N00027229,Michael G Fitzpatrick (R),2016,Securities & Investment,0,2000,2000
F000451,N00027229,Michael G Fitzpatrick (R),2016,Electronics Mfg & Equip,0,2000,2000
F000451,N00027229,Michael G Fitzpatrick (R),2016,Lawyers/Law Firms,0,2000,2000
F000451,N00027229,Michael G Fitzpatrick (R),2016,Hospitals/Nursing Homes,0,1000,1000
F000451,N00027229,Michael G Fitzpatrick (R),2016,Candidate Committees,0,750,750
C001071,N00027441,Bob Corker (R),2016,Securities & Investment,780880,180170,961050
C001071,N00027441,Bob Corker (R),2016,Real Estate,525663,85100,610763
C001071,N00027441,Bob Corker (R),2016,Retired,498865,0,498865
C001071,N00027441,Bob Corker (R),2016,Lawyers/Law Firms,363967,106000,469967
C001071,N00027441,Bob Corker (R),2016,Health Professionals,323509,77000,400509
C001071,N00027441,Bob Corker (R),2016,Insurance,178829,201700,380529
C001071,N00027441,Bob Corker (R),2016,Commercial Banks,225431,143800,369231
C001071,N00027441,Bob Corker (R),2016,Misc Finance,339811,23500,363311
C001071,N00027441,Bob Corker (R),2016,Leadership PACs,0,288000,288000
C001071,N00027441,Bob Corker (R),2016,General Contractors,239448,6000,245448
B001257,N00027462,Gus Bilirakis (R),2016,Health Professionals,56474,162500,218974
B001257,N00027462,Gus Bilirakis (R),2016,Pharmaceuticals/Health Products,2350,78500,80850
B001257,N00027462,Gus Bilirakis (R),2016,Real Estate,54531,20000,74531
B001257,N00027462,Gus Bilirakis (R),2016,Retired,66930,0,66930
B001257,N00027462,Gus Bilirakis (R),2016,Health Services/HMOs,700,58100,58800
B001257,N00027462,Gus Bilirakis (R),2016,Lawyers/Law Firms,36461,19750,56211
B001257,N00027462,Gus Bilirakis (R),2016,Telecom Services,0,49500,49500
B001257,N00027462,Gus Bilirakis (R),2016,Insurance,10600,32500,43100
B001257,N00027462,Gus Bilirakis (R),2016,Electric Utilities,0,41000,41000
B001257,N00027462,Gus Bilirakis (R),2016,Lodging/Tourism,850,38500,39350
C001070,N00027503,Bob Casey (D),2016,Lawyers/Law Firms,1738630,207233,1945863
C001070,N00027503,Bob Casey (D),2016,Pharmaceuticals/Health Products,142310,364329,506639
C001070,N00027503,Bob Casey (D),2016,Securities & Investment,334606,163700,498306
C001070,N00027503,Bob Casey (D),2016,Real Estate,361809,59900,421709
C001070,N00027503,Bob Casey (D),2016,Lobbyists,396401,12300,408701
C001070,N00027503,Bob Casey (D),2016,Retired,402087,0,402087
C001070,N00027503,Bob Casey (D),2016,Insurance,156500,222500,379000
C001070,N00027503,Bob Casey (D),2016,Health Professionals,193614,169250,362864
C001070,N00027503,Bob Casey (D),2016,Hospitals/Nursing Homes,233585,123000,356585
C001070,N00027503,Bob Casey (D),2016,Leadership PACs,1000,340364,341364
C001066,N00027514,Kathy Castor (D),2016,Health Professionals,6325,73000,79325
C001066,N00027514,Kathy Castor (D),2016,Lawyers/Law Firms,45205,18250,63455
C001066,N00027514,Kathy Castor (D),2016,Telecom Services,1000,33000,34000
C001066,N00027514,Kathy Castor (D),2016,Insurance,12000,16500,28500
C001066,N00027514,Kathy Castor (D),2016,Hospitals/Nursing Homes,11900,16500,28400
C001066,N00027514,Kathy Castor (D),2016,Industrial Unions,0,22500,22500
C001066,N00027514,Kathy Castor (D),2016,Building Trade Unions,0,17500,17500
C001066,N00027514,Kathy Castor (D),2016,Real Estate,8050,8000,16050
C001066,N00027514,Kathy Castor (D),2016,Misc Unions,0,16000,16000
C001066,N00027514,Kathy Castor (D),2016,Public Sector Unions,0,15000,15000
H001041,N00027522,Dean Heller (R),2016,Retired,583942,0,583942
H001041,N00027522,Dean Heller (R),2016,Securities & Investment,355265,169700,524965
H001041,N00027522,Dean Heller (R),2016,Leadership PACs,500,490592,491092
H001041,N00027522,Dean Heller (R),2016,Insurance,98705,333800,432505
H001041,N00027522,Dean Heller (R),2016,Casinos/Gambling,308982,106500,415482
H001041,N00027522,Dean Heller (R),2016,Real Estate,325465,54000,379465
H001041,N00027522,Dean Heller (R),2016,Health Professionals,155845,151000,306845
H001041,N00027522,Dean Heller (R),2016,Lobbyists,260614,13714,274328
H001041,N00027522,Dean Heller (R),2016,Oil & Gas,106200,162750,268950
H001041,N00027522,Dean Heller (R),2016,Mining,155275,108825,264100
B001260,N00027626,Vernon Buchanan (R),2016,Hospitals/Nursing Homes,51500,74500,126000
B001260,N00027626,Vernon Buchanan (R),2016,Health Professionals,56715,54500,111215
B001260,N00027626,Vernon Buchanan (R),2016,Retired,110425,0,110425
B001260,N00027626,Vernon Buchanan (R),2016,Misc Issues,86000,8000,94000
B001260,N00027626,Vernon Buchanan (R),2016,Real Estate,65550,27675,93225
B001260,N00027626,Vernon Buchanan (R),2016,Insurance,7400,62000,69400
B001260,N00027626,Vernon Buchanan (R),2016,Pharmaceuticals/Health Products,29400,31000,60400
B001260,N00027626,Vernon Buchanan (R),2016,Health Services/HMOs,0,43000,43000
B001260,N00027626,Vernon Buchanan (R),2016,Sea Transport,23100,18500,41600
B001260,N00027626,Vernon Buchanan (R),2016,Food & Beverage,22800,16500,39300
H001057,N00027649,Tim Huelskamp (R),2016,Republican/Conservative,35319,28930,64249
H001057,N00027649,Tim Huelskamp (R),2016,Misc Manufacturing & Distributing,63600,0,63600
H001057,N00027649,Tim Huelskamp (R),2016,Retired,49826,0,49826
H001057,N00027649,Tim Huelskamp (R),2016,Oil & Gas,32797,13000,45797
H001057,N00027649,Tim Huelskamp (R),2016,Leadership PACs,0,35752,35752
H001057,N00027649,Tim Huelskamp (R),2016,Candidate Committees,0,29200,29200
H001057,N00027649,Tim Huelskamp (R),2016,Securities & Investment,25600,0,25600
H001057,N00027649,Tim Huelskamp (R),2016,Crop Production & Basic Processing,22694,1000,23694
H001057,N00027649,Tim Huelskamp (R),2016,Home Builders,17200,5000,22200
H001057,N00027649,Tim Huelskamp (R),2016,Health Professionals,16350,4500,20850
G000555,N00027658,Kirsten Gillibrand (D),2016,Lawyers/Law Firms,2294052,174700,2468752
G000555,N00027658,Kirsten Gillibrand (D),2016,Securities & Investment,1518237,189500,1707737
G000555,N00027658,Kirsten Gillibrand (D),2016,Real Estate,696158,76500,772658
G000555,N00027658,Kirsten Gillibrand (D),2016,Retired,756913,0,756913
G000555,N00027658,Kirsten Gillibrand (D),2016,Women's Issues,571105,14500,585605
G000555,N00027658,Kirsten Gillibrand (D),2016,TV/Movies/Music,473914,57500,531414
G000555,N00027658,Kirsten Gillibrand (D),2016,Lobbyists,389130,17845,406975
G000555,N00027658,Kirsten Gillibrand (D),2016,Business Services,369108,31000,400108
G000555,N00027658,Kirsten Gillibrand (D),2016,Insurance,173741,213116,386857
G000555,N00027658,Kirsten Gillibrand (D),2016,Misc Finance,338828,10100,348928
D000622,N00027860,Tammy Duckworth (D),2016,Women's Issues,1279741,36635,1316376
D000622,N00027860,Tammy Duckworth (D),2016,Lawyers/Law Firms,1205199,25900,1231099
D000622,N00027860,Tammy Duckworth (D),2016,Retired,1208777,0,1208777
D000622,N00027860,Tammy Duckworth (D),2016,Democratic/Liberal,704603,23031,727634
D000622,N00027860,Tammy Duckworth (D),2016,Securities & Investment,450781,11000,461781
D000622,N00027860,Tammy Duckworth (D),2016,Leadership PACs,0,386800,386800
D000622,N00027860,Tammy Duckworth (D),2016,Pro-Israel,301684,20850,322534
D000622,N00027860,Tammy Duckworth (D),2016,Real Estate,309146,13000,322146
D000622,N00027860,Tammy Duckworth (D),2016,Education,302020,7500,309520
D000622,N00027860,Tammy Duckworth (D),2016,Environment,240232,19532,259764
H001042,N00028139,Mazie K Hirono (D),2016,Lawyers/Law Firms,738901,64750,803651
H001042,N00028139,Mazie K Hirono (D),2016,Women's Issues,310272,29500,339772
H001042,N00028139,Mazie K Hirono (D),2016,Retired,239070,0,239070
H001042,N00028139,Mazie K Hirono (D),2016,Leadership PACs,1000,228000,229000
H001042,N00028139,Mazie K Hirono (D),2016,Real Estate,161599,24500,186099
H001042,N00028139,Mazie K Hirono (D),2016,Lobbyists,175094,6750,181844
H001042,N00028139,Mazie K Hirono (D),2016,Sea Transport,92185,78852,171037
H001042,N00028139,Mazie K Hirono (D),2016,Transportation Unions,1400,136875,138275
H001042,N00028139,Mazie K Hirono (D),2016,Human Rights,87966,33244,121210
H001042,N00028139,Mazie K Hirono (D),2016,Public Sector Unions,300,117000,117300
E000290,N00028249,Donna Edwards (D),2016,Women's Issues,450754,19000,469754
E000290,N00028249,Donna Edwards (D),2016,Democratic/Liberal,140483,8466,148949
E000290,N00028249,Donna Edwards (D),2016,Retired,133129,0,133129
E000290,N00028249,Donna Edwards (D),2016,Lawyers/Law Firms,105639,1000,106639
E000290,N00028249,Donna Edwards (D),2016,Human Rights,63927,31999,95926
E000290,N00028249,Donna Edwards (D),2016,Education,92598,0,92598
E000290,N00028249,Donna Edwards (D),2016,Non-Profit Institutions,85465,0,85465
E000290,N00028249,Donna Edwards (D),2016,Business Services,66447,0,66447
E000290,N00028249,Donna Edwards (D),2016,Real Estate,62775,0,62775
E000290,N00028249,Donna Edwards (D),2016,Securities & Investment,60850,0,60850
E000288,N00028257,Keith Ellison (D),2016,Health Professionals,168212,5000,173212
E000288,N00028257,Keith Ellison (D),2016,Retired,135209,0,135209
E000288,N00028257,Keith Ellison (D),2016,Democratic/Liberal,79135,10000,89135
E000288,N00028257,Keith Ellison (D),2016,Human Rights,58694,12500,71194
E000288,N00028257,Keith Ellison (D),2016,Lawyers/Law Firms,37819,19066,56885
E000288,N00028257,Keith Ellison (D),2016,Public Sector Unions,0,51500,51500
E000288,N00028257,Keith Ellison (D),2016,Securities & Investment,47915,1000,48915
E000288,N00028257,Keith Ellison (D),2016,Industrial Unions,25,42500,42525
E000288,N00028257,Keith Ellison (D),2016,Misc Unions,3330,35250,38580
E000288,N00028257,Keith Ellison (D),2016,Education,38199,0,38199
C001076,N00028958,Jason Chaffetz (R),2016,Pharmaceuticals/Health Products,23350,66000,89350
C001076,N00028958,Jason Chaffetz (R),2016,Lawyers/Law Firms,41700,27250,68950
C001076,N00028958,Jason Chaffetz (R),2016,Internet,42600,26000,68600
C001076,N00028958,Jason Chaffetz (R),2016,Retail Sales,3000,64500,67500
C001076,N00028958,Jason Chaffetz (R),2016,Lobbyists,57400,2041,59441
C001076,N00028958,Jason Chaffetz (R),2016,Real Estate,40600,16000,56600
C001076,N00028958,Jason Chaffetz (R),2016,Securities & Investment,26600,28000,54600
C001076,N00028958,Jason Chaffetz (R),2016,Electronics Mfg & Equip,14550,37000,51550
C001076,N00028958,Jason Chaffetz (R),2016,Misc Manufacturing & Distributing,24400,25500,49900
C001076,N00028958,Jason Chaffetz (R),2016,Oil & Gas,14300,35500,49800
F000457,N00029016,Al Franken (D),2016,Retired,1494688,0,1494688
F000457,N00029016,Al Franken (D),2016,Lawyers/Law Firms,1215563,96188,1311751
F000457,N00029016,Al Franken (D),2016,TV/Movies/Music,606128,20004,626132
F000457,N00029016,Al Franken (D),2016,Securities & Investment,383266,7000,390266
F000457,N00029016,Al Franken (D),2016,Leadership PACs,250,377400,377650
F000457,N00029016,Al Franken (D),2016,Real Estate,313864,15010,328874
F000457,N00029016,Al Franken (D),2016,Health Professionals,172689,73400,246089
F000457,N00029016,Al Franken (D),2016,Printing & Publishing,240628,2000,242628
F000457,N00029016,Al Franken (D),2016,Education,235706,2000,237706
F000457,N00029016,Al Franken (D),2016,Democratic/Liberal,200303,19617,219920
H001047,N00029070,Jim Himes (D),2016,Securities & Investment,203940,174400,378340
H001047,N00029070,Jim Himes (D),2016,Insurance,70750,194000,264750
H001047,N00029070,Jim Himes (D),2016,Retired,159095,0,159095
H001047,N00029070,Jim Himes (D),2016,Commercial Banks,17250,81500,98750
H001047,N00029070,Jim Himes (D),2016,Real Estate,29385,68000,97385
H001047,N00029070,Jim Himes (D),2016,Lawyers/Law Firms,54460,15250,69710
H001047,N00029070,Jim Himes (D),2016,Accountants,1785,57500,59285
H001047,N00029070,Jim Himes (D),2016,Retail Sales,29300,23000,52300
H001047,N00029070,Jim Himes (D),2016,Democratic/Liberal,43041,6500,49541
H001047,N00029070,Jim Himes (D),2016,Pharmaceuticals/Health Products,6400,40500,46900
F000454,N00029139,Bill Foster (D),2016,Education,464887,0,464887
F000454,N00029139,Bill Foster (D),2016,Democratic/Liberal,215272,10000,225272
F000454,N00029139,Bill Foster (D),2016,Retired,217553,0,217553
F000454,N00029139,Bill Foster (D),2016,Securities & Investment,91335,111000,202335
F000454,N00029139,Bill Foster (D),2016,Lawyers/Law Firms,154900,26998,181898
F000454,N00029139,Bill Foster (D),2016,Real Estate,63005,58000,121005
F000454,N00029139,Bill Foster (D),2016,Civil Servants/Public Officials,114536,0,114536
F000454,N00029139,Bill Foster (D),2016,Insurance,7900,77700,85600
F000454,N00029139,Bill Foster (D),2016,Pro-Israel,80140,2450,82590
F000454,N00029139,Bill Foster (D),2016,Building Trade Unions,0,63500,63500
H001052,N00029147,Andy Harris (R),2016,Health Professionals,128802,124200,253002
H001052,N00029147,Andy Harris (R),2016,Retired,73347,0,73347
H001052,N00029147,Andy Harris (R),2016,Real Estate,42725,7000,49725
H001052,N00029147,Andy Harris (R),2016,Food & Beverage,23700,12000,35700
H001052,N00029147,Andy Harris (R),2016,Misc Defense,5900,22000,27900
H001052,N00029147,Andy Harris (R),2016,Food Processing & Sales,2750,24500,27250
H001052,N00029147,Andy Harris (R),2016,Lawyers/Law Firms,23532,3000,26532
H001052,N00029147,Andy Harris (R),2016,Education,22650,1000,23650
H001052,N00029147,Andy Harris (R),2016,Tobacco,500,20807,21307
H001052,N00029147,Andy Harris (R),2016,Oil & Gas,1500,19000,20500
H001048,N00029258,Duncan D Hunter (R),2016,Sea Transport,31100,58750,89850
H001048,N00029258,Duncan D Hunter (R),2016,Misc Defense,9250,66777,76027
H001048,N00029258,Duncan D Hunter (R),2016,Defense Aerospace,1000,67500,68500
H001048,N00029258,Duncan D Hunter (R),2016,Defense Electronics,2000,55750,57750
H001048,N00029258,Duncan D Hunter (R),2016,Lobbyists,44500,3476,47976
H001048,N00029258,Duncan D Hunter (R),2016,Transportation Unions,0,41000,41000
H001048,N00029258,Duncan D Hunter (R),2016,Air Transport,0,40500,40500
H001048,N00029258,Duncan D Hunter (R),2016,Building Materials & Equipment,0,30500,30500
H001048,N00029258,Duncan D Hunter (R),2016,Electric Utilities,20250,10000,30250
H001048,N00029258,Duncan D Hunter (R),2016,Trucking,1500,26500,28000
C001072,N00029513,Andre Carson (D),2016,Lawyers/Law Firms,71704,16000,87704
C001072,N00029513,Andre Carson (D),2016,Health Professionals,70327,12000,82327
C001072,N00029513,Andre Carson (D),2016,Air Transport,0,63500,63500
C001072,N00029513,Andre Carson (D),2016,Building Trade Unions,0,62500,62500
C001072,N00029513,Andre Carson (D),2016,Transportation Unions,0,49000,49000
C001072,N00029513,Andre Carson (D),2016,Industrial Unions,0,47000,47000
C001072,N00029513,Andre Carson (D),2016,Real Estate,32299,11200,43499
C001072,N00029513,Andre Carson (D),2016,Pharmaceuticals/Health Products,19151,20000,39151
C001072,N00029513,Andre Carson (D),2016,Public Sector Unions,500,37000,37500
C001072,N00029513,Andre Carson (D),2016,Construction Services,29666,7750,37416
H001045,N00029632,Gregg Harper (R),2016,Health Professionals,19250,76000,95250
H001045,N00029632,Gregg Harper (R),2016,Oil & Gas,21550,38500,60050
H001045,N00029632,Gregg Harper (R),2016,Lawyers/Law Firms,27000,18500,45500
H001045,N00029632,Gregg Harper (R),2016,Electric Utilities,1000,44000,45000
H001045,N00029632,Gregg Harper (R),2016,Commercial Banks,7500,32000,39500
H001045,N00029632,Gregg Harper (R),2016,Defense Aerospace,5000,29000,34000
H001045,N00029632,Gregg Harper (R),2016,Real Estate,18850,10000,28850
H001045,N00029632,Gregg Harper (R),2016,Crop Production & Basic Processing,5100,23000,28100
H001045,N00029632,Gregg Harper (R),2016,Leadership PACs,0,27500,27500
H001045,N00029632,Gregg Harper (R),2016,Lobbyists,25300,0,25300
G000558,N00029675,Brett Guthrie (R),2016,Health Professionals,14600,240500,255100
G000558,N00029675,Brett Guthrie (R),2016,Pharmaceuticals/Health Products,7850,200772,208622
G000558,N00029675,Brett Guthrie (R),2016,Health Services/HMOs,250,101200,101450
G000558,N00029675,Brett Guthrie (R),2016,Insurance,10000,84000,94000
G000558,N00029675,Brett Guthrie (R),2016,Telecom Services,2000,67250,69250
G000558,N00029675,Brett Guthrie (R),2016,Lobbyists,56489,2000,58489
G000558,N00029675,Brett Guthrie (R),2016,Oil & Gas,1000,56000,57000
G000558,N00029675,Brett Guthrie (R),2016,Electric Utilities,0,44500,44500
G000558,N00029675,Brett Guthrie (R),2016,Retail Sales,6250,38000,44250
G000558,N00029675,Brett Guthrie (R),2016,Building Materials & Equipment,3750,40500,44250
F000456,N00029679,John Fleming (R),2016,Republican/Conservative,402991,22500,425491
F000456,N00029679,John Fleming (R),2016,Health Professionals,194705,36500,231205
F000456,N00029679,John Fleming (R),2016,Retired,187953,0,187953
F000456,N00029679,John Fleming (R),2016,Oil & Gas,148430,9000,157430
F000456,N00029679,John Fleming (R),2016,Real Estate,98450,3000,101450
F000456,N00029679,John Fleming (R),2016,General Contractors,59650,6500,66150
F000456,N00029679,John Fleming (R),2016,Pro-Israel,47750,16500,64250
F000456,N00029679,John Fleming (R),2016,Securities & Investment,62550,0,62550
F000456,N00029679,John Fleming (R),2016,Lawyers/Law Firms,54135,3500,57635
F000456,N00029679,John Fleming (R),2016,Hospitals/Nursing Homes,57066,0,57066
H001046,N00029835,Martin Heinrich (D),2016,Lawyers/Law Firms,680727,91975,772702
H001046,N00029835,Martin Heinrich (D),2016,Retired,585142,0,585142
H001046,N00029835,Martin Heinrich (D),2016,Lobbyists,404052,3724,407776
H001046,N00029835,Martin Heinrich (D),2016,Environment,243668,31166,274834
H001046,N00029835,Martin Heinrich (D),2016,Leadership PACs,0,243500,243500
H001046,N00029835,Martin Heinrich (D),2016,Health Professionals,128262,105500,233762
H001046,N00029835,Martin Heinrich (D),2016,Education,172041,6500,178541
H001046,N00029835,Martin Heinrich (D),2016,Casinos/Gambling,162050,13500,175550
H001046,N00029835,Martin Heinrich (D),2016,Democratic/Liberal,134053,31435,165488
H001046,N00029835,Martin Heinrich (D),2016,Pro-Israel,134380,23993,158373
C001078,N00029891,Gerry Connolly (D),2016,Retired,124188,0,124188
C001078,N00029891,Gerry Connolly (D),2016,Electronics Mfg & Equip,32945,83000,115945
C001078,N00029891,Gerry Connolly (D),2016,Public Sector Unions,250,98813,99063
C001078,N00029891,Gerry Connolly (D),2016,Lawyers/Law Firms,69340,26750,96090
C001078,N00029891,Gerry Connolly (D),2016,Real Estate,68044,12000,80044
C001078,N00029891,Gerry Connolly (D),2016,Business Services,56742,8500,65242
C001078,N00029891,Gerry Connolly (D),2016,Lobbyists,58600,500,59100
C001078,N00029891,Gerry Connolly (D),2016,Securities & Investment,12350,39000,51350
C001078,N00029891,Gerry Connolly (D),2016,Democratic/Liberal,38584,11000,49584
C001078,N00029891,Gerry Connolly (D),2016,Misc Defense,2350,47000,49350
G000573,N00029908,Joe Garcia (D),2016,Lawyers/Law Firms,170336,1000,171336
G000573,N00029908,Joe Garcia (D),2016,Leadership PACs,12200,125500,137700
G000573,N00029908,Joe Garcia (D),2016,Real Estate,61085,0,61085
G000573,N00029908,Joe Garcia (D),2016,Retired,56945,0,56945
G000573,N00029908,Joe Garcia (D),2016,Candidate Committees,0,42500,42500
G000573,N00029908,Joe Garcia (D),2016,Democratic/Liberal,30002,11000,41002
G000573,N00029908,Joe Garcia (D),2016,Foreign & Defense Policy,29750,10000,39750
G000573,N00029908,Joe Garcia (D),2016,Securities & Investment,37450,0,37450
G000573,N00029908,Joe Garcia (D),2016,General Contractors,33700,0,33700
G000573,N00029908,Joe Garcia (D),2016,Misc Business,27850,0,27850
H001051,N00030197,Richard Hanna (R),2016,Air Transport,500,29000,29500
H001051,N00030197,Richard Hanna (R),2016,Securities & Investment,19900,1000,20900
H001051,N00030197,Richard Hanna (R),2016,Transportation Unions,0,17000,17000
H001051,N00030197,Richard Hanna (R),2016,Special Trade Contractors,0,16500,16500
H001051,N00030197,Richard Hanna (R),2016,Health Professionals,1000,15000,16000
H001051,N00030197,Richard Hanna (R),2016,Building Trade Unions,0,15000,15000
H001051,N00030197,Richard Hanna (R),2016,Construction Services,0,14000,14000
H001051,N00030197,Richard Hanna (R),2016,General Contractors,1000,12000,13000
H001051,N00030197,Richard Hanna (R),2016,Building Materials & Equipment,0,10500,10500
H001051,N00030197,Richard Hanna (R),2016,Trucking,0,9500,9500
H001051,N00030197,Richard Hanna (R),2016,Insurance,500,9000,9500
C001075,N00030245,Bill Cassidy (R),2016,Health Professionals,861265,343100,1204365
C001075,N00030245,Bill Cassidy (R),2016,Retired,1145288,0,1145288
C001075,N00030245,Bill Cassidy (R),2016,Securities & Investment,976976,8500,985476
C001075,N00030245,Bill Cassidy (R),2016,Oil & Gas,709170,132000,841170
C001075,N00030245,Bill Cassidy (R),2016,Leadership PACs,0,607794,607794
C001075,N00030245,Bill Cassidy (R),2016,Real Estate,444395,6400,450795
C001075,N00030245,Bill Cassidy (R),2016,Republican/Conservative,197826,104714,302540
C001075,N00030245,Bill Cassidy (R),2016,Lawyers/Law Firms,256485,21500,277985
C001075,N00030245,Bill Cassidy (R),2016,General Contractors,226000,38500,264500
C001075,N00030245,Bill Cassidy (R),2016,Misc Finance,243067,5000,248067
F000455,N00030490,Marcia L Fudge (D),2016,Public Sector Unions,0,54500,54500
F000455,N00030490,Marcia L Fudge (D),2016,Industrial Unions,5000,42500,47500
F000455,N00030490,Marcia L Fudge (D),2016,Agricultural Services/Products,0,44000,44000
F000455,N00030490,Marcia L Fudge (D),2016,Electric Utilities,0,40500,40500
F000455,N00030490,Marcia L Fudge (D),2016,Building Trade Unions,2000,35000,37000
F000455,N00030490,Marcia L Fudge (D),2016,Lawyers/Law Firms,7531,23000,30531
F000455,N00030490,Marcia L Fudge (D),2016,Insurance,0,27000,27000
F000455,N00030490,Marcia L Fudge (D),2016,Transportation Unions,0,26500,26500
F000455,N00030490,Marcia L Fudge (D),2016,Food Processing & Sales,2000,21500,23500
F000455,N00030490,Marcia L Fudge (D),2016,Food & Beverage,500,23000,23500
C001080,N00030600,Judy Chu (D),2016,Real Estate,58900,7000,65900
C001080,N00030600,Judy Chu (D),2016,Lawyers/Law Firms,41700,16000,57700
C001080,N00030600,Judy Chu (D),2016,Health Professionals,24100,27000,51100
C001080,N00030600,Judy Chu (D),2016,Public Sector Unions,0,46500,46500
C001080,N00030600,Judy Chu (D),2016,TV/Movies/Music,6800,28200,35000
C001080,N00030600,Judy Chu (D),2016,Building Trade Unions,0,34000,34000
C001080,N00030600,Judy Chu (D),2016,Misc Unions,0,33500,33500
C001080,N00030600,Judy Chu (D),2016,Industrial Unions,0,33000,33000
C001080,N00030600,Judy Chu (D),2016,Retired,31548,0,31548
C001080,N00030600,Judy Chu (D),2016,Telecom Services,10550,16500,27050
B001267,N00030608,Michael F Bennet (D),2016,Securities & Investment,1845499,195450,2040949
B001267,N00030608,Michael F Bennet (D),2016,Lawyers/Law Firms,1695953,228712,1924665
B001267,N00030608,Michael F Bennet (D),2016,Retired,953328,0,953328
B001267,N00030608,Michael F Bennet (D),2016,Real Estate,842592,93900,936492
B001267,N00030608,Michael F Bennet (D),2016,Democratic/Liberal,711776,23030,734806
B001267,N00030608,Michael F Bennet (D),2016,Education,501566,27500,529066
B001267,N00030608,Michael F Bennet (D),2016,Lobbyists,494264,25200,519464
B001267,N00030608,Michael F Bennet (D),2016,Environment,480252,27709,507961
B001267,N00030608,Michael F Bennet (D),2016,Health Professionals,273899,207500,481399
B001267,N00030608,Michael F Bennet (D),2016,TV/Movies/Music,427090,42000,469090
H001058,N00030673,Bill Huizenga (R),2016,Insurance,0,170500,170500
H001058,N00030673,Bill Huizenga (R),2016,Real Estate,75000,70000,145000
H001058,N00030673,Bill Huizenga (R),2016,Securities & Investment,18200,99000,117200
H001058,N00030673,Bill Huizenga (R),2016,Commercial Banks,3000,97500,100500
H001058,N00030673,Bill Huizenga (R),2016,Misc Manufacturing & Distributing,48000,10700,58700
H001058,N00030673,Bill Huizenga (R),2016,Accountants,0,40000,40000
H001058,N00030673,Bill Huizenga (R),2016,Finance/Credit Companies,0,36000,36000
H001058,N00030673,Bill Huizenga (R),2016,Lawyers/Law Firms,7500,24250,31750
H001058,N00030673,Bill Huizenga (R),2016,Retail Sales,21600,10000,31600
H001058,N00030673,Bill Huizenga (R),2016,Retired,28475,0,28475
D000617,N00030693,Suzan DelBene (D),2016,Electronics Mfg & Equip,92788,53784,146572
D000617,N00030693,Suzan DelBene (D),2016,Democratic/Liberal,101999,16000,117999
D000617,N00030693,Suzan DelBene (D),2016,Retired,92648,0,92648
D000617,N00030693,Suzan DelBene (D),2016,Lawyers/Law Firms,42820,21000,63820
D000617,N00030693,Suzan DelBene (D),2016,Retail Sales,11615,50500,62115
D000617,N00030693,Suzan DelBene (D),2016,TV/Movies/Music,17005,37000,54005
D000617,N00030693,Suzan DelBene (D),2016,Agricultural Services/Products,225,47500,47725
D000617,N00030693,Suzan DelBene (D),2016,Pharmaceuticals/Health Products,2750,44236,46986
D000617,N00030693,Suzan DelBene (D),2016,Securities & Investment,17700,28000,45700
D000617,N00030693,Suzan DelBene (D),2016,Casinos/Gambling,41650,0,41650
D000617,N00030693,Suzan DelBene (D),2016,Internet,20150,21500,41650
D000623,N00030709,Mark Desaulnier (D),2016,Public Sector Unions,0,56500,56500
D000623,N00030709,Mark Desaulnier (D),2016,Real Estate,42050,6000,48050
D000623,N00030709,Mark Desaulnier (D),2016,Lawyers/Law Firms,32505,8500,41005
D000623,N00030709,Mark Desaulnier (D),2016,Building Trade Unions,0,40500,40500
D000623,N00030709,Mark Desaulnier (D),2016,Industrial Unions,0,37000,37000
D000623,N00030709,Mark Desaulnier (D),2016,Retired,22385,0,22385
D000623,N00030709,Mark Desaulnier (D),2016,Transportation Unions,0,22125,22125
D000623,N00030709,Mark Desaulnier (D),2016,Home Builders,18930,2000,20930
D000623,N00030709,Mark Desaulnier (D),2016,Democratic/Liberal,19320,250,19570
D000623,N00030709,Mark Desaulnier (D),2016,Crop Production & Basic Processing,1000,17000,18000
B001287,N00030717,Ami Bera (D),2016,Retired,328990,0,328990
B001287,N00030717,Ami Bera (D),2016,Health Professionals,89992,221150,311142
B001287,N00030717,Ami Bera (D),2016,Democratic/Liberal,260635,18648,279283
B001287,N00030717,Ami Bera (D),2016,Leadership PACs,2700,241983,244683
B001287,N00030717,Ami Bera (D),2016,Securities & Investment,154750,9500,164250
B001287,N00030717,Ami Bera (D),2016,Human Rights,100925,48600,149525
B001287,N00030717,Ami Bera (D),2016,Lawyers/Law Firms,125833,17685,143518
B001287,N00030717,Ami Bera (D),2016,Pharmaceuticals/Health Products,24450,93250,117700
B001287,N00030717,Ami Bera (D),2016,Education,116944,0,116944
B001287,N00030717,Ami Bera (D),2016,Real Estate,87894,18500,106394
C001083,N00030736,John Carney (D),2016,Securities & Investment,4250,47500,51750
C001083,N00030736,John Carney (D),2016,Insurance,500,38000,38500
C001083,N00030736,John Carney (D),2016,Commercial Banks,1350,24500,25850
C001083,N00030736,John Carney (D),2016,Accountants,0,18000,18000
C001083,N00030736,John Carney (D),2016,Pharmaceuticals/Health Products,0,17500,17500
C001083,N00030736,John Carney (D),2016,Lawyers/Law Firms,8650,6000,14650
C001083,N00030736,John Carney (D),2016,Finance/Credit Companies,0,13500,13500
C001083,N00030736,John Carney (D),2016,Real Estate,3700,9000,12700
C001083,N00030736,John Carney (D),2016,Lobbyists,7750,0,7750
C001083,N00030736,John Carney (D),2016,Democratic/Liberal,500,5000,5500
D000615,N00030752,Jeff Duncan (R),2016,Oil & Gas,1000,41500,42500
D000615,N00030752,Jeff Duncan (R),2016,Retired,33180,0,33180
D000615,N00030752,Jeff Duncan (R),2016,Pro-Israel,5000,20000,25000
D000615,N00030752,Jeff Duncan (R),2016,Insurance,550,23500,24050
D000615,N00030752,Jeff Duncan (R),2016,Health Professionals,2588,20500,23088
D000615,N00030752,Jeff Duncan (R),2016,Hospitals/Nursing Homes,2650,18600,21250
D000615,N00030752,Jeff Duncan (R),2016,Foreign & Defense Policy,10000,10000,20000
D000615,N00030752,Jeff Duncan (R),2016,Securities & Investment,19212,0,19212
D000615,N00030752,Jeff Duncan (R),2016,Lawyers/Law Firms,5250,13750,19000
D000615,N00030752,Jeff Duncan (R),2016,Electric Utilities,1966,17000,18966
C001087,N00030770,Rick Crawford (R),2016,Crop Production & Basic Processing,64900,86000,150900
C001087,N00030770,Rick Crawford (R),2016,Agricultural Services/Products,3950,49500,53450
C001087,N00030770,Rick Crawford (R),2016,Health Professionals,17500,21500,39000
C001087,N00030770,Rick Crawford (R),2016,Construction Services,6400,13500,19900
C001087,N00030770,Rick Crawford (R),2016,Retired,19549,0,19549
C001087,N00030770,Rick Crawford (R),2016,Poultry & Eggs,5400,13000,18400
C001087,N00030770,Rick Crawford (R),2016,Air Transport,0,18000,18000
C001087,N00030770,Rick Crawford (R),2016,Commercial Banks,3000,12000,15000
C001087,N00030770,Rick Crawford (R),2016,Real Estate,6700,8000,14700
C001087,N00030770,Rick Crawford (R),2016,Trucking,3000,11500,14500
G000565,N00030771,Paul Gosar (R),2016,Health Professionals,108800,67313,176113
G000565,N00030771,Paul Gosar (R),2016,Leadership PACs,3200,29500,32700
G000565,N00030771,Paul Gosar (R),2016,Electric Utilities,1500,29000,30500
G000565,N00030771,Paul Gosar (R),2016,Retired,26200,0,26200
G000565,N00030771,Paul Gosar (R),2016,Lawyers/Law Firms,20650,3250,23900
G000565,N00030771,Paul Gosar (R),2016,Mining,4250,19500,23750
G000565,N00030771,Paul Gosar (R),2016,Republican/Conservative,17382,6000,23382
G000565,N00030771,Paul Gosar (R),2016,Candidate Committees,0,13500,13500
G000565,N00030771,Paul Gosar (R),2016,Casinos/Gambling,12000,1000,13000
G000565,N00030771,Paul Gosar (R),2016,Air Transport,6900,3500,10400
G000562,N00030780,Cory Gardner (R),2016,Retired,1410171,0,1410171
G000562,N00030780,Cory Gardner (R),2016,Securities & Investment,793145,26000,819145
G000562,N00030780,Cory Gardner (R),2016,Oil & Gas,444199,269700,713899
G000562,N00030780,Cory Gardner (R),2016,Real Estate,498956,30500,529456
G000562,N00030780,Cory Gardner (R),2016,Leadership PACs,0,406194,406194
G000562,N00030780,Cory Gardner (R),2016,Republican/Conservative,309033,64622,373655
G000562,N00030780,Cory Gardner (R),2016,Misc Finance,257211,12100,269311
G000562,N00030780,Cory Gardner (R),2016,Lawyers/Law Firms,225648,20838,246486
G000562,N00030780,Cory Gardner (R),2016,Commercial Banks,151956,87500,239456
G000562,N00030780,Cory Gardner (R),2016,Lobbyists,202150,19602,221752
G000560,N00030788,Tom Graves (R),2016,Commercial Banks,350,77499,77849
G000560,N00030788,Tom Graves (R),2016,Real Estate,33300,35500,68800
G000560,N00030788,Tom Graves (R),2016,Insurance,8150,58000,66150
G000560,N00030788,Tom Graves (R),2016,Lobbyists,50950,500,51450
G000560,N00030788,Tom Graves (R),2016,Textiles,37300,11726,49026
G000560,N00030788,Tom Graves (R),2016,Defense Electronics,7400,38500,45900
G000560,N00030788,Tom Graves (R),2016,Misc Manufacturing & Distributing,19300,25000,44300
G000560,N00030788,Tom Graves (R),2016,Finance/Credit Companies,9900,33500,43400
G000560,N00030788,Tom Graves (R),2016,Accountants,1000,41000,42000
G000560,N00030788,Tom Graves (R),2016,Securities & Investment,5000,33500,38500
G000570,N00030801,Frank Guinta (R),2016,Leadership PACs,0,223300,223300
G000570,N00030801,Frank Guinta (R),2016,Insurance,40450,86500,126950
G000570,N00030801,Frank Guinta (R),2016,Securities & Investment,60575,48500,109075
G000570,N00030801,Frank Guinta (R),2016,Real Estate,51000,28000,79000
G000570,N00030801,Frank Guinta (R),2016,Retired,72450,0,72450
G000570,N00030801,Frank Guinta (R),2016,Candidate Committees,1167,62230,63397
G000570,N00030801,Frank Guinta (R),2016,Commercial Banks,6750,35500,42250
G000570,N00030801,Frank Guinta (R),2016,Republican/Conservative,24250,12000,36250
G000570,N00030801,Frank Guinta (R),2016,Automotive,14250,20000,34250
G000570,N00030801,Frank Guinta (R),2016,Misc Manufacturing & Distributing,31200,1998,33198
F000459,N00030815,Chuck Fleischmann (R),2016,General Contractors,61600,20500,82100
F000459,N00030815,Chuck Fleischmann (R),2016,Health Professionals,40200,29500,69700
F000459,N00030815,Chuck Fleischmann (R),2016,Leadership PACs,0,68200,68200
F000459,N00030815,Chuck Fleischmann (R),2016,Insurance,29300,34500,63800
F000459,N00030815,Chuck Fleischmann (R),2016,Real Estate,52200,10500,62700
F000459,N00030815,Chuck Fleischmann (R),2016,Electric Utilities,10800,39500,50300
F000459,N00030815,Chuck Fleischmann (R),2016,Lawyers/Law Firms,34150,13250,47400
F000459,N00030815,Chuck Fleischmann (R),2016,Pharmaceuticals/Health Products,31000,13000,44000
F000459,N00030815,Chuck Fleischmann (R),2016,Retired,43800,0,43800
F000459,N00030815,Chuck Fleischmann (R),2016,Food Processing & Sales,26800,10700,37500
B001297,N00030829,Kenneth R Buck (R),2016,Retired,64726,0,64726
B001297,N00030829,Kenneth R Buck (R),2016,Oil & Gas,13950,49000,62950
B001297,N00030829,Kenneth R Buck (R),2016,Real Estate,38617,8500,47117
B001297,N00030829,Kenneth R Buck (R),2016,Securities & Investment,34000,0,34000
B001297,N00030829,Kenneth R Buck (R),2016,General Contractors,21000,9000,30000
B001297,N00030829,Kenneth R Buck (R),2016,Automotive,14600,15000,29600
B001297,N00030829,Kenneth R Buck (R),2016,Leadership PACs,0,29500,29500
B001297,N00030829,Kenneth R Buck (R),2016,Crop Production & Basic Processing,12250,16000,28250
B001297,N00030829,Kenneth R Buck (R),2016,"Beer, Wine & Liquor",9400,13000,22400
B001297,N00030829,Kenneth R Buck (R),2016,Telecom Services,8100,10500,18600
G000559,N00030856,John Garamendi (D),2016,Transportation Unions,0,96500,96500
G000559,N00030856,John Garamendi (D),2016,Lawyers/Law Firms,36512,30500,67012
G000559,N00030856,John Garamendi (D),2016,Real Estate,45417,15500,60917
G000559,N00030856,John Garamendi (D),2016,Building Trade Unions,0,60800,60800
G000559,N00030856,John Garamendi (D),2016,Crop Production & Basic Processing,33805,25933,59738
G000559,N00030856,John Garamendi (D),2016,Sea Transport,5700,46500,52200
G000559,N00030856,John Garamendi (D),2016,Public Sector Unions,1080,41500,42580
G000559,N00030856,John Garamendi (D),2016,Insurance,16300,25500,41800
G000559,N00030856,John Garamendi (D),2016,Defense Aerospace,0,34500,34500
G000559,N00030856,John Garamendi (D),2016,Industrial Unions,0,29500,29500
G000566,N00030880,Trey Gowdy (R),2016,Retired,172320,0,172320
G000566,N00030880,Trey Gowdy (R),2016,Republican/Conservative,74361,18622,92983
G000566,N00030880,Trey Gowdy (R),2016,Lawyers/Law Firms,39345,4000,43345
G000566,N00030880,Trey Gowdy (R),2016,Real Estate,21785,15900,37685
G000566,N00030880,Trey Gowdy (R),2016,Accountants,4600,32000,36600
G000566,N00030880,Trey Gowdy (R),2016,Health Professionals,26141,8000,34141
G000566,N00030880,Trey Gowdy (R),2016,Insurance,6450,22000,28450
G000566,N00030880,Trey Gowdy (R),2016,Oil & Gas,10900,15500,26400
G000566,N00030880,Trey Gowdy (R),2016,Securities & Investment,13550,10000,23550
G000566,N00030880,Trey Gowdy (R),2016,Misc Manufacturing & Distributing,6600,16200,22800
B001274,N00030910,Mo Brooks (R),2016,Defense Aerospace,1000,44533,45533
B001274,N00030910,Mo Brooks (R),2016,Misc Defense,19250,15300,34550
B001274,N00030910,Mo Brooks (R),2016,Defense Electronics,4000,27700,31700
B001274,N00030910,Mo Brooks (R),2016,Health Professionals,16850,14000,30850
B001274,N00030910,Mo Brooks (R),2016,Real Estate,17100,10000,27100
B001274,N00030910,Mo Brooks (R),2016,Lawyers/Law Firms,5200,14000,19200
B001274,N00030910,Mo Brooks (R),2016,Retired,18550,0,18550
B001274,N00030910,Mo Brooks (R),2016,Agricultural Services/Products,0,17000,17000
B001274,N00030910,Mo Brooks (R),2016,Insurance,0,16000,16000
B001274,N00030910,Mo Brooks (R),2016,Securities & Investment,15200,0,15200
D000616,N00030957,Scott Desjarlais (R),2016,Leadership PACs,0,52000,52000
D000616,N00030957,Scott Desjarlais (R),2016,Health Professionals,31300,5500,36800
D000616,N00030957,Scott Desjarlais (R),2016,Retired,35284,0,35284
D000616,N00030957,Scott Desjarlais (R),2016,Real Estate,20550,9000,29550
D000616,N00030957,Scott Desjarlais (R),2016,Lawyers/Law Firms,28900,0,28900
D000616,N00030957,Scott Desjarlais (R),2016,Food Processing & Sales,21200,5000,26200
D000616,N00030957,Scott Desjarlais (R),2016,Candidate Committees,0,21000,21000
D000616,N00030957,Scott Desjarlais (R),2016,Misc Manufacturing & Distributing,19700,0,19700
D000616,N00030957,Scott Desjarlais (R),2016,Automotive,3700,15000,18700
D000616,N00030957,Scott Desjarlais (R),2016,Gun Rights,5550,10500,16050
D000614,N00030967,Sean P Duffy (R),2016,Insurance,14655,223800,238455
D000614,N00030967,Sean P Duffy (R),2016,Securities & Investment,51982,143500,195482
D000614,N00030967,Sean P Duffy (R),2016,Retired,169759,0,169759
D000614,N00030967,Sean P Duffy (R),2016,Commercial Banks,37170,100894,138064
D000614,N00030967,Sean P Duffy (R),2016,Real Estate,42720,77500,120220
D000614,N00030967,Sean P Duffy (R),2016,Finance/Credit Companies,24650,49500,74150
D000614,N00030967,Sean P Duffy (R),2016,Republican/Conservative,42468,15350,57818
D000614,N00030967,Sean P Duffy (R),2016,Accountants,1350,50000,51350
D000614,N00030967,Sean P Duffy (R),2016,Misc Manufacturing & Distributing,39945,11000,50945
D000614,N00030967,Sean P Duffy (R),2016,Lawyers/Law Firms,26895,22750,49645
A000368,N00030980,Kelly Ayotte (R),2016,Retired,1966431,0,1966431
A000368,N00030980,Kelly Ayotte (R),2016,Securities & Investment,1413762,119200,1532962
A000368,N00030980,Kelly Ayotte (R),2016,Real Estate,665006,58000,723006
A000368,N00030980,Kelly Ayotte (R),2016,Lawyers/Law Firms,442888,181224,624112
A000368,N00030980,Kelly Ayotte (R),2016,Leadership PACs,26050,591300,617350
A000368,N00030980,Kelly Ayotte (R),2016,Lobbyists,440693,14587,455280
A000368,N00030980,Kelly Ayotte (R),2016,Insurance,157650,294000,451650
A000368,N00030980,Kelly Ayotte (R),2016,Pro-Israel,366414,61700,428114
A000368,N00030980,Kelly Ayotte (R),2016,Oil & Gas,194756,227000,421756
A000368,N00030980,Kelly Ayotte (R),2016,Misc Finance,364559,45000,409559
H001053,N00031005,Vicky Hartzler (R),2016,Crop Production & Basic Processing,15250,44000,59250
H001053,N00031005,Vicky Hartzler (R),2016,Retired,58844,0,58844
H001053,N00031005,Vicky Hartzler (R),2016,Agricultural Services/Products,5650,45700,51350
H001053,N00031005,Vicky Hartzler (R),2016,Defense Aerospace,0,45000,45000
H001053,N00031005,Vicky Hartzler (R),2016,Health Professionals,25550,13500,39050
H001053,N00031005,Vicky Hartzler (R),2016,Real Estate,28350,6000,34350
H001053,N00031005,Vicky Hartzler (R),2016,Leadership PACs,0,32829,32829
H001053,N00031005,Vicky Hartzler (R),2016,Food & Beverage,20800,10500,31300
H001053,N00031005,Vicky Hartzler (R),2016,Lawyers/Law Firms,21080,8750,29830
H001053,N00031005,Vicky Hartzler (R),2016,Defense Electronics,0,29000,29000
C001106,N00031064,Ryan Costello (R),2016,Leadership PACs,0,227071,227071
C001106,N00031064,Ryan Costello (R),2016,Pharmaceuticals/Health Products,20700,144100,164800
C001106,N00031064,Ryan Costello (R),2016,Lawyers/Law Firms,105550,35733,141283
C001106,N00031064,Ryan Costello (R),2016,Insurance,26940,73700,100640
C001106,N00031064,Ryan Costello (R),2016,Health Professionals,15500,74000,89500
C001106,N00031064,Ryan Costello (R),2016,Securities & Investment,77000,11500,88500
C001106,N00031064,Ryan Costello (R),2016,Retired,78300,0,78300
C001106,N00031064,Ryan Costello (R),2016,Real Estate,43050,30000,73050
C001106,N00031064,Ryan Costello (R),2016,Construction Services,30750,26200,56950
C001106,N00031064,Ryan Costello (R),2016,Air Transport,1600,49000,50600
D000613,N00031103,Bob Dold (R),2016,Securities & Investment,507300,104500,611800
D000613,N00031103,Bob Dold (R),2016,Retired,442912,0,442912
D000613,N00031103,Bob Dold (R),2016,Leadership PACs,0,387500,387500
D000613,N00031103,Bob Dold (R),2016,Insurance,44470,219100,263570
D000613,N00031103,Bob Dold (R),2016,Lawyers/Law Firms,225540,30000,255540
D000613,N00031103,Bob Dold (R),2016,Real Estate,130100,61000,191100
D000613,N00031103,Bob Dold (R),2016,Pharmaceuticals/Health Products,60100,130700,190800
D000613,N00031103,Bob Dold (R),2016,Pro-Israel,123473,26290,149763
D000613,N00031103,Bob Dold (R),2016,Health Professionals,46974,99750,146724
D000613,N00031103,Bob Dold (R),2016,Misc Finance,86721,22000,108721
H001059,N00031104,Randy Hultgren (R),2016,Insurance,1250,144000,145250
H001059,N00031104,Randy Hultgren (R),2016,Securities & Investment,44050,99500,143550
H001059,N00031104,Randy Hultgren (R),2016,Commercial Banks,7200,73000,80200
H001059,N00031104,Randy Hultgren (R),2016,Leadership PACs,0,73500,73500
H001059,N00031104,Randy Hultgren (R),2016,Real Estate,14550,56500,71050
H001059,N00031104,Randy Hultgren (R),2016,Accountants,1000,46500,47500
H001059,N00031104,Randy Hultgren (R),2016,Electric Utilities,9000,21500,30500
H001059,N00031104,Randy Hultgren (R),2016,Misc Manufacturing & Distributing,10950,18000,28950
H001059,N00031104,Randy Hultgren (R),2016,Defense Aerospace,0,28000,28000
H001059,N00031104,Randy Hultgren (R),2016,Finance/Credit Companies,0,28000,28000
G000563,N00031128,Bob Gibbs (R),2016,Agricultural Services/Products,2500,49500,52000
G000563,N00031128,Bob Gibbs (R),2016,Transportation Unions,0,39000,39000
G000563,N00031128,Bob Gibbs (R),2016,Construction Services,500,37000,37500
G000563,N00031128,Bob Gibbs (R),2016,Electric Utilities,1000,34250,35250
G000563,N00031128,Bob Gibbs (R),2016,Oil & Gas,1000,32500,33500
G000563,N00031128,Bob Gibbs (R),2016,Misc Manufacturing & Distributing,20100,13000,33100
G000563,N00031128,Bob Gibbs (R),2016,Leadership PACs,0,31091,31091
G000563,N00031128,Bob Gibbs (R),2016,Air Transport,0,30500,30500
G000563,N00031128,Bob Gibbs (R),2016,Crop Production & Basic Processing,0,30500,30500
G000563,N00031128,Bob Gibbs (R),2016,Railroads,0,29499,29499
F000458,N00031141,Steve Fincher (R),2016,Insurance,0,63000,63000
F000458,N00031141,Steve Fincher (R),2016,Real Estate,1000,42500,43500
F000458,N00031141,Steve Fincher (R),2016,Commercial Banks,0,41000,41000
F000458,N00031141,Steve Fincher (R),2016,Securities & Investment,500,36000,36500
F000458,N00031141,Steve Fincher (R),2016,Leadership PACs,0,23000,23000
F000458,N00031141,Steve Fincher (R),2016,Crop Production & Basic Processing,0,23000,23000
F000458,N00031141,Steve Fincher (R),2016,Agricultural Services/Products,0,22000,22000
F000458,N00031141,Steve Fincher (R),2016,Finance/Credit Companies,500,17500,18000
F000458,N00031141,Steve Fincher (R),2016,Accountants,0,15952,15952
F000458,N00031141,Steve Fincher (R),2016,Defense Aerospace,0,15500,15500
A000369,N00031177,Mark Amodei (R),2016,Retired,58750,0,58750
A000369,N00031177,Mark Amodei (R),2016,Health Professionals,19250,25500,44750
A000369,N00031177,Mark Amodei (R),2016,Casinos/Gambling,24300,16000,40300
A000369,N00031177,Mark Amodei (R),2016,Lawyers/Law Firms,21850,10750,32600
A000369,N00031177,Mark Amodei (R),2016,Real Estate,20450,12000,32450
A000369,N00031177,Mark Amodei (R),2016,Mining,4000,26200,30200
A000369,N00031177,Mark Amodei (R),2016,Defense Aerospace,0,24000,24000
A000369,N00031177,Mark Amodei (R),2016,Lobbyists,18350,3000,21350
A000369,N00031177,Mark Amodei (R),2016,Livestock,7450,12000,19450
A000369,N00031177,Mark Amodei (R),2016,"Beer, Wine & Liquor",0,17850,17850
B001275,N00031227,Larry Bucshon (R),2016,Health Professionals,35225,154125,189350
B001275,N00031227,Larry Bucshon (R),2016,Pharmaceuticals/Health Products,17600,96500,114100
B001275,N00031227,Larry Bucshon (R),2016,Electric Utilities,5200,33499,38699
B001275,N00031227,Larry Bucshon (R),2016,Lobbyists,20839,7500,28339
B001275,N00031227,Larry Bucshon (R),2016,Chemical & Related Manufacturing,18000,8000,26000
B001275,N00031227,Larry Bucshon (R),2016,Health Services/HMOs,3000,22200,25200
B001275,N00031227,Larry Bucshon (R),2016,Leadership PACs,0,25000,25000
B001275,N00031227,Larry Bucshon (R),2016,Mining,13600,8900,22500
B001275,N00031227,Larry Bucshon (R),2016,Telecom Services,0,21000,21000
B001275,N00031227,Larry Bucshon (R),2016,Real Estate,8900,11500,20400
B001282,N00031233,Andy Barr (R),2016,Securities & Investment,84326,105500,189826
B001282,N00031233,Andy Barr (R),2016,Insurance,21150,153360,174510
B001282,N00031233,Andy Barr (R),2016,Commercial Banks,37085,104050,141135
B001282,N00031233,Andy Barr (R),2016,Real Estate,70800,60000,130800
B001282,N00031233,Andy Barr (R),2016,Retired,124753,0,124753
B001282,N00031233,Andy Barr (R),2016,Mining,77450,27000,104450
B001282,N00031233,Andy Barr (R),2016,Health Professionals,30750,70650,101400
B001282,N00031233,Andy Barr (R),2016,Leadership PACs,0,75000,75000
B001282,N00031233,Andy Barr (R),2016,Lawyers/Law Firms,59694,8500,68194
B001282,N00031233,Andy Barr (R),2016,Finance/Credit Companies,8700,54400,63100
H001055,N00031244,Joe Heck (R),2016,Retired,1341855,0,1341855
H001055,N00031244,Joe Heck (R),2016,Securities & Investment,899053,22000,921053
H001055,N00031244,Joe Heck (R),2016,Leadership PACs,0,597952,597952
H001055,N00031244,Joe Heck (R),2016,Health Professionals,352128,245500,597628
H001055,N00031244,Joe Heck (R),2016,Real Estate,557839,35000,592839
H001055,N00031244,Joe Heck (R),2016,Republican/Conservative,412914,76279,489193
H001055,N00031244,Joe Heck (R),2016,Oil & Gas,133515,169666,303181
H001055,N00031244,Joe Heck (R),2016,Casinos/Gambling,235150,52500,287650
H001055,N00031244,Joe Heck (R),2016,Misc Finance,235030,12500,247530
H001055,N00031244,Joe Heck (R),2016,Lawyers/Law Firms,182060,23250,205310
H001060,N00031265,Robert Hurt (R),2016,Securities & Investment,6650,45500,52150
H001060,N00031265,Robert Hurt (R),2016,Insurance,500,50500,51000
H001060,N00031265,Robert Hurt (R),2016,Commercial Banks,2500,44500,47000
H001060,N00031265,Robert Hurt (R),2016,Real Estate,8000,30000,38000
H001060,N00031265,Robert Hurt (R),2016,Accountants,500,20000,20500
H001060,N00031265,Robert Hurt (R),2016,Lobbyists,15750,1000,16750
H001060,N00031265,Robert Hurt (R),2016,Retired,16150,0,16150
H001060,N00031265,Robert Hurt (R),2016,Misc Finance,3000,12000,15000
H001060,N00031265,Robert Hurt (R),2016,Finance/Credit Companies,750,13500,14250
H001060,N00031265,Robert Hurt (R),2016,Electric Utilities,0,13500,13500
D000610,N00031317,Ted Deutch (D),2016,Real Estate,151090,12000,163090
D000610,N00031317,Ted Deutch (D),2016,Lawyers/Law Firms,116910,27000,143910
D000610,N00031317,Ted Deutch (D),2016,Pro-Israel,106900,36700,143600
D000610,N00031317,Ted Deutch (D),2016,Securities & Investment,132900,0,132900
D000610,N00031317,Ted Deutch (D),2016,Retired,72167,0,72167
D000610,N00031317,Ted Deutch (D),2016,TV/Movies/Music,18100,40500,58600
D000610,N00031317,Ted Deutch (D),2016,Misc Finance,37850,0,37850
D000610,N00031317,Ted Deutch (D),2016,Health Professionals,27585,8500,36085
D000610,N00031317,Ted Deutch (D),2016,"Beer, Wine & Liquor",15850,16000,31850
D000610,N00031317,Ted Deutch (D),2016,Industrial Unions,0,30000,30000
E000291,N00031513,Renee Ellmers (R),2016,Health Professionals,18425,175100,193525
E000291,N00031513,Renee Ellmers (R),2016,Pharmaceuticals/Health Products,1500,148699,150199
E000291,N00031513,Renee Ellmers (R),2016,Health Services/HMOs,500,60000,60500
E000291,N00031513,Renee Ellmers (R),2016,Insurance,3500,50500,54000
E000291,N00031513,Renee Ellmers (R),2016,Electric Utilities,1000,46000,47000
E000291,N00031513,Renee Ellmers (R),2016,Leadership PACs,0,43900,43900
E000291,N00031513,Renee Ellmers (R),2016,Retail Sales,3950,32500,36450
E000291,N00031513,Renee Ellmers (R),2016,Lobbyists,34200,0,34200
E000291,N00031513,Renee Ellmers (R),2016,Oil & Gas,1500,29000,30500
E000291,N00031513,Renee Ellmers (R),2016,Crop Production & Basic Processing,8000,21500,29500
B001273,N00031539,Diane Black (R),2016,Insurance,25550,114750,140300
B001273,N00031539,Diane Black (R),2016,Health Professionals,29760,97500,127260
B001273,N00031539,Diane Black (R),2016,Misc Issues,107250,380,107630
B001273,N00031539,Diane Black (R),2016,Pharmaceuticals/Health Products,0,99839,99839
B001273,N00031539,Diane Black (R),2016,Leadership PACs,0,86826,86826
B001273,N00031539,Diane Black (R),2016,Retired,79450,0,79450
B001273,N00031539,Diane Black (R),2016,Health Services/HMOs,5400,58500,63900
B001273,N00031539,Diane Black (R),2016,Real Estate,19800,38500,58300
B001273,N00031539,Diane Black (R),2016,Accountants,10150,47500,57650
B001273,N00031539,Diane Black (R),2016,Hospitals/Nursing Homes,2100,48200,50300
F000461,N00031545,Bill Flores (R),2016,Oil & Gas,49500,153000,202500
F000461,N00031545,Bill Flores (R),2016,Health Professionals,11300,115500,126800
F000461,N00031545,Bill Flores (R),2016,Insurance,12300,64500,76800
F000461,N00031545,Bill Flores (R),2016,Accountants,12100,57000,69100
F000461,N00031545,Bill Flores (R),2016,Retired,68061,0,68061
F000461,N00031545,Bill Flores (R),2016,Real Estate,35700,23000,58700
F000461,N00031545,Bill Flores (R),2016,Electronics Mfg & Equip,21000,29500,50500
F000461,N00031545,Bill Flores (R),2016,Pharmaceuticals/Health Products,0,48000,48000
F000461,N00031545,Bill Flores (R),2016,Leadership PACs,0,44000,44000
F000461,N00031545,Bill Flores (R),2016,Automotive,10900,32500,43400
H001064,N00031557,Dennis Heck (D),2016,Insurance,1350,88500,89850
H001064,N00031557,Dennis Heck (D),2016,Securities & Investment,11400,76000,87400
H001064,N00031557,Dennis Heck (D),2016,Casinos/Gambling,82050,3500,85550
H001064,N00031557,Dennis Heck (D),2016,Real Estate,19100,57500,76600
H001064,N00031557,Dennis Heck (D),2016,Misc Issues,63100,0,63100
H001064,N00031557,Dennis Heck (D),2016,Commercial Banks,1500,61500,63000
H001064,N00031557,Dennis Heck (D),2016,Lawyers/Law Firms,47714,14750,62464
H001064,N00031557,Dennis Heck (D),2016,Retired,51246,0,51246
H001064,N00031557,Dennis Heck (D),2016,Building Trade Unions,100,50000,50100
H001064,N00031557,Dennis Heck (D),2016,Health Professionals,14300,32000,46300
H001056,N00031559,Jaime Herrera Beutler (R),2016,Retired,147915,0,147915
H001056,N00031559,Jaime Herrera Beutler (R),2016,Forestry & Forest Products,31950,30500,62450
H001056,N00031559,Jaime Herrera Beutler (R),2016,Real Estate,39600,19500,59100
H001056,N00031559,Jaime Herrera Beutler (R),2016,Securities & Investment,53850,3000,56850
H001056,N00031559,Jaime Herrera Beutler (R),2016,Food & Beverage,29950,2500,32450
H001056,N00031559,Jaime Herrera Beutler (R),2016,Defense Aerospace,250,29500,29750
H001056,N00031559,Jaime Herrera Beutler (R),2016,Insurance,700,28000,28700
H001056,N00031559,Jaime Herrera Beutler (R),2016,Republican/Conservative,17710,10000,27710
H001056,N00031559,Jaime Herrera Beutler (R),2016,Leadership PACs,0,25900,25900
H001056,N00031559,Jaime Herrera Beutler (R),2016,Health Professionals,9716,16000,25716
D000612,N00031593,Jeff Denham (R),2016,Leadership PACs,0,355800,355800
D000612,N00031593,Jeff Denham (R),2016,Crop Production & Basic Processing,186390,80750,267140
D000612,N00031593,Jeff Denham (R),2016,Oil & Gas,14600,174399,188999
D000612,N00031593,Jeff Denham (R),2016,Trucking,39350,77700,117050
D000612,N00031593,Jeff Denham (R),2016,Casinos/Gambling,112278,4500,116778
D000612,N00031593,Jeff Denham (R),2016,Railroads,46700,62000,108700
D000612,N00031593,Jeff Denham (R),2016,Insurance,5150,94500,99650
D000612,N00031593,Jeff Denham (R),2016,Air Transport,13450,80000,93450
D000612,N00031593,Jeff Denham (R),2016,Agricultural Services/Products,8250,81206,89456
D000612,N00031593,Jeff Denham (R),2016,Real Estate,35835,39500,75335
F000460,N00031672,Blake Farenthold (R),2016,Oil & Gas,15450,54500,69950
F000460,N00031672,Blake Farenthold (R),2016,Retired,68766,0,68766
F000460,N00031672,Blake Farenthold (R),2016,General Contractors,46275,4000,50275
F000460,N00031672,Blake Farenthold (R),2016,Health Professionals,34750,8200,42950
F000460,N00031672,Blake Farenthold (R),2016,Air Transport,775,39500,40275
F000460,N00031672,Blake Farenthold (R),2016,Railroads,0,37999,37999
F000460,N00031672,Blake Farenthold (R),2016,Crop Production & Basic Processing,1500,34650,36150
F000460,N00031672,Blake Farenthold (R),2016,Internet,4200,29900,34100
F000460,N00031672,Blake Farenthold (R),2016,Leadership PACs,0,32500,32500
F000460,N00031672,Blake Farenthold (R),2016,Construction Services,17750,14000,31750
B001277,N00031685,Richard Blumenthal (D),2016,Lawyers/Law Firms,1147900,138841,1286741
B001277,N00031685,Richard Blumenthal (D),2016,Securities & Investment,818078,68500,886578
B001277,N00031685,Richard Blumenthal (D),2016,Real Estate,424301,33000,457301
B001277,N00031685,Richard Blumenthal (D),2016,Retired,372385,0,372385
B001277,N00031685,Richard Blumenthal (D),2016,Leadership PACs,0,337500,337500
B001277,N00031685,Richard Blumenthal (D),2016,Lobbyists,292052,15550,307602
B001277,N00031685,Richard Blumenthal (D),2016,Health Professionals,124698,143250,267948
B001277,N00031685,Richard Blumenthal (D),2016,Telecom Services,151450,110750,262200
B001277,N00031685,Richard Blumenthal (D),2016,TV/Movies/Music,169113,39000,208113
B001277,N00031685,Richard Blumenthal (D),2016,Insurance,46635,126600,173235
H001061,N00031688,John Hoeven (R),2016,Oil & Gas,152355,203098,355453
H001061,N00031688,John Hoeven (R),2016,Leadership PACs,0,317627,317627
H001061,N00031688,John Hoeven (R),2016,Electric Utilities,20305,111750,132055
H001061,N00031688,John Hoeven (R),2016,Mining,76248,42425,118673
H001061,N00031688,John Hoeven (R),2016,Crop Production & Basic Processing,36845,78500,115345
H001061,N00031688,John Hoeven (R),2016,Insurance,43070,68500,111570
H001061,N00031688,John Hoeven (R),2016,Securities & Investment,83233,27000,110233
H001061,N00031688,John Hoeven (R),2016,Real Estate,79133,26000,105133
H001061,N00031688,John Hoeven (R),2016,Agricultural Services/Products,850,100400,101250
H001061,N00031688,John Hoeven (R),2016,Misc Manufacturing & Distributing,75143,14500,89643
C001088,N00031820,Chris Coons (D),2016,Lawyers/Law Firms,973383,152089,1125472
C001088,N00031820,Chris Coons (D),2016,Securities & Investment,323249,89500,412749
C001088,N00031820,Chris Coons (D),2016,Leadership PACs,0,316000,316000
C001088,N00031820,Chris Coons (D),2016,Lobbyists,273797,22330,296127
C001088,N00031820,Chris Coons (D),2016,Pharmaceuticals/Health Products,53800,174000,227800
C001088,N00031820,Chris Coons (D),2016,Commercial Banks,74700,99550,174250
C001088,N00031820,Chris Coons (D),2016,Insurance,29852,141000,170852
C001088,N00031820,Chris Coons (D),2016,Real Estate,111889,46000,157889
C001088,N00031820,Chris Coons (D),2016,TV/Movies/Music,92131,50357,142488
C001088,N00031820,Chris Coons (D),2016,Chemical & Related Manufacturing,61825,77000,138825
B001270,N00031877,Karen Bass (D),2016,TV/Movies/Music,43900,36000,79900
B001270,N00031877,Karen Bass (D),2016,Lawyers/Law Firms,14514,13500,28014
B001270,N00031877,Karen Bass (D),2016,Building Trade Unions,0,26500,26500
B001270,N00031877,Karen Bass (D),2016,Health Professionals,-150,26500,26350
B001270,N00031877,Karen Bass (D),2016,Misc Unions,-250,26500,26250
B001270,N00031877,Karen Bass (D),2016,Public Sector Unions,0,25500,25500
B001270,N00031877,Karen Bass (D),2016,Retired,24641,0,24641
B001270,N00031877,Karen Bass (D),2016,Industrial Unions,0,21000,21000
B001270,N00031877,Karen Bass (D),2016,Business Services,14600,2000,16600
B001270,N00031877,Karen Bass (D),2016,Electric Utilities,0,14500,14500
B001271,N00031934,Dan Benishek (R),2016,Health Professionals,12250,66000,78250
B001271,N00031934,Dan Benishek (R),2016,Leadership PACs,0,70000,70000
B001271,N00031934,Dan Benishek (R),2016,Forestry & Forest Products,3600,20000,23600
B001271,N00031934,Dan Benishek (R),2016,Casinos/Gambling,23500,0,23500
B001271,N00031934,Dan Benishek (R),2016,Oil & Gas,5175,14750,19925
B001271,N00031934,Dan Benishek (R),2016,Candidate Committees,2167,16000,18167
B001271,N00031934,Dan Benishek (R),2016,Insurance,250,17000,17250
B001271,N00031934,Dan Benishek (R),2016,Crop Production & Basic Processing,0,15000,15000
B001271,N00031934,Dan Benishek (R),2016,Automotive,9500,4500,14000
B001271,N00031934,Dan Benishek (R),2016,Agricultural Services/Products,0,13000,13000
A000367,N00031938,Justin Amash (R),2016,Misc Manufacturing & Distributing,56250,1000,57250
A000367,N00031938,Justin Amash (R),2016,Securities & Investment,56875,0,56875
A000367,N00031938,Justin Amash (R),2016,Republican/Conservative,31465,5450,36915
A000367,N00031938,Justin Amash (R),2016,Retail Sales,35005,0,35005
A000367,N00031938,Justin Amash (R),2016,Retired,31980,0,31980
A000367,N00031938,Justin Amash (R),2016,Food Processing & Sales,31500,0,31500
A000367,N00031938,Justin Amash (R),2016,Real Estate,26100,2000,28100
A000367,N00031938,Justin Amash (R),2016,Health Professionals,22586,0,22586
A000367,N00031938,Justin Amash (R),2016,Automotive,20200,0,20200
A000367,N00031938,Justin Amash (R),2016,Crop Production & Basic Processing,11700,0,11700
G000564,N00031998,Chris Gibson (R),2016,Building Trade Unions,0,5000,5000
G000564,N00031998,Chris Gibson (R),2016,Health Professionals,0,2500,2500
G000564,N00031998,Chris Gibson (R),2016,Leadership PACs,0,2000,2000
C001084,N00032019,David Cicilline (D),2016,Retired,138932,0,138932
C001084,N00032019,David Cicilline (D),2016,Lawyers/Law Firms,97581,22000,119581
C001084,N00032019,David Cicilline (D),2016,Real Estate,69550,10500,80050
C001084,N00032019,David Cicilline (D),2016,Building Trade Unions,0,68500,68500
C001084,N00032019,David Cicilline (D),2016,Securities & Investment,56900,5000,61900
C001084,N00032019,David Cicilline (D),2016,TV/Movies/Music,33480,17500,50980
C001084,N00032019,David Cicilline (D),2016,Health Professionals,22293,20000,42293
C001084,N00032019,David Cicilline (D),2016,Public Sector Unions,600,36500,37100
C001084,N00032019,David Cicilline (D),2016,Transportation Unions,0,34500,34500
C001084,N00032019,David Cicilline (D),2016,Industrial Unions,0,32000,32000
G000568,N00032029,Morgan Griffith (R),2016,Health Professionals,8200,87500,95700
G000568,N00032029,Morgan Griffith (R),2016,Electric Utilities,1500,51000,52500
G000568,N00032029,Morgan Griffith (R),2016,Retired,47080,0,47080
G000568,N00032029,Morgan Griffith (R),2016,Oil & Gas,1250,37068,38318
G000568,N00032029,Morgan Griffith (R),2016,Telecom Services,900,32500,33400
G000568,N00032029,Morgan Griffith (R),2016,Lawyers/Law Firms,19700,13000,32700
G000568,N00032029,Morgan Griffith (R),2016,Retail Sales,19100,12500,31600
G000568,N00032029,Morgan Griffith (R),2016,Mining,6100,22000,28100
G000568,N00032029,Morgan Griffith (R),2016,Pharmaceuticals/Health Products,1000,19000,20000
G000568,N00032029,Morgan Griffith (R),2016,Chemical & Related Manufacturing,0,18500,18500
D000618,N00033054,Steven Daines (R),2016,Retired,611804,0,611804
D000618,N00033054,Steven Daines (R),2016,Securities & Investment,494300,36500,530800
D000618,N00033054,Steven Daines (R),2016,Oil & Gas,247756,182500,430256
D000618,N00033054,Steven Daines (R),2016,Leadership PACs,0,329249,329249
D000618,N00033054,Steven Daines (R),2016,Real Estate,244075,24500,268575
D000618,N00033054,Steven Daines (R),2016,General Contractors,167450,22500,189950
D000618,N00033054,Steven Daines (R),2016,Republican/Conservative,131675,52851,184526
D000618,N00033054,Steven Daines (R),2016,Commercial Banks,86850,90600,177450
D000618,N00033054,Steven Daines (R),2016,Mining,92350,62350,154700
D000618,N00033054,Steven Daines (R),2016,Livestock,133575,18500,152075
C001098,N00033085,Ted Cruz (R),2016,Retired,2075197,0,2075197
C001098,N00033085,Ted Cruz (R),2016,Republican/Conservative,1926677,115405,2042082
C001098,N00033085,Ted Cruz (R),2016,Oil & Gas,1228068,181000,1409068
C001098,N00033085,Ted Cruz (R),2016,Lawyers/Law Firms,1223012,57249,1280261
C001098,N00033085,Ted Cruz (R),2016,Securities & Investment,1189587,24500,1214087
C001098,N00033085,Ted Cruz (R),2016,Real Estate,983455,24000,1007455
C001098,N00033085,Ted Cruz (R),2016,Misc Finance,667229,3500,670729
C001098,N00033085,Ted Cruz (R),2016,Health Professionals,560642,38000,598642
C001098,N00033085,Ted Cruz (R),2016,Misc Business,457888,10500,468388
C001098,N00033085,Ted Cruz (R),2016,Business Services,451719,8000,459719
E000293,N00033217,Elizabeth Esty (D),2016,Retired,168404,0,168404
E000293,N00033217,Elizabeth Esty (D),2016,Lawyers/Law Firms,145930,17000,162930
E000293,N00033217,Elizabeth Esty (D),2016,Securities & Investment,96250,3000,99250
E000293,N00033217,Elizabeth Esty (D),2016,Women's Issues,72489,5000,77489
E000293,N00033217,Elizabeth Esty (D),2016,Democratic/Liberal,51765,13200,64965
E000293,N00033217,Elizabeth Esty (D),2016,Health Professionals,22194,42000,64194
E000293,N00033217,Elizabeth Esty (D),2016,Leadership PACs,0,60609,60609
E000293,N00033217,Elizabeth Esty (D),2016,Transportation Unions,0,59000,59000
E000293,N00033217,Elizabeth Esty (D),2016,Education,53769,0,53769
E000293,N00033217,Elizabeth Esty (D),2016,Air Transport,260,48500,48760
G000571,N00033281,Tulsi Gabbard (D),2016,Health Professionals,81522,16000,97522
G000571,N00033281,Tulsi Gabbard (D),2016,Retired,65476,0,65476
G000571,N00033281,Tulsi Gabbard (D),2016,Democratic/Liberal,55916,5000,60916
G000571,N00033281,Tulsi Gabbard (D),2016,Real Estate,45145,12700,57845
G000571,N00033281,Tulsi Gabbard (D),2016,Lawyers/Law Firms,36515,9000,45515
G000571,N00033281,Tulsi Gabbard (D),2016,Building Trade Unions,0,43500,43500
G000571,N00033281,Tulsi Gabbard (D),2016,Human Rights,37330,6000,43330
G000571,N00033281,Tulsi Gabbard (D),2016,Sea Transport,20935,21000,41935
G000571,N00033281,Tulsi Gabbard (D),2016,Securities & Investment,41062,0,41062
G000571,N00033281,Tulsi Gabbard (D),2016,Electronics Mfg & Equip,35904,5000,40904
C001091,N00033316,Joaquin Castro (D),2016,Lawyers/Law Firms,93730,33082,126812
C001091,N00033316,Joaquin Castro (D),2016,Real Estate,27800,26000,53800
C001091,N00033316,Joaquin Castro (D),2016,Building Trade Unions,0,40000,40000
C001091,N00033316,Joaquin Castro (D),2016,Hospitals/Nursing Homes,15785,23500,39285
C001091,N00033316,Joaquin Castro (D),2016,Public Sector Unions,0,37000,37000
C001091,N00033316,Joaquin Castro (D),2016,Insurance,2250,34250,36500
C001091,N00033316,Joaquin Castro (D),2016,Defense Aerospace,0,36000,36000
C001091,N00033316,Joaquin Castro (D),2016,Retail Sales,10650,23000,33650
C001091,N00033316,Joaquin Castro (D),2016,Industrial Unions,0,31000,31000
C001091,N00033316,Joaquin Castro (D),2016,Accountants,1500,26500,28000
C001095,N00033363,Tom Cotton (R),2016,Securities & Investment,1143450,87750,1231200
C001095,N00033363,Tom Cotton (R),2016,Retired,1131789,0,1131789
C001095,N00033363,Tom Cotton (R),2016,Republican/Conservative,861377,83883,945260
C001095,N00033363,Tom Cotton (R),2016,Real Estate,446930,27500,474430
C001095,N00033363,Tom Cotton (R),2016,Leadership PACs,22300,440171,462471
C001095,N00033363,Tom Cotton (R),2016,Oil & Gas,368005,86100,454105
C001095,N00033363,Tom Cotton (R),2016,Lawyers/Law Firms,367822,50865,418687
C001095,N00033363,Tom Cotton (R),2016,Health Professionals,330476,60000,390476
C001095,N00033363,Tom Cotton (R),2016,Commercial Banks,185885,156750,342635
C001095,N00033363,Tom Cotton (R),2016,Misc Finance,288800,12500,301300
C001097,N00033373,Tony Cardenas (D),2016,Pharmaceuticals/Health Products,22452,114750,137202
C001097,N00033373,Tony Cardenas (D),2016,Health Professionals,33482,45600,79082
C001097,N00033373,Tony Cardenas (D),2016,Real Estate,48900,21500,70400
C001097,N00033373,Tony Cardenas (D),2016,Insurance,2750,67500,70250
C001097,N00033373,Tony Cardenas (D),2016,Casinos/Gambling,64400,0,64400
C001097,N00033373,Tony Cardenas (D),2016,TV/Movies/Music,32260,30000,62260
C001097,N00033373,Tony Cardenas (D),2016,Securities & Investment,31950,28500,60450
C001097,N00033373,Tony Cardenas (D),2016,Lawyers/Law Firms,36300,14000,50300
C001097,N00033373,Tony Cardenas (D),2016,Health Services/HMOs,5550,38000,43550
C001097,N00033373,Tony Cardenas (D),2016,Electric Utilities,7750,35500,43250
B001286,N00033390,Cheri Bustos (D),2016,Democratic/Liberal,189601,16850,206451
B001286,N00033390,Cheri Bustos (D),2016,Leadership PACs,1000,177850,178850
B001286,N00033390,Cheri Bustos (D),2016,Lawyers/Law Firms,147806,15750,163556
B001286,N00033390,Cheri Bustos (D),2016,Retired,121702,0,121702
B001286,N00033390,Cheri Bustos (D),2016,Women's Issues,93837,10000,103837
B001286,N00033390,Cheri Bustos (D),2016,Securities & Investment,38831,39000,77831
B001286,N00033390,Cheri Bustos (D),2016,Education,69041,5000,74041
B001286,N00033390,Cheri Bustos (D),2016,Insurance,15544,58000,73544
B001286,N00033390,Cheri Bustos (D),2016,Transportation Unions,65,70500,70565
B001286,N00033390,Cheri Bustos (D),2016,Real Estate,47760,22000,69760
H001065,N00033399,George Holding (R),2016,Insurance,29550,186300,215850
H001065,N00033399,George Holding (R),2016,Lawyers/Law Firms,136950,35750,172700
H001065,N00033399,George Holding (R),2016,Leadership PACs,0,160203,160203
H001065,N00033399,George Holding (R),2016,Real Estate,88570,56500,145070
H001065,N00033399,George Holding (R),2016,Lobbyists,135355,2500,137855
H001065,N00033399,George Holding (R),2016,Health Professionals,60051,69500,129551
H001065,N00033399,George Holding (R),2016,Securities & Investment,49850,65500,115350
H001065,N00033399,George Holding (R),2016,Pharmaceuticals/Health Products,5000,99500,104500
H001065,N00033399,George Holding (R),2016,Commercial Banks,40250,61500,101750
H001065,N00033399,George Holding (R),2016,Electronics Mfg & Equip,50300,37500,87800
F000463,N00033443,Deb Fischer (R),2016,Leadership PACs,200,407182,407382
F000463,N00033443,Deb Fischer (R),2016,Retired,358387,0,358387
F000463,N00033443,Deb Fischer (R),2016,Insurance,83000,129000,212000
F000463,N00033443,Deb Fischer (R),2016,Crop Production & Basic Processing,134360,72552,206912
F000463,N00033443,Deb Fischer (R),2016,Republican/Conservative,153071,46500,199571
F000463,N00033443,Deb Fischer (R),2016,Agricultural Services/Products,76525,100500,177025
F000463,N00033443,Deb Fischer (R),2016,Lawyers/Law Firms,96186,76250,172436
F000463,N00033443,Deb Fischer (R),2016,Commercial Banks,89000,81170,170170
F000463,N00033443,Deb Fischer (R),2016,Oil & Gas,68234,90400,158634
F000463,N00033443,Deb Fischer (R),2016,Health Professionals,109199,44500,153699
D000627,N00033449,Val Demings (D),2016,Women's Issues,71992,8100,80092
D000627,N00033449,Val Demings (D),2016,Lawyers/Law Firms,68411,0,68411
D000627,N00033449,Val Demings (D),2016,Leadership PACs,4000,45014,49014
D000627,N00033449,Val Demings (D),2016,Retired,48338,0,48338
D000627,N00033449,Val Demings (D),2016,Public Sector Unions,0,44000,44000
D000627,N00033449,Val Demings (D),2016,Real Estate,30975,2000,32975
D000627,N00033449,Val Demings (D),2016,Education,30856,0,30856
D000627,N00033449,Val Demings (D),2016,Pro-Israel,29560,0,29560
D000627,N00033449,Val Demings (D),2016,Securities & Investment,27600,0,27600
D000627,N00033449,Val Demings (D),2016,Health Professionals,23945,2000,25945
B001278,N00033474,Suzanne Bonamici (D),2016,Lawyers/Law Firms,61645,17000,78645
B001278,N00033474,Suzanne Bonamici (D),2016,Misc Manufacturing & Distributing,20200,35000,55200
B001278,N00033474,Suzanne Bonamici (D),2016,Health Professionals,7934,40000,47934
B001278,N00033474,Suzanne Bonamici (D),2016,Insurance,0,37500,37500
B001278,N00033474,Suzanne Bonamici (D),2016,Retired,32436,0,32436
B001278,N00033474,Suzanne Bonamici (D),2016,Electronics Mfg & Equip,7650,24000,31650
B001278,N00033474,Suzanne Bonamici (D),2016,Crop Production & Basic Processing,2795,23500,26295
B001278,N00033474,Suzanne Bonamici (D),2016,Public Sector Unions,0,25500,25500
B001278,N00033474,Suzanne Bonamici (D),2016,Lobbyists,25435,0,25435
B001278,N00033474,Suzanne Bonamici (D),2016,Real Estate,13969,9000,22969
B001284,N00033495,Susan Brooks (R),2016,Pharmaceuticals/Health Products,23000,119500,142500
B001284,N00033495,Susan Brooks (R),2016,Health Professionals,29128,76500,105628
B001284,N00033495,Susan Brooks (R),2016,Securities & Investment,66500,18500,85000
B001284,N00033495,Susan Brooks (R),2016,Lawyers/Law Firms,58390,13500,71890
B001284,N00033495,Susan Brooks (R),2016,Real Estate,36550,29900,66450
B001284,N00033495,Susan Brooks (R),2016,Retired,55850,0,55850
B001284,N00033495,Susan Brooks (R),2016,Lobbyists,46564,8000,54564
B001284,N00033495,Susan Brooks (R),2016,Automotive,15100,32000,47100
B001284,N00033495,Susan Brooks (R),2016,Insurance,14500,31500,46000
B001284,N00033495,Susan Brooks (R),2016,Accountants,11250,34500,45750
C001093,N00033518,Doug Collins (R),2016,Leadership PACs,0,109500,109500
C001093,N00033518,Doug Collins (R),2016,Health Professionals,22450,42500,64950
C001093,N00033518,Doug Collins (R),2016,TV/Movies/Music,11900,45200,57100
C001093,N00033518,Doug Collins (R),2016,Lawyers/Law Firms,30325,25000,55325
C001093,N00033518,Doug Collins (R),2016,Retail Sales,24238,28000,52238
C001093,N00033518,Doug Collins (R),2016,Telecom Services,3100,38000,41100
C001093,N00033518,Doug Collins (R),2016,Lobbyists,39078,1000,40078
C001093,N00033518,Doug Collins (R),2016,Electronics Mfg & Equip,6950,31000,37950
C001093,N00033518,Doug Collins (R),2016,Candidate Committees,250,32500,32750
C001093,N00033518,Doug Collins (R),2016,Insurance,4500,25500,30000
B001283,N00033532,James Bridenstine (R),2016,Retired,84015,0,84015
B001283,N00033532,James Bridenstine (R),2016,Health Professionals,53900,19500,73400
B001283,N00033532,James Bridenstine (R),2016,Republican/Conservative,24540,29685,54225
B001283,N00033532,James Bridenstine (R),2016,Defense Aerospace,1500,43500,45000
B001283,N00033532,James Bridenstine (R),2016,Oil & Gas,12250,26500,38750
B001283,N00033532,James Bridenstine (R),2016,Defense Electronics,0,34000,34000
B001283,N00033532,James Bridenstine (R),2016,Telecom Services,4250,19000,23250
B001283,N00033532,James Bridenstine (R),2016,Lawyers/Law Firms,15500,4000,19500
B001283,N00033532,James Bridenstine (R),2016,Misc Finance,18800,0,18800
B001283,N00033532,James Bridenstine (R),2016,Automotive,13150,5000,18150
G000572,N00033541,Pete Gallego (D),2016,Lawyers/Law Firms,288084,11000,299084
G000572,N00033541,Pete Gallego (D),2016,Leadership PACs,12900,206800,219700
G000572,N00033541,Pete Gallego (D),2016,Democratic/Liberal,94895,26256,121151
G000572,N00033541,Pete Gallego (D),2016,Candidate Committees,1000,68700,69700
G000572,N00033541,Pete Gallego (D),2016,Education,55357,0,55357
G000572,N00033541,Pete Gallego (D),2016,Securities & Investment,54571,0,54571
G000572,N00033541,Pete Gallego (D),2016,Public Sector Unions,0,48000,48000
G000572,N00033541,Pete Gallego (D),2016,Building Trade Unions,0,46500,46500
G000572,N00033541,Pete Gallego (D),2016,Retired,42790,0,42790
G000572,N00033541,Pete Gallego (D),2016,Human Rights,15877,26000,41877
B001280,N00033625,Kerry Bentivolio (I),2016,Misc Business,20400,0,20400
B001280,N00033625,Kerry Bentivolio (I),2016,Health Professionals,8100,0,8100
B001280,N00033625,Kerry Bentivolio (I),2016,Hospitals/Nursing Homes,4436,0,4436
B001280,N00033625,Kerry Bentivolio (I),2016,Electronics Mfg & Equip,2700,0,2700
B001280,N00033625,Kerry Bentivolio (I),2016,Lodging/Tourism,2700,0,2700
B001280,N00033625,Kerry Bentivolio (I),2016,Republican/Conservative,0,1234,1234
A000372,N00033720,Richard W Allen (R),2016,Retired,97700,0,97700
A000372,N00033720,Richard W Allen (R),2016,Health Professionals,46450,21000,67450
A000372,N00033720,Richard W Allen (R),2016,Crop Production & Basic Processing,18022,45000,63022
A000372,N00033720,Richard W Allen (R),2016,Real Estate,47425,11500,58925
A000372,N00033720,Richard W Allen (R),2016,Securities & Investment,17650,28000,45650
A000372,N00033720,Richard W Allen (R),2016,Leadership PACs,1429,38900,40329
A000372,N00033720,Richard W Allen (R),2016,General Contractors,21000,17500,38500
A000372,N00033720,Richard W Allen (R),2016,Insurance,5350,24500,29850
A000372,N00033720,Richard W Allen (R),2016,Food & Beverage,6850,22500,29350
A000372,N00033720,Richard W Allen (R),2016,Agricultural Services/Products,4250,21500,25750
B001294,N00033744,Rod Blum (R),2016,Leadership PACs,20625,150750,171375
B001294,N00033744,Rod Blum (R),2016,Republican/Conservative,124183,28000,152183
B001294,N00033744,Rod Blum (R),2016,Retired,143969,0,143969
B001294,N00033744,Rod Blum (R),2016,Insurance,27100,35000,62100
B001294,N00033744,Rod Blum (R),2016,Candidate Committees,500,55900,56400
B001294,N00033744,Rod Blum (R),2016,Commercial Banks,19225,22300,41525
B001294,N00033744,Rod Blum (R),2016,Crop Production & Basic Processing,21000,17000,38000
B001294,N00033744,Rod Blum (R),2016,Trucking,33150,1000,34150
B001294,N00033744,Rod Blum (R),2016,Securities & Investment,27720,4000,31720
B001294,N00033744,Rod Blum (R),2016,Real Estate,21800,9000,30800
D000620,N00033897,John K Delaney (D),2016,Securities & Investment,96250,96000,192250
D000620,N00033897,John K Delaney (D),2016,Real Estate,117375,53000,170375
D000620,N00033897,John K Delaney (D),2016,Lawyers/Law Firms,107725,20500,128225
D000620,N00033897,John K Delaney (D),2016,Commercial Banks,42400,54500,96900
D000620,N00033897,John K Delaney (D),2016,Insurance,7750,74000,81750
D000620,N00033897,John K Delaney (D),2016,Misc Finance,50450,5000,55450
D000620,N00033897,John K Delaney (D),2016,Business Services,47700,0,47700
D000620,N00033897,John K Delaney (D),2016,Retired,46575,0,46575
D000620,N00033897,John K Delaney (D),2016,Accountants,5900,35500,41400
D000620,N00033897,John K Delaney (D),2016,Finance/Credit Companies,16100,18500,34600
B001281,N00033904,Joyce Beatty (D),2016,Insurance,33650,146500,180150
B001281,N00033904,Joyce Beatty (D),2016,Securities & Investment,3000,68100,71100
B001281,N00033904,Joyce Beatty (D),2016,Commercial Banks,11300,56300,67600
B001281,N00033904,Joyce Beatty (D),2016,Lawyers/Law Firms,23052,28750,51802
B001281,N00033904,Joyce Beatty (D),2016,Real Estate,8050,39000,47050
B001281,N00033904,Joyce Beatty (D),2016,Electric Utilities,500,44000,44500
B001281,N00033904,Joyce Beatty (D),2016,Industrial Unions,0,41500,41500
B001281,N00033904,Joyce Beatty (D),2016,Building Trade Unions,0,37500,37500
B001281,N00033904,Joyce Beatty (D),2016,Retail Sales,13900,23000,36900
B001281,N00033904,Joyce Beatty (D),2016,Pharmaceuticals/Health Products,1000,32000,33000
A000371,N00033997,Pete Aguilar (D),2016,Democratic/Liberal,164325,12000,176325
A000371,N00033997,Pete Aguilar (D),2016,Leadership PACs,0,175500,175500
A000371,N00033997,Pete Aguilar (D),2016,Lawyers/Law Firms,113157,23500,136657
A000371,N00033997,Pete Aguilar (D),2016,Real Estate,99908,24000,123908
A000371,N00033997,Pete Aguilar (D),2016,Retired,82105,0,82105
A000371,N00033997,Pete Aguilar (D),2016,Health Professionals,44655,30100,74755
A000371,N00033997,Pete Aguilar (D),2016,Securities & Investment,30850,33500,64350
A000371,N00033997,Pete Aguilar (D),2016,Candidate Committees,0,64000,64000
A000371,N00033997,Pete Aguilar (D),2016,Public Sector Unions,50,63500,63550
A000371,N00033997,Pete Aguilar (D),2016,Casinos/Gambling,50600,5000,55600
C001090,N00034128,Matt Cartwright (D),2016,Lawyers/Law Firms,255101,14000,269101
C001090,N00034128,Matt Cartwright (D),2016,Building Trade Unions,350,70000,70350
C001090,N00034128,Matt Cartwright (D),2016,Public Sector Unions,0,58000,58000
C001090,N00034128,Matt Cartwright (D),2016,Industrial Unions,0,48000,48000
C001090,N00034128,Matt Cartwright (D),2016,Transportation Unions,0,39500,39500
C001090,N00034128,Matt Cartwright (D),2016,Misc Unions,1000,22250,23250
C001090,N00034128,Matt Cartwright (D),2016,Defense Aerospace,0,19000,19000
C001090,N00034128,Matt Cartwright (D),2016,Hospitals/Nursing Homes,755,15000,15755
C001090,N00034128,Matt Cartwright (D),2016,Automotive,3150,11000,14150
C001090,N00034128,Matt Cartwright (D),2016,Environment,8100,5571,13671
C001094,N00034224,Paul Cook (R),2016,Leadership PACs,0,95700,95700
C001094,N00034224,Paul Cook (R),2016,Casinos/Gambling,76200,5000,81200
C001094,N00034224,Paul Cook (R),2016,Public Sector Unions,0,47500,47500
C001094,N00034224,Paul Cook (R),2016,Transportation Unions,0,46000,46000
C001094,N00034224,Paul Cook (R),2016,Building Trade Unions,0,42500,42500
C001094,N00034224,Paul Cook (R),2016,Defense Aerospace,0,41000,41000
C001094,N00034224,Paul Cook (R),2016,Real Estate,25600,10000,35600
C001094,N00034224,Paul Cook (R),2016,Defense Electronics,0,33000,33000
C001094,N00034224,Paul Cook (R),2016,Building Materials & Equipment,8650,22500,31150
C001094,N00034224,Paul Cook (R),2016,Republican/Conservative,5800,22750,28550
B001285,N00034254,Julia Brownley (D),2016,Women's Issues,218625,15000,233625
B001285,N00034254,Julia Brownley (D),2016,Retired,190656,0,190656
B001285,N00034254,Julia Brownley (D),2016,Leadership PACs,0,186266,186266
B001285,N00034254,Julia Brownley (D),2016,Democratic/Liberal,164180,2750,166930
B001285,N00034254,Julia Brownley (D),2016,Lawyers/Law Firms,107608,13000,120608
B001285,N00034254,Julia Brownley (D),2016,Misc Issues,81994,18500,100494
B001285,N00034254,Julia Brownley (D),2016,Transportation Unions,0,91505,91505
B001285,N00034254,Julia Brownley (D),2016,Human Rights,67240,21200,88440
B001285,N00034254,Julia Brownley (D),2016,Health Professionals,20109,67000,87109
B001285,N00034254,Julia Brownley (D),2016,Public Sector Unions,0,78900,78900
E000297,N00034549,Adriano Espaillat (D),2016,Lawyers/Law Firms,34000,12500,46500
E000297,N00034549,Adriano Espaillat (D),2016,Health Professionals,39870,1000,40870
E000297,N00034549,Adriano Espaillat (D),2016,Real Estate,34550,6000,40550
E000297,N00034549,Adriano Espaillat (D),2016,Leadership PACs,0,31900,31900
E000297,N00034549,Adriano Espaillat (D),2016,Public Sector Unions,0,31000,31000
E000297,N00034549,Adriano Espaillat (D),2016,Securities & Investment,29000,0,29000
E000297,N00034549,Adriano Espaillat (D),2016,Retired,27650,0,27650
E000297,N00034549,Adriano Espaillat (D),2016,Education,23675,0,23675
E000297,N00034549,Adriano Espaillat (D),2016,Misc Business,22775,0,22775
E000297,N00034549,Adriano Espaillat (D),2016,Industrial Unions,0,22000,22000
D000621,N00034746,Ron DeSantis (R),2016,Retired,806629,0,806629
D000621,N00034746,Ron DeSantis (R),2016,Republican/Conservative,589351,60069,649420
D000621,N00034746,Ron DeSantis (R),2016,Securities & Investment,282270,0,282270
D000621,N00034746,Ron DeSantis (R),2016,Real Estate,189196,4500,193696
D000621,N00034746,Ron DeSantis (R),2016,Misc Finance,120610,3500,124110
D000621,N00034746,Ron DeSantis (R),2016,Lawyers/Law Firms,105583,14000,119583
D000621,N00034746,Ron DeSantis (R),2016,Health Professionals,111310,6500,117810
D000621,N00034746,Ron DeSantis (R),2016,Leadership PACs,0,108900,108900
D000621,N00034746,Ron DeSantis (R),2016,Pro-Israel,69500,12500,82000
D000621,N00034746,Ron DeSantis (R),2016,Misc Manufacturing & Distributing,76100,5000,81100
D000619,N00034784,Rodney Davis (R),2016,Agricultural Services/Products,12170,153846,166016
D000619,N00034784,Rodney Davis (R),2016,Leadership PACs,0,161893,161893
D000619,N00034784,Rodney Davis (R),2016,Insurance,25146,101500,126646
D000619,N00034784,Rodney Davis (R),2016,Health Professionals,22575,70250,92825
D000619,N00034784,Rodney Davis (R),2016,Crop Production & Basic Processing,22785,68750,91535
D000619,N00034784,Rodney Davis (R),2016,Securities & Investment,32650,44500,77150
D000619,N00034784,Rodney Davis (R),2016,Air Transport,0,71999,71999
D000619,N00034784,Rodney Davis (R),2016,Lawyers/Law Firms,34070,28000,62070
D000619,N00034784,Rodney Davis (R),2016,Oil & Gas,2000,59000,61000
D000619,N00034784,Rodney Davis (R),2016,Food & Beverage,17357,42500,59857
B001288,N00035267,Cory Booker (D),2016,Lawyers/Law Firms,2327325,186000,2513325
B001288,N00035267,Cory Booker (D),2016,Securities & Investment,2281577,61200,2342777
B001288,N00035267,Cory Booker (D),2016,Real Estate,1183160,29000,1212160
B001288,N00035267,Cory Booker (D),2016,TV/Movies/Music,725870,32000,757870
B001288,N00035267,Cory Booker (D),2016,Misc Finance,513925,15000,528925
B001288,N00035267,Cory Booker (D),2016,Business Services,478871,10500,489371
B001288,N00035267,Cory Booker (D),2016,Pro-Israel,397599,36527,434126
B001288,N00035267,Cory Booker (D),2016,Pharmaceuticals/Health Products,174941,218500,393441
B001288,N00035267,Cory Booker (D),2016,Insurance,254550,124000,378550
B001288,N00035267,Cory Booker (D),2016,Retired,376988,0,376988
C001101,N00035278,Katherine Clark (D),2016,Lawyers/Law Firms,83785,19000,102785
C001101,N00035278,Katherine Clark (D),2016,Pharmaceuticals/Health Products,10950,86000,96950
C001101,N00035278,Katherine Clark (D),2016,Retired,80529,0,80529
C001101,N00035278,Katherine Clark (D),2016,Securities & Investment,42700,23000,65700
C001101,N00035278,Katherine Clark (D),2016,Real Estate,52606,8500,61106
C001101,N00035278,Katherine Clark (D),2016,Building Trade Unions,0,60000,60000
C001101,N00035278,Katherine Clark (D),2016,Women's Issues,49008,5,49013
C001101,N00035278,Katherine Clark (D),2016,Public Sector Unions,0,49000,49000
C001101,N00035278,Katherine Clark (D),2016,Insurance,14163,32000,46163
C001101,N00035278,Katherine Clark (D),2016,Health Professionals,9894,26750,36644
B001296,N00035307,Brendan Boyle (D),2016,Lawyers/Law Firms,56950,19000,75950
B001296,N00035307,Brendan Boyle (D),2016,Public Sector Unions,0,60000,60000
B001296,N00035307,Brendan Boyle (D),2016,Building Trade Unions,0,53012,53012
B001296,N00035307,Brendan Boyle (D),2016,Securities & Investment,38750,7500,46250
B001296,N00035307,Brendan Boyle (D),2016,Insurance,9500,35500,45000
B001296,N00035307,Brendan Boyle (D),2016,Real Estate,33150,10500,43650
B001296,N00035307,Brendan Boyle (D),2016,Transportation Unions,0,43000,43000
B001296,N00035307,Brendan Boyle (D),2016,Pharmaceuticals/Health Products,500,41500,42000
B001296,N00035307,Brendan Boyle (D),2016,Industrial Unions,0,40000,40000
B001296,N00035307,Brendan Boyle (D),2016,Pro-Israel,15900,17500,33400
C001103,N00035346,Buddy Carter (R),2016,Health Professionals,51600,133700,185300
C001103,N00035346,Buddy Carter (R),2016,Retail Sales,78000,32500,110500
C001103,N00035346,Buddy Carter (R),2016,Pharmaceuticals/Health Products,9900,42900,52800
C001103,N00035346,Buddy Carter (R),2016,Retired,45445,0,45445
C001103,N00035346,Buddy Carter (R),2016,Forestry & Forest Products,7900,33998,41898
C001103,N00035346,Buddy Carter (R),2016,Insurance,5500,33000,38500
C001103,N00035346,Buddy Carter (R),2016,Crop Production & Basic Processing,1625,31500,33125
C001103,N00035346,Buddy Carter (R),2016,Air Transport,9700,19500,29200
C001103,N00035346,Buddy Carter (R),2016,Leadership PACs,0,27000,27000
C001103,N00035346,Buddy Carter (R),2016,Lawyers/Law Firms,12032,13500,25532
B001289,N00035380,Bradley Byrne (R),2016,Lawyers/Law Firms,36800,33750,70550
B001289,N00035380,Bradley Byrne (R),2016,Defense Aerospace,1250,62500,63750
B001289,N00035380,Bradley Byrne (R),2016,Real Estate,33803,29000,62803
B001289,N00035380,Bradley Byrne (R),2016,Insurance,8700,51500,60200
B001289,N00035380,Bradley Byrne (R),2016,Leadership PACs,0,54150,54150
B001289,N00035380,Bradley Byrne (R),2016,Forestry & Forest Products,23639,25500,49139
B001289,N00035380,Bradley Byrne (R),2016,Crop Production & Basic Processing,8100,40500,48600
B001289,N00035380,Bradley Byrne (R),2016,Health Professionals,16672,28200,44872
B001289,N00035380,Bradley Byrne (R),2016,Building Materials & Equipment,12450,24000,36450
B001289,N00035380,Bradley Byrne (R),2016,General Contractors,22850,13500,36350
C001107,N00035403,Carlos Curbelo (R),2016,Leadership PACs,0,417700,417700
C001107,N00035403,Carlos Curbelo (R),2016,Real Estate,153975,46000,199975
C001107,N00035403,Carlos Curbelo (R),2016,Securities & Investment,141950,54000,195950
C001107,N00035403,Carlos Curbelo (R),2016,Retired,160535,0,160535
C001107,N00035403,Carlos Curbelo (R),2016,Insurance,5850,145000,150850
C001107,N00035403,Carlos Curbelo (R),2016,Foreign & Defense Policy,130349,10000,140349
C001107,N00035403,Carlos Curbelo (R),2016,Pro-Israel,102550,36500,139050
C001107,N00035403,Carlos Curbelo (R),2016,Lawyers/Law Firms,85903,29250,115153
C001107,N00035403,Carlos Curbelo (R),2016,Candidate Committees,667,107050,107717
C001107,N00035403,Carlos Curbelo (R),2016,Air Transport,2000,86500,88500
B001295,N00035420,Mike Bost (R),2016,Leadership PACs,1429,223700,225129
B001295,N00035420,Mike Bost (R),2016,Retired,150028,0,150028
B001295,N00035420,Mike Bost (R),2016,Crop Production & Basic Processing,72650,40500,113150
B001295,N00035420,Mike Bost (R),2016,Insurance,28150,42700,70850
B001295,N00035420,Mike Bost (R),2016,Agricultural Services/Products,2500,63889,66389
B001295,N00035420,Mike Bost (R),2016,Health Professionals,35770,28500,64270
B001295,N00035420,Mike Bost (R),2016,Lawyers/Law Firms,49045,15000,64045
B001295,N00035420,Mike Bost (R),2016,Securities & Investment,42350,20000,62350
B001295,N00035420,Mike Bost (R),2016,Candidate Committees,571,53116,53687
B001295,N00035420,Mike Bost (R),2016,Automotive,24250,24000,48250
E000294,N00035440,Tom Emmer (R),2016,Retired,151758,0,151758
E000294,N00035440,Tom Emmer (R),2016,Securities & Investment,39600,67850,107450
E000294,N00035440,Tom Emmer (R),2016,Insurance,17325,84000,101325
E000294,N00035440,Tom Emmer (R),2016,Commercial Banks,14030,81500,95530
E000294,N00035440,Tom Emmer (R),2016,Republican/Conservative,64733,9000,73733
E000294,N00035440,Tom Emmer (R),2016,Real Estate,18500,45000,63500
E000294,N00035440,Tom Emmer (R),2016,Crop Production & Basic Processing,16771,36000,52771
E000294,N00035440,Tom Emmer (R),2016,Agricultural Services/Products,12500,32500,45000
E000294,N00035440,Tom Emmer (R),2016,Lawyers/Law Firms,24100,20875,44975
E000294,N00035440,Tom Emmer (R),2016,Misc Finance,28950,13500,42450
A000370,N00035451,Alma Adams (D),2016,Leadership PACs,0,70500,70500
A000370,N00035451,Alma Adams (D),2016,Industrial Unions,0,67000,67000
A000370,N00035451,Alma Adams (D),2016,Public Sector Unions,0,57000,57000
A000370,N00035451,Alma Adams (D),2016,Candidate Committees,0,44500,44500
A000370,N00035451,Alma Adams (D),2016,Health Professionals,26400,11500,37900
A000370,N00035451,Alma Adams (D),2016,Women's Issues,26265,6000,32265
A000370,N00035451,Alma Adams (D),2016,Insurance,1000,29500,30500
A000370,N00035451,Alma Adams (D),2016,Building Trade Unions,0,30000,30000
A000370,N00035451,Alma Adams (D),2016,Securities & Investment,4300,22000,26300
A000370,N00035451,Alma Adams (D),2016,Lawyers/Law Firms,16665,9500,26165
E000295,N00035483,Joni Ernst (R),2016,Leadership PACs,2000,361036,363036
E000295,N00035483,Joni Ernst (R),2016,Retired,265542,0,265542
E000295,N00035483,Joni Ernst (R),2016,Securities & Investment,217770,6000,223770
E000295,N00035483,Joni Ernst (R),2016,Republican/Conservative,90191,86530,176721
E000295,N00035483,Joni Ernst (R),2016,Oil & Gas,70800,86000,156800
E000295,N00035483,Joni Ernst (R),2016,Real Estate,111022,15000,126022
E000295,N00035483,Joni Ernst (R),2016,Insurance,34115,64000,98115
E000295,N00035483,Joni Ernst (R),2016,Food & Beverage,16300,65600,81900
E000295,N00035483,Joni Ernst (R),2016,Commercial Banks,25450,56000,81450
E000295,N00035483,Joni Ernst (R),2016,Lawyers/Law Firms,51395,24250,75645
C001109,N00035504,Liz Cheney (R),2016,Retired,302629,0,302629
C001109,N00035504,Liz Cheney (R),2016,Securities & Investment,209316,0,209316
C001109,N00035504,Liz Cheney (R),2016,Real Estate,115882,6000,121882
C001109,N00035504,Liz Cheney (R),2016,Oil & Gas,80275,35200,115475
C001109,N00035504,Liz Cheney (R),2016,Leadership PACs,0,83500,83500
C001109,N00035504,Liz Cheney (R),2016,Misc Finance,73800,0,73800
C001109,N00035504,Liz Cheney (R),2016,Lawyers/Law Firms,58700,3500,62200
C001109,N00035504,Liz Cheney (R),2016,Retail Sales,44550,7500,52050
C001109,N00035504,Liz Cheney (R),2016,Health Professionals,38000,3500,41500
C001109,N00035504,Liz Cheney (R),2016,Republican/Conservative,30928,5000,35928
G000575,N00035688,Gwen Graham (D),2016,Lawyers/Law Firms,149879,11000,160879
G000575,N00035688,Gwen Graham (D),2016,Retired,108175,0,108175
G000575,N00035688,Gwen Graham (D),2016,Leadership PACs,250,102597,102847
G000575,N00035688,Gwen Graham (D),2016,Real Estate,72525,12500,85025
G000575,N00035688,Gwen Graham (D),2016,Health Professionals,22014,32300,54314
G000575,N00035688,Gwen Graham (D),2016,Securities & Investment,42250,9000,51250
G000575,N00035688,Gwen Graham (D),2016,Lobbyists,50596,0,50596
G000575,N00035688,Gwen Graham (D),2016,Democratic/Liberal,37520,13000,50520
G000575,N00035688,Gwen Graham (D),2016,Insurance,19850,27000,46850
G000575,N00035688,Gwen Graham (D),2016,Women's Issues,38041,7500,45541
C001102,N00035854,Curt Clawson (R),2016,Retired,139387,0,139387
C001102,N00035854,Curt Clawson (R),2016,Lawyers/Law Firms,24147,0,24147
C001102,N00035854,Curt Clawson (R),2016,Real Estate,17623,0,17623
C001102,N00035854,Curt Clawson (R),2016,Securities & Investment,12850,0,12850
C001102,N00035854,Curt Clawson (R),2016,Health Professionals,7250,0,7250
C001102,N00035854,Curt Clawson (R),2016,Automotive,5750,0,5750
C001102,N00035854,Curt Clawson (R),2016,Misc Transport,5200,0,5200
C001102,N00035854,Curt Clawson (R),2016,Leadership PACs,0,5000,5000
C001102,N00035854,Curt Clawson (R),2016,General Contractors,4041,0,4041
C001102,N00035854,Curt Clawson (R),2016,TV/Movies/Music,3500,0,3500
B001290,N00036013,Dave Brat (R),2016,Retired,156995,0,156995
B001290,N00036013,Dave Brat (R),2016,Republican/Conservative,83526,19100,102626
B001290,N00036013,Dave Brat (R),2016,Real Estate,81900,6000,87900
B001290,N00036013,Dave Brat (R),2016,Securities & Investment,73633,0,73633
B001290,N00036013,Dave Brat (R),2016,Lawyers/Law Firms,24674,1250,25924
B001290,N00036013,Dave Brat (R),2016,Automotive,8550,16000,24550
B001290,N00036013,Dave Brat (R),2016,Misc Manufacturing & Distributing,21900,1998,23898
B001290,N00036013,Dave Brat (R),2016,Health Services/HMOs,11800,8500,20300
B001290,N00036013,Dave Brat (R),2016,Insurance,11025,8750,19775
B001290,N00036013,Dave Brat (R),2016,Misc Finance,19610,0,19610
B001292,N00036018,Don Beyer (D),2016,Lawyers/Law Firms,144420,36950,181370
B001292,N00036018,Don Beyer (D),2016,Retired,149313,0,149313
B001292,N00036018,Don Beyer (D),2016,Real Estate,108175,25000,133175
B001292,N00036018,Don Beyer (D),2016,Automotive,57975,43182,101157
B001292,N00036018,Don Beyer (D),2016,Securities & Investment,34600,21000,55600
B001292,N00036018,Don Beyer (D),2016,Health Professionals,10851,41500,52351
B001292,N00036018,Don Beyer (D),2016,Misc Defense,6950,43300,50250
B001292,N00036018,Don Beyer (D),2016,Business Services,39328,10000,49328
B001292,N00036018,Don Beyer (D),2016,Insurance,4250,45000,49250
B001292,N00036018,Don Beyer (D),2016,Electronics Mfg & Equip,15025,33850,48875
C001105,N00036023,Barbara Comstock (R),2016,Leadership PACs,2900,367100,370000
C001105,N00036023,Barbara Comstock (R),2016,Retired,313407,0,313407
C001105,N00036023,Barbara Comstock (R),2016,Securities & Investment,292029,4500,296529
C001105,N00036023,Barbara Comstock (R),2016,Lobbyists,247525,7513,255038
C001105,N00036023,Barbara Comstock (R),2016,Lawyers/Law Firms,204040,46250,250290
C001105,N00036023,Barbara Comstock (R),2016,Real Estate,188313,29000,217313
C001105,N00036023,Barbara Comstock (R),2016,Business Services,126900,15700,142600
C001105,N00036023,Barbara Comstock (R),2016,Republican/Conservative,66174,53000,119174
C001105,N00036023,Barbara Comstock (R),2016,Electronics Mfg & Equip,61150,53183,114333
C001105,N00036023,Barbara Comstock (R),2016,Air Transport,7764,99500,107264
G000574,N00036097,Ruben Gallego (D),2016,Lawyers/Law Firms,40069,17500,57569
G000574,N00036097,Ruben Gallego (D),2016,Real Estate,40500,11500,52000
G000574,N00036097,Ruben Gallego (D),2016,Transportation Unions,0,47500,47500
G000574,N00036097,Ruben Gallego (D),2016,Health Professionals,17883,18000,35883
G000574,N00036097,Ruben Gallego (D),2016,Misc Unions,0,30000,30000
G000574,N00036097,Ruben Gallego (D),2016,Industrial Unions,0,29500,29500
G000574,N00036097,Ruben Gallego (D),2016,Lobbyists,28396,0,28396
G000574,N00036097,Ruben Gallego (D),2016,Building Trade Unions,0,28000,28000
G000574,N00036097,Ruben Gallego (D),2016,Casinos/Gambling,26191,0,26191
G000574,N00036097,Ruben Gallego (D),2016,Business Services,25630,0,25630
G000577,N00036135,Garret Graves (R),2016,Oil & Gas,58966,135233,194199
G000577,N00036135,Garret Graves (R),2016,Lawyers/Law Firms,69650,47100,116750
G000577,N00036135,Garret Graves (R),2016,Sea Transport,37750,42100,79850
G000577,N00036135,Garret Graves (R),2016,Lobbyists,72287,7000,79287
G000577,N00036135,Garret Graves (R),2016,Insurance,18300,47250,65550
G000577,N00036135,Garret Graves (R),2016,General Contractors,47590,15500,63090
G000577,N00036135,Garret Graves (R),2016,Construction Services,35837,26250,62087
G000577,N00036135,Garret Graves (R),2016,Real Estate,39833,14000,53833
G000577,N00036135,Garret Graves (R),2016,Food & Beverage,39050,12000,51050
G000577,N00036135,Garret Graves (R),2016,Air Transport,6900,37000,43900
D000624,N00036149,Debbie Dingell (D),2016,Lawyers/Law Firms,47475,38100,85575
D000624,N00036149,Debbie Dingell (D),2016,Industrial Unions,100,54500,54600
D000624,N00036149,Debbie Dingell (D),2016,Automotive,15300,39000,54300
D000624,N00036149,Debbie Dingell (D),2016,Retired,53899,0,53899
D000624,N00036149,Debbie Dingell (D),2016,Electric Utilities,6200,42500,48700
D000624,N00036149,Debbie Dingell (D),2016,Building Trade Unions,0,44500,44500
D000624,N00036149,Debbie Dingell (D),2016,Public Sector Unions,0,39500,39500
D000624,N00036149,Debbie Dingell (D),2016,Real Estate,30450,7000,37450
D000624,N00036149,Debbie Dingell (D),2016,Lobbyists,26900,1500,28400
D000624,N00036149,Debbie Dingell (D),2016,Defense Aerospace,4000,18000,22000
G000576,N00036409,Glenn S Grothman (R),2016,Retired,140896,0,140896
G000576,N00036409,Glenn S Grothman (R),2016,Misc Manufacturing & Distributing,17275,19998,37273
G000576,N00036409,Glenn S Grothman (R),2016,Insurance,6994,27500,34494
G000576,N00036409,Glenn S Grothman (R),2016,Real Estate,25225,7000,32225
G000576,N00036409,Glenn S Grothman (R),2016,Securities & Investment,22970,4000,26970
G000576,N00036409,Glenn S Grothman (R),2016,Lawyers/Law Firms,22660,3000,25660
G000576,N00036409,Glenn S Grothman (R),2016,Leadership PACs,0,25500,25500
G000576,N00036409,Glenn S Grothman (R),2016,General Contractors,20883,2500,23383
G000576,N00036409,Glenn S Grothman (R),2016,Oil & Gas,8700,14500,23200
G000576,N00036409,Glenn S Grothman (R),2016,Trucking,4450,16000,20450
B001293,N00036449,Mike Bishop (R),2016,Leadership PACs,0,212450,212450
B001293,N00036449,Mike Bishop (R),2016,Insurance,9400,73500,82900
B001293,N00036449,Mike Bishop (R),2016,Real Estate,59775,21700,81475
B001293,N00036449,Mike Bishop (R),2016,Automotive,31050,35000,66050
B001293,N00036449,Mike Bishop (R),2016,Securities & Investment,41350,14500,55850
B001293,N00036449,Mike Bishop (R),2016,Health Professionals,8100,45250,53350
B001293,N00036449,Mike Bishop (R),2016,Retail Sales,19900,25000,44900
B001293,N00036449,Mike Bishop (R),2016,Electric Utilities,1250,41500,42750
B001293,N00036449,Mike Bishop (R),2016,Lawyers/Law Firms,24975,12000,36975
B001293,N00036449,Mike Bishop (R),2016,Candidate Committees,0,35500,35500
A000374,N00036633,Ralph Abraham (R),2016,Crop Production & Basic Processing,22871,45000,67871
A000374,N00036633,Ralph Abraham (R),2016,Health Professionals,19050,30000,49050
A000374,N00036633,Ralph Abraham (R),2016,Agricultural Services/Products,3700,30000,33700
A000374,N00036633,Ralph Abraham (R),2016,Leadership PACs,1429,30000,31429
A000374,N00036633,Ralph Abraham (R),2016,Real Estate,13425,8500,21925
A000374,N00036633,Ralph Abraham (R),2016,Commercial Banks,12100,8500,20600
A000374,N00036633,Ralph Abraham (R),2016,Forestry & Forest Products,6400,13000,19400
A000374,N00036633,Ralph Abraham (R),2016,Lawyers/Law Firms,8250,9000,17250
A000374,N00036633,Ralph Abraham (R),2016,Oil & Gas,5250,11000,16250
A000374,N00036633,Ralph Abraham (R),2016,Misc Business,15100,0,15100
D000625,N00036928,Dan Donovan (R),2016,Leadership PACs,0,181200,181200
D000625,N00036928,Dan Donovan (R),2016,Real Estate,120722,29500,150222
D000625,N00036928,Dan Donovan (R),2016,Lawyers/Law Firms,118384,11750,130134
D000625,N00036928,Dan Donovan (R),2016,Securities & Investment,99846,10500,110346
D000625,N00036928,Dan Donovan (R),2016,Building Trade Unions,0,70500,70500
D000625,N00036928,Dan Donovan (R),2016,Retired,69032,0,69032
D000625,N00036928,Dan Donovan (R),2016,Insurance,7185,47000,54185
D000625,N00036928,Dan Donovan (R),2016,Commercial Banks,14150,38000,52150
D000625,N00036928,Dan Donovan (R),2016,Transportation Unions,500,50750,51250
D000625,N00036928,Dan Donovan (R),2016,Health Professionals,38775,8000,46775
G000583,N00036944,Josh Gottheimer (D),2016,Securities & Investment,550581,5000,555581
G000583,N00036944,Josh Gottheimer (D),2016,Lawyers/Law Firms,423886,14000,437886
G000583,N00036944,Josh Gottheimer (D),2016,Retired,210631,0,210631
G000583,N00036944,Josh Gottheimer (D),2016,Leadership PACs,8100,184074,192174
G000583,N00036944,Josh Gottheimer (D),2016,Real Estate,173314,11000,184314
G000583,N00036944,Josh Gottheimer (D),2016,Business Services,138247,0,138247
G000583,N00036944,Josh Gottheimer (D),2016,Democratic/Liberal,107235,29500,136735
G000583,N00036944,Josh Gottheimer (D),2016,Lobbyists,115436,5000,120436
G000583,N00036944,Josh Gottheimer (D),2016,Misc Finance,98156,0,98156
G000583,N00036944,Josh Gottheimer (D),2016,Health Professionals,67035,21000,88035
B001304,N00036999,Anthony Brown (D),2016,Lawyers/Law Firms,94994,12750,107744
B001304,N00036999,Anthony Brown (D),2016,Real Estate,62821,11500,74321
B001304,N00036999,Anthony Brown (D),2016,Public Sector Unions,0,60000,60000
B001304,N00036999,Anthony Brown (D),2016,Health Professionals,30975,21500,52475
B001304,N00036999,Anthony Brown (D),2016,Retired,44867,0,44867
B001304,N00036999,Anthony Brown (D),2016,Leadership PACs,0,40700,40700
B001304,N00036999,Anthony Brown (D),2016,Human Rights,5238,19500,24738
B001304,N00036999,Anthony Brown (D),2016,Misc Unions,0,22500,22500
B001304,N00036999,Anthony Brown (D),2016,Transportation Unions,0,22500,22500
B001304,N00036999,Anthony Brown (D),2016,Lobbyists,22300,0,22300
C001112,N00037015,Salud Carbajal (D),2016,Retired,575172,0,575172
C001112,N00037015,Salud Carbajal (D),2016,Leadership PACs,2700,167444,170144
C001112,N00037015,Salud Carbajal (D),2016,Democratic/Liberal,145088,19200,164288
C001112,N00037015,Salud Carbajal (D),2016,Real Estate,143106,5000,148106
C001112,N00037015,Salud Carbajal (D),2016,Lawyers/Law Firms,124580,6000,130580
C001112,N00037015,Salud Carbajal (D),2016,Misc Finance,74550,0,74550
C001112,N00037015,Salud Carbajal (D),2016,Public Sector Unions,500,63000,63500
C001112,N00037015,Salud Carbajal (D),2016,Health Professionals,37190,19500,56690
C001112,N00037015,Salud Carbajal (D),2016,TV/Movies/Music,55785,0,55785
C001112,N00037015,Salud Carbajal (D),2016,Building Trade Unions,0,55000,55000
B001300,N00037019,Nanette Barragan (D),2016,Lawyers/Law Firms,227045,9816,236861
B001300,N00037019,Nanette Barragan (D),2016,Women's Issues,147554,31500,179054
B001300,N00037019,Nanette Barragan (D),2016,Democratic/Liberal,141768,12393,154161
B001300,N00037019,Nanette Barragan (D),2016,Human Rights,35832,26962,62794
B001300,N00037019,Nanette Barragan (D),2016,Securities & Investment,61968,0,61968
B001300,N00037019,Nanette Barragan (D),2016,Leadership PACs,0,61200,61200
B001300,N00037019,Nanette Barragan (D),2016,Retired,58468,0,58468
B001300,N00037019,Nanette Barragan (D),2016,Environment,40782,15130,55912
B001300,N00037019,Nanette Barragan (D),2016,Real Estate,43897,0,43897
B001300,N00037019,Nanette Barragan (D),2016,Education,31998,0,31998
B001298,N00037049,Don Bacon (R),2016,Leadership PACs,0,225100,225100
B001298,N00037049,Don Bacon (R),2016,Retired,152702,0,152702
B001298,N00037049,Don Bacon (R),2016,Republican/Conservative,29665,39998,69663
B001298,N00037049,Don Bacon (R),2016,Candidate Committees,0,58725,58725
B001298,N00037049,Don Bacon (R),2016,Other,40950,0,40950
B001298,N00037049,Don Bacon (R),2016,Securities & Investment,34075,2000,36075
B001298,N00037049,Don Bacon (R),2016,Lawyers/Law Firms,28732,6000,34732
B001298,N00037049,Don Bacon (R),2016,Insurance,16365,14000,30365
B001298,N00037049,Don Bacon (R),2016,Health Professionals,22175,7000,29175
B001298,N00037049,Don Bacon (R),2016,Real Estate,26462,2500,28962
C001113,N00037161,Catherine Cortez Masto (D),2016,Women's Issues,1627058,41485,1668543
C001113,N00037161,Catherine Cortez Masto (D),2016,Democratic/Liberal,1431489,25234,1456723
C001113,N00037161,Catherine Cortez Masto (D),2016,Lawyers/Law Firms,1314378,21474,1335852
C001113,N00037161,Catherine Cortez Masto (D),2016,Retired,673735,0,673735
C001113,N00037161,Catherine Cortez Masto (D),2016,Education,570239,0,570239
C001113,N00037161,Catherine Cortez Masto (D),2016,Human Rights,493695,52271,545966
C001113,N00037161,Catherine Cortez Masto (D),2016,Environment,492597,19863,512460
C001113,N00037161,Catherine Cortez Masto (D),2016,Securities & Investment,475490,0,475490
C001113,N00037161,Catherine Cortez Masto (D),2016,Leadership PACs,7900,396876,404776
C001113,N00037161,Catherine Cortez Masto (D),2016,Real Estate,354282,0,354282
B001299,N00037185,Jim Banks (R),2016,Republican/Conservative,297108,42098,339206
B001299,N00037185,Jim Banks (R),2016,Leadership PACs,15275,79700,94975
B001299,N00037185,Jim Banks (R),2016,Retired,68073,0,68073
B001299,N00037185,Jim Banks (R),2016,Environment,57650,0,57650
B001299,N00037185,Jim Banks (R),2016,Real Estate,29685,13700,43385
B001299,N00037185,Jim Banks (R),2016,Health Professionals,18400,22000,40400
B001299,N00037185,Jim Banks (R),2016,Oil & Gas,7535,20000,27535
B001299,N00037185,Jim Banks (R),2016,Food & Beverage,19900,1000,20900
B001299,N00037185,Jim Banks (R),2016,Misc Manufacturing & Distributing,14100,5000,19100
B001299,N00037185,Jim Banks (R),2016,Women's Issues,18750,0,18750
C001110,N00037260,Lou Correa (D),2016,Leadership PACs,2700,59800,62500
C001110,N00037260,Lou Correa (D),2016,Casinos/Gambling,41800,6000,47800
C001110,N00037260,Lou Correa (D),2016,Health Professionals,11149,31500,42649
C001110,N00037260,Lou Correa (D),2016,Democratic/Liberal,24250,17500,41750
C001110,N00037260,Lou Correa (D),2016,Real Estate,26018,12000,38018
C001110,N00037260,Lou Correa (D),2016,Lawyers/Law Firms,31425,3000,34425
C001110,N00037260,Lou Correa (D),2016,Insurance,4300,26622,30922
C001110,N00037260,Lou Correa (D),2016,Human Rights,5200,22500,27700
C001110,N00037260,Lou Correa (D),2016,Public Sector Unions,6000,20500,26500
C001110,N00037260,Lou Correa (D),2016,Pharmaceuticals/Health Products,750,24000,24750
F000464,N00037288,John Faso (R),2016,Securities & Investment,359099,0,359099
F000464,N00037288,John Faso (R),2016,Retired,297385,0,297385
F000464,N00037288,John Faso (R),2016,Lawyers/Law Firms,163303,500,163803
F000464,N00037288,John Faso (R),2016,Real Estate,140932,10000,150932
F000464,N00037288,John Faso (R),2016,Leadership PACs,0,136200,136200
F000464,N00037288,John Faso (R),2016,Insurance,56439,47500,103939
F000464,N00037288,John Faso (R),2016,Misc Finance,61800,0,61800
F000464,N00037288,John Faso (R),2016,Pro-Israel,41750,18200,59950
F000464,N00037288,John Faso (R),2016,Misc Manufacturing & Distributing,51750,7000,58750
F000464,N00037288,John Faso (R),2016,Business Services,50654,6000,56654
D000628,N00037442,Neal Dunn (R),2016,Health Professionals,258022,73000,331022
D000628,N00037442,Neal Dunn (R),2016,Retired,125451,0,125451
D000628,N00037442,Neal Dunn (R),2016,Leadership PACs,0,87500,87500
D000628,N00037442,Neal Dunn (R),2016,Real Estate,66660,10000,76660
D000628,N00037442,Neal Dunn (R),2016,Lawyers/Law Firms,33153,6500,39653
D000628,N00037442,Neal Dunn (R),2016,General Contractors,30100,6000,36100
D000628,N00037442,Neal Dunn (R),2016,Crop Production & Basic Processing,23900,5000,28900
D000628,N00037442,Neal Dunn (R),2016,"Beer, Wine & Liquor",21000,7500,28500
D000628,N00037442,Neal Dunn (R),2016,Automotive,11970,13000,24970
D000628,N00037442,Neal Dunn (R),2016,Candidate Committees,0,22950,22950
G000582,N00037615,Jenniffer Gonzalez (3),2016,Lawyers/Law Firms,135678,7748,143426
G000582,N00037615,Jenniffer Gonzalez (3),2016,Health Professionals,46500,0,46500
G000582,N00037615,Jenniffer Gonzalez (3),2016,Misc Business,41758,0,41758
G000582,N00037615,Jenniffer Gonzalez (3),2016,Business Services,31780,1000,32780
G000582,N00037615,Jenniffer Gonzalez (3),2016,Lobbyists,29150,1000,30150
G000582,N00037615,Jenniffer Gonzalez (3),2016,Food & Beverage,28111,1000,29111
G000582,N00037615,Jenniffer Gonzalez (3),2016,Real Estate,24250,3000,27250
G000582,N00037615,Jenniffer Gonzalez (3),2016,Retired,23595,0,23595
G000582,N00037615,Jenniffer Gonzalez (3),2016,Retail Sales,17700,2500,20200
G000582,N00037615,Jenniffer Gonzalez (3),2016,Misc Finance,17700,0,17700
C001108,N00038260,James Comer (R),2016,Crop Production & Basic Processing,63390,10500,73890
C001108,N00038260,James Comer (R),2016,Leadership PACs,0,66000,66000
C001108,N00038260,James Comer (R),2016,Retired,64150,0,64150
C001108,N00038260,James Comer (R),2016,Real Estate,42800,15000,57800
C001108,N00038260,James Comer (R),2016,Health Professionals,28250,8500,36750
C001108,N00038260,James Comer (R),2016,General Contractors,25800,7000,32800
C001108,N00038260,James Comer (R),2016,Lobbyists,31300,0,31300
C001108,N00038260,James Comer (R),2016,Lawyers/Law Firms,23665,2700,26365
C001108,N00038260,James Comer (R),2016,Commercial Banks,15700,6000,21700
C001108,N00038260,James Comer (R),2016,Agricultural Services/Products,13600,6000,19600
A000375,N00038285,Jodey Arrington (R),2016,Retired,135425,0,135425
A000375,N00038285,Jodey Arrington (R),2016,Crop Production & Basic Processing,80130,38700,118830
A000375,N00038285,Jodey Arrington (R),2016,Commercial Banks,63797,20000,83797
A000375,N00038285,Jodey Arrington (R),2016,Leadership PACs,0,82500,82500
A000375,N00038285,Jodey Arrington (R),2016,Oil & Gas,41550,36000,77550
A000375,N00038285,Jodey Arrington (R),2016,Real Estate,58950,13000,71950
A000375,N00038285,Jodey Arrington (R),2016,Health Professionals,49372,15500,64872
A000375,N00038285,Jodey Arrington (R),2016,Lawyers/Law Firms,57624,5000,62624
A000375,N00038285,Jodey Arrington (R),2016,Livestock,35315,23500,58815
A000375,N00038285,Jodey Arrington (R),2016,Automotive,19400,14000,33400
B001303,N00038414,Lisa Blunt Rochester (D),2016,Women's Issues,74508,5500,80008
B001303,N00038414,Lisa Blunt Rochester (D),2016,Leadership PACs,0,68150,68150
B001303,N00038414,Lisa Blunt Rochester (D),2016,Retired,62611,0,62611
B001303,N00038414,Lisa Blunt Rochester (D),2016,Lawyers/Law Firms,42590,10500,53090
B001303,N00038414,Lisa Blunt Rochester (D),2016,Human Rights,22508,13214,35722
B001303,N00038414,Lisa Blunt Rochester (D),2016,Public Sector Unions,0,32000,32000
B001303,N00038414,Lisa Blunt Rochester (D),2016,Industrial Unions,0,29500,29500
B001303,N00038414,Lisa Blunt Rochester (D),2016,Health Professionals,11075,15500,26575
B001303,N00038414,Lisa Blunt Rochester (D),2016,Commercial Banks,7550,18500,26050
B001303,N00038414,Lisa Blunt Rochester (D),2016,Candidate Committees,0,24814,24814
E000296,N00038450,Dwight Evans (D),2016,Lawyers/Law Firms,143898,22324,166222
E000296,N00038450,Dwight Evans (D),2016,Real Estate,86341,13000,99341
E000296,N00038450,Dwight Evans (D),2016,Building Trade Unions,250,50500,50750
E000296,N00038450,Dwight Evans (D),2016,Public Sector Unions,950,35000,35950
E000296,N00038450,Dwight Evans (D),2016,Insurance,22500,13000,35500
E000296,N00038450,Dwight Evans (D),2016,Democratic/Liberal,34322,1000,35322
E000296,N00038450,Dwight Evans (D),2016,Lobbyists,31100,1000,32100
E000296,N00038450,Dwight Evans (D),2016,Civil Servants/Public Officials,28087,0,28087
E000296,N00038450,Dwight Evans (D),2016,Food Processing & Sales,25825,2250,28075
E000296,N00038450,Dwight Evans (D),2016,Industrial Unions,0,28000,28000
D000626,N00038767,Warren Davidson (R),2016,Republican/Conservative,79442,11242,90684
D000626,N00038767,Warren Davidson (R),2016,Leadership PACs,26900,35000,61900
D000626,N00038767,Warren Davidson (R),2016,Retired,40061,0,40061
D000626,N00038767,Warren Davidson (R),2016,Misc Manufacturing & Distributing,27220,5500,32720
D000626,N00038767,Warren Davidson (R),2016,Securities & Investment,30403,0,30403
D000626,N00038767,Warren Davidson (R),2016,Misc Finance,27055,0,27055
D000626,N00038767,Warren Davidson (R),2016,Non-Profit Institutions,22600,0,22600
D000626,N00038767,Warren Davidson (R),2016,Accountants,19363,0,19363
D000626,N00038767,Warren Davidson (R),2016,Real Estate,7845,5000,12845
D000626,N00038767,Warren Davidson (R),2016,Misc Business,11642,1000,12642
F000466,N00038779,Brian Fitzpatrick (R),2016,Leadership PACs,0,202950,202950
F000466,N00038779,Brian Fitzpatrick (R),2016,Retired,116041,0,116041
F000466,N00038779,Brian Fitzpatrick (R),2016,Lawyers/Law Firms,85656,8000,93656
F000466,N00038779,Brian Fitzpatrick (R),2016,Health Professionals,21975,50000,71975
F000466,N00038779,Brian Fitzpatrick (R),2016,Real Estate,48350,18000,66350
F000466,N00038779,Brian Fitzpatrick (R),2016,Securities & Investment,62575,2700,65275
F000466,N00038779,Brian Fitzpatrick (R),2016,Candidate Committees,0,55000,55000
F000466,N00038779,Brian Fitzpatrick (R),2016,Insurance,20350,30700,51050
F000466,N00038779,Brian Fitzpatrick (R),2016,Accountants,5100,37000,42100
F000466,N00038779,Brian Fitzpatrick (R),2016,Republican/Conservative,18647,22500,41147
G000581,N00038809,Vicente Gonzalez (D),2016,Lawyers/Law Firms,58450,5000,63450
G000581,N00038809,Vicente Gonzalez (D),2016,Leadership PACs,0,41600,41600
G000581,N00038809,Vicente Gonzalez (D),2016,Human Rights,15650,17662,33312
G000581,N00038809,Vicente Gonzalez (D),2016,Building Trade Unions,0,25000,25000
G000581,N00038809,Vicente Gonzalez (D),2016,Public Sector Unions,0,21000,21000
G000581,N00038809,Vicente Gonzalez (D),2016,Crop Production & Basic Processing,3250,17000,20250
G000581,N00038809,Vicente Gonzalez (D),2016,Industrial Unions,0,20000,20000
G000581,N00038809,Vicente Gonzalez (D),2016,Hospitals/Nursing Homes,3500,16000,19500
G000581,N00038809,Vicente Gonzalez (D),2016,Candidate Committees,0,19012,19012
G000581,N00038809,Vicente Gonzalez (D),2016,Real Estate,4250,8500,12750
G000580,N00038847,Tom Garrett (R),2016,Leadership PACs,0,81500,81500
G000580,N00038847,Tom Garrett (R),2016,Retired,52575,0,52575
G000580,N00038847,Tom Garrett (R),2016,Candidate Committees,0,25000,25000
G000580,N00038847,Tom Garrett (R),2016,Business Services,24040,0,24040
G000580,N00038847,Tom Garrett (R),2016,Crop Production & Basic Processing,13950,5000,18950
G000580,N00038847,Tom Garrett (R),2016,Republican/Conservative,11000,7600,18600
G000580,N00038847,Tom Garrett (R),2016,"Beer, Wine & Liquor",6000,10000,16000
G000580,N00038847,Tom Garrett (R),2016,Automotive,3700,10000,13700
G000580,N00038847,Tom Garrett (R),2016,Electric Utilities,1500,11000,12500
G000580,N00038847,Tom Garrett (R),2016,Oil & Gas,6400,6000,12400
F000465,N00039090,Drew Ferguson (R),2016,Health Professionals,210880,83500,294380
F000465,N00039090,Drew Ferguson (R),2016,Leadership PACs,0,103866,103866
F000465,N00039090,Drew Ferguson (R),2016,Retired,84205,0,84205
F000465,N00039090,Drew Ferguson (R),2016,Insurance,21200,20500,41700
F000465,N00039090,Drew Ferguson (R),2016,Real Estate,27450,5000,32450
F000465,N00039090,Drew Ferguson (R),2016,Commercial Banks,10650,21000,31650
F000465,N00039090,Drew Ferguson (R),2016,General Contractors,22150,7500,29650
F000465,N00039090,Drew Ferguson (R),2016,Candidate Committees,1000,27500,28500
F000465,N00039090,Drew Ferguson (R),2016,Lawyers/Law Firms,23434,4000,27434
F000465,N00039090,Drew Ferguson (R),2016,Building Materials & Equipment,14750,10500,25250
B001302,N00039293,Andy Biggs (R),2016,Republican/Conservative,74522,17150,91672
B001302,N00039293,Andy Biggs (R),2016,Retired,57510,0,57510
B001302,N00039293,Andy Biggs (R),2016,Leadership PACs,6650,42000,48650
B001302,N00039293,Andy Biggs (R),2016,Real Estate,33550,6000,39550
B001302,N00039293,Andy Biggs (R),2016,Candidate Committees,0,32000,32000
B001302,N00039293,Andy Biggs (R),2016,Health Professionals,14200,10500,24700
B001302,N00039293,Andy Biggs (R),2016,Finance/Credit Companies,17200,5000,22200
B001302,N00039293,Andy Biggs (R),2016,Automotive,13800,7500,21300
B001302,N00039293,Andy Biggs (R),2016,Home Builders,10000,10500,20500
B001302,N00039293,Andy Biggs (R),2016,Electric Utilities,4600,15000,19600
G000579,N00039330,Mike Gallagher (R),2016,Retired,293592,0,293592
G000579,N00039330,Mike Gallagher (R),2016,Securities & Investment,267397,0,267397
G000579,N00039330,Mike Gallagher (R),2016,Leadership PACs,0,184500,184500
G000579,N00039330,Mike Gallagher (R),2016,Real Estate,119290,11000,130290
G000579,N00039330,Mike Gallagher (R),2016,Health Professionals,107530,18500,126030
G000579,N00039330,Mike Gallagher (R),2016,Lawyers/Law Firms,91884,2000,93884
G000579,N00039330,Mike Gallagher (R),2016,Republican/Conservative,44591,30500,75091
G000579,N00039330,Mike Gallagher (R),2016,Misc Finance,69000,2000,71000
G000579,N00039330,Mike Gallagher (R),2016,General Contractors,45850,12900,58750
G000579,N00039330,Mike Gallagher (R),2016,Candidate Committees,0,58500,58500
G000578,N00039503,Matt Gaetz (R),2016,Real Estate,63500,12318,75818
G000578,N00039503,Matt Gaetz (R),2016,Retired,54263,0,54263
G000578,N00039503,Matt Gaetz (R),2016,Leadership PACs,0,51000,51000
G000578,N00039503,Matt Gaetz (R),2016,Health Professionals,33750,16000,49750
G000578,N00039503,Matt Gaetz (R),2016,"Beer, Wine & Liquor",37000,7500,44500
G000578,N00039503,Matt Gaetz (R),2016,Crop Production & Basic Processing,20400,8000,28400
G000578,N00039503,Matt Gaetz (R),2016,Food & Beverage,24106,1000,25106
G000578,N00039503,Matt Gaetz (R),2016,Lawyers/Law Firms,23050,2000,25050
G000578,N00039503,Matt Gaetz (R),2016,Marijuana,21600,0,21600
G000578,N00039503,Matt Gaetz (R),2016,Lobbyists,17250,1000,18250
B001301,N00039533,John Bergman (R),2016,Leadership PACs,0,143000,143000
B001301,N00039533,John Bergman (R),2016,Retired,87018,0,87018
B001301,N00039533,John Bergman (R),2016,Candidate Committees,0,37000,37000
B001301,N00039533,John Bergman (R),2016,Republican/Conservative,6675,25000,31675
B001301,N00039533,John Bergman (R),2016,Real Estate,22450,5000,27450
B001301,N00039533,John Bergman (R),2016,Retail Sales,21000,5000,26000
B001301,N00039533,John Bergman (R),2016,Insurance,6100,16000,22100
B001301,N00039533,John Bergman (R),2016,Securities & Investment,22050,0,22050
B001301,N00039533,John Bergman (R),2016,Misc Business,14870,6000,20870
B001301,N00039533,John Bergman (R),2016,Automotive,16200,4495,20695
B001305,N00039551,Ted Budd (R),2016,Leadership PACs,13200,58000,71200
B001305,N00039551,Ted Budd (R),2016,Retired,44950,0,44950
B001305,N00039551,Ted Budd (R),2016,Republican/Conservative,33723,5000,38723
B001305,N00039551,Ted Budd (R),2016,Candidate Committees,0,23500,23500
B001305,N00039551,Ted Budd (R),2016,Trucking,18600,0,18600
B001305,N00039551,Ted Budd (R),2016,Gun Rights,8900,7000,15900
B001305,N00039551,Ted Budd (R),2016,Misc Finance,11900,2500,14400
B001305,N00039551,Ted Budd (R),2016,Real Estate,7950,5000,12950
B001305,N00039551,Ted Budd (R),2016,General Contractors,7800,5000,12800
B001305,N00039551,Ted Budd (R),2016,Retail Sales,1500,10000,11500
