bioguide_id,crp_id,cand_name,cycle,sector_name,indivs,pacs,totals
C000380,N00000133,Donna Christian-Christensen (D),2012,Agribusiness,500,0,500
C000380,N00000133,Donna Christian-Christensen (D),2012,Communic/Electronics,5650,40500,46150
C000380,N00000133,Donna Christian-Christensen (D),2012,Construction,4500,0,4500
C000380,N00000133,Donna Christian-Christensen (D),2012,Defense,0,2000,2000
C000380,N00000133,Donna Christian-Christensen (D),2012,Energy/Nat Resource,350,8500,8850
C000380,N00000133,Donna Christian-Christensen (D),2012,Finance/Insur/RealEst,30200,3000,33200
C000380,N00000133,Donna Christian-Christensen (D),2012,Health,7250,71615,78865
C000380,N00000133,Donna Christian-Christensen (D),2012,Lawyers & Lobbyists,15050,8500,23550
C000380,N00000133,Donna Christian-Christensen (D),2012,Misc Business,11300,8500,19800
C000380,N00000133,Donna Christian-Christensen (D),2012,Labor,0,20500,20500
C000380,N00000133,Donna Christian-Christensen (D),2012,Ideology/Single-Issue,900,28500,29400
C000380,N00000133,Donna Christian-Christensen (D),2012,Other,11100,0,11100
C001037,N00000267,Michael E Capuano (D),2012,Agribusiness,1750,11000,12750
C001037,N00000267,Michael E Capuano (D),2012,Communic/Electronics,10800,8000,18800
C001037,N00000267,Michael E Capuano (D),2012,Construction,24450,24500,48950
C001037,N00000267,Michael E Capuano (D),2012,Defense,500,11000,11500
C001037,N00000267,Michael E Capuano (D),2012,Energy/Nat Resource,29250,8000,37250
C001037,N00000267,Michael E Capuano (D),2012,Finance/Insur/RealEst,63750,136500,200250
C001037,N00000267,Michael E Capuano (D),2012,Health,26250,57250,83500
C001037,N00000267,Michael E Capuano (D),2012,Lawyers & Lobbyists,70800,17250,88050
C001037,N00000267,Michael E Capuano (D),2012,Transportation,750,26000,26750
C001037,N00000267,Michael E Capuano (D),2012,Misc Business,19800,12554,32354
C001037,N00000267,Michael E Capuano (D),2012,Labor,250,156750,157000
C001037,N00000267,Michael E Capuano (D),2012,Ideology/Single-Issue,2000,7000,9000
C001037,N00000267,Michael E Capuano (D),2012,Other,36375,0,36375
C001035,N00000491,Susan Collins (R),2012,Agribusiness,86538,130400,216938
C001035,N00000491,Susan Collins (R),2012,Communic/Electronics,211350,238832,450182
C001035,N00000491,Susan Collins (R),2012,Construction,139496,133000,272496
C001035,N00000491,Susan Collins (R),2012,Defense,103701,219300,323001
C001035,N00000491,Susan Collins (R),2012,Energy/Nat Resource,96750,120750,217500
C001035,N00000491,Susan Collins (R),2012,Finance/Insur/RealEst,997629,446534,1444163
C001035,N00000491,Susan Collins (R),2012,Health,249269,574723,823992
C001035,N00000491,Susan Collins (R),2012,Lawyers & Lobbyists,687573,151447,839020
C001035,N00000491,Susan Collins (R),2012,Transportation,55294,175500,230794
C001035,N00000491,Susan Collins (R),2012,Misc Business,518420,482000,1000420
C001035,N00000491,Susan Collins (R),2012,Labor,0,134500,134500
C001035,N00000491,Susan Collins (R),2012,Ideology/Single-Issue,248566,538443,787009
C001035,N00000491,Susan Collins (R),2012,Other,630847,1000,631847
D000216,N00000615,Rosa L DeLauro (D),2012,Agribusiness,750,42400,43150
D000216,N00000615,Rosa L DeLauro (D),2012,Communic/Electronics,12000,10500,22500
D000216,N00000615,Rosa L DeLauro (D),2012,Construction,8900,5000,13900
D000216,N00000615,Rosa L DeLauro (D),2012,Defense,500,35000,35500
D000216,N00000615,Rosa L DeLauro (D),2012,Energy/Nat Resource,1500,4000,5500
D000216,N00000615,Rosa L DeLauro (D),2012,Finance/Insur/RealEst,41100,28000,69100
D000216,N00000615,Rosa L DeLauro (D),2012,Health,26196,147500,173696
D000216,N00000615,Rosa L DeLauro (D),2012,Lawyers & Lobbyists,119695,31175,150870
D000216,N00000615,Rosa L DeLauro (D),2012,Transportation,8450,-1000,7450
D000216,N00000615,Rosa L DeLauro (D),2012,Misc Business,35717,28000,63717
D000216,N00000615,Rosa L DeLauro (D),2012,Labor,0,231500,231500
D000216,N00000615,Rosa L DeLauro (D),2012,Ideology/Single-Issue,69230,51493,120723
D000216,N00000615,Rosa L DeLauro (D),2012,Other,52745,3500,56245
F000372,N00000684,Rodney Frelinghuysen (R),2012,Agribusiness,3500,7000,10500
F000372,N00000684,Rodney Frelinghuysen (R),2012,Communic/Electronics,2750,22750,25500
F000372,N00000684,Rodney Frelinghuysen (R),2012,Construction,20800,68650,89450
F000372,N00000684,Rodney Frelinghuysen (R),2012,Defense,20725,126500,147225
F000372,N00000684,Rodney Frelinghuysen (R),2012,Energy/Nat Resource,6600,100500,107100
F000372,N00000684,Rodney Frelinghuysen (R),2012,Finance/Insur/RealEst,82650,38000,120650
F000372,N00000684,Rodney Frelinghuysen (R),2012,Health,30550,78000,108550
F000372,N00000684,Rodney Frelinghuysen (R),2012,Lawyers & Lobbyists,63125,26749,89874
F000372,N00000684,Rodney Frelinghuysen (R),2012,Transportation,3200,46000,49200
F000372,N00000684,Rodney Frelinghuysen (R),2012,Misc Business,41325,45500,86825
F000372,N00000684,Rodney Frelinghuysen (R),2012,Labor,0,1000,1000
F000372,N00000684,Rodney Frelinghuysen (R),2012,Ideology/Single-Issue,10300,30000,40300
F000372,N00000684,Rodney Frelinghuysen (R),2012,Other,89375,500,89875
G000548,N00000743,Scott Garrett (R),2012,Agribusiness,7600,14600,22200
G000548,N00000743,Scott Garrett (R),2012,Communic/Electronics,48850,15500,64350
G000548,N00000743,Scott Garrett (R),2012,Construction,13800,19000,32800
G000548,N00000743,Scott Garrett (R),2012,Defense,0,17500,17500
G000548,N00000743,Scott Garrett (R),2012,Energy/Nat Resource,28800,46000,74800
G000548,N00000743,Scott Garrett (R),2012,Finance/Insur/RealEst,570567,653746,1224313
G000548,N00000743,Scott Garrett (R),2012,Health,33990,39000,72990
G000548,N00000743,Scott Garrett (R),2012,Lawyers & Lobbyists,104940,47500,152440
G000548,N00000743,Scott Garrett (R),2012,Transportation,10500,20999,31499
G000548,N00000743,Scott Garrett (R),2012,Misc Business,49750,37500,87250
G000548,N00000743,Scott Garrett (R),2012,Ideology/Single-Issue,27840,23372,51212
G000548,N00000743,Scott Garrett (R),2012,Other,80150,0,80150
A000210,N00000826,Robert E Andrews (D),2012,Agribusiness,11600,5500,17100
A000210,N00000826,Robert E Andrews (D),2012,Communic/Electronics,16275,16500,32775
A000210,N00000826,Robert E Andrews (D),2012,Construction,24700,28250,52950
A000210,N00000826,Robert E Andrews (D),2012,Defense,10600,105000,115600
A000210,N00000826,Robert E Andrews (D),2012,Energy/Nat Resource,13100,23000,36100
A000210,N00000826,Robert E Andrews (D),2012,Finance/Insur/RealEst,73225,81941,155166
A000210,N00000826,Robert E Andrews (D),2012,Health,32300,61000,93300
A000210,N00000826,Robert E Andrews (D),2012,Lawyers & Lobbyists,133248,58750,191998
A000210,N00000826,Robert E Andrews (D),2012,Transportation,3450,21000,24450
A000210,N00000826,Robert E Andrews (D),2012,Misc Business,70450,39825,110275
A000210,N00000826,Robert E Andrews (D),2012,Labor,0,211250,211250
A000210,N00000826,Robert E Andrews (D),2012,Ideology/Single-Issue,35575,34500,70075
A000210,N00000826,Robert E Andrews (D),2012,Other,106650,35101,141751
H001032,N00000860,Rush Holt (D),2012,Agribusiness,16800,1000,17800
H001032,N00000860,Rush Holt (D),2012,Communic/Electronics,47226,17750,64976
H001032,N00000860,Rush Holt (D),2012,Construction,5300,11000,16300
H001032,N00000860,Rush Holt (D),2012,Defense,6000,2000,8000
H001032,N00000860,Rush Holt (D),2012,Energy/Nat Resource,7750,11000,18750
H001032,N00000860,Rush Holt (D),2012,Finance/Insur/RealEst,75015,201500,276515
H001032,N00000860,Rush Holt (D),2012,Health,59268,90500,149768
H001032,N00000860,Rush Holt (D),2012,Lawyers & Lobbyists,64306,24750,89056
H001032,N00000860,Rush Holt (D),2012,Transportation,10500,11000,21500
H001032,N00000860,Rush Holt (D),2012,Misc Business,76079,42500,118579
H001032,N00000860,Rush Holt (D),2012,Labor,500,177000,177500
H001032,N00000860,Rush Holt (D),2012,Ideology/Single-Issue,109656,27317,136973
H001032,N00000860,Rush Holt (D),2012,Other,445545,1500,447045
E000179,N00001003,Eliot L Engel (D),2012,Agribusiness,3250,16500,19750
E000179,N00001003,Eliot L Engel (D),2012,Communic/Electronics,26610,50000,76610
E000179,N00001003,Eliot L Engel (D),2012,Construction,41310,0,41310
E000179,N00001003,Eliot L Engel (D),2012,Defense,250,9000,9250
E000179,N00001003,Eliot L Engel (D),2012,Energy/Nat Resource,1000,6750,7750
E000179,N00001003,Eliot L Engel (D),2012,Finance/Insur/RealEst,106950,14000,120950
E000179,N00001003,Eliot L Engel (D),2012,Health,35201,135000,170201
E000179,N00001003,Eliot L Engel (D),2012,Lawyers & Lobbyists,33250,21500,54750
E000179,N00001003,Eliot L Engel (D),2012,Transportation,5000,9500,14500
E000179,N00001003,Eliot L Engel (D),2012,Misc Business,50350,12525,62875
E000179,N00001003,Eliot L Engel (D),2012,Labor,0,108500,108500
E000179,N00001003,Eliot L Engel (D),2012,Ideology/Single-Issue,59400,56500,115900
E000179,N00001003,Eliot L Engel (D),2012,Other,75325,2500,77825
C001038,N00001127,Joseph Crowley (D),2012,Agribusiness,10250,29000,39250
C001038,N00001127,Joseph Crowley (D),2012,Communic/Electronics,30000,117548,147548
C001038,N00001127,Joseph Crowley (D),2012,Construction,28200,34250,62450
C001038,N00001127,Joseph Crowley (D),2012,Defense,250,37500,37750
C001038,N00001127,Joseph Crowley (D),2012,Energy/Nat Resource,2500,62750,65250
C001038,N00001127,Joseph Crowley (D),2012,Finance/Insur/RealEst,287249,617596,904845
C001038,N00001127,Joseph Crowley (D),2012,Health,29150,226250,255400
C001038,N00001127,Joseph Crowley (D),2012,Lawyers & Lobbyists,162701,51350,214051
C001038,N00001127,Joseph Crowley (D),2012,Transportation,13850,61000,74850
C001038,N00001127,Joseph Crowley (D),2012,Misc Business,93723,167522,261245
C001038,N00001127,Joseph Crowley (D),2012,Labor,1750,132500,134250
C001038,N00001127,Joseph Crowley (D),2012,Ideology/Single-Issue,25050,39000,64050
C001038,N00001127,Joseph Crowley (D),2012,Other,48700,500,49200
C001092,N00001285,Chris Collins (R),2012,Agribusiness,8500,8000,16500
C001092,N00001285,Chris Collins (R),2012,Communic/Electronics,1500,15500,17000
C001092,N00001285,Chris Collins (R),2012,Construction,36950,12000,48950
C001092,N00001285,Chris Collins (R),2012,Defense,0,2000,2000
C001092,N00001285,Chris Collins (R),2012,Energy/Nat Resource,16250,24500,40750
C001092,N00001285,Chris Collins (R),2012,Finance/Insur/RealEst,43850,31750,75600
C001092,N00001285,Chris Collins (R),2012,Health,26300,19500,45800
C001092,N00001285,Chris Collins (R),2012,Lawyers & Lobbyists,18200,1000,19200
C001092,N00001285,Chris Collins (R),2012,Transportation,6600,21500,28100
C001092,N00001285,Chris Collins (R),2012,Misc Business,39310,35500,74810
C001092,N00001285,Chris Collins (R),2012,Labor,0,5000,5000
C001092,N00001285,Chris Collins (R),2012,Ideology/Single-Issue,4350,134220,138570
C001092,N00001285,Chris Collins (R),2012,Other,34700,500,35200
D000482,N00001373,Mike Doyle (D),2012,Agribusiness,0,12500,12500
D000482,N00001373,Mike Doyle (D),2012,Communic/Electronics,8850,88120,96970
D000482,N00001373,Mike Doyle (D),2012,Construction,33820,7500,41320
D000482,N00001373,Mike Doyle (D),2012,Defense,800,11000,11800
D000482,N00001373,Mike Doyle (D),2012,Energy/Nat Resource,2000,107250,109250
D000482,N00001373,Mike Doyle (D),2012,Finance/Insur/RealEst,38600,31000,69600
D000482,N00001373,Mike Doyle (D),2012,Health,14500,57750,72250
D000482,N00001373,Mike Doyle (D),2012,Lawyers & Lobbyists,36700,18750,55450
D000482,N00001373,Mike Doyle (D),2012,Transportation,1000,23500,24500
D000482,N00001373,Mike Doyle (D),2012,Misc Business,18050,41500,59550
D000482,N00001373,Mike Doyle (D),2012,Labor,0,189000,189000
D000482,N00001373,Mike Doyle (D),2012,Ideology/Single-Issue,27250,12559,39809
D000482,N00001373,Mike Doyle (D),2012,Other,16000,1000,17000
B001227,N00001619,Robert A Brady (D),2012,Agribusiness,17500,2000,19500
B001227,N00001619,Robert A Brady (D),2012,Communic/Electronics,5000,31500,36500
B001227,N00001619,Robert A Brady (D),2012,Construction,36650,5000,41650
B001227,N00001619,Robert A Brady (D),2012,Defense,0,16000,16000
B001227,N00001619,Robert A Brady (D),2012,Energy/Nat Resource,1000,15500,16500
B001227,N00001619,Robert A Brady (D),2012,Finance/Insur/RealEst,32250,7500,39750
B001227,N00001619,Robert A Brady (D),2012,Health,9050,14800,23850
B001227,N00001619,Robert A Brady (D),2012,Lawyers & Lobbyists,57950,23250,81200
B001227,N00001619,Robert A Brady (D),2012,Transportation,10500,19500,30000
B001227,N00001619,Robert A Brady (D),2012,Misc Business,43000,4500,47500
B001227,N00001619,Robert A Brady (D),2012,Labor,500,172500,173000
B001227,N00001619,Robert A Brady (D),2012,Ideology/Single-Issue,9900,4000,13900
B001227,N00001619,Robert A Brady (D),2012,Other,25600,0,25600
F000043,N00001746,Chaka Fattah (D),2012,Agribusiness,500,2000,2500
F000043,N00001746,Chaka Fattah (D),2012,Communic/Electronics,11300,29500,40800
F000043,N00001746,Chaka Fattah (D),2012,Construction,10000,2000,12000
F000043,N00001746,Chaka Fattah (D),2012,Defense,0,42500,42500
F000043,N00001746,Chaka Fattah (D),2012,Energy/Nat Resource,1500,16500,18000
F000043,N00001746,Chaka Fattah (D),2012,Finance/Insur/RealEst,33250,24750,58000
F000043,N00001746,Chaka Fattah (D),2012,Health,5900,29000,34900
F000043,N00001746,Chaka Fattah (D),2012,Lawyers & Lobbyists,55104,35000,90104
F000043,N00001746,Chaka Fattah (D),2012,Transportation,9750,12500,22250
F000043,N00001746,Chaka Fattah (D),2012,Misc Business,16750,18000,34750
F000043,N00001746,Chaka Fattah (D),2012,Labor,0,115500,115500
F000043,N00001746,Chaka Fattah (D),2012,Ideology/Single-Issue,0,4500,4500
F000043,N00001746,Chaka Fattah (D),2012,Other,18050,0,18050
G000386,N00001758,Chuck Grassley (R),2012,Agribusiness,127630,340250,467880
G000386,N00001758,Chuck Grassley (R),2012,Communic/Electronics,69650,289726,359376
G000386,N00001758,Chuck Grassley (R),2012,Construction,95798,104000,199798
G000386,N00001758,Chuck Grassley (R),2012,Defense,1000,55000,56000
G000386,N00001758,Chuck Grassley (R),2012,Energy/Nat Resource,127456,298750,426206
G000386,N00001758,Chuck Grassley (R),2012,Finance/Insur/RealEst,468652,678390,1147042
G000386,N00001758,Chuck Grassley (R),2012,Health,343597,720810,1064407
G000386,N00001758,Chuck Grassley (R),2012,Lawyers & Lobbyists,389350,124691,514041
G000386,N00001758,Chuck Grassley (R),2012,Transportation,63199,142799,205998
G000386,N00001758,Chuck Grassley (R),2012,Misc Business,203192,330000,533192
G000386,N00001758,Chuck Grassley (R),2012,Labor,2000,29500,31500
G000386,N00001758,Chuck Grassley (R),2012,Ideology/Single-Issue,110690,384750,495440
G000386,N00001758,Chuck Grassley (R),2012,Other,258507,13500,272007
D000355,N00001783,John D Dingell (D),2012,Agribusiness,0,64500,64500
D000355,N00001783,John D Dingell (D),2012,Communic/Electronics,22300,131500,153800
D000355,N00001783,John D Dingell (D),2012,Construction,3200,1000,4200
D000355,N00001783,John D Dingell (D),2012,Defense,0,17500,17500
D000355,N00001783,John D Dingell (D),2012,Energy/Nat Resource,18100,121500,139600
D000355,N00001783,John D Dingell (D),2012,Finance/Insur/RealEst,14500,58800,73300
D000355,N00001783,John D Dingell (D),2012,Health,21900,192000,213900
D000355,N00001783,John D Dingell (D),2012,Lawyers & Lobbyists,117766,69137,186903
D000355,N00001783,John D Dingell (D),2012,Transportation,37300,46500,83800
D000355,N00001783,John D Dingell (D),2012,Misc Business,21950,110750,132700
D000355,N00001783,John D Dingell (D),2012,Labor,0,198500,198500
D000355,N00001783,John D Dingell (D),2012,Ideology/Single-Issue,4750,21500,26250
D000355,N00001783,John D Dingell (D),2012,Other,41450,1500,42950
H000874,N00001821,Steny H Hoyer (D),2012,Agribusiness,15001,96500,111501
H000874,N00001821,Steny H Hoyer (D),2012,Communic/Electronics,81005,160831,241836
H000874,N00001821,Steny H Hoyer (D),2012,Construction,15125,74500,89625
H000874,N00001821,Steny H Hoyer (D),2012,Defense,15200,137500,152700
H000874,N00001821,Steny H Hoyer (D),2012,Energy/Nat Resource,23300,279000,302300
H000874,N00001821,Steny H Hoyer (D),2012,Finance/Insur/RealEst,323558,571770,895328
H000874,N00001821,Steny H Hoyer (D),2012,Health,86621,462575,549196
H000874,N00001821,Steny H Hoyer (D),2012,Lawyers & Lobbyists,252565,96350,348915
H000874,N00001821,Steny H Hoyer (D),2012,Transportation,27650,153500,181150
H000874,N00001821,Steny H Hoyer (D),2012,Misc Business,97680,278500,376180
H000874,N00001821,Steny H Hoyer (D),2012,Labor,1000,333640,334640
H000874,N00001821,Steny H Hoyer (D),2012,Ideology/Single-Issue,160725,63350,224075
H000874,N00001821,Steny H Hoyer (D),2012,Other,89655,13500,103155
C000141,N00001955,Ben Cardin (D),2012,Agribusiness,20250,32000,52250
C000141,N00001955,Ben Cardin (D),2012,Communic/Electronics,227674,122446,350120
C000141,N00001955,Ben Cardin (D),2012,Construction,83422,89500,172922
C000141,N00001955,Ben Cardin (D),2012,Defense,15550,69500,85050
C000141,N00001955,Ben Cardin (D),2012,Energy/Nat Resource,65650,119750,185400
C000141,N00001955,Ben Cardin (D),2012,Finance/Insur/RealEst,824908,463999,1288907
C000141,N00001955,Ben Cardin (D),2012,Health,324440,555411,879851
C000141,N00001955,Ben Cardin (D),2012,Lawyers & Lobbyists,663869,128266,792135
C000141,N00001955,Ben Cardin (D),2012,Transportation,35150,81000,116150
C000141,N00001955,Ben Cardin (D),2012,Misc Business,267929,222000,489929
C000141,N00001955,Ben Cardin (D),2012,Labor,1500,307500,309000
C000141,N00001955,Ben Cardin (D),2012,Ideology/Single-Issue,289362,299280,588642
C000141,N00001955,Ben Cardin (D),2012,Other,491757,12000,503757
C000984,N00001971,Elijah E Cummings (D),2012,Agribusiness,2250,2000,4250
C000984,N00001971,Elijah E Cummings (D),2012,Communic/Electronics,5500,21000,26500
C000984,N00001971,Elijah E Cummings (D),2012,Construction,7250,20625,27875
C000984,N00001971,Elijah E Cummings (D),2012,Defense,0,13500,13500
C000984,N00001971,Elijah E Cummings (D),2012,Energy/Nat Resource,10750,10500,21250
C000984,N00001971,Elijah E Cummings (D),2012,Finance/Insur/RealEst,19500,48000,67500
C000984,N00001971,Elijah E Cummings (D),2012,Health,18400,40000,58400
C000984,N00001971,Elijah E Cummings (D),2012,Lawyers & Lobbyists,20250,19000,39250
C000984,N00001971,Elijah E Cummings (D),2012,Transportation,12500,108500,121000
C000984,N00001971,Elijah E Cummings (D),2012,Misc Business,11500,35000,46500
C000984,N00001971,Elijah E Cummings (D),2012,Labor,0,219100,219100
C000984,N00001971,Elijah E Cummings (D),2012,Ideology/Single-Issue,500,6500,7000
C000984,N00001971,Elijah E Cummings (D),2012,Other,10650,1000,11650
B001135,N00002221,Richard Burr (R),2012,Agribusiness,309752,346482,656234
B001135,N00002221,Richard Burr (R),2012,Communic/Electronics,114628,165500,280128
B001135,N00002221,Richard Burr (R),2012,Construction,236295,89000,325295
B001135,N00002221,Richard Burr (R),2012,Defense,29597,129500,159097
B001135,N00002221,Richard Burr (R),2012,Energy/Nat Resource,288797,406799,695596
B001135,N00002221,Richard Burr (R),2012,Finance/Insur/RealEst,1116138,560649,1676787
B001135,N00002221,Richard Burr (R),2012,Health,588369,721760,1310129
B001135,N00002221,Richard Burr (R),2012,Lawyers & Lobbyists,661591,153500,815091
B001135,N00002221,Richard Burr (R),2012,Transportation,156451,138000,294451
B001135,N00002221,Richard Burr (R),2012,Misc Business,738509,472489,1210998
B001135,N00002221,Richard Burr (R),2012,Labor,0,14000,14000
B001135,N00002221,Richard Burr (R),2012,Ideology/Single-Issue,124075,377478,501553
B001135,N00002221,Richard Burr (R),2012,Other,745433,35500,780933
C000556,N00002247,Howard Coble (R),2012,Agribusiness,15000,37998,52998
C000556,N00002247,Howard Coble (R),2012,Communic/Electronics,2240,37500,39740
C000556,N00002247,Howard Coble (R),2012,Construction,750,13000,13750
C000556,N00002247,Howard Coble (R),2012,Defense,0,5000,5000
C000556,N00002247,Howard Coble (R),2012,Energy/Nat Resource,0,22000,22000
C000556,N00002247,Howard Coble (R),2012,Finance/Insur/RealEst,11480,38569,50049
C000556,N00002247,Howard Coble (R),2012,Health,3500,33500,37000
C000556,N00002247,Howard Coble (R),2012,Lawyers & Lobbyists,24500,24500,49000
C000556,N00002247,Howard Coble (R),2012,Transportation,3750,69500,73250
C000556,N00002247,Howard Coble (R),2012,Misc Business,23325,47800,71125
C000556,N00002247,Howard Coble (R),2012,Labor,0,19000,19000
C000556,N00002247,Howard Coble (R),2012,Ideology/Single-Issue,750,25100,25850
C000556,N00002247,Howard Coble (R),2012,Other,18300,2000,20300
C000537,N00002408,James E Clyburn (D),2012,Agribusiness,950,100500,101450
C000537,N00002408,James E Clyburn (D),2012,Communic/Electronics,40000,173500,213500
C000537,N00002408,James E Clyburn (D),2012,Construction,29462,74500,103962
C000537,N00002408,James E Clyburn (D),2012,Defense,2500,75500,78000
C000537,N00002408,James E Clyburn (D),2012,Energy/Nat Resource,12150,148000,160150
C000537,N00002408,James E Clyburn (D),2012,Finance/Insur/RealEst,48150,307389,355539
C000537,N00002408,James E Clyburn (D),2012,Health,27750,327894,355644
C000537,N00002408,James E Clyburn (D),2012,Lawyers & Lobbyists,116125,69859,185984
C000537,N00002408,James E Clyburn (D),2012,Transportation,8750,108000,116750
C000537,N00002408,James E Clyburn (D),2012,Misc Business,46794,187963,234757
C000537,N00002408,James E Clyburn (D),2012,Labor,0,271500,271500
C000537,N00002408,James E Clyburn (D),2012,Ideology/Single-Issue,10400,17000,27400
C000537,N00002408,James E Clyburn (D),2012,Other,50957,6000,56957
B000490,N00002674,Sanford D Bishop Jr (D),2012,Agribusiness,13250,178680,191930
B000490,N00002674,Sanford D Bishop Jr (D),2012,Communic/Electronics,12750,35000,47750
B000490,N00002674,Sanford D Bishop Jr (D),2012,Construction,4750,4000,8750
B000490,N00002674,Sanford D Bishop Jr (D),2012,Defense,1000,67500,68500
B000490,N00002674,Sanford D Bishop Jr (D),2012,Energy/Nat Resource,3750,30750,34500
B000490,N00002674,Sanford D Bishop Jr (D),2012,Finance/Insur/RealEst,44500,73750,118250
B000490,N00002674,Sanford D Bishop Jr (D),2012,Health,33780,50400,84180
B000490,N00002674,Sanford D Bishop Jr (D),2012,Lawyers & Lobbyists,89643,30400,120043
B000490,N00002674,Sanford D Bishop Jr (D),2012,Transportation,2250,36500,38750
B000490,N00002674,Sanford D Bishop Jr (D),2012,Misc Business,32800,94000,126800
B000490,N00002674,Sanford D Bishop Jr (D),2012,Labor,0,141500,141500
B000490,N00002674,Sanford D Bishop Jr (D),2012,Ideology/Single-Issue,3750,68400,72150
B000490,N00002674,Sanford D Bishop Jr (D),2012,Other,60336,500,60836
C000286,N00002685,Saxby Chambliss (R),2012,Agribusiness,824015,1026616,1850631
C000286,N00002685,Saxby Chambliss (R),2012,Communic/Electronics,137750,240184,377934
C000286,N00002685,Saxby Chambliss (R),2012,Construction,362751,149000,511751
C000286,N00002685,Saxby Chambliss (R),2012,Defense,61900,240500,302400
C000286,N00002685,Saxby Chambliss (R),2012,Energy/Nat Resource,306358,380000,686358
C000286,N00002685,Saxby Chambliss (R),2012,Finance/Insur/RealEst,1613381,636697,2250078
C000286,N00002685,Saxby Chambliss (R),2012,Health,422434,475050,897484
C000286,N00002685,Saxby Chambliss (R),2012,Lawyers & Lobbyists,838573,184233,1022806
C000286,N00002685,Saxby Chambliss (R),2012,Transportation,156850,253500,410350
C000286,N00002685,Saxby Chambliss (R),2012,Misc Business,837755,602062,1439817
C000286,N00002685,Saxby Chambliss (R),2012,Labor,3000,21500,24500
C000286,N00002685,Saxby Chambliss (R),2012,Ideology/Single-Issue,411260,753687,1164947
C000286,N00002685,Saxby Chambliss (R),2012,Other,931302,6500,937802
B000911,N00002713,Corrine Brown (D),2012,Agribusiness,5500,5500,11000
B000911,N00002713,Corrine Brown (D),2012,Communic/Electronics,4200,19000,23200
B000911,N00002713,Corrine Brown (D),2012,Construction,23000,9500,32500
B000911,N00002713,Corrine Brown (D),2012,Energy/Nat Resource,2433,4500,6933
B000911,N00002713,Corrine Brown (D),2012,Finance/Insur/RealEst,24150,12010,36160
B000911,N00002713,Corrine Brown (D),2012,Health,8000,14500,22500
B000911,N00002713,Corrine Brown (D),2012,Lawyers & Lobbyists,55300,8000,63300
B000911,N00002713,Corrine Brown (D),2012,Transportation,17450,99000,116450
B000911,N00002713,Corrine Brown (D),2012,Misc Business,12050,13500,25550
B000911,N00002713,Corrine Brown (D),2012,Labor,0,113500,113500
B000911,N00002713,Corrine Brown (D),2012,Ideology/Single-Issue,500,29500,30000
B000911,N00002713,Corrine Brown (D),2012,Other,21650,2000,23650
H000324,N00002884,Alcee L Hastings (D),2012,Agribusiness,18300,26000,44300
H000324,N00002884,Alcee L Hastings (D),2012,Communic/Electronics,2000,27500,29500
H000324,N00002884,Alcee L Hastings (D),2012,Construction,8250,0,8250
H000324,N00002884,Alcee L Hastings (D),2012,Defense,2000,0,2000
H000324,N00002884,Alcee L Hastings (D),2012,Energy/Nat Resource,0,6250,6250
H000324,N00002884,Alcee L Hastings (D),2012,Finance/Insur/RealEst,34158,33000,67158
H000324,N00002884,Alcee L Hastings (D),2012,Health,9800,14800,24600
H000324,N00002884,Alcee L Hastings (D),2012,Lawyers & Lobbyists,44026,13500,57526
H000324,N00002884,Alcee L Hastings (D),2012,Transportation,12000,14500,26500
H000324,N00002884,Alcee L Hastings (D),2012,Misc Business,47375,12032,59407
H000324,N00002884,Alcee L Hastings (D),2012,Labor,250,109250,109500
H000324,N00002884,Alcee L Hastings (D),2012,Ideology/Single-Issue,18250,31500,49750
H000324,N00002884,Alcee L Hastings (D),2012,Other,62050,31250,93300
F000462,N00002893,Lois J Frankel (D),2012,Agribusiness,34330,2500,36830
F000462,N00002893,Lois J Frankel (D),2012,Communic/Electronics,46425,3500,49925
F000462,N00002893,Lois J Frankel (D),2012,Construction,52700,0,52700
F000462,N00002893,Lois J Frankel (D),2012,Defense,11500,1000,12500
F000462,N00002893,Lois J Frankel (D),2012,Energy/Nat Resource,11500,0,11500
F000462,N00002893,Lois J Frankel (D),2012,Finance/Insur/RealEst,254534,5000,259534
F000462,N00002893,Lois J Frankel (D),2012,Health,97654,11500,109154
F000462,N00002893,Lois J Frankel (D),2012,Lawyers & Lobbyists,408654,14000,422654
F000462,N00002893,Lois J Frankel (D),2012,Transportation,18500,10000,28500
F000462,N00002893,Lois J Frankel (D),2012,Misc Business,197137,34200,231337
F000462,N00002893,Lois J Frankel (D),2012,Labor,1000,164500,165500
F000462,N00002893,Lois J Frankel (D),2012,Ideology/Single-Issue,223889,172183,396072
F000462,N00002893,Lois J Frankel (D),2012,Other,373662,500,374162
A000055,N00003028,Robert B Aderholt (R),2012,Agribusiness,7997,56000,63997
A000055,N00003028,Robert B Aderholt (R),2012,Communic/Electronics,20800,51000,71800
A000055,N00003028,Robert B Aderholt (R),2012,Construction,42500,21500,64000
A000055,N00003028,Robert B Aderholt (R),2012,Defense,27500,130000,157500
A000055,N00003028,Robert B Aderholt (R),2012,Energy/Nat Resource,9196,58500,67696
A000055,N00003028,Robert B Aderholt (R),2012,Finance/Insur/RealEst,56479,60500,116979
A000055,N00003028,Robert B Aderholt (R),2012,Health,33635,45500,79135
A000055,N00003028,Robert B Aderholt (R),2012,Lawyers & Lobbyists,51746,36000,87746
A000055,N00003028,Robert B Aderholt (R),2012,Transportation,64844,35000,99844
A000055,N00003028,Robert B Aderholt (R),2012,Misc Business,48491,68250,116741
A000055,N00003028,Robert B Aderholt (R),2012,Labor,0,6000,6000
A000055,N00003028,Robert B Aderholt (R),2012,Ideology/Single-Issue,1000,34250,35250
A000055,N00003028,Robert B Aderholt (R),2012,Other,19393,1000,20393
B001243,N00003105,Marsha Blackburn (R),2012,Agribusiness,7000,52000,59000
B001243,N00003105,Marsha Blackburn (R),2012,Communic/Electronics,37850,162100,199950
B001243,N00003105,Marsha Blackburn (R),2012,Construction,11800,21000,32800
B001243,N00003105,Marsha Blackburn (R),2012,Defense,1000,27500,28500
B001243,N00003105,Marsha Blackburn (R),2012,Energy/Nat Resource,15000,114000,129000
B001243,N00003105,Marsha Blackburn (R),2012,Finance/Insur/RealEst,76200,109413,185613
B001243,N00003105,Marsha Blackburn (R),2012,Health,85818,377433,463251
B001243,N00003105,Marsha Blackburn (R),2012,Lawyers & Lobbyists,38898,14750,53648
B001243,N00003105,Marsha Blackburn (R),2012,Transportation,28000,54000,82000
B001243,N00003105,Marsha Blackburn (R),2012,Misc Business,72300,139500,211800
B001243,N00003105,Marsha Blackburn (R),2012,Labor,0,11500,11500
B001243,N00003105,Marsha Blackburn (R),2012,Ideology/Single-Issue,6250,30052,36302
B001243,N00003105,Marsha Blackburn (R),2012,Other,52030,2000,54030
C000754,N00003132,Jim Cooper (D),2012,Agribusiness,3750,16250,20000
C000754,N00003132,Jim Cooper (D),2012,Communic/Electronics,28800,24750,53550
C000754,N00003132,Jim Cooper (D),2012,Construction,9250,19000,28250
C000754,N00003132,Jim Cooper (D),2012,Defense,0,23000,23000
C000754,N00003132,Jim Cooper (D),2012,Energy/Nat Resource,8525,3000,11525
C000754,N00003132,Jim Cooper (D),2012,Finance/Insur/RealEst,153681,74344,228025
C000754,N00003132,Jim Cooper (D),2012,Health,52032,23500,75532
C000754,N00003132,Jim Cooper (D),2012,Lawyers & Lobbyists,123400,11250,134650
C000754,N00003132,Jim Cooper (D),2012,Transportation,8550,26500,35050
C000754,N00003132,Jim Cooper (D),2012,Misc Business,76997,49000,125997
C000754,N00003132,Jim Cooper (D),2012,Labor,0,42500,42500
C000754,N00003132,Jim Cooper (D),2012,Ideology/Single-Issue,8950,29000,37950
C000754,N00003132,Jim Cooper (D),2012,Other,115550,6000,121550
D000533,N00003209,John J Duncan Jr (R),2012,Agribusiness,500,9000,9500
D000533,N00003209,John J Duncan Jr (R),2012,Communic/Electronics,250,5000,5250
D000533,N00003209,John J Duncan Jr (R),2012,Construction,19250,116344,135594
D000533,N00003209,John J Duncan Jr (R),2012,Defense,0,10000,10000
D000533,N00003209,John J Duncan Jr (R),2012,Energy/Nat Resource,1500,29000,30500
D000533,N00003209,John J Duncan Jr (R),2012,Finance/Insur/RealEst,4250,26000,30250
D000533,N00003209,John J Duncan Jr (R),2012,Health,1750,3500,5250
D000533,N00003209,John J Duncan Jr (R),2012,Lawyers & Lobbyists,36500,30500,67000
D000533,N00003209,John J Duncan Jr (R),2012,Transportation,12000,164197,176197
D000533,N00003209,John J Duncan Jr (R),2012,Misc Business,7500,41437,48937
D000533,N00003209,John J Duncan Jr (R),2012,Labor,0,23000,23000
D000533,N00003209,John J Duncan Jr (R),2012,Ideology/Single-Issue,0,7600,7600
D000533,N00003209,John J Duncan Jr (R),2012,Other,4050,0,4050
C001068,N00003225,Steve Cohen (D),2012,Agribusiness,2500,30500,33000
C001068,N00003225,Steve Cohen (D),2012,Communic/Electronics,6350,53000,59350
C001068,N00003225,Steve Cohen (D),2012,Construction,5750,9000,14750
C001068,N00003225,Steve Cohen (D),2012,Energy/Nat Resource,250,3500,3750
C001068,N00003225,Steve Cohen (D),2012,Finance/Insur/RealEst,70150,17500,87650
C001068,N00003225,Steve Cohen (D),2012,Health,23750,37500,61250
C001068,N00003225,Steve Cohen (D),2012,Lawyers & Lobbyists,50000,19500,69500
C001068,N00003225,Steve Cohen (D),2012,Transportation,7000,82250,89250
C001068,N00003225,Steve Cohen (D),2012,Misc Business,25550,58521,84071
C001068,N00003225,Steve Cohen (D),2012,Labor,0,141000,141000
C001068,N00003225,Steve Cohen (D),2012,Ideology/Single-Issue,9150,23600,32750
C001068,N00003225,Steve Cohen (D),2012,Other,39593,0,39593
C000567,N00003328,Thad Cochran (R),2012,Agribusiness,188394,256500,444894
C000567,N00003328,Thad Cochran (R),2012,Communic/Electronics,70300,50000,120300
C000567,N00003328,Thad Cochran (R),2012,Construction,96150,39000,135150
C000567,N00003328,Thad Cochran (R),2012,Defense,16750,167700,184450
C000567,N00003328,Thad Cochran (R),2012,Energy/Nat Resource,44906,115500,160406
C000567,N00003328,Thad Cochran (R),2012,Finance/Insur/RealEst,156300,100660,256960
C000567,N00003328,Thad Cochran (R),2012,Health,45300,140200,185500
C000567,N00003328,Thad Cochran (R),2012,Lawyers & Lobbyists,238714,88300,327014
C000567,N00003328,Thad Cochran (R),2012,Transportation,44647,99000,143647
C000567,N00003328,Thad Cochran (R),2012,Misc Business,102601,130480,233081
C000567,N00003328,Thad Cochran (R),2012,Labor,0,20500,20500
C000567,N00003328,Thad Cochran (R),2012,Ideology/Single-Issue,4300,101950,106250
C000567,N00003328,Thad Cochran (R),2012,Other,91850,4000,95850
B000944,N00003535,Sherrod Brown (D),2012,Agribusiness,93325,107757,201082
B000944,N00003535,Sherrod Brown (D),2012,Communic/Electronics,504029,119250,623279
B000944,N00003535,Sherrod Brown (D),2012,Construction,229472,66300,295772
B000944,N00003535,Sherrod Brown (D),2012,Defense,32850,75500,108350
B000944,N00003535,Sherrod Brown (D),2012,Energy/Nat Resource,136910,142500,279410
B000944,N00003535,Sherrod Brown (D),2012,Finance/Insur/RealEst,1241088,425518,1666606
B000944,N00003535,Sherrod Brown (D),2012,Health,968085,486700,1454785
B000944,N00003535,Sherrod Brown (D),2012,Lawyers & Lobbyists,2320419,219004,2539423
B000944,N00003535,Sherrod Brown (D),2012,Transportation,92650,69000,161650
B000944,N00003535,Sherrod Brown (D),2012,Misc Business,748822,288416,1037238
B000944,N00003535,Sherrod Brown (D),2012,Labor,31656,466500,498156
B000944,N00003535,Sherrod Brown (D),2012,Ideology/Single-Issue,1362033,583097,1945130
B000944,N00003535,Sherrod Brown (D),2012,Other,2281468,31550,2313018
B000589,N00003675,John Boehner (R),2012,Agribusiness,525040,205000,730040
B000589,N00003675,John Boehner (R),2012,Communic/Electronics,443541,174665,618206
B000589,N00003675,John Boehner (R),2012,Construction,588799,89000,677799
B000589,N00003675,John Boehner (R),2012,Defense,45100,84250,129350
B000589,N00003675,John Boehner (R),2012,Energy/Nat Resource,1007766,359000,1366766
B000589,N00003675,John Boehner (R),2012,Finance/Insur/RealEst,2900305,572800,3473105
B000589,N00003675,John Boehner (R),2012,Health,879182,412250,1291432
B000589,N00003675,John Boehner (R),2012,Lawyers & Lobbyists,801402,87406,888808
B000589,N00003675,John Boehner (R),2012,Transportation,326575,133250,459825
B000589,N00003675,John Boehner (R),2012,Misc Business,1472209,455222,1927431
B000589,N00003675,John Boehner (R),2012,Labor,250,43500,43750
B000589,N00003675,John Boehner (R),2012,Ideology/Single-Issue,629636,64500,694136
B000589,N00003675,John Boehner (R),2012,Other,1436181,12250,1448431
C000266,N00003689,Steve Chabot (R),2012,Agribusiness,21950,19000,40950
C000266,N00003689,Steve Chabot (R),2012,Communic/Electronics,25936,66000,91936
C000266,N00003689,Steve Chabot (R),2012,Construction,13850,19000,32850
C000266,N00003689,Steve Chabot (R),2012,Defense,0,20000,20000
C000266,N00003689,Steve Chabot (R),2012,Energy/Nat Resource,1950,30000,31950
C000266,N00003689,Steve Chabot (R),2012,Finance/Insur/RealEst,74350,78223,152573
C000266,N00003689,Steve Chabot (R),2012,Health,46450,24000,70450
C000266,N00003689,Steve Chabot (R),2012,Lawyers & Lobbyists,57900,18000,75900
C000266,N00003689,Steve Chabot (R),2012,Transportation,15000,33000,48000
C000266,N00003689,Steve Chabot (R),2012,Misc Business,106700,83000,189700
C000266,N00003689,Steve Chabot (R),2012,Labor,0,1000,1000
C000266,N00003689,Steve Chabot (R),2012,Ideology/Single-Issue,11950,85288,97238
C000266,N00003689,Steve Chabot (R),2012,Other,67000,0,67000
C000542,N00003845,Dan Coats (R),2012,Agribusiness,45850,72950,118800
C000542,N00003845,Dan Coats (R),2012,Communic/Electronics,40664,51000,91664
C000542,N00003845,Dan Coats (R),2012,Construction,89650,64500,154150
C000542,N00003845,Dan Coats (R),2012,Defense,27875,102050,129925
C000542,N00003845,Dan Coats (R),2012,Energy/Nat Resource,51333,172750,224083
C000542,N00003845,Dan Coats (R),2012,Finance/Insur/RealEst,440491,261347,701838
C000542,N00003845,Dan Coats (R),2012,Health,86950,248348,335298
C000542,N00003845,Dan Coats (R),2012,Lawyers & Lobbyists,280787,55500,336287
C000542,N00003845,Dan Coats (R),2012,Transportation,42500,69400,111900
C000542,N00003845,Dan Coats (R),2012,Misc Business,188223,212550,400773
C000542,N00003845,Dan Coats (R),2012,Labor,250,0,250
C000542,N00003845,Dan Coats (R),2012,Ideology/Single-Issue,67750,282358,350108
C000542,N00003845,Dan Coats (R),2012,Other,217174,4000,221174
C000714,N00004029,John Conyers Jr (D),2012,Agribusiness,750,16000,16750
C000714,N00004029,John Conyers Jr (D),2012,Communic/Electronics,44350,171000,215350
C000714,N00004029,John Conyers Jr (D),2012,Defense,0,3000,3000
C000714,N00004029,John Conyers Jr (D),2012,Energy/Nat Resource,750,10500,11250
C000714,N00004029,John Conyers Jr (D),2012,Finance/Insur/RealEst,8400,14500,22900
C000714,N00004029,John Conyers Jr (D),2012,Health,18934,51000,69934
C000714,N00004029,John Conyers Jr (D),2012,Lawyers & Lobbyists,139635,44250,183885
C000714,N00004029,John Conyers Jr (D),2012,Transportation,1500,22500,24000
C000714,N00004029,John Conyers Jr (D),2012,Misc Business,37900,57000,94900
C000714,N00004029,John Conyers Jr (D),2012,Labor,1275,151500,152775
C000714,N00004029,John Conyers Jr (D),2012,Ideology/Single-Issue,11900,77018,88918
C000714,N00004029,John Conyers Jr (D),2012,Other,16339,2000,18339
H000206,N00004207,Tom Harkin (D),2012,Agribusiness,257360,399986,657346
H000206,N00004207,Tom Harkin (D),2012,Communic/Electronics,176880,63750,240630
H000206,N00004207,Tom Harkin (D),2012,Construction,74210,39000,113210
H000206,N00004207,Tom Harkin (D),2012,Defense,18047,71000,89047
H000206,N00004207,Tom Harkin (D),2012,Energy/Nat Resource,58186,82766,140952
H000206,N00004207,Tom Harkin (D),2012,Finance/Insur/RealEst,701700,245841,947541
H000206,N00004207,Tom Harkin (D),2012,Health,527050,718964,1246014
H000206,N00004207,Tom Harkin (D),2012,Lawyers & Lobbyists,814477,163587,978064
H000206,N00004207,Tom Harkin (D),2012,Transportation,43820,53908,97728
H000206,N00004207,Tom Harkin (D),2012,Misc Business,289650,131000,420650
H000206,N00004207,Tom Harkin (D),2012,Labor,1200,322330,323530
H000206,N00004207,Tom Harkin (D),2012,Ideology/Single-Issue,157313,256980,414293
H000206,N00004207,Tom Harkin (D),2012,Other,530356,24000,554356
B001230,N00004367,Tammy Baldwin (D),2012,Agribusiness,54059,11000,65059
B001230,N00004367,Tammy Baldwin (D),2012,Communic/Electronics,381366,2000,383366
B001230,N00004367,Tammy Baldwin (D),2012,Construction,53230,1600,54830
B001230,N00004367,Tammy Baldwin (D),2012,Defense,4450,0,4450
B001230,N00004367,Tammy Baldwin (D),2012,Energy/Nat Resource,34194,30500,64694
B001230,N00004367,Tammy Baldwin (D),2012,Finance/Insur/RealEst,408139,26400,434539
B001230,N00004367,Tammy Baldwin (D),2012,Health,300924,57495,358419
B001230,N00004367,Tammy Baldwin (D),2012,Lawyers & Lobbyists,708199,19109,727308
B001230,N00004367,Tammy Baldwin (D),2012,Transportation,19135,3250,22385
B001230,N00004367,Tammy Baldwin (D),2012,Misc Business,391036,22500,413536
B001230,N00004367,Tammy Baldwin (D),2012,Labor,22280,360250,382530
B001230,N00004367,Tammy Baldwin (D),2012,Ideology/Single-Issue,1853895,670650,2524545
B001230,N00004367,Tammy Baldwin (D),2012,Other,1330651,3500,1334151
C001096,N00004614,Kevin Cramer (R),2012,Agribusiness,93740,31800,125540
C001096,N00004614,Kevin Cramer (R),2012,Communic/Electronics,10800,12500,23300
C001096,N00004614,Kevin Cramer (R),2012,Construction,65650,10500,76150
C001096,N00004614,Kevin Cramer (R),2012,Defense,0,6000,6000
C001096,N00004614,Kevin Cramer (R),2012,Energy/Nat Resource,181550,68500,250050
C001096,N00004614,Kevin Cramer (R),2012,Finance/Insur/RealEst,91705,25000,116705
C001096,N00004614,Kevin Cramer (R),2012,Health,14500,2500,17000
C001096,N00004614,Kevin Cramer (R),2012,Lawyers & Lobbyists,23753,500,24253
C001096,N00004614,Kevin Cramer (R),2012,Transportation,20831,10500,31331
C001096,N00004614,Kevin Cramer (R),2012,Misc Business,75550,22000,97550
C001096,N00004614,Kevin Cramer (R),2012,Ideology/Single-Issue,24129,116000,140129
C001096,N00004614,Kevin Cramer (R),2012,Other,117720,0,117720
B000243,N00004643,Max Baucus (D),2012,Agribusiness,219819,431500,651319
B000243,N00004643,Max Baucus (D),2012,Communic/Electronics,171993,333272,505265
B000243,N00004643,Max Baucus (D),2012,Construction,115175,204065,319240
B000243,N00004643,Max Baucus (D),2012,Defense,23400,84000,107400
B000243,N00004643,Max Baucus (D),2012,Energy/Nat Resource,210778,508800,719578
B000243,N00004643,Max Baucus (D),2012,Finance/Insur/RealEst,1671179,867116,2538295
B000243,N00004643,Max Baucus (D),2012,Health,863579,1298218,2161797
B000243,N00004643,Max Baucus (D),2012,Lawyers & Lobbyists,1030381,233603,1263984
B000243,N00004643,Max Baucus (D),2012,Transportation,123088,290300,413388
B000243,N00004643,Max Baucus (D),2012,Misc Business,608047,590100,1198147
B000243,N00004643,Max Baucus (D),2012,Labor,2652,236025,238677
B000243,N00004643,Max Baucus (D),2012,Ideology/Single-Issue,163900,226475,390375
B000243,N00004643,Max Baucus (D),2012,Other,292385,16000,308385
G000535,N00004874,Luis V Gutierrez (D),2012,Agribusiness,500,0,500
G000535,N00004874,Luis V Gutierrez (D),2012,Communic/Electronics,2660,16500,19160
G000535,N00004874,Luis V Gutierrez (D),2012,Construction,4150,4500,8650
G000535,N00004874,Luis V Gutierrez (D),2012,Defense,0,3500,3500
G000535,N00004874,Luis V Gutierrez (D),2012,Energy/Nat Resource,0,2500,2500
G000535,N00004874,Luis V Gutierrez (D),2012,Finance/Insur/RealEst,8750,104911,113661
G000535,N00004874,Luis V Gutierrez (D),2012,Health,3500,7700,11200
G000535,N00004874,Luis V Gutierrez (D),2012,Lawyers & Lobbyists,19060,9000,28060
G000535,N00004874,Luis V Gutierrez (D),2012,Transportation,660,1000,1660
G000535,N00004874,Luis V Gutierrez (D),2012,Misc Business,10495,26027,36522
G000535,N00004874,Luis V Gutierrez (D),2012,Labor,0,54500,54500
G000535,N00004874,Luis V Gutierrez (D),2012,Ideology/Single-Issue,0,10500,10500
G000535,N00004874,Luis V Gutierrez (D),2012,Other,500,6500,7000
D000096,N00004884,Danny K Davis (D),2012,Agribusiness,0,12000,12000
D000096,N00004884,Danny K Davis (D),2012,Communic/Electronics,2000,24500,26500
D000096,N00004884,Danny K Davis (D),2012,Construction,0,3000,3000
D000096,N00004884,Danny K Davis (D),2012,Defense,0,3000,3000
D000096,N00004884,Danny K Davis (D),2012,Energy/Nat Resource,0,16000,16000
D000096,N00004884,Danny K Davis (D),2012,Finance/Insur/RealEst,0,48000,48000
D000096,N00004884,Danny K Davis (D),2012,Health,12471,31500,43971
D000096,N00004884,Danny K Davis (D),2012,Lawyers & Lobbyists,10071,17000,27071
D000096,N00004884,Danny K Davis (D),2012,Transportation,0,17900,17900
D000096,N00004884,Danny K Davis (D),2012,Misc Business,9650,44000,53650
D000096,N00004884,Danny K Davis (D),2012,Labor,0,96250,96250
D000096,N00004884,Danny K Davis (D),2012,Ideology/Single-Issue,2000,9500,11500
D000096,N00004884,Danny K Davis (D),2012,Other,8100,0,8100
D000563,N00004981,Dick Durbin (D),2012,Agribusiness,86414,166700,253114
D000563,N00004981,Dick Durbin (D),2012,Communic/Electronics,281725,211500,493225
D000563,N00004981,Dick Durbin (D),2012,Construction,131350,80000,211350
D000563,N00004981,Dick Durbin (D),2012,Defense,35050,92300,127350
D000563,N00004981,Dick Durbin (D),2012,Energy/Nat Resource,68250,142300,210550
D000563,N00004981,Dick Durbin (D),2012,Finance/Insur/RealEst,1407793,349150,1756943
D000563,N00004981,Dick Durbin (D),2012,Health,310021,402191,712212
D000563,N00004981,Dick Durbin (D),2012,Lawyers & Lobbyists,1871597,164495,2036092
D000563,N00004981,Dick Durbin (D),2012,Transportation,122675,172267,294942
D000563,N00004981,Dick Durbin (D),2012,Misc Business,495155,384499,879654
D000563,N00004981,Dick Durbin (D),2012,Labor,37450,310450,347900
D000563,N00004981,Dick Durbin (D),2012,Ideology/Single-Issue,450078,232274,682352
D000563,N00004981,Dick Durbin (D),2012,Other,636130,6500,642630
E000172,N00005090,Jo Ann Emerson (R),2012,Agribusiness,80712,154504,235216
E000172,N00005090,Jo Ann Emerson (R),2012,Communic/Electronics,16500,63750,80250
E000172,N00005090,Jo Ann Emerson (R),2012,Construction,16200,54500,70700
E000172,N00005090,Jo Ann Emerson (R),2012,Defense,0,31000,31000
E000172,N00005090,Jo Ann Emerson (R),2012,Energy/Nat Resource,2500,47750,50250
E000172,N00005090,Jo Ann Emerson (R),2012,Finance/Insur/RealEst,35050,144300,179350
E000172,N00005090,Jo Ann Emerson (R),2012,Health,32828,68500,101328
E000172,N00005090,Jo Ann Emerson (R),2012,Lawyers & Lobbyists,99029,23750,122779
E000172,N00005090,Jo Ann Emerson (R),2012,Transportation,9800,60100,69900
E000172,N00005090,Jo Ann Emerson (R),2012,Misc Business,42666,112384,155050
E000172,N00005090,Jo Ann Emerson (R),2012,Labor,0,156000,156000
E000172,N00005090,Jo Ann Emerson (R),2012,Ideology/Single-Issue,4200,43000,47200
E000172,N00005090,Jo Ann Emerson (R),2012,Other,33500,3000,36500
B000575,N00005195,Roy Blunt (R),2012,Agribusiness,407000,318191,725191
B000575,N00005195,Roy Blunt (R),2012,Communic/Electronics,249201,257686,506887
B000575,N00005195,Roy Blunt (R),2012,Construction,314185,111000,425185
B000575,N00005195,Roy Blunt (R),2012,Defense,26400,74000,100400
B000575,N00005195,Roy Blunt (R),2012,Energy/Nat Resource,478558,377750,856308
B000575,N00005195,Roy Blunt (R),2012,Finance/Insur/RealEst,1804450,563800,2368250
B000575,N00005195,Roy Blunt (R),2012,Health,570872,449250,1020122
B000575,N00005195,Roy Blunt (R),2012,Lawyers & Lobbyists,733627,131600,865227
B000575,N00005195,Roy Blunt (R),2012,Transportation,371886,210350,582236
B000575,N00005195,Roy Blunt (R),2012,Misc Business,1149911,479750,1629661
B000575,N00005195,Roy Blunt (R),2012,Labor,2900,13500,16400
B000575,N00005195,Roy Blunt (R),2012,Ideology/Single-Issue,238444,757164,995608
B000575,N00005195,Roy Blunt (R),2012,Other,798035,6000,804035
C000560,N00005601,Tom Coburn (R),2012,Agribusiness,31125,67000,98125
C000560,N00005601,Tom Coburn (R),2012,Communic/Electronics,20730,93500,114230
C000560,N00005601,Tom Coburn (R),2012,Construction,30100,30500,60600
C000560,N00005601,Tom Coburn (R),2012,Defense,16150,21000,37150
C000560,N00005601,Tom Coburn (R),2012,Energy/Nat Resource,86050,121550,207600
C000560,N00005601,Tom Coburn (R),2012,Finance/Insur/RealEst,216125,245010,461135
C000560,N00005601,Tom Coburn (R),2012,Health,118965,286250,405215
C000560,N00005601,Tom Coburn (R),2012,Lawyers & Lobbyists,132450,54618,187068
C000560,N00005601,Tom Coburn (R),2012,Transportation,9700,57000,66700
C000560,N00005601,Tom Coburn (R),2012,Misc Business,92150,109900,202050
C000560,N00005601,Tom Coburn (R),2012,Labor,0,6000,6000
C000560,N00005601,Tom Coburn (R),2012,Ideology/Single-Issue,117445,167820,285265
C000560,N00005601,Tom Coburn (R),2012,Other,109900,0,109900
H000067,N00005645,Ralph Hall (R),2012,Agribusiness,8250,17147,25397
H000067,N00005645,Ralph Hall (R),2012,Communic/Electronics,16000,22000,38000
H000067,N00005645,Ralph Hall (R),2012,Construction,5500,14000,19500
H000067,N00005645,Ralph Hall (R),2012,Defense,3000,43500,46500
H000067,N00005645,Ralph Hall (R),2012,Energy/Nat Resource,26750,67000,93750
H000067,N00005645,Ralph Hall (R),2012,Finance/Insur/RealEst,37500,19010,56510
H000067,N00005645,Ralph Hall (R),2012,Health,25750,27000,52750
H000067,N00005645,Ralph Hall (R),2012,Lawyers & Lobbyists,25000,13500,38500
H000067,N00005645,Ralph Hall (R),2012,Transportation,8304,27500,35804
H000067,N00005645,Ralph Hall (R),2012,Misc Business,12500,35500,48000
H000067,N00005645,Ralph Hall (R),2012,Labor,0,2500,2500
H000067,N00005645,Ralph Hall (R),2012,Ideology/Single-Issue,2500,45100,47600
H000067,N00005645,Ralph Hall (R),2012,Other,19750,0,19750
B000213,N00005656,Joe Barton (R),2012,Agribusiness,8300,22547,30847
B000213,N00005656,Joe Barton (R),2012,Communic/Electronics,23050,75600,98650
B000213,N00005656,Joe Barton (R),2012,Construction,18050,5500,23550
B000213,N00005656,Joe Barton (R),2012,Defense,2500,13000,15500
B000213,N00005656,Joe Barton (R),2012,Energy/Nat Resource,75600,264500,340100
B000213,N00005656,Joe Barton (R),2012,Finance/Insur/RealEst,61150,57500,118650
B000213,N00005656,Joe Barton (R),2012,Health,50400,108800,159200
B000213,N00005656,Joe Barton (R),2012,Lawyers & Lobbyists,38192,35750,73942
B000213,N00005656,Joe Barton (R),2012,Transportation,10750,50500,61250
B000213,N00005656,Joe Barton (R),2012,Misc Business,87450,88353,175803
B000213,N00005656,Joe Barton (R),2012,Labor,0,1300,1300
B000213,N00005656,Joe Barton (R),2012,Ideology/Single-Issue,2000,19600,21600
B000213,N00005656,Joe Barton (R),2012,Other,23100,0,23100
G000410,N00005870,Gene Green (D),2012,Agribusiness,0,7500,7500
G000410,N00005870,Gene Green (D),2012,Communic/Electronics,9750,75500,85250
G000410,N00005870,Gene Green (D),2012,Construction,15750,13500,29250
G000410,N00005870,Gene Green (D),2012,Defense,0,15500,15500
G000410,N00005870,Gene Green (D),2012,Energy/Nat Resource,8500,159000,167500
G000410,N00005870,Gene Green (D),2012,Finance/Insur/RealEst,8250,35500,43750
G000410,N00005870,Gene Green (D),2012,Health,16900,150000,166900
G000410,N00005870,Gene Green (D),2012,Lawyers & Lobbyists,37000,34000,71000
G000410,N00005870,Gene Green (D),2012,Transportation,9200,61100,70300
G000410,N00005870,Gene Green (D),2012,Misc Business,23300,80000,103300
G000410,N00005870,Gene Green (D),2012,Labor,1400,179700,181100
G000410,N00005870,Gene Green (D),2012,Ideology/Single-Issue,0,1500,1500
G000410,N00005870,Gene Green (D),2012,Other,8300,0,8300
B000755,N00005883,Kevin Brady (R),2012,Agribusiness,1000,83897,84897
B000755,N00005883,Kevin Brady (R),2012,Communic/Electronics,2750,74000,76750
B000755,N00005883,Kevin Brady (R),2012,Construction,7500,29000,36500
B000755,N00005883,Kevin Brady (R),2012,Defense,0,24000,24000
B000755,N00005883,Kevin Brady (R),2012,Energy/Nat Resource,15665,185500,201165
B000755,N00005883,Kevin Brady (R),2012,Finance/Insur/RealEst,28350,282439,310789
B000755,N00005883,Kevin Brady (R),2012,Health,37200,164250,201450
B000755,N00005883,Kevin Brady (R),2012,Lawyers & Lobbyists,47700,31318,79018
B000755,N00005883,Kevin Brady (R),2012,Transportation,18500,55999,74499
B000755,N00005883,Kevin Brady (R),2012,Misc Business,31967,144250,176217
B000755,N00005883,Kevin Brady (R),2012,Labor,0,4500,4500
B000755,N00005883,Kevin Brady (R),2012,Ideology/Single-Issue,1500,12500,14000
B000755,N00005883,Kevin Brady (R),2012,Other,11400,2500,13900
H000636,N00006008,Ruben Hinojosa (D),2012,Agribusiness,3000,38547,41547
H000636,N00006008,Ruben Hinojosa (D),2012,Communic/Electronics,7500,20000,27500
H000636,N00006008,Ruben Hinojosa (D),2012,Construction,26100,5500,31600
H000636,N00006008,Ruben Hinojosa (D),2012,Defense,0,4500,4500
H000636,N00006008,Ruben Hinojosa (D),2012,Energy/Nat Resource,2500,20000,22500
H000636,N00006008,Ruben Hinojosa (D),2012,Finance/Insur/RealEst,21750,60000,81750
H000636,N00006008,Ruben Hinojosa (D),2012,Health,80350,20800,101150
H000636,N00006008,Ruben Hinojosa (D),2012,Lawyers & Lobbyists,26350,8000,34350
H000636,N00006008,Ruben Hinojosa (D),2012,Transportation,0,8500,8500
H000636,N00006008,Ruben Hinojosa (D),2012,Misc Business,52000,31500,83500
H000636,N00006008,Ruben Hinojosa (D),2012,Labor,0,66000,66000
H000636,N00006008,Ruben Hinojosa (D),2012,Ideology/Single-Issue,1500,21000,22500
H000636,N00006008,Ruben Hinojosa (D),2012,Other,12050,500,12550
D000399,N00006023,Lloyd Doggett (D),2012,Agribusiness,14000,1000,15000
D000399,N00006023,Lloyd Doggett (D),2012,Communic/Electronics,48550,9000,57550
D000399,N00006023,Lloyd Doggett (D),2012,Construction,32518,3500,36018
D000399,N00006023,Lloyd Doggett (D),2012,Energy/Nat Resource,21750,12750,34500
D000399,N00006023,Lloyd Doggett (D),2012,Finance/Insur/RealEst,92500,38500,131000
D000399,N00006023,Lloyd Doggett (D),2012,Health,47818,74800,122618
D000399,N00006023,Lloyd Doggett (D),2012,Lawyers & Lobbyists,363309,30750,394059
D000399,N00006023,Lloyd Doggett (D),2012,Transportation,2000,7750,9750
D000399,N00006023,Lloyd Doggett (D),2012,Misc Business,85100,8000,93100
D000399,N00006023,Lloyd Doggett (D),2012,Labor,0,198500,198500
D000399,N00006023,Lloyd Doggett (D),2012,Ideology/Single-Issue,12900,15887,28787
D000399,N00006023,Lloyd Doggett (D),2012,Other,157879,0,157879
D000197,N00006134,Diana DeGette (D),2012,Agribusiness,5175,13500,18675
D000197,N00006134,Diana DeGette (D),2012,Communic/Electronics,11195,100750,111945
D000197,N00006134,Diana DeGette (D),2012,Construction,3000,0,3000
D000197,N00006134,Diana DeGette (D),2012,Defense,1000,6500,7500
D000197,N00006134,Diana DeGette (D),2012,Energy/Nat Resource,500,22750,23250
D000197,N00006134,Diana DeGette (D),2012,Finance/Insur/RealEst,37250,32000,69250
D000197,N00006134,Diana DeGette (D),2012,Health,16150,188159,204309
D000197,N00006134,Diana DeGette (D),2012,Lawyers & Lobbyists,77350,38500,115850
D000197,N00006134,Diana DeGette (D),2012,Transportation,2250,9000,11250
D000197,N00006134,Diana DeGette (D),2012,Misc Business,20419,16500,36919
D000197,N00006134,Diana DeGette (D),2012,Labor,250,128550,128800
D000197,N00006134,Diana DeGette (D),2012,Ideology/Single-Issue,90383,21433,111816
D000197,N00006134,Diana DeGette (D),2012,Other,77650,2000,79650
B001261,N00006236,John A Barrasso (R),2012,Agribusiness,48700,118000,166700
B001261,N00006236,John A Barrasso (R),2012,Communic/Electronics,90600,177500,268100
B001261,N00006236,John A Barrasso (R),2012,Construction,70983,126250,197233
B001261,N00006236,John A Barrasso (R),2012,Defense,10500,76000,86500
B001261,N00006236,John A Barrasso (R),2012,Energy/Nat Resource,385897,760150,1146047
B001261,N00006236,John A Barrasso (R),2012,Finance/Insur/RealEst,430825,462304,893129
B001261,N00006236,John A Barrasso (R),2012,Health,641526,684539,1326065
B001261,N00006236,John A Barrasso (R),2012,Lawyers & Lobbyists,331529,73125,404654
B001261,N00006236,John A Barrasso (R),2012,Transportation,60152,184749,244901
B001261,N00006236,John A Barrasso (R),2012,Misc Business,233387,345498,578885
B001261,N00006236,John A Barrasso (R),2012,Labor,0,32500,32500
B001261,N00006236,John A Barrasso (R),2012,Ideology/Single-Issue,116459,540674,657133
B001261,N00006236,John A Barrasso (R),2012,Other,228584,4500,233084
E000285,N00006249,Mike Enzi (R),2012,Agribusiness,24909,62500,87409
E000285,N00006249,Mike Enzi (R),2012,Communic/Electronics,8550,65000,73550
E000285,N00006249,Mike Enzi (R),2012,Construction,6200,44500,50700
E000285,N00006249,Mike Enzi (R),2012,Defense,500,25000,25500
E000285,N00006249,Mike Enzi (R),2012,Energy/Nat Resource,45350,165300,210650
E000285,N00006249,Mike Enzi (R),2012,Finance/Insur/RealEst,64999,395934,460933
E000285,N00006249,Mike Enzi (R),2012,Health,46950,490249,537199
E000285,N00006249,Mike Enzi (R),2012,Lawyers & Lobbyists,88556,29000,117556
E000285,N00006249,Mike Enzi (R),2012,Transportation,6000,36500,42500
E000285,N00006249,Mike Enzi (R),2012,Misc Business,35775,166500,202275
E000285,N00006249,Mike Enzi (R),2012,Labor,0,17500,17500
E000285,N00006249,Mike Enzi (R),2012,Ideology/Single-Issue,20666,151300,171966
E000285,N00006249,Mike Enzi (R),2012,Other,31789,10000,41789
C000880,N00006267,Mike Crapo (R),2012,Agribusiness,83164,219135,302299
C000880,N00006267,Mike Crapo (R),2012,Communic/Electronics,25250,132312,157562
C000880,N00006267,Mike Crapo (R),2012,Construction,50020,84500,134520
C000880,N00006267,Mike Crapo (R),2012,Defense,1000,39000,40000
C000880,N00006267,Mike Crapo (R),2012,Energy/Nat Resource,71906,213902,285808
C000880,N00006267,Mike Crapo (R),2012,Finance/Insur/RealEst,460593,903065,1363658
C000880,N00006267,Mike Crapo (R),2012,Health,86444,423421,509865
C000880,N00006267,Mike Crapo (R),2012,Lawyers & Lobbyists,245418,75991,321409
C000880,N00006267,Mike Crapo (R),2012,Transportation,14550,105477,120027
C000880,N00006267,Mike Crapo (R),2012,Misc Business,118967,204880,323847
C000880,N00006267,Mike Crapo (R),2012,Labor,0,11750,11750
C000880,N00006267,Mike Crapo (R),2012,Ideology/Single-Issue,49450,207350,256800
C000880,N00006267,Mike Crapo (R),2012,Other,144877,0,144877
F000448,N00006423,Trent Franks (R),2012,Agribusiness,5250,3500,8750
F000448,N00006423,Trent Franks (R),2012,Communic/Electronics,5000,38000,43000
F000448,N00006423,Trent Franks (R),2012,Construction,6500,4000,10500
F000448,N00006423,Trent Franks (R),2012,Defense,4000,60000,64000
F000448,N00006423,Trent Franks (R),2012,Energy/Nat Resource,3400,28000,31400
F000448,N00006423,Trent Franks (R),2012,Finance/Insur/RealEst,8900,23000,31900
F000448,N00006423,Trent Franks (R),2012,Health,250,2500,2750
F000448,N00006423,Trent Franks (R),2012,Lawyers & Lobbyists,25250,3750,29000
F000448,N00006423,Trent Franks (R),2012,Transportation,1050,5000,6050
F000448,N00006423,Trent Franks (R),2012,Misc Business,15800,9000,24800
F000448,N00006423,Trent Franks (R),2012,Ideology/Single-Issue,10476,17474,27950
F000448,N00006423,Trent Franks (R),2012,Other,22050,0,22050
B000711,N00006692,Barbara Boxer (D),2012,Agribusiness,112400,107300,219700
B000711,N00006692,Barbara Boxer (D),2012,Communic/Electronics,1616893,244031,1860924
B000711,N00006692,Barbara Boxer (D),2012,Construction,238429,187866,426295
B000711,N00006692,Barbara Boxer (D),2012,Defense,14400,11500,25900
B000711,N00006692,Barbara Boxer (D),2012,Energy/Nat Resource,178600,154399,332999
B000711,N00006692,Barbara Boxer (D),2012,Finance/Insur/RealEst,1571246,95941,1667187
B000711,N00006692,Barbara Boxer (D),2012,Health,611840,126200,738040
B000711,N00006692,Barbara Boxer (D),2012,Lawyers & Lobbyists,2396670,156968,2553638
B000711,N00006692,Barbara Boxer (D),2012,Transportation,80099,156558,236657
B000711,N00006692,Barbara Boxer (D),2012,Misc Business,1267534,114702,1382236
B000711,N00006692,Barbara Boxer (D),2012,Labor,13950,414600,428550
B000711,N00006692,Barbara Boxer (D),2012,Ideology/Single-Issue,2238102,675171,2913273
B000711,N00006692,Barbara Boxer (D),2012,Other,2365320,4500,2369820
H001063,N00006806,Janice Hahn (D),2012,Agribusiness,9000,13000,22000
H001063,N00006806,Janice Hahn (D),2012,Communic/Electronics,34150,14000,48150
H001063,N00006806,Janice Hahn (D),2012,Construction,43550,24500,68050
H001063,N00006806,Janice Hahn (D),2012,Defense,8750,22000,30750
H001063,N00006806,Janice Hahn (D),2012,Energy/Nat Resource,24050,30500,54550
H001063,N00006806,Janice Hahn (D),2012,Finance/Insur/RealEst,154500,54000,208500
H001063,N00006806,Janice Hahn (D),2012,Health,23750,46500,70250
H001063,N00006806,Janice Hahn (D),2012,Lawyers & Lobbyists,146900,20500,167400
H001063,N00006806,Janice Hahn (D),2012,Transportation,43500,43966,87466
H001063,N00006806,Janice Hahn (D),2012,Misc Business,143399,29000,172399
H001063,N00006806,Janice Hahn (D),2012,Labor,2250,418499,420749
H001063,N00006806,Janice Hahn (D),2012,Ideology/Single-Issue,127727,140738,268465
H001063,N00006806,Janice Hahn (D),2012,Other,133058,0,133058
C000059,N00007099,Ken Calvert (R),2012,Agribusiness,28400,34000,62400
C000059,N00007099,Ken Calvert (R),2012,Communic/Electronics,11350,38000,49350
C000059,N00007099,Ken Calvert (R),2012,Construction,67450,44000,111450
C000059,N00007099,Ken Calvert (R),2012,Defense,3150,107500,110650
C000059,N00007099,Ken Calvert (R),2012,Energy/Nat Resource,7675,47500,55175
C000059,N00007099,Ken Calvert (R),2012,Finance/Insur/RealEst,66015,44500,110515
C000059,N00007099,Ken Calvert (R),2012,Health,21215,32100,53315
C000059,N00007099,Ken Calvert (R),2012,Lawyers & Lobbyists,73851,8750,82601
C000059,N00007099,Ken Calvert (R),2012,Transportation,15470,65500,80970
C000059,N00007099,Ken Calvert (R),2012,Misc Business,92368,46441,138809
C000059,N00007099,Ken Calvert (R),2012,Labor,0,10000,10000
C000059,N00007099,Ken Calvert (R),2012,Ideology/Single-Issue,23600,34350,57950
C000059,N00007099,Ken Calvert (R),2012,Other,39300,0,39300
C001036,N00007232,Lois Capps (D),2012,Agribusiness,12250,2750,15000
C001036,N00007232,Lois Capps (D),2012,Communic/Electronics,138875,85000,223875
C001036,N00007232,Lois Capps (D),2012,Construction,10496,1500,11996
C001036,N00007232,Lois Capps (D),2012,Defense,2900,15500,18400
C001036,N00007232,Lois Capps (D),2012,Energy/Nat Resource,8000,16500,24500
C001036,N00007232,Lois Capps (D),2012,Finance/Insur/RealEst,115635,46000,161635
C001036,N00007232,Lois Capps (D),2012,Health,93725,286500,380225
C001036,N00007232,Lois Capps (D),2012,Lawyers & Lobbyists,141428,36750,178178
C001036,N00007232,Lois Capps (D),2012,Transportation,3250,6500,9750
C001036,N00007232,Lois Capps (D),2012,Misc Business,115619,43500,159119
C001036,N00007232,Lois Capps (D),2012,Labor,4500,251500,256000
C001036,N00007232,Lois Capps (D),2012,Ideology/Single-Issue,308801,334186,642987
C001036,N00007232,Lois Capps (D),2012,Other,429426,1000,430426
F000030,N00007312,Sam Farr (D),2012,Agribusiness,37991,109773,147764
F000030,N00007312,Sam Farr (D),2012,Communic/Electronics,800,2500,3300
F000030,N00007312,Sam Farr (D),2012,Construction,1250,3000,4250
F000030,N00007312,Sam Farr (D),2012,Defense,0,6000,6000
F000030,N00007312,Sam Farr (D),2012,Energy/Nat Resource,800,27500,28300
F000030,N00007312,Sam Farr (D),2012,Finance/Insur/RealEst,8170,21000,29170
F000030,N00007312,Sam Farr (D),2012,Health,15650,41500,57150
F000030,N00007312,Sam Farr (D),2012,Lawyers & Lobbyists,16910,17500,34410
F000030,N00007312,Sam Farr (D),2012,Transportation,3000,27499,30499
F000030,N00007312,Sam Farr (D),2012,Misc Business,22453,44800,67253
F000030,N00007312,Sam Farr (D),2012,Labor,0,79500,79500
F000030,N00007312,Sam Farr (D),2012,Ideology/Single-Issue,16950,16000,32950
F000030,N00007312,Sam Farr (D),2012,Other,58115,4000,62115
E000215,N00007335,Anna Eshoo (D),2012,Agribusiness,2000,3000,5000
E000215,N00007335,Anna Eshoo (D),2012,Communic/Electronics,104550,250951,355501
E000215,N00007335,Anna Eshoo (D),2012,Construction,8700,0,8700
E000215,N00007335,Anna Eshoo (D),2012,Defense,4750,17500,22250
E000215,N00007335,Anna Eshoo (D),2012,Energy/Nat Resource,10500,19750,30250
E000215,N00007335,Anna Eshoo (D),2012,Finance/Insur/RealEst,111000,60000,171000
E000215,N00007335,Anna Eshoo (D),2012,Health,82598,193700,276298
E000215,N00007335,Anna Eshoo (D),2012,Lawyers & Lobbyists,89610,18500,108110
E000215,N00007335,Anna Eshoo (D),2012,Transportation,2450,5000,7450
E000215,N00007335,Anna Eshoo (D),2012,Misc Business,49574,21500,71074
E000215,N00007335,Anna Eshoo (D),2012,Labor,0,65000,65000
E000215,N00007335,Anna Eshoo (D),2012,Ideology/Single-Issue,30670,10250,40920
E000215,N00007335,Anna Eshoo (D),2012,Other,146100,0,146100
F000062,N00007364,Dianne Feinstein (D),2012,Agribusiness,354733,236333,591066
F000062,N00007364,Dianne Feinstein (D),2012,Communic/Electronics,347291,267689,614980
F000062,N00007364,Dianne Feinstein (D),2012,Construction,110650,81500,192150
F000062,N00007364,Dianne Feinstein (D),2012,Defense,94800,109000,203800
F000062,N00007364,Dianne Feinstein (D),2012,Energy/Nat Resource,268400,203650,472050
F000062,N00007364,Dianne Feinstein (D),2012,Finance/Insur/RealEst,847987,215750,1063737
F000062,N00007364,Dianne Feinstein (D),2012,Health,195042,253800,448842
F000062,N00007364,Dianne Feinstein (D),2012,Lawyers & Lobbyists,737651,151374,889025
F000062,N00007364,Dianne Feinstein (D),2012,Transportation,44550,74500,119050
F000062,N00007364,Dianne Feinstein (D),2012,Misc Business,421636,253000,674636
F000062,N00007364,Dianne Feinstein (D),2012,Labor,3000,228200,231200
F000062,N00007364,Dianne Feinstein (D),2012,Ideology/Single-Issue,399475,225246,624721
F000062,N00007364,Dianne Feinstein (D),2012,Other,674716,1000,675716
F000010,N00007632,Eni F H Faleomavaega (D),2012,Construction,3500,0,3500
F000010,N00007632,Eni F H Faleomavaega (D),2012,Energy/Nat Resource,4500,1500,6000
F000010,N00007632,Eni F H Faleomavaega (D),2012,Finance/Insur/RealEst,6500,0,6500
F000010,N00007632,Eni F H Faleomavaega (D),2012,Health,4500,0,4500
F000010,N00007632,Eni F H Faleomavaega (D),2012,Lawyers & Lobbyists,2000,1000,3000
F000010,N00007632,Eni F H Faleomavaega (D),2012,Misc Business,31000,0,31000
F000010,N00007632,Eni F H Faleomavaega (D),2012,Labor,0,5000,5000
F000010,N00007632,Eni F H Faleomavaega (D),2012,Ideology/Single-Issue,0,3250,3250
F000010,N00007632,Eni F H Faleomavaega (D),2012,Other,3000,0,3000
B000574,N00007727,Earl Blumenauer (D),2012,Agribusiness,4623,10250,14873
B000574,N00007727,Earl Blumenauer (D),2012,Communic/Electronics,14125,22250,36375
B000574,N00007727,Earl Blumenauer (D),2012,Construction,31460,110000,141460
B000574,N00007727,Earl Blumenauer (D),2012,Defense,0,7000,7000
B000574,N00007727,Earl Blumenauer (D),2012,Energy/Nat Resource,17900,37255,55155
B000574,N00007727,Earl Blumenauer (D),2012,Finance/Insur/RealEst,84869,85000,169869
B000574,N00007727,Earl Blumenauer (D),2012,Health,12815,141750,154565
B000574,N00007727,Earl Blumenauer (D),2012,Lawyers & Lobbyists,45550,27500,73050
B000574,N00007727,Earl Blumenauer (D),2012,Transportation,20975,89145,110120
B000574,N00007727,Earl Blumenauer (D),2012,Misc Business,89895,66206,156101
B000574,N00007727,Earl Blumenauer (D),2012,Labor,0,152750,152750
B000574,N00007727,Earl Blumenauer (D),2012,Ideology/Single-Issue,14900,27300,42200
B000574,N00007727,Earl Blumenauer (D),2012,Other,32345,0,32345
D000191,N00007781,Peter DeFazio (D),2012,Agribusiness,17318,26500,43818
D000191,N00007781,Peter DeFazio (D),2012,Communic/Electronics,1035,2500,3535
D000191,N00007781,Peter DeFazio (D),2012,Construction,4450,72000,76450
D000191,N00007781,Peter DeFazio (D),2012,Defense,0,6000,6000
D000191,N00007781,Peter DeFazio (D),2012,Energy/Nat Resource,250,21500,21750
D000191,N00007781,Peter DeFazio (D),2012,Finance/Insur/RealEst,6300,18000,24300
D000191,N00007781,Peter DeFazio (D),2012,Health,11450,11000,22450
D000191,N00007781,Peter DeFazio (D),2012,Lawyers & Lobbyists,40148,28500,68648
D000191,N00007781,Peter DeFazio (D),2012,Transportation,5950,137000,142950
D000191,N00007781,Peter DeFazio (D),2012,Misc Business,47900,15500,63400
D000191,N00007781,Peter DeFazio (D),2012,Labor,0,212500,212500
D000191,N00007781,Peter DeFazio (D),2012,Ideology/Single-Issue,2500,52500,55000
D000191,N00007781,Peter DeFazio (D),2012,Other,92895,1500,94395
C000127,N00007836,Maria Cantwell (D),2012,Agribusiness,83633,9000,92633
C000127,N00007836,Maria Cantwell (D),2012,Communic/Electronics,467246,9512,476758
C000127,N00007836,Maria Cantwell (D),2012,Construction,96973,3000,99973
C000127,N00007836,Maria Cantwell (D),2012,Defense,39475,1500,40975
C000127,N00007836,Maria Cantwell (D),2012,Energy/Nat Resource,337189,13000,350189
C000127,N00007836,Maria Cantwell (D),2012,Finance/Insur/RealEst,869054,13000,882054
C000127,N00007836,Maria Cantwell (D),2012,Health,465710,28500,494210
C000127,N00007836,Maria Cantwell (D),2012,Lawyers & Lobbyists,1350634,8250,1358884
C000127,N00007836,Maria Cantwell (D),2012,Transportation,177740,25000,202740
C000127,N00007836,Maria Cantwell (D),2012,Misc Business,785784,8500,794284
C000127,N00007836,Maria Cantwell (D),2012,Labor,6650,21200,27850
C000127,N00007836,Maria Cantwell (D),2012,Ideology/Single-Issue,410108,65937,476045
C000127,N00007836,Maria Cantwell (D),2012,Other,1042339,0,1042339
C000071,N00008086,Dave Camp (R),2012,Agribusiness,10750,209750,220500
C000071,N00008086,Dave Camp (R),2012,Communic/Electronics,19500,133121,152621
C000071,N00008086,Dave Camp (R),2012,Construction,15000,109000,124000
C000071,N00008086,Dave Camp (R),2012,Defense,0,47500,47500
C000071,N00008086,Dave Camp (R),2012,Energy/Nat Resource,90800,392800,483600
C000071,N00008086,Dave Camp (R),2012,Finance/Insur/RealEst,320633,686758,1007391
C000071,N00008086,Dave Camp (R),2012,Health,144929,779900,924829
C000071,N00008086,Dave Camp (R),2012,Lawyers & Lobbyists,205350,89756,295106
C000071,N00008086,Dave Camp (R),2012,Transportation,54675,174549,229224
C000071,N00008086,Dave Camp (R),2012,Misc Business,150011,447732,597743
C000071,N00008086,Dave Camp (R),2012,Labor,0,18500,18500
C000071,N00008086,Dave Camp (R),2012,Ideology/Single-Issue,6700,46300,53000
C000071,N00008086,Dave Camp (R),2012,Other,51195,6200,57395
B000013,N00008091,Spencer Bachus (R),2012,Agribusiness,11600,33302,44902
B000013,N00008091,Spencer Bachus (R),2012,Communic/Electronics,14950,20000,34950
B000013,N00008091,Spencer Bachus (R),2012,Construction,62500,48500,111000
B000013,N00008091,Spencer Bachus (R),2012,Defense,0,18500,18500
B000013,N00008091,Spencer Bachus (R),2012,Energy/Nat Resource,16500,66000,82500
B000013,N00008091,Spencer Bachus (R),2012,Finance/Insur/RealEst,469745,891500,1361245
B000013,N00008091,Spencer Bachus (R),2012,Health,25350,31500,56850
B000013,N00008091,Spencer Bachus (R),2012,Lawyers & Lobbyists,104434,83304,187738
B000013,N00008091,Spencer Bachus (R),2012,Transportation,24500,75000,99500
B000013,N00008091,Spencer Bachus (R),2012,Misc Business,87130,99500,186630
B000013,N00008091,Spencer Bachus (R),2012,Labor,0,11500,11500
B000013,N00008091,Spencer Bachus (R),2012,Ideology/Single-Issue,12150,107000,119150
B000013,N00008091,Spencer Bachus (R),2012,Other,43700,1000,44700
G000377,N00008799,Kay Granger (R),2012,Agribusiness,3750,29147,32897
G000377,N00008799,Kay Granger (R),2012,Communic/Electronics,10750,23500,34250
G000377,N00008799,Kay Granger (R),2012,Construction,28310,20000,48310
G000377,N00008799,Kay Granger (R),2012,Defense,55950,127000,182950
G000377,N00008799,Kay Granger (R),2012,Energy/Nat Resource,66900,35500,102400
G000377,N00008799,Kay Granger (R),2012,Finance/Insur/RealEst,137445,80500,217945
G000377,N00008799,Kay Granger (R),2012,Health,35320,53500,88820
G000377,N00008799,Kay Granger (R),2012,Lawyers & Lobbyists,89482,29490,118972
G000377,N00008799,Kay Granger (R),2012,Transportation,19850,71600,91450
G000377,N00008799,Kay Granger (R),2012,Misc Business,71680,51500,123180
G000377,N00008799,Kay Granger (R),2012,Labor,0,6000,6000
G000377,N00008799,Kay Granger (R),2012,Ideology/Single-Issue,26700,38500,65200
G000377,N00008799,Kay Granger (R),2012,Other,70675,1500,72175
G000289,N00009154,Bob Goodlatte (R),2012,Agribusiness,30750,190849,221599
G000289,N00009154,Bob Goodlatte (R),2012,Communic/Electronics,51500,241993,293493
G000289,N00009154,Bob Goodlatte (R),2012,Construction,18035,20000,38035
G000289,N00009154,Bob Goodlatte (R),2012,Defense,1000,26500,27500
G000289,N00009154,Bob Goodlatte (R),2012,Energy/Nat Resource,13750,34000,47750
G000289,N00009154,Bob Goodlatte (R),2012,Finance/Insur/RealEst,40418,117000,157418
G000289,N00009154,Bob Goodlatte (R),2012,Health,22950,49750,72700
G000289,N00009154,Bob Goodlatte (R),2012,Lawyers & Lobbyists,77193,37250,114443
G000289,N00009154,Bob Goodlatte (R),2012,Transportation,25850,59260,85110
G000289,N00009154,Bob Goodlatte (R),2012,Misc Business,47860,134000,181860
G000289,N00009154,Bob Goodlatte (R),2012,Labor,0,11000,11000
G000289,N00009154,Bob Goodlatte (R),2012,Ideology/Single-Issue,7000,16600,23600
G000289,N00009154,Bob Goodlatte (R),2012,Other,102972,13000,115972
H000329,N00009157,Doc Hastings (R),2012,Agribusiness,92169,101120,193289
H000329,N00009157,Doc Hastings (R),2012,Communic/Electronics,8950,24000,32950
H000329,N00009157,Doc Hastings (R),2012,Construction,63325,43500,106825
H000329,N00009157,Doc Hastings (R),2012,Defense,1300,22500,23800
H000329,N00009157,Doc Hastings (R),2012,Energy/Nat Resource,159453,215260,374713
H000329,N00009157,Doc Hastings (R),2012,Finance/Insur/RealEst,27850,39000,66850
H000329,N00009157,Doc Hastings (R),2012,Health,19801,18900,38701
H000329,N00009157,Doc Hastings (R),2012,Lawyers & Lobbyists,55978,29000,84978
H000329,N00009157,Doc Hastings (R),2012,Transportation,32850,24500,57350
H000329,N00009157,Doc Hastings (R),2012,Misc Business,141174,30250,171424
H000329,N00009157,Doc Hastings (R),2012,Ideology/Single-Issue,15500,24000,39500
H000329,N00009157,Doc Hastings (R),2012,Other,60555,0,60555
F000444,N00009573,Jeff Flake (R),2012,Agribusiness,200477,107500,307977
F000444,N00009573,Jeff Flake (R),2012,Communic/Electronics,105500,67150,172650
F000444,N00009573,Jeff Flake (R),2012,Construction,179400,56500,235900
F000444,N00009573,Jeff Flake (R),2012,Defense,4800,16000,20800
F000444,N00009573,Jeff Flake (R),2012,Energy/Nat Resource,276287,196500,472787
F000444,N00009573,Jeff Flake (R),2012,Finance/Insur/RealEst,960858,157500,1118358
F000444,N00009573,Jeff Flake (R),2012,Health,285332,119500,404832
F000444,N00009573,Jeff Flake (R),2012,Lawyers & Lobbyists,249652,34500,284152
F000444,N00009573,Jeff Flake (R),2012,Transportation,198250,85000,283250
F000444,N00009573,Jeff Flake (R),2012,Misc Business,505060,174500,679560
F000444,N00009573,Jeff Flake (R),2012,Labor,0,3500,3500
F000444,N00009573,Jeff Flake (R),2012,Ideology/Single-Issue,1381137,442422,1823559
F000444,N00009573,Jeff Flake (R),2012,Other,724169,20000,744169
D000598,N00009604,Susan A Davis (D),2012,Agribusiness,8500,0,8500
D000598,N00009604,Susan A Davis (D),2012,Communic/Electronics,21200,16000,37200
D000598,N00009604,Susan A Davis (D),2012,Construction,1500,7000,8500
D000598,N00009604,Susan A Davis (D),2012,Defense,10050,53500,63550
D000598,N00009604,Susan A Davis (D),2012,Energy/Nat Resource,250,10000,10250
D000598,N00009604,Susan A Davis (D),2012,Finance/Insur/RealEst,20250,22500,42750
D000598,N00009604,Susan A Davis (D),2012,Health,12044,64000,76044
D000598,N00009604,Susan A Davis (D),2012,Lawyers & Lobbyists,9000,15500,24500
D000598,N00009604,Susan A Davis (D),2012,Transportation,1000,2500,3500
D000598,N00009604,Susan A Davis (D),2012,Misc Business,27200,14000,41200
D000598,N00009604,Susan A Davis (D),2012,Labor,0,66050,66050
D000598,N00009604,Susan A Davis (D),2012,Ideology/Single-Issue,42100,50000,92100
D000598,N00009604,Susan A Davis (D),2012,Other,43000,14500,57500
C001048,N00009738,John Culberson (R),2012,Agribusiness,4900,18147,23047
C001048,N00009738,John Culberson (R),2012,Communic/Electronics,6500,28500,35000
C001048,N00009738,John Culberson (R),2012,Construction,24500,23000,47500
C001048,N00009738,John Culberson (R),2012,Defense,0,40500,40500
C001048,N00009738,John Culberson (R),2012,Energy/Nat Resource,40400,79500,119900
C001048,N00009738,John Culberson (R),2012,Finance/Insur/RealEst,104800,43000,147800
C001048,N00009738,John Culberson (R),2012,Health,27500,27000,54500
C001048,N00009738,John Culberson (R),2012,Lawyers & Lobbyists,34816,10500,45316
C001048,N00009738,John Culberson (R),2012,Transportation,11050,55000,66050
C001048,N00009738,John Culberson (R),2012,Misc Business,58805,33000,91805
C001048,N00009738,John Culberson (R),2012,Labor,0,7000,7000
C001048,N00009738,John Culberson (R),2012,Ideology/Single-Issue,500,3650,4150
C001048,N00009738,John Culberson (R),2012,Other,58050,2000,60050
C001047,N00009771,Shelley Moore Capito (R),2012,Agribusiness,12000,12500,24500
C001047,N00009771,Shelley Moore Capito (R),2012,Communic/Electronics,6850,21500,28350
C001047,N00009771,Shelley Moore Capito (R),2012,Construction,115900,41500,157400
C001047,N00009771,Shelley Moore Capito (R),2012,Defense,0,2000,2000
C001047,N00009771,Shelley Moore Capito (R),2012,Energy/Nat Resource,190987,120749,311736
C001047,N00009771,Shelley Moore Capito (R),2012,Finance/Insur/RealEst,138500,603850,742350
C001047,N00009771,Shelley Moore Capito (R),2012,Health,61000,87000,148000
C001047,N00009771,Shelley Moore Capito (R),2012,Lawyers & Lobbyists,126543,15000,141543
C001047,N00009771,Shelley Moore Capito (R),2012,Transportation,31450,113000,144450
C001047,N00009771,Shelley Moore Capito (R),2012,Misc Business,103140,75500,178640
C001047,N00009771,Shelley Moore Capito (R),2012,Labor,0,59500,59500
C001047,N00009771,Shelley Moore Capito (R),2012,Ideology/Single-Issue,16550,53000,69550
C001047,N00009771,Shelley Moore Capito (R),2012,Other,107250,1500,108750
B000287,N00009774,Xavier Becerra (D),2012,Agribusiness,3000,27000,30000
B000287,N00009774,Xavier Becerra (D),2012,Communic/Electronics,34900,114500,149400
B000287,N00009774,Xavier Becerra (D),2012,Construction,16835,10500,27335
B000287,N00009774,Xavier Becerra (D),2012,Defense,0,28000,28000
B000287,N00009774,Xavier Becerra (D),2012,Energy/Nat Resource,1000,31750,32750
B000287,N00009774,Xavier Becerra (D),2012,Finance/Insur/RealEst,162008,259000,421008
B000287,N00009774,Xavier Becerra (D),2012,Health,86722,354492,441214
B000287,N00009774,Xavier Becerra (D),2012,Lawyers & Lobbyists,88255,40785,129040
B000287,N00009774,Xavier Becerra (D),2012,Transportation,0,53000,53000
B000287,N00009774,Xavier Becerra (D),2012,Misc Business,85850,113000,198850
B000287,N00009774,Xavier Becerra (D),2012,Labor,0,170000,170000
B000287,N00009774,Xavier Becerra (D),2012,Ideology/Single-Issue,5100,18000,23100
B000287,N00009774,Xavier Becerra (D),2012,Other,20250,0,20250
H000338,N00009869,Orrin G Hatch (R),2012,Agribusiness,51683,153000,204683
H000338,N00009869,Orrin G Hatch (R),2012,Communic/Electronics,263531,345000,608531
H000338,N00009869,Orrin G Hatch (R),2012,Construction,107166,140750,247916
H000338,N00009869,Orrin G Hatch (R),2012,Defense,12250,96000,108250
H000338,N00009869,Orrin G Hatch (R),2012,Energy/Nat Resource,231768,458500,690268
H000338,N00009869,Orrin G Hatch (R),2012,Finance/Insur/RealEst,1756727,933145,2689872
H000338,N00009869,Orrin G Hatch (R),2012,Health,737107,1378641,2115748
H000338,N00009869,Orrin G Hatch (R),2012,Lawyers & Lobbyists,759957,233581,993538
H000338,N00009869,Orrin G Hatch (R),2012,Transportation,50716,164000,214716
H000338,N00009869,Orrin G Hatch (R),2012,Misc Business,634759,548915,1183674
H000338,N00009869,Orrin G Hatch (R),2012,Labor,0,39000,39000
H000338,N00009869,Orrin G Hatch (R),2012,Ideology/Single-Issue,143800,440378,584178
H000338,N00009869,Orrin G Hatch (R),2012,Other,234273,23000,257273
A000360,N00009888,Lamar Alexander (R),2012,Agribusiness,94544,132477,227021
A000360,N00009888,Lamar Alexander (R),2012,Communic/Electronics,110999,83932,194931
A000360,N00009888,Lamar Alexander (R),2012,Construction,238950,91000,329950
A000360,N00009888,Lamar Alexander (R),2012,Defense,14650,73300,87950
A000360,N00009888,Lamar Alexander (R),2012,Energy/Nat Resource,77050,190500,267550
A000360,N00009888,Lamar Alexander (R),2012,Finance/Insur/RealEst,943054,231100,1174154
A000360,N00009888,Lamar Alexander (R),2012,Health,305061,282900,587961
A000360,N00009888,Lamar Alexander (R),2012,Lawyers & Lobbyists,410275,76750,487025
A000360,N00009888,Lamar Alexander (R),2012,Transportation,93300,123300,216600
A000360,N00009888,Lamar Alexander (R),2012,Misc Business,456766,255900,712666
A000360,N00009888,Lamar Alexander (R),2012,Labor,0,10500,10500
A000360,N00009888,Lamar Alexander (R),2012,Ideology/Single-Issue,33300,328550,361850
A000360,N00009888,Lamar Alexander (R),2012,Other,579382,25400,604782
G000359,N00009975,Lindsey Graham (R),2012,Agribusiness,113281,177750,291031
G000359,N00009975,Lindsey Graham (R),2012,Communic/Electronics,99989,121676,221665
G000359,N00009975,Lindsey Graham (R),2012,Construction,236152,88250,324402
G000359,N00009975,Lindsey Graham (R),2012,Defense,55716,111300,167016
G000359,N00009975,Lindsey Graham (R),2012,Energy/Nat Resource,282569,192202,474771
G000359,N00009975,Lindsey Graham (R),2012,Finance/Insur/RealEst,808347,238350,1046697
G000359,N00009975,Lindsey Graham (R),2012,Health,210998,123500,334498
G000359,N00009975,Lindsey Graham (R),2012,Lawyers & Lobbyists,994924,80203,1075127
G000359,N00009975,Lindsey Graham (R),2012,Transportation,82204,70000,152204
G000359,N00009975,Lindsey Graham (R),2012,Misc Business,510176,249500,759676
G000359,N00009975,Lindsey Graham (R),2012,Labor,0,13500,13500
G000359,N00009975,Lindsey Graham (R),2012,Ideology/Single-Issue,79577,321730,401307
G000359,N00009975,Lindsey Graham (R),2012,Other,365923,2000,367923
C001049,N00012460,William L Clay Jr (D),2012,Agribusiness,750,11000,11750
C001049,N00012460,William L Clay Jr (D),2012,Communic/Electronics,2000,20000,22000
C001049,N00012460,William L Clay Jr (D),2012,Construction,10500,6000,16500
C001049,N00012460,William L Clay Jr (D),2012,Defense,0,17000,17000
C001049,N00012460,William L Clay Jr (D),2012,Energy/Nat Resource,2500,15000,17500
C001049,N00012460,William L Clay Jr (D),2012,Finance/Insur/RealEst,22950,134400,157350
C001049,N00012460,William L Clay Jr (D),2012,Health,8450,44000,52450
C001049,N00012460,William L Clay Jr (D),2012,Lawyers & Lobbyists,46480,23500,69980
C001049,N00012460,William L Clay Jr (D),2012,Transportation,1250,33000,34250
C001049,N00012460,William L Clay Jr (D),2012,Misc Business,29509,68042,97551
C001049,N00012460,William L Clay Jr (D),2012,Labor,0,149200,149200
C001049,N00012460,William L Clay Jr (D),2012,Ideology/Single-Issue,1250,43500,44750
C001049,N00012460,William L Clay Jr (D),2012,Other,34040,1000,35040
C000174,N00012508,Tom Carper (D),2012,Agribusiness,20885,71000,91885
C000174,N00012508,Tom Carper (D),2012,Communic/Electronics,68106,202384,270490
C000174,N00012508,Tom Carper (D),2012,Construction,22660,67750,90410
C000174,N00012508,Tom Carper (D),2012,Defense,2200,61000,63200
C000174,N00012508,Tom Carper (D),2012,Energy/Nat Resource,27790,159110,186900
C000174,N00012508,Tom Carper (D),2012,Finance/Insur/RealEst,458250,816690,1274940
C000174,N00012508,Tom Carper (D),2012,Health,113617,449020,562637
C000174,N00012508,Tom Carper (D),2012,Lawyers & Lobbyists,396254,141451,537705
C000174,N00012508,Tom Carper (D),2012,Transportation,13770,96850,110620
C000174,N00012508,Tom Carper (D),2012,Misc Business,184235,365940,550175
C000174,N00012508,Tom Carper (D),2012,Labor,0,164220,164220
C000174,N00012508,Tom Carper (D),2012,Ideology/Single-Issue,53900,237599,291499
C000174,N00012508,Tom Carper (D),2012,Other,186450,13500,199950
H001034,N00012611,Mike Honda (D),2012,Agribusiness,2050,9000,11050
H001034,N00012611,Mike Honda (D),2012,Communic/Electronics,55100,32750,87850
H001034,N00012611,Mike Honda (D),2012,Construction,4200,9000,13200
H001034,N00012611,Mike Honda (D),2012,Defense,5750,18000,23750
H001034,N00012611,Mike Honda (D),2012,Energy/Nat Resource,3000,8500,11500
H001034,N00012611,Mike Honda (D),2012,Finance/Insur/RealEst,78870,12500,91370
H001034,N00012611,Mike Honda (D),2012,Health,11400,45000,56400
H001034,N00012611,Mike Honda (D),2012,Lawyers & Lobbyists,50986,16000,66986
H001034,N00012611,Mike Honda (D),2012,Transportation,825,7500,8325
H001034,N00012611,Mike Honda (D),2012,Misc Business,59310,19660,78970
H001034,N00012611,Mike Honda (D),2012,Labor,0,129600,129600
H001034,N00012611,Mike Honda (D),2012,Ideology/Single-Issue,45700,29036,74736
H001034,N00012611,Mike Honda (D),2012,Other,68879,0,68879
C001045,N00012739,Ander Crenshaw (R),2012,Agribusiness,3000,21000,24000
C001045,N00012739,Ander Crenshaw (R),2012,Communic/Electronics,10000,10250,20250
C001045,N00012739,Ander Crenshaw (R),2012,Construction,17750,16000,33750
C001045,N00012739,Ander Crenshaw (R),2012,Defense,0,85500,85500
C001045,N00012739,Ander Crenshaw (R),2012,Energy/Nat Resource,1000,13500,14500
C001045,N00012739,Ander Crenshaw (R),2012,Finance/Insur/RealEst,49750,37966,87716
C001045,N00012739,Ander Crenshaw (R),2012,Health,13650,10500,24150
C001045,N00012739,Ander Crenshaw (R),2012,Lawyers & Lobbyists,14500,15750,30250
C001045,N00012739,Ander Crenshaw (R),2012,Transportation,7000,36000,43000
C001045,N00012739,Ander Crenshaw (R),2012,Misc Business,21250,43500,64750
C001045,N00012739,Ander Crenshaw (R),2012,Ideology/Single-Issue,1000,12000,13000
C001045,N00012739,Ander Crenshaw (R),2012,Other,32950,0,32950
C001046,N00013131,Eric Cantor (R),2012,Agribusiness,72150,179000,251150
C001046,N00013131,Eric Cantor (R),2012,Communic/Electronics,140200,231165,371365
C001046,N00013131,Eric Cantor (R),2012,Construction,134800,88000,222800
C001046,N00013131,Eric Cantor (R),2012,Defense,11800,93500,105300
C001046,N00013131,Eric Cantor (R),2012,Energy/Nat Resource,263544,318500,582044
C001046,N00013131,Eric Cantor (R),2012,Finance/Insur/RealEst,1564482,632600,2197082
C001046,N00013131,Eric Cantor (R),2012,Health,237110,510200,747310
C001046,N00013131,Eric Cantor (R),2012,Lawyers & Lobbyists,339431,74250,413681
C001046,N00013131,Eric Cantor (R),2012,Transportation,124850,181500,306350
C001046,N00013131,Eric Cantor (R),2012,Misc Business,417376,410000,827376
C001046,N00013131,Eric Cantor (R),2012,Labor,0,33000,33000
C001046,N00013131,Eric Cantor (R),2012,Ideology/Single-Issue,260190,65634,325824
C001046,N00013131,Eric Cantor (R),2012,Other,394357,11500,405857
G000546,N00013323,Sam Graves (R),2012,Agribusiness,11430,133750,145180
G000546,N00013323,Sam Graves (R),2012,Communic/Electronics,12450,78500,90950
G000546,N00013323,Sam Graves (R),2012,Construction,38400,98999,137399
G000546,N00013323,Sam Graves (R),2012,Defense,0,16500,16500
G000546,N00013323,Sam Graves (R),2012,Energy/Nat Resource,11500,48500,60000
G000546,N00013323,Sam Graves (R),2012,Finance/Insur/RealEst,20497,110200,130697
G000546,N00013323,Sam Graves (R),2012,Health,9100,104000,113100
G000546,N00013323,Sam Graves (R),2012,Lawyers & Lobbyists,19950,22000,41950
G000546,N00013323,Sam Graves (R),2012,Transportation,41250,194188,235438
G000546,N00013323,Sam Graves (R),2012,Misc Business,22198,170000,192198
G000546,N00013323,Sam Graves (R),2012,Labor,0,60500,60500
G000546,N00013323,Sam Graves (R),2012,Ideology/Single-Issue,10500,7000,17500
G000546,N00013323,Sam Graves (R),2012,Other,6450,1000,7450
F000445,N00013799,Randy Forbes (R),2012,Agribusiness,19050,23500,42550
F000445,N00013799,Randy Forbes (R),2012,Communic/Electronics,3500,25500,29000
F000445,N00013799,Randy Forbes (R),2012,Construction,42233,27000,69233
F000445,N00013799,Randy Forbes (R),2012,Defense,26300,108000,134300
F000445,N00013799,Randy Forbes (R),2012,Energy/Nat Resource,21200,11500,32700
F000445,N00013799,Randy Forbes (R),2012,Finance/Insur/RealEst,55957,51344,107301
F000445,N00013799,Randy Forbes (R),2012,Health,28150,20000,48150
F000445,N00013799,Randy Forbes (R),2012,Lawyers & Lobbyists,30383,8250,38633
F000445,N00013799,Randy Forbes (R),2012,Transportation,53890,27492,81382
F000445,N00013799,Randy Forbes (R),2012,Misc Business,29700,32500,62200
F000445,N00013799,Randy Forbes (R),2012,Labor,0,14000,14000
F000445,N00013799,Randy Forbes (R),2012,Ideology/Single-Issue,3800,13000,16800
F000445,N00013799,Randy Forbes (R),2012,Other,92208,5000,97208
B001236,N00013873,John Boozman (R),2012,Agribusiness,121719,52200,173919
B001236,N00013873,John Boozman (R),2012,Communic/Electronics,26196,36750,62946
B001236,N00013873,John Boozman (R),2012,Construction,103800,78000,181800
B001236,N00013873,John Boozman (R),2012,Defense,1250,2000,3250
B001236,N00013873,John Boozman (R),2012,Energy/Nat Resource,123350,59500,182850
B001236,N00013873,John Boozman (R),2012,Finance/Insur/RealEst,463359,102500,565859
B001236,N00013873,John Boozman (R),2012,Health,221314,95500,316814
B001236,N00013873,John Boozman (R),2012,Lawyers & Lobbyists,137134,21216,158350
B001236,N00013873,John Boozman (R),2012,Transportation,52845,124400,177245
B001236,N00013873,John Boozman (R),2012,Misc Business,286226,82300,368526
B001236,N00013873,John Boozman (R),2012,Labor,0,14000,14000
B001236,N00013873,John Boozman (R),2012,Ideology/Single-Issue,91498,253521,345019
B001236,N00013873,John Boozman (R),2012,Other,372154,1500,373654
C001077,N00024753,Mike Coffman (R),2012,Agribusiness,20205,31250,51455
C001077,N00024753,Mike Coffman (R),2012,Communic/Electronics,67754,52000,119754
C001077,N00024753,Mike Coffman (R),2012,Construction,37850,47000,84850
C001077,N00024753,Mike Coffman (R),2012,Defense,2900,95500,98400
C001077,N00024753,Mike Coffman (R),2012,Energy/Nat Resource,166756,140250,307006
C001077,N00024753,Mike Coffman (R),2012,Finance/Insur/RealEst,300777,96500,397277
C001077,N00024753,Mike Coffman (R),2012,Health,44325,60500,104825
C001077,N00024753,Mike Coffman (R),2012,Lawyers & Lobbyists,107353,8750,116103
C001077,N00024753,Mike Coffman (R),2012,Transportation,51980,29500,81480
C001077,N00024753,Mike Coffman (R),2012,Misc Business,133662,72000,205662
C001077,N00024753,Mike Coffman (R),2012,Ideology/Single-Issue,63985,365577,429562
C001077,N00024753,Mike Coffman (R),2012,Other,270465,4250,274715
G000550,N00024760,Phil Gingrey (R),2012,Agribusiness,6750,16000,22750
G000550,N00024760,Phil Gingrey (R),2012,Communic/Electronics,13000,105350,118350
G000550,N00024760,Phil Gingrey (R),2012,Construction,40750,24000,64750
G000550,N00024760,Phil Gingrey (R),2012,Defense,5500,23500,29000
G000550,N00024760,Phil Gingrey (R),2012,Energy/Nat Resource,9750,70500,80250
G000550,N00024760,Phil Gingrey (R),2012,Finance/Insur/RealEst,104000,91000,195000
G000550,N00024760,Phil Gingrey (R),2012,Health,176350,350150,526500
G000550,N00024760,Phil Gingrey (R),2012,Lawyers & Lobbyists,58450,22250,80700
G000550,N00024760,Phil Gingrey (R),2012,Transportation,25800,29000,54800
G000550,N00024760,Phil Gingrey (R),2012,Misc Business,46100,96250,142350
G000550,N00024760,Phil Gingrey (R),2012,Ideology/Single-Issue,5250,17600,22850
G000550,N00024760,Phil Gingrey (R),2012,Other,64600,1000,65600
C001069,N00024842,Joe Courtney (D),2012,Agribusiness,7250,76411,83661
C001069,N00024842,Joe Courtney (D),2012,Communic/Electronics,10650,19000,29650
C001069,N00024842,Joe Courtney (D),2012,Construction,10450,14500,24950
C001069,N00024842,Joe Courtney (D),2012,Defense,20500,108500,129000
C001069,N00024842,Joe Courtney (D),2012,Energy/Nat Resource,3150,21500,24650
C001069,N00024842,Joe Courtney (D),2012,Finance/Insur/RealEst,86100,74250,160350
C001069,N00024842,Joe Courtney (D),2012,Health,32300,134300,166600
C001069,N00024842,Joe Courtney (D),2012,Lawyers & Lobbyists,115829,15750,131579
C001069,N00024842,Joe Courtney (D),2012,Transportation,6700,9000,15700
C001069,N00024842,Joe Courtney (D),2012,Misc Business,55100,25553,80653
C001069,N00024842,Joe Courtney (D),2012,Labor,500,185750,186250
C001069,N00024842,Joe Courtney (D),2012,Ideology/Single-Issue,6100,21250,27350
C001069,N00024842,Joe Courtney (D),2012,Other,102012,2500,104512
C001056,N00024852,John Cornyn (R),2012,Agribusiness,516956,222750,739706
C001056,N00024852,John Cornyn (R),2012,Communic/Electronics,242350,251745,494095
C001056,N00024852,John Cornyn (R),2012,Construction,522934,114500,637434
C001056,N00024852,John Cornyn (R),2012,Defense,66500,201076,267576
C001056,N00024852,John Cornyn (R),2012,Energy/Nat Resource,1119315,368106,1487421
C001056,N00024852,John Cornyn (R),2012,Finance/Insur/RealEst,2549921,564222,3114143
C001056,N00024852,John Cornyn (R),2012,Health,994381,515656,1510037
C001056,N00024852,John Cornyn (R),2012,Lawyers & Lobbyists,1275298,156675,1431973
C001056,N00024852,John Cornyn (R),2012,Transportation,288991,147450,436441
C001056,N00024852,John Cornyn (R),2012,Misc Business,1238907,379816,1618723
C001056,N00024852,John Cornyn (R),2012,Labor,250,27000,27250
C001056,N00024852,John Cornyn (R),2012,Ideology/Single-Issue,238571,393422,631993
C001056,N00024852,John Cornyn (R),2012,Other,1236068,0,1236068
B001245,N00024866,Madeleine Z Bordallo (D),2012,Agribusiness,10650,0,10650
B001245,N00024866,Madeleine Z Bordallo (D),2012,Communic/Electronics,1500,0,1500
B001245,N00024866,Madeleine Z Bordallo (D),2012,Construction,4450,2200,6650
B001245,N00024866,Madeleine Z Bordallo (D),2012,Defense,9950,13200,23150
B001245,N00024866,Madeleine Z Bordallo (D),2012,Finance/Insur/RealEst,34324,2000,36324
B001245,N00024866,Madeleine Z Bordallo (D),2012,Health,2660,-100,2560
B001245,N00024866,Madeleine Z Bordallo (D),2012,Lawyers & Lobbyists,4000,1000,5000
B001245,N00024866,Madeleine Z Bordallo (D),2012,Transportation,3750,5950,9700
B001245,N00024866,Madeleine Z Bordallo (D),2012,Misc Business,23240,0,23240
B001245,N00024866,Madeleine Z Bordallo (D),2012,Labor,1000,1000,2000
B001245,N00024866,Madeleine Z Bordallo (D),2012,Ideology/Single-Issue,300,3000,3300
B001245,N00024866,Madeleine Z Bordallo (D),2012,Other,10160,0,10160
H001036,N00024922,Jeb Hensarling (R),2012,Agribusiness,26650,58500,85150
H001036,N00024922,Jeb Hensarling (R),2012,Communic/Electronics,11201,61500,72701
H001036,N00024922,Jeb Hensarling (R),2012,Construction,38950,29000,67950
H001036,N00024922,Jeb Hensarling (R),2012,Defense,1500,25000,26500
H001036,N00024922,Jeb Hensarling (R),2012,Energy/Nat Resource,108950,104000,212950
H001036,N00024922,Jeb Hensarling (R),2012,Finance/Insur/RealEst,504456,831150,1335606
H001036,N00024922,Jeb Hensarling (R),2012,Health,40500,144000,184500
H001036,N00024922,Jeb Hensarling (R),2012,Lawyers & Lobbyists,123622,61650,185272
H001036,N00024922,Jeb Hensarling (R),2012,Transportation,14000,62000,76000
H001036,N00024922,Jeb Hensarling (R),2012,Misc Business,121400,99000,220400
H001036,N00024922,Jeb Hensarling (R),2012,Labor,0,3000,3000
H001036,N00024922,Jeb Hensarling (R),2012,Ideology/Single-Issue,34750,9750,44500
H001036,N00024922,Jeb Hensarling (R),2012,Other,124250,0,124250
C001063,N00024978,Henry Cuellar (D),2012,Agribusiness,37950,123647,161597
C001063,N00024978,Henry Cuellar (D),2012,Communic/Electronics,10500,41000,51500
C001063,N00024978,Henry Cuellar (D),2012,Construction,87600,33750,121350
C001063,N00024978,Henry Cuellar (D),2012,Defense,0,50000,50000
C001063,N00024978,Henry Cuellar (D),2012,Energy/Nat Resource,25125,110250,135375
C001063,N00024978,Henry Cuellar (D),2012,Finance/Insur/RealEst,87907,104000,191907
C001063,N00024978,Henry Cuellar (D),2012,Health,60200,64250,124450
C001063,N00024978,Henry Cuellar (D),2012,Lawyers & Lobbyists,80579,21000,101579
C001063,N00024978,Henry Cuellar (D),2012,Transportation,26100,56500,82600
C001063,N00024978,Henry Cuellar (D),2012,Misc Business,119852,104999,224851
C001063,N00024978,Henry Cuellar (D),2012,Labor,0,50500,50500
C001063,N00024978,Henry Cuellar (D),2012,Ideology/Single-Issue,3000,25500,28500
C001063,N00024978,Henry Cuellar (D),2012,Other,31100,1500,32600
G000549,N00025025,Jim Gerlach (R),2012,Agribusiness,10750,27500,38250
G000549,N00025025,Jim Gerlach (R),2012,Communic/Electronics,17500,70000,87500
G000549,N00025025,Jim Gerlach (R),2012,Construction,33650,59500,93150
G000549,N00025025,Jim Gerlach (R),2012,Defense,333,24250,24583
G000549,N00025025,Jim Gerlach (R),2012,Energy/Nat Resource,9750,96000,105750
G000549,N00025025,Jim Gerlach (R),2012,Finance/Insur/RealEst,141600,332622,474222
G000549,N00025025,Jim Gerlach (R),2012,Health,74950,355745,430695
G000549,N00025025,Jim Gerlach (R),2012,Lawyers & Lobbyists,128499,48250,176749
G000549,N00025025,Jim Gerlach (R),2012,Transportation,20500,61000,81500
G000549,N00025025,Jim Gerlach (R),2012,Misc Business,95603,138553,234156
G000549,N00025025,Jim Gerlach (R),2012,Labor,0,82000,82000
G000549,N00025025,Jim Gerlach (R),2012,Ideology/Single-Issue,20900,56579,77479
G000549,N00025025,Jim Gerlach (R),2012,Other,65800,7500,73300
C001051,N00025095,John Carter (R),2012,Agribusiness,30500,37647,68147
C001051,N00025095,John Carter (R),2012,Communic/Electronics,7750,64000,71750
C001051,N00025095,John Carter (R),2012,Construction,61550,30000,91550
C001051,N00025095,John Carter (R),2012,Defense,500,45000,45500
C001051,N00025095,John Carter (R),2012,Energy/Nat Resource,14150,64300,78450
C001051,N00025095,John Carter (R),2012,Finance/Insur/RealEst,97759,49000,146759
C001051,N00025095,John Carter (R),2012,Health,34275,22500,56775
C001051,N00025095,John Carter (R),2012,Lawyers & Lobbyists,39769,8500,48269
C001051,N00025095,John Carter (R),2012,Transportation,10500,43000,53500
C001051,N00025095,John Carter (R),2012,Misc Business,38250,42000,80250
C001051,N00025095,John Carter (R),2012,Labor,0,7500,7500
C001051,N00025095,John Carter (R),2012,Ideology/Single-Issue,4000,18950,22950
C001051,N00025095,John Carter (R),2012,Other,38500,0,38500
B001248,N00025219,Michael Burgess (R),2012,Agribusiness,0,8508,8508
B001248,N00025219,Michael Burgess (R),2012,Communic/Electronics,5750,47500,53250
B001248,N00025219,Michael Burgess (R),2012,Construction,1500,4000,5500
B001248,N00025219,Michael Burgess (R),2012,Defense,0,16000,16000
B001248,N00025219,Michael Burgess (R),2012,Energy/Nat Resource,3500,101000,104500
B001248,N00025219,Michael Burgess (R),2012,Finance/Insur/RealEst,8950,50500,59450
B001248,N00025219,Michael Burgess (R),2012,Health,46638,519750,566388
B001248,N00025219,Michael Burgess (R),2012,Lawyers & Lobbyists,42144,23500,65644
B001248,N00025219,Michael Burgess (R),2012,Transportation,500,24000,24500
B001248,N00025219,Michael Burgess (R),2012,Misc Business,7500,38000,45500
B001248,N00025219,Michael Burgess (R),2012,Labor,0,500,500
B001248,N00025219,Michael Burgess (R),2012,Ideology/Single-Issue,500,18000,18500
B001248,N00025219,Michael Burgess (R),2012,Other,15650,0,15650
G000551,N00025284,Raul M Grijalva (D),2012,Agribusiness,12750,5500,18250
G000551,N00025284,Raul M Grijalva (D),2012,Communic/Electronics,1750,6000,7750
G000551,N00025284,Raul M Grijalva (D),2012,Construction,5630,2000,7630
G000551,N00025284,Raul M Grijalva (D),2012,Defense,3500,3000,6500
G000551,N00025284,Raul M Grijalva (D),2012,Energy/Nat Resource,3200,12603,15803
G000551,N00025284,Raul M Grijalva (D),2012,Finance/Insur/RealEst,15750,12500,28250
G000551,N00025284,Raul M Grijalva (D),2012,Health,3750,11500,15250
G000551,N00025284,Raul M Grijalva (D),2012,Lawyers & Lobbyists,51700,10500,62200
G000551,N00025284,Raul M Grijalva (D),2012,Transportation,0,3500,3500
G000551,N00025284,Raul M Grijalva (D),2012,Misc Business,62675,10541,73216
G000551,N00025284,Raul M Grijalva (D),2012,Labor,1745,180000,181745
G000551,N00025284,Raul M Grijalva (D),2012,Ideology/Single-Issue,34603,75022,109625
G000551,N00025284,Raul M Grijalva (D),2012,Other,64725,0,64725
B001250,N00025292,Rob Bishop (R),2012,Agribusiness,2250,11000,13250
B001250,N00025292,Rob Bishop (R),2012,Communic/Electronics,14250,3000,17250
B001250,N00025292,Rob Bishop (R),2012,Construction,0,5000,5000
B001250,N00025292,Rob Bishop (R),2012,Defense,0,33000,33000
B001250,N00025292,Rob Bishop (R),2012,Energy/Nat Resource,7000,77000,84000
B001250,N00025292,Rob Bishop (R),2012,Finance/Insur/RealEst,25000,31500,56500
B001250,N00025292,Rob Bishop (R),2012,Health,4254,14000,18254
B001250,N00025292,Rob Bishop (R),2012,Lawyers & Lobbyists,24000,5500,29500
B001250,N00025292,Rob Bishop (R),2012,Transportation,1750,24000,25750
B001250,N00025292,Rob Bishop (R),2012,Misc Business,5850,22500,28350
B001250,N00025292,Rob Bishop (R),2012,Labor,0,0,0
B001250,N00025292,Rob Bishop (R),2012,Ideology/Single-Issue,1500,14100,15600
B001250,N00025292,Rob Bishop (R),2012,Other,2550,0,2550
B001244,N00025330,Jo Bonner (R),2012,Agribusiness,11500,65000,76500
B001244,N00025330,Jo Bonner (R),2012,Communic/Electronics,5450,12000,17450
B001244,N00025330,Jo Bonner (R),2012,Construction,34650,30500,65150
B001244,N00025330,Jo Bonner (R),2012,Defense,10350,75500,85850
B001244,N00025330,Jo Bonner (R),2012,Energy/Nat Resource,2000,41000,43000
B001244,N00025330,Jo Bonner (R),2012,Finance/Insur/RealEst,96200,50000,146200
B001244,N00025330,Jo Bonner (R),2012,Health,37525,36500,74025
B001244,N00025330,Jo Bonner (R),2012,Lawyers & Lobbyists,62050,30000,92050
B001244,N00025330,Jo Bonner (R),2012,Transportation,26900,39534,66434
B001244,N00025330,Jo Bonner (R),2012,Misc Business,42050,57500,99550
B001244,N00025330,Jo Bonner (R),2012,Ideology/Single-Issue,16875,70492,87367
B001244,N00025330,Jo Bonner (R),2012,Other,82200,0,82200
D000600,N00025337,Mario Diaz-Balart (R),2012,Agribusiness,7590,36500,44090
D000600,N00025337,Mario Diaz-Balart (R),2012,Communic/Electronics,3500,37500,41000
D000600,N00025337,Mario Diaz-Balart (R),2012,Construction,6500,30000,36500
D000600,N00025337,Mario Diaz-Balart (R),2012,Defense,1000,25500,26500
D000600,N00025337,Mario Diaz-Balart (R),2012,Energy/Nat Resource,11700,18750,30450
D000600,N00025337,Mario Diaz-Balart (R),2012,Finance/Insur/RealEst,50450,51000,101450
D000600,N00025337,Mario Diaz-Balart (R),2012,Health,53500,16500,70000
D000600,N00025337,Mario Diaz-Balart (R),2012,Lawyers & Lobbyists,40750,16250,57000
D000600,N00025337,Mario Diaz-Balart (R),2012,Transportation,32000,59000,91000
D000600,N00025337,Mario Diaz-Balart (R),2012,Misc Business,36750,58303,95053
D000600,N00025337,Mario Diaz-Balart (R),2012,Labor,250,83500,83750
D000600,N00025337,Mario Diaz-Balart (R),2012,Ideology/Single-Issue,39250,43000,82250
D000600,N00025337,Mario Diaz-Balart (R),2012,Other,13000,0,13000
B001242,N00025413,Timothy H Bishop (D),2012,Agribusiness,4012,19500,23512
B001242,N00025413,Timothy H Bishop (D),2012,Communic/Electronics,55556,28833,84389
B001242,N00025413,Timothy H Bishop (D),2012,Construction,53175,43850,97025
B001242,N00025413,Timothy H Bishop (D),2012,Defense,1000,14000,15000
B001242,N00025413,Timothy H Bishop (D),2012,Energy/Nat Resource,22200,17857,40057
B001242,N00025413,Timothy H Bishop (D),2012,Finance/Insur/RealEst,165076,84700,249776
B001242,N00025413,Timothy H Bishop (D),2012,Health,64400,83000,147400
B001242,N00025413,Timothy H Bishop (D),2012,Lawyers & Lobbyists,125024,19750,144774
B001242,N00025413,Timothy H Bishop (D),2012,Transportation,32950,70623,103573
B001242,N00025413,Timothy H Bishop (D),2012,Misc Business,90150,21804,111954
B001242,N00025413,Timothy H Bishop (D),2012,Labor,1250,339750,341000
B001242,N00025413,Timothy H Bishop (D),2012,Ideology/Single-Issue,96607,293169,389776
B001242,N00025413,Timothy H Bishop (D),2012,Other,304282,13750,318032
A000361,N00025464,Rodney Alexander (R),2012,Agribusiness,64500,67100,131600
A000361,N00025464,Rodney Alexander (R),2012,Communic/Electronics,3250,26000,29250
A000361,N00025464,Rodney Alexander (R),2012,Construction,89940,22500,112440
A000361,N00025464,Rodney Alexander (R),2012,Defense,0,25000,25000
A000361,N00025464,Rodney Alexander (R),2012,Energy/Nat Resource,39638,66000,105638
A000361,N00025464,Rodney Alexander (R),2012,Finance/Insur/RealEst,94656,48500,143156
A000361,N00025464,Rodney Alexander (R),2012,Health,109166,58000,167166
A000361,N00025464,Rodney Alexander (R),2012,Lawyers & Lobbyists,92581,27729,120310
A000361,N00025464,Rodney Alexander (R),2012,Transportation,21000,26500,47500
A000361,N00025464,Rodney Alexander (R),2012,Misc Business,75711,40200,115911
A000361,N00025464,Rodney Alexander (R),2012,Labor,0,28500,28500
A000361,N00025464,Rodney Alexander (R),2012,Ideology/Single-Issue,12650,43000,55650
A000361,N00025464,Rodney Alexander (R),2012,Other,42450,0,42450
B001269,N00025495,Lou Barletta (R),2012,Agribusiness,2300,15000,17300
B001269,N00025495,Lou Barletta (R),2012,Communic/Electronics,5620,23500,29120
B001269,N00025495,Lou Barletta (R),2012,Construction,37075,47617,84692
B001269,N00025495,Lou Barletta (R),2012,Defense,0,4000,4000
B001269,N00025495,Lou Barletta (R),2012,Energy/Nat Resource,5550,51000,56550
B001269,N00025495,Lou Barletta (R),2012,Finance/Insur/RealEst,50696,90500,141196
B001269,N00025495,Lou Barletta (R),2012,Health,38300,30000,68300
B001269,N00025495,Lou Barletta (R),2012,Lawyers & Lobbyists,38765,3250,42015
B001269,N00025495,Lou Barletta (R),2012,Transportation,29875,85764,115639
B001269,N00025495,Lou Barletta (R),2012,Misc Business,62862,67525,130387
B001269,N00025495,Lou Barletta (R),2012,Labor,0,48500,48500
B001269,N00025495,Lou Barletta (R),2012,Ideology/Single-Issue,8047,132387,140434
B001269,N00025495,Lou Barletta (R),2012,Other,60680,2500,63180
C001053,N00025726,Tom Cole (R),2012,Agribusiness,6750,15000,21750
C001053,N00025726,Tom Cole (R),2012,Communic/Electronics,5750,20250,26000
C001053,N00025726,Tom Cole (R),2012,Construction,18500,13000,31500
C001053,N00025726,Tom Cole (R),2012,Defense,2250,69000,71250
C001053,N00025726,Tom Cole (R),2012,Energy/Nat Resource,58450,99500,157950
C001053,N00025726,Tom Cole (R),2012,Finance/Insur/RealEst,108900,58500,167400
C001053,N00025726,Tom Cole (R),2012,Health,14500,16500,31000
C001053,N00025726,Tom Cole (R),2012,Lawyers & Lobbyists,47842,14250,62092
C001053,N00025726,Tom Cole (R),2012,Transportation,21500,29489,50989
C001053,N00025726,Tom Cole (R),2012,Misc Business,41499,65460,106959
C001053,N00025726,Tom Cole (R),2012,Labor,0,5500,5500
C001053,N00025726,Tom Cole (R),2012,Ideology/Single-Issue,102190,14000,116190
C001053,N00025726,Tom Cole (R),2012,Other,44350,500,44850
H001050,N00025881,Colleen Hanabusa (D),2012,Agribusiness,3500,18500,22000
H001050,N00025881,Colleen Hanabusa (D),2012,Communic/Electronics,19750,13000,32750
H001050,N00025881,Colleen Hanabusa (D),2012,Construction,96150,2500,98650
H001050,N00025881,Colleen Hanabusa (D),2012,Defense,12600,78000,90600
H001050,N00025881,Colleen Hanabusa (D),2012,Energy/Nat Resource,9500,6500,16000
H001050,N00025881,Colleen Hanabusa (D),2012,Finance/Insur/RealEst,94210,35000,129210
H001050,N00025881,Colleen Hanabusa (D),2012,Health,33550,28500,62050
H001050,N00025881,Colleen Hanabusa (D),2012,Lawyers & Lobbyists,95386,17000,112386
H001050,N00025881,Colleen Hanabusa (D),2012,Transportation,19500,34500,54000
H001050,N00025881,Colleen Hanabusa (D),2012,Misc Business,68000,19500,87500
H001050,N00025881,Colleen Hanabusa (D),2012,Labor,5400,188850,194250
H001050,N00025881,Colleen Hanabusa (D),2012,Ideology/Single-Issue,20050,32831,52881
H001050,N00025881,Colleen Hanabusa (D),2012,Other,100550,4500,105050
C001062,N00026041,Mike Conaway (R),2012,Agribusiness,95581,211397,306978
C001062,N00026041,Mike Conaway (R),2012,Communic/Electronics,2250,41000,43250
C001062,N00026041,Mike Conaway (R),2012,Construction,22321,11500,33821
C001062,N00026041,Mike Conaway (R),2012,Defense,0,75000,75000
C001062,N00026041,Mike Conaway (R),2012,Energy/Nat Resource,122336,79500,201836
C001062,N00026041,Mike Conaway (R),2012,Finance/Insur/RealEst,77550,149499,227049
C001062,N00026041,Mike Conaway (R),2012,Health,18350,16000,34350
C001062,N00026041,Mike Conaway (R),2012,Lawyers & Lobbyists,41387,15500,56887
C001062,N00026041,Mike Conaway (R),2012,Transportation,3900,11500,15400
C001062,N00026041,Mike Conaway (R),2012,Misc Business,32850,29500,62350
C001062,N00026041,Mike Conaway (R),2012,Labor,0,2000,2000
C001062,N00026041,Mike Conaway (R),2012,Ideology/Single-Issue,2750,17000,19750
C001062,N00026041,Mike Conaway (R),2012,Other,60075,1500,61575
B001252,N00026080,John Barrow (D),2012,Agribusiness,19750,112500,132250
B001252,N00026080,John Barrow (D),2012,Communic/Electronics,35250,149620,184870
B001252,N00026080,John Barrow (D),2012,Construction,2253,34500,36753
B001252,N00026080,John Barrow (D),2012,Defense,3000,38750,41750
B001252,N00026080,John Barrow (D),2012,Energy/Nat Resource,26379,210150,236529
B001252,N00026080,John Barrow (D),2012,Finance/Insur/RealEst,63975,212000,275975
B001252,N00026080,John Barrow (D),2012,Health,44110,316500,360610
B001252,N00026080,John Barrow (D),2012,Lawyers & Lobbyists,442370,56755,499125
B001252,N00026080,John Barrow (D),2012,Transportation,12250,77558,89808
B001252,N00026080,John Barrow (D),2012,Misc Business,71050,187250,258300
B001252,N00026080,John Barrow (D),2012,Labor,0,152550,152550
B001252,N00026080,John Barrow (D),2012,Ideology/Single-Issue,27751,240400,268151
B001252,N00026080,John Barrow (D),2012,Other,84637,1500,86137
G000552,N00026148,Louis B Gohmert Jr (R),2012,Agribusiness,21000,20508,41508
G000552,N00026148,Louis B Gohmert Jr (R),2012,Communic/Electronics,1250,22500,23750
G000552,N00026148,Louis B Gohmert Jr (R),2012,Construction,24250,2500,26750
G000552,N00026148,Louis B Gohmert Jr (R),2012,Defense,0,2000,2000
G000552,N00026148,Louis B Gohmert Jr (R),2012,Energy/Nat Resource,47950,27000,74950
G000552,N00026148,Louis B Gohmert Jr (R),2012,Finance/Insur/RealEst,105500,4000,109500
G000552,N00026148,Louis B Gohmert Jr (R),2012,Health,55737,5500,61237
G000552,N00026148,Louis B Gohmert Jr (R),2012,Lawyers & Lobbyists,20750,0,20750
G000552,N00026148,Louis B Gohmert Jr (R),2012,Transportation,4750,11500,16250
G000552,N00026148,Louis B Gohmert Jr (R),2012,Misc Business,28050,6000,34050
G000552,N00026148,Louis B Gohmert Jr (R),2012,Labor,0,1000,1000
G000552,N00026148,Louis B Gohmert Jr (R),2012,Ideology/Single-Issue,2750,14200,16950
G000552,N00026148,Louis B Gohmert Jr (R),2012,Other,116800,0,116800
F000450,N00026166,Virginia Foxx (R),2012,Agribusiness,15200,29500,44700
F000450,N00026166,Virginia Foxx (R),2012,Communic/Electronics,7690,16000,23690
F000450,N00026166,Virginia Foxx (R),2012,Construction,18725,16500,35225
F000450,N00026166,Virginia Foxx (R),2012,Defense,0,3000,3000
F000450,N00026166,Virginia Foxx (R),2012,Energy/Nat Resource,3750,18000,21750
F000450,N00026166,Virginia Foxx (R),2012,Finance/Insur/RealEst,51635,44249,95884
F000450,N00026166,Virginia Foxx (R),2012,Health,36958,23500,60458
F000450,N00026166,Virginia Foxx (R),2012,Lawyers & Lobbyists,17040,11500,28540
F000450,N00026166,Virginia Foxx (R),2012,Transportation,11500,28000,39500
F000450,N00026166,Virginia Foxx (R),2012,Misc Business,76916,53500,130416
F000450,N00026166,Virginia Foxx (R),2012,Ideology/Single-Issue,17450,30752,48202
F000450,N00026166,Virginia Foxx (R),2012,Other,161393,35584,196977
D000604,N00026171,Charlie Dent (R),2012,Agribusiness,17300,17750,35050
D000604,N00026171,Charlie Dent (R),2012,Communic/Electronics,16000,58500,74500
D000604,N00026171,Charlie Dent (R),2012,Construction,36550,78500,115050
D000604,N00026171,Charlie Dent (R),2012,Defense,3000,40500,43500
D000604,N00026171,Charlie Dent (R),2012,Energy/Nat Resource,46100,94750,140850
D000604,N00026171,Charlie Dent (R),2012,Finance/Insur/RealEst,115450,57863,173313
D000604,N00026171,Charlie Dent (R),2012,Health,59706,182539,242245
D000604,N00026171,Charlie Dent (R),2012,Lawyers & Lobbyists,63993,18650,82643
D000604,N00026171,Charlie Dent (R),2012,Transportation,42450,51000,93450
D000604,N00026171,Charlie Dent (R),2012,Misc Business,118200,101500,219700
D000604,N00026171,Charlie Dent (R),2012,Labor,2500,51500,54000
D000604,N00026171,Charlie Dent (R),2012,Ideology/Single-Issue,20375,56000,76375
D000604,N00026171,Charlie Dent (R),2012,Other,112325,2500,114825
C001059,N00026341,Jim Costa (D),2012,Agribusiness,172074,224142,396216
C001059,N00026341,Jim Costa (D),2012,Communic/Electronics,5950,26500,32450
C001059,N00026341,Jim Costa (D),2012,Construction,25500,18500,44000
C001059,N00026341,Jim Costa (D),2012,Defense,500,0,500
C001059,N00026341,Jim Costa (D),2012,Energy/Nat Resource,17500,108600,126100
C001059,N00026341,Jim Costa (D),2012,Finance/Insur/RealEst,99300,38750,138050
C001059,N00026341,Jim Costa (D),2012,Health,57200,23500,80700
C001059,N00026341,Jim Costa (D),2012,Lawyers & Lobbyists,69000,11750,80750
C001059,N00026341,Jim Costa (D),2012,Transportation,7250,20500,27750
C001059,N00026341,Jim Costa (D),2012,Misc Business,68700,48000,116700
C001059,N00026341,Jim Costa (D),2012,Labor,0,115960,115960
C001059,N00026341,Jim Costa (D),2012,Ideology/Single-Issue,12500,55500,68000
C001059,N00026341,Jim Costa (D),2012,Other,60344,0,60344
D000607,N00026586,Joe Donnelly (D),2012,Agribusiness,35891,52000,87891
D000607,N00026586,Joe Donnelly (D),2012,Communic/Electronics,112412,5750,118162
D000607,N00026586,Joe Donnelly (D),2012,Construction,95910,15500,111410
D000607,N00026586,Joe Donnelly (D),2012,Defense,28733,7000,35733
D000607,N00026586,Joe Donnelly (D),2012,Energy/Nat Resource,37700,52000,89700
D000607,N00026586,Joe Donnelly (D),2012,Finance/Insur/RealEst,381574,140610,522184
D000607,N00026586,Joe Donnelly (D),2012,Health,160212,80921,241133
D000607,N00026586,Joe Donnelly (D),2012,Lawyers & Lobbyists,723403,46500,769903
D000607,N00026586,Joe Donnelly (D),2012,Transportation,19300,30500,49800
D000607,N00026586,Joe Donnelly (D),2012,Misc Business,251418,37500,288918
D000607,N00026586,Joe Donnelly (D),2012,Labor,5540,325000,330540
D000607,N00026586,Joe Donnelly (D),2012,Ideology/Single-Issue,124980,502972,627952
D000607,N00026586,Joe Donnelly (D),2012,Other,500746,2000,502746
B001255,N00026595,Charles W Boustany Jr (R),2012,Agribusiness,76400,122000,198400
B001255,N00026595,Charles W Boustany Jr (R),2012,Communic/Electronics,44500,50499,94999
B001255,N00026595,Charles W Boustany Jr (R),2012,Construction,127467,65500,192967
B001255,N00026595,Charles W Boustany Jr (R),2012,Defense,4800,46000,50800
B001255,N00026595,Charles W Boustany Jr (R),2012,Energy/Nat Resource,196120,199250,395370
B001255,N00026595,Charles W Boustany Jr (R),2012,Finance/Insur/RealEst,196791,489700,686491
B001255,N00026595,Charles W Boustany Jr (R),2012,Health,299345,684405,983750
B001255,N00026595,Charles W Boustany Jr (R),2012,Lawyers & Lobbyists,241209,66887,308096
B001255,N00026595,Charles W Boustany Jr (R),2012,Transportation,64900,95000,159900
B001255,N00026595,Charles W Boustany Jr (R),2012,Misc Business,150700,231500,382200
B001255,N00026595,Charles W Boustany Jr (R),2012,Labor,0,16500,16500
B001255,N00026595,Charles W Boustany Jr (R),2012,Ideology/Single-Issue,103675,142000,245675
B001255,N00026595,Charles W Boustany Jr (R),2012,Other,110767,1000,111767
F000449,N00026631,Jeff Fortenberry (R),2012,Agribusiness,18350,46750,65100
F000449,N00026631,Jeff Fortenberry (R),2012,Communic/Electronics,11300,9000,20300
F000449,N00026631,Jeff Fortenberry (R),2012,Construction,8000,7500,15500
F000449,N00026631,Jeff Fortenberry (R),2012,Defense,0,17000,17000
F000449,N00026631,Jeff Fortenberry (R),2012,Energy/Nat Resource,750,23000,23750
F000449,N00026631,Jeff Fortenberry (R),2012,Finance/Insur/RealEst,49310,72000,121310
F000449,N00026631,Jeff Fortenberry (R),2012,Health,54567,16500,71067
F000449,N00026631,Jeff Fortenberry (R),2012,Lawyers & Lobbyists,25000,5000,30000
F000449,N00026631,Jeff Fortenberry (R),2012,Transportation,4750,22500,27250
F000449,N00026631,Jeff Fortenberry (R),2012,Misc Business,36350,11500,47850
F000449,N00026631,Jeff Fortenberry (R),2012,Labor,0,1000,1000
F000449,N00026631,Jeff Fortenberry (R),2012,Ideology/Single-Issue,10850,30000,40850
F000449,N00026631,Jeff Fortenberry (R),2012,Other,34050,500,34550
G000553,N00026686,Al Green (D),2012,Agribusiness,3050,1500,4550
G000553,N00026686,Al Green (D),2012,Communic/Electronics,3500,4500,8000
G000553,N00026686,Al Green (D),2012,Construction,2750,9000,11750
G000553,N00026686,Al Green (D),2012,Defense,0,0,0
G000553,N00026686,Al Green (D),2012,Energy/Nat Resource,8600,4000,12600
G000553,N00026686,Al Green (D),2012,Finance/Insur/RealEst,26650,42000,68650
G000553,N00026686,Al Green (D),2012,Health,1750,4800,6550
G000553,N00026686,Al Green (D),2012,Lawyers & Lobbyists,51439,14250,65689
G000553,N00026686,Al Green (D),2012,Transportation,4650,3000,7650
G000553,N00026686,Al Green (D),2012,Misc Business,7789,8000,15789
G000553,N00026686,Al Green (D),2012,Labor,0,83500,83500
G000553,N00026686,Al Green (D),2012,Ideology/Single-Issue,0,1500,1500
G000553,N00026686,Al Green (D),2012,Other,10000,0,10000
C001061,N00026790,Emanuel Cleaver (D),2012,Agribusiness,7500,14500,22000
C001061,N00026790,Emanuel Cleaver (D),2012,Communic/Electronics,7450,71000,78450
C001061,N00026790,Emanuel Cleaver (D),2012,Construction,9200,24950,34150
C001061,N00026790,Emanuel Cleaver (D),2012,Defense,0,13500,13500
C001061,N00026790,Emanuel Cleaver (D),2012,Energy/Nat Resource,1750,23500,25250
C001061,N00026790,Emanuel Cleaver (D),2012,Finance/Insur/RealEst,22450,235688,258138
C001061,N00026790,Emanuel Cleaver (D),2012,Health,8800,60094,68894
C001061,N00026790,Emanuel Cleaver (D),2012,Lawyers & Lobbyists,63000,45750,108750
C001061,N00026790,Emanuel Cleaver (D),2012,Transportation,2000,18500,20500
C001061,N00026790,Emanuel Cleaver (D),2012,Misc Business,33480,67271,100751
C001061,N00026790,Emanuel Cleaver (D),2012,Labor,6000,208500,214500
C001061,N00026790,Emanuel Cleaver (D),2012,Ideology/Single-Issue,10000,22500,32500
C001061,N00026790,Emanuel Cleaver (D),2012,Other,35060,6000,41060
C001067,N00026961,Yvette D Clarke (D),2012,Agribusiness,1300,2000,3300
C001067,N00026961,Yvette D Clarke (D),2012,Communic/Electronics,3350,56500,59850
C001067,N00026961,Yvette D Clarke (D),2012,Construction,12560,1500,14060
C001067,N00026961,Yvette D Clarke (D),2012,Defense,0,29500,29500
C001067,N00026961,Yvette D Clarke (D),2012,Energy/Nat Resource,500,1500,2000
C001067,N00026961,Yvette D Clarke (D),2012,Finance/Insur/RealEst,43315,44500,87815
C001067,N00026961,Yvette D Clarke (D),2012,Health,51947,19500,71447
C001067,N00026961,Yvette D Clarke (D),2012,Lawyers & Lobbyists,19150,8000,27150
C001067,N00026961,Yvette D Clarke (D),2012,Transportation,0,14500,14500
C001067,N00026961,Yvette D Clarke (D),2012,Misc Business,22450,19700,42150
C001067,N00026961,Yvette D Clarke (D),2012,Labor,200,150700,150900
C001067,N00026961,Yvette D Clarke (D),2012,Ideology/Single-Issue,450,22850,23300
C001067,N00026961,Yvette D Clarke (D),2012,Other,43130,2000,45130
B001251,N00027035,G K Butterfield (D),2012,Agribusiness,9900,64750,74650
B001251,N00027035,G K Butterfield (D),2012,Communic/Electronics,0,95000,95000
B001251,N00027035,G K Butterfield (D),2012,Construction,4600,2000,6600
B001251,N00027035,G K Butterfield (D),2012,Defense,0,33500,33500
B001251,N00027035,G K Butterfield (D),2012,Energy/Nat Resource,8500,53250,61750
B001251,N00027035,G K Butterfield (D),2012,Finance/Insur/RealEst,14050,48500,62550
B001251,N00027035,G K Butterfield (D),2012,Health,36200,101800,138000
B001251,N00027035,G K Butterfield (D),2012,Lawyers & Lobbyists,30568,25032,55600
B001251,N00027035,G K Butterfield (D),2012,Transportation,2000,41500,43500
B001251,N00027035,G K Butterfield (D),2012,Misc Business,7245,65500,72745
B001251,N00027035,G K Butterfield (D),2012,Labor,0,87692,87692
B001251,N00027035,G K Butterfield (D),2012,Ideology/Single-Issue,3500,9500,13000
B001251,N00027035,G K Butterfield (D),2012,Other,43875,0,43875
H001038,N00027060,Brian M Higgins (D),2012,Agribusiness,1000,10000,11000
H001038,N00027060,Brian M Higgins (D),2012,Communic/Electronics,2250,9000,11250
H001038,N00027060,Brian M Higgins (D),2012,Construction,57450,8500,65950
H001038,N00027060,Brian M Higgins (D),2012,Defense,1500,17000,18500
H001038,N00027060,Brian M Higgins (D),2012,Energy/Nat Resource,3500,9470,12970
H001038,N00027060,Brian M Higgins (D),2012,Finance/Insur/RealEst,81699,39500,121199
H001038,N00027060,Brian M Higgins (D),2012,Health,39400,23000,62400
H001038,N00027060,Brian M Higgins (D),2012,Lawyers & Lobbyists,87540,12500,100040
H001038,N00027060,Brian M Higgins (D),2012,Transportation,2500,21000,23500
H001038,N00027060,Brian M Higgins (D),2012,Misc Business,48900,36500,85400
H001038,N00027060,Brian M Higgins (D),2012,Labor,750,206750,207500
H001038,N00027060,Brian M Higgins (D),2012,Ideology/Single-Issue,500,21000,21500
H001038,N00027060,Brian M Higgins (D),2012,Other,41425,0,41425
F000451,N00027229,Michael G Fitzpatrick (R),2012,Agribusiness,12100,18000,30100
F000451,N00027229,Michael G Fitzpatrick (R),2012,Communic/Electronics,35700,36000,71700
F000451,N00027229,Michael G Fitzpatrick (R),2012,Construction,127950,31000,158950
F000451,N00027229,Michael G Fitzpatrick (R),2012,Defense,8850,19000,27850
F000451,N00027229,Michael G Fitzpatrick (R),2012,Energy/Nat Resource,9050,53500,62550
F000451,N00027229,Michael G Fitzpatrick (R),2012,Finance/Insur/RealEst,192750,327400,520150
F000451,N00027229,Michael G Fitzpatrick (R),2012,Health,58166,79350,137516
F000451,N00027229,Michael G Fitzpatrick (R),2012,Lawyers & Lobbyists,150778,33125,183903
F000451,N00027229,Michael G Fitzpatrick (R),2012,Transportation,36040,19500,55540
F000451,N00027229,Michael G Fitzpatrick (R),2012,Misc Business,97950,69323,167273
F000451,N00027229,Michael G Fitzpatrick (R),2012,Labor,0,60100,60100
F000451,N00027229,Michael G Fitzpatrick (R),2012,Ideology/Single-Issue,105900,209750,315650
F000451,N00027229,Michael G Fitzpatrick (R),2012,Other,104948,4750,109698
C001071,N00027441,Bob Corker (R),2012,Agribusiness,205866,126100,331966
C001071,N00027441,Bob Corker (R),2012,Communic/Electronics,275581,155751,431332
C001071,N00027441,Bob Corker (R),2012,Construction,553060,74750,627810
C001071,N00027441,Bob Corker (R),2012,Defense,15600,55000,70600
C001071,N00027441,Bob Corker (R),2012,Energy/Nat Resource,325538,325499,651037
C001071,N00027441,Bob Corker (R),2012,Finance/Insur/RealEst,2748571,1111520,3860091
C001071,N00027441,Bob Corker (R),2012,Health,734780,395400,1130180
C001071,N00027441,Bob Corker (R),2012,Lawyers & Lobbyists,728817,127135,855952
C001071,N00027441,Bob Corker (R),2012,Transportation,281775,146500,428275
C001071,N00027441,Bob Corker (R),2012,Misc Business,1028608,388791,1417399
C001071,N00027441,Bob Corker (R),2012,Labor,0,15000,15000
C001071,N00027441,Bob Corker (R),2012,Ideology/Single-Issue,137790,324750,462540
C001071,N00027441,Bob Corker (R),2012,Other,719475,3500,722975
B001257,N00027462,Gus Bilirakis (R),2012,Agribusiness,3762,18000,21762
B001257,N00027462,Gus Bilirakis (R),2012,Communic/Electronics,12245,26000,38245
B001257,N00027462,Gus Bilirakis (R),2012,Construction,10500,16000,26500
B001257,N00027462,Gus Bilirakis (R),2012,Defense,250,18000,18250
B001257,N00027462,Gus Bilirakis (R),2012,Energy/Nat Resource,17300,15000,32300
B001257,N00027462,Gus Bilirakis (R),2012,Finance/Insur/RealEst,48149,53500,101649
B001257,N00027462,Gus Bilirakis (R),2012,Health,59978,48500,108478
B001257,N00027462,Gus Bilirakis (R),2012,Lawyers & Lobbyists,29688,7750,37438
B001257,N00027462,Gus Bilirakis (R),2012,Transportation,5750,11500,17250
B001257,N00027462,Gus Bilirakis (R),2012,Misc Business,47164,39500,86664
B001257,N00027462,Gus Bilirakis (R),2012,Labor,0,8500,8500
B001257,N00027462,Gus Bilirakis (R),2012,Ideology/Single-Issue,10850,9600,20450
B001257,N00027462,Gus Bilirakis (R),2012,Other,47850,1000,48850
B001259,N00027464,Bruce Braley (D),2012,Agribusiness,8450,49868,58318
B001259,N00027464,Bruce Braley (D),2012,Communic/Electronics,20250,37250,57500
B001259,N00027464,Bruce Braley (D),2012,Construction,1250,23250,24500
B001259,N00027464,Bruce Braley (D),2012,Defense,4100,14500,18600
B001259,N00027464,Bruce Braley (D),2012,Energy/Nat Resource,4200,21750,25950
B001259,N00027464,Bruce Braley (D),2012,Finance/Insur/RealEst,66963,50500,117463
B001259,N00027464,Bruce Braley (D),2012,Health,68350,151634,219984
B001259,N00027464,Bruce Braley (D),2012,Lawyers & Lobbyists,986557,32497,1019054
B001259,N00027464,Bruce Braley (D),2012,Transportation,1500,25500,27000
B001259,N00027464,Bruce Braley (D),2012,Misc Business,35200,54579,89779
B001259,N00027464,Bruce Braley (D),2012,Labor,900,257500,258400
B001259,N00027464,Bruce Braley (D),2012,Ideology/Single-Issue,46150,156963,203113
B001259,N00027464,Bruce Braley (D),2012,Other,98370,8000,106370
B001256,N00027493,Michele Bachmann (R),2012,Agribusiness,66231,10500,76731
B001256,N00027493,Michele Bachmann (R),2012,Communic/Electronics,67588,6000,73588
B001256,N00027493,Michele Bachmann (R),2012,Construction,128413,5500,133913
B001256,N00027493,Michele Bachmann (R),2012,Defense,24335,4000,28335
B001256,N00027493,Michele Bachmann (R),2012,Energy/Nat Resource,63574,22500,86074
B001256,N00027493,Michele Bachmann (R),2012,Finance/Insur/RealEst,285997,46510,332507
B001256,N00027493,Michele Bachmann (R),2012,Health,164280,1500,165780
B001256,N00027493,Michele Bachmann (R),2012,Lawyers & Lobbyists,50002,3500,53502
B001256,N00027493,Michele Bachmann (R),2012,Transportation,60262,12000,72262
B001256,N00027493,Michele Bachmann (R),2012,Misc Business,173307,16500,189807
B001256,N00027493,Michele Bachmann (R),2012,Labor,800,0,800
B001256,N00027493,Michele Bachmann (R),2012,Ideology/Single-Issue,625036,110790,735826
B001256,N00027493,Michele Bachmann (R),2012,Other,974947,0,974947
C001070,N00027503,Bob Casey (D),2012,Agribusiness,67750,188000,255750
C001070,N00027503,Bob Casey (D),2012,Communic/Electronics,308530,137250,445780
C001070,N00027503,Bob Casey (D),2012,Construction,175126,44000,219126
C001070,N00027503,Bob Casey (D),2012,Defense,28425,104500,132925
C001070,N00027503,Bob Casey (D),2012,Energy/Nat Resource,141850,150400,292250
C001070,N00027503,Bob Casey (D),2012,Finance/Insur/RealEst,1037778,429950,1467728
C001070,N00027503,Bob Casey (D),2012,Health,652482,554080,1206562
C001070,N00027503,Bob Casey (D),2012,Lawyers & Lobbyists,2245151,235752,2480903
C001070,N00027503,Bob Casey (D),2012,Transportation,86750,85397,172147
C001070,N00027503,Bob Casey (D),2012,Misc Business,524777,245387,770164
C001070,N00027503,Bob Casey (D),2012,Labor,38929,362950,401879
C001070,N00027503,Bob Casey (D),2012,Ideology/Single-Issue,190043,435934,625977
C001070,N00027503,Bob Casey (D),2012,Other,696975,20000,716975
C001066,N00027514,Kathy Castor (D),2012,Agribusiness,21750,18000,39750
C001066,N00027514,Kathy Castor (D),2012,Communic/Electronics,5500,33500,39000
C001066,N00027514,Kathy Castor (D),2012,Construction,4750,1500,6250
C001066,N00027514,Kathy Castor (D),2012,Defense,0,17000,17000
C001066,N00027514,Kathy Castor (D),2012,Energy/Nat Resource,5250,10000,15250
C001066,N00027514,Kathy Castor (D),2012,Finance/Insur/RealEst,37800,28000,65800
C001066,N00027514,Kathy Castor (D),2012,Health,45200,112800,158000
C001066,N00027514,Kathy Castor (D),2012,Lawyers & Lobbyists,87425,26000,113425
C001066,N00027514,Kathy Castor (D),2012,Transportation,14650,18500,33150
C001066,N00027514,Kathy Castor (D),2012,Misc Business,38750,21250,60000
C001066,N00027514,Kathy Castor (D),2012,Labor,0,128000,128000
C001066,N00027514,Kathy Castor (D),2012,Ideology/Single-Issue,14750,23570,38320
C001066,N00027514,Kathy Castor (D),2012,Other,61543,2600,64143
H001041,N00027522,Dean Heller (R),2012,Agribusiness,54840,116000,170840
H001041,N00027522,Dean Heller (R),2012,Communic/Electronics,131200,211500,342700
H001041,N00027522,Dean Heller (R),2012,Construction,184807,87500,272307
H001041,N00027522,Dean Heller (R),2012,Defense,7250,22500,29750
H001041,N00027522,Dean Heller (R),2012,Energy/Nat Resource,300501,348075,648576
H001041,N00027522,Dean Heller (R),2012,Finance/Insur/RealEst,862678,486900,1349578
H001041,N00027522,Dean Heller (R),2012,Health,188129,246350,434479
H001041,N00027522,Dean Heller (R),2012,Lawyers & Lobbyists,280932,61645,342577
H001041,N00027522,Dean Heller (R),2012,Transportation,138360,171499,309859
H001041,N00027522,Dean Heller (R),2012,Misc Business,606467,380924,987391
H001041,N00027522,Dean Heller (R),2012,Ideology/Single-Issue,149879,545783,695662
H001041,N00027522,Dean Heller (R),2012,Other,585432,12000,597432
C001064,N00027565,John Campbell (R),2012,Agribusiness,2500,0,2500
C001064,N00027565,John Campbell (R),2012,Communic/Electronics,9300,26000,35300
C001064,N00027565,John Campbell (R),2012,Construction,35750,13000,48750
C001064,N00027565,John Campbell (R),2012,Defense,2000,19500,21500
C001064,N00027565,John Campbell (R),2012,Energy/Nat Resource,2500,10500,13000
C001064,N00027565,John Campbell (R),2012,Finance/Insur/RealEst,122819,375850,498669
C001064,N00027565,John Campbell (R),2012,Health,10250,48500,58750
C001064,N00027565,John Campbell (R),2012,Lawyers & Lobbyists,20700,6500,27200
C001064,N00027565,John Campbell (R),2012,Transportation,57000,42000,99000
C001064,N00027565,John Campbell (R),2012,Misc Business,47900,39270,87170
C001064,N00027565,John Campbell (R),2012,Ideology/Single-Issue,50900,13500,64400
C001064,N00027565,John Campbell (R),2012,Other,72177,0,72177
B001260,N00027626,Vernon Buchanan (R),2012,Agribusiness,43500,49320,92820
B001260,N00027626,Vernon Buchanan (R),2012,Communic/Electronics,36000,26000,62000
B001260,N00027626,Vernon Buchanan (R),2012,Construction,106550,25000,131550
B001260,N00027626,Vernon Buchanan (R),2012,Defense,250,13500,13750
B001260,N00027626,Vernon Buchanan (R),2012,Energy/Nat Resource,-1150,18500,17350
B001260,N00027626,Vernon Buchanan (R),2012,Finance/Insur/RealEst,202900,155500,358400
B001260,N00027626,Vernon Buchanan (R),2012,Health,264595,177150,441745
B001260,N00027626,Vernon Buchanan (R),2012,Lawyers & Lobbyists,71325,12250,83575
B001260,N00027626,Vernon Buchanan (R),2012,Transportation,30500,46500,77000
B001260,N00027626,Vernon Buchanan (R),2012,Misc Business,196123,112243,308366
B001260,N00027626,Vernon Buchanan (R),2012,Labor,0,7000,7000
B001260,N00027626,Vernon Buchanan (R),2012,Ideology/Single-Issue,27500,115000,142500
B001260,N00027626,Vernon Buchanan (R),2012,Other,198265,1000,199265
H001057,N00027649,Tim Huelskamp (R),2012,Agribusiness,39509,150250,189759
H001057,N00027649,Tim Huelskamp (R),2012,Communic/Electronics,6546,29160,35706
H001057,N00027649,Tim Huelskamp (R),2012,Construction,8750,16000,24750
H001057,N00027649,Tim Huelskamp (R),2012,Defense,0,4000,4000
H001057,N00027649,Tim Huelskamp (R),2012,Energy/Nat Resource,55000,36250,91250
H001057,N00027649,Tim Huelskamp (R),2012,Finance/Insur/RealEst,24588,55750,80338
H001057,N00027649,Tim Huelskamp (R),2012,Health,15880,35000,50880
H001057,N00027649,Tim Huelskamp (R),2012,Lawyers & Lobbyists,12750,5000,17750
H001057,N00027649,Tim Huelskamp (R),2012,Transportation,17750,35500,53250
H001057,N00027649,Tim Huelskamp (R),2012,Misc Business,38712,30000,68712
H001057,N00027649,Tim Huelskamp (R),2012,Labor,0,2000,2000
H001057,N00027649,Tim Huelskamp (R),2012,Ideology/Single-Issue,10450,33536,43986
H001057,N00027649,Tim Huelskamp (R),2012,Other,24500,500,25000
G000555,N00027658,Kirsten Gillibrand (D),2012,Agribusiness,166283,292733,459016
G000555,N00027658,Kirsten Gillibrand (D),2012,Communic/Electronics,1529324,339858,1869182
G000555,N00027658,Kirsten Gillibrand (D),2012,Construction,298533,141041,439574
G000555,N00027658,Kirsten Gillibrand (D),2012,Defense,51764,209900,261664
G000555,N00027658,Kirsten Gillibrand (D),2012,Energy/Nat Resource,143148,256250,399398
G000555,N00027658,Kirsten Gillibrand (D),2012,Finance/Insur/RealEst,5420423,940216,6360639
G000555,N00027658,Kirsten Gillibrand (D),2012,Health,654774,521610,1176384
G000555,N00027658,Kirsten Gillibrand (D),2012,Lawyers & Lobbyists,4663471,339116,5002587
G000555,N00027658,Kirsten Gillibrand (D),2012,Transportation,88684,181500,270184
G000555,N00027658,Kirsten Gillibrand (D),2012,Misc Business,1797848,428110,2225958
G000555,N00027658,Kirsten Gillibrand (D),2012,Labor,1250,559250,560500
G000555,N00027658,Kirsten Gillibrand (D),2012,Ideology/Single-Issue,1816576,592810,2409386
G000555,N00027658,Kirsten Gillibrand (D),2012,Other,1775150,24250,1799400
D000622,N00027860,Tammy Duckworth (D),2012,Agribusiness,7900,10000,17900
D000622,N00027860,Tammy Duckworth (D),2012,Communic/Electronics,88570,12500,101070
D000622,N00027860,Tammy Duckworth (D),2012,Construction,39200,2750,41950
D000622,N00027860,Tammy Duckworth (D),2012,Defense,9450,12500,21950
D000622,N00027860,Tammy Duckworth (D),2012,Energy/Nat Resource,19600,1750,21350
D000622,N00027860,Tammy Duckworth (D),2012,Finance/Insur/RealEst,265217,14500,279717
D000622,N00027860,Tammy Duckworth (D),2012,Health,76742,58500,135242
D000622,N00027860,Tammy Duckworth (D),2012,Lawyers & Lobbyists,355814,31000,386814
D000622,N00027860,Tammy Duckworth (D),2012,Transportation,7150,1000,8150
D000622,N00027860,Tammy Duckworth (D),2012,Misc Business,123046,13000,136046
D000622,N00027860,Tammy Duckworth (D),2012,Labor,4400,226500,230900
D000622,N00027860,Tammy Duckworth (D),2012,Ideology/Single-Issue,629020,288115,917135
D000622,N00027860,Tammy Duckworth (D),2012,Other,387282,6500,393782
H001042,N00028139,Mazie K Hirono (D),2012,Agribusiness,15500,13000,28500
H001042,N00028139,Mazie K Hirono (D),2012,Communic/Electronics,109261,30500,139761
H001042,N00028139,Mazie K Hirono (D),2012,Construction,138299,24000,162299
H001042,N00028139,Mazie K Hirono (D),2012,Defense,25150,3000,28150
H001042,N00028139,Mazie K Hirono (D),2012,Energy/Nat Resource,28875,15000,43875
H001042,N00028139,Mazie K Hirono (D),2012,Finance/Insur/RealEst,291690,62500,354190
H001042,N00028139,Mazie K Hirono (D),2012,Health,76368,26300,102668
H001042,N00028139,Mazie K Hirono (D),2012,Lawyers & Lobbyists,613713,27750,641463
H001042,N00028139,Mazie K Hirono (D),2012,Transportation,63335,102000,165335
H001042,N00028139,Mazie K Hirono (D),2012,Misc Business,200048,25500,225548
H001042,N00028139,Mazie K Hirono (D),2012,Labor,1700,373900,375600
H001042,N00028139,Mazie K Hirono (D),2012,Ideology/Single-Issue,497539,343869,841408
H001042,N00028139,Mazie K Hirono (D),2012,Other,339911,5000,344911
E000290,N00028249,Donna Edwards (D),2012,Agribusiness,300,2000,2300
E000290,N00028249,Donna Edwards (D),2012,Communic/Electronics,9000,10500,19500
E000290,N00028249,Donna Edwards (D),2012,Construction,1250,1000,2250
E000290,N00028249,Donna Edwards (D),2012,Defense,1750,11000,12750
E000290,N00028249,Donna Edwards (D),2012,Energy/Nat Resource,3750,6500,10250
E000290,N00028249,Donna Edwards (D),2012,Finance/Insur/RealEst,28750,8000,36750
E000290,N00028249,Donna Edwards (D),2012,Health,4250,9000,13250
E000290,N00028249,Donna Edwards (D),2012,Lawyers & Lobbyists,24400,13500,37900
E000290,N00028249,Donna Edwards (D),2012,Transportation,1250,67500,68750
E000290,N00028249,Donna Edwards (D),2012,Misc Business,25000,24000,49000
E000290,N00028249,Donna Edwards (D),2012,Labor,200,219149,219349
E000290,N00028249,Donna Edwards (D),2012,Ideology/Single-Issue,62750,77203,139953
E000290,N00028249,Donna Edwards (D),2012,Other,61740,1000,62740
E000288,N00028257,Keith Ellison (D),2012,Agribusiness,10700,30000,40700
E000288,N00028257,Keith Ellison (D),2012,Communic/Electronics,48276,2000,50276
E000288,N00028257,Keith Ellison (D),2012,Construction,26800,0,26800
E000288,N00028257,Keith Ellison (D),2012,Defense,750,2000,2750
E000288,N00028257,Keith Ellison (D),2012,Energy/Nat Resource,13100,1000,14100
E000288,N00028257,Keith Ellison (D),2012,Finance/Insur/RealEst,109162,56700,165862
E000288,N00028257,Keith Ellison (D),2012,Health,232150,14550,246700
E000288,N00028257,Keith Ellison (D),2012,Lawyers & Lobbyists,52135,28763,80898
E000288,N00028257,Keith Ellison (D),2012,Transportation,12000,2000,14000
E000288,N00028257,Keith Ellison (D),2012,Misc Business,75120,26000,101120
E000288,N00028257,Keith Ellison (D),2012,Labor,250,173500,173750
E000288,N00028257,Keith Ellison (D),2012,Ideology/Single-Issue,46650,39723,86373
E000288,N00028257,Keith Ellison (D),2012,Other,112150,500,112650
G000556,N00028418,Alan Grayson (D),2012,Agribusiness,7750,1000,8750
G000556,N00028418,Alan Grayson (D),2012,Communic/Electronics,43700,2000,45700
G000556,N00028418,Alan Grayson (D),2012,Construction,12800,0,12800
G000556,N00028418,Alan Grayson (D),2012,Defense,1225,0,1225
G000556,N00028418,Alan Grayson (D),2012,Energy/Nat Resource,3300,0,3300
G000556,N00028418,Alan Grayson (D),2012,Finance/Insur/RealEst,33600,5500,39100
G000556,N00028418,Alan Grayson (D),2012,Health,27225,0,27225
G000556,N00028418,Alan Grayson (D),2012,Lawyers & Lobbyists,34480,10000,44480
G000556,N00028418,Alan Grayson (D),2012,Transportation,4300,500,4800
G000556,N00028418,Alan Grayson (D),2012,Misc Business,49410,6000,55410
G000556,N00028418,Alan Grayson (D),2012,Labor,0,164500,164500
G000556,N00028418,Alan Grayson (D),2012,Ideology/Single-Issue,110675,34266,144941
G000556,N00028418,Alan Grayson (D),2012,Other,153889,0,153889
C001076,N00028958,Jason Chaffetz (R),2012,Agribusiness,0,9000,9000
C001076,N00028958,Jason Chaffetz (R),2012,Communic/Electronics,20750,81093,101843
C001076,N00028958,Jason Chaffetz (R),2012,Construction,7559,9500,17059
C001076,N00028958,Jason Chaffetz (R),2012,Defense,0,27000,27000
C001076,N00028958,Jason Chaffetz (R),2012,Energy/Nat Resource,15500,43500,59000
C001076,N00028958,Jason Chaffetz (R),2012,Finance/Insur/RealEst,63100,88800,151900
C001076,N00028958,Jason Chaffetz (R),2012,Health,30650,44845,75495
C001076,N00028958,Jason Chaffetz (R),2012,Lawyers & Lobbyists,39558,7410,46968
C001076,N00028958,Jason Chaffetz (R),2012,Transportation,873,31000,31873
C001076,N00028958,Jason Chaffetz (R),2012,Misc Business,82880,46000,128880
C001076,N00028958,Jason Chaffetz (R),2012,Labor,0,4000,4000
C001076,N00028958,Jason Chaffetz (R),2012,Ideology/Single-Issue,12200,22662,34862
C001076,N00028958,Jason Chaffetz (R),2012,Other,16425,0,16425
B001262,N00028986,Paul Broun Jr (R),2012,Agribusiness,26901,23750,50651
B001262,N00028986,Paul Broun Jr (R),2012,Communic/Electronics,6500,11500,18000
B001262,N00028986,Paul Broun Jr (R),2012,Construction,17601,6000,23601
B001262,N00028986,Paul Broun Jr (R),2012,Defense,706,9000,9706
B001262,N00028986,Paul Broun Jr (R),2012,Energy/Nat Resource,13450,26000,39450
B001262,N00028986,Paul Broun Jr (R),2012,Finance/Insur/RealEst,54175,35000,89175
B001262,N00028986,Paul Broun Jr (R),2012,Health,57693,104500,162193
B001262,N00028986,Paul Broun Jr (R),2012,Lawyers & Lobbyists,20037,8500,28537
B001262,N00028986,Paul Broun Jr (R),2012,Transportation,20670,23999,44669
B001262,N00028986,Paul Broun Jr (R),2012,Misc Business,54586,65000,119586
B001262,N00028986,Paul Broun Jr (R),2012,Labor,0,4000,4000
B001262,N00028986,Paul Broun Jr (R),2012,Ideology/Single-Issue,70387,69549,139936
B001262,N00028986,Paul Broun Jr (R),2012,Other,123456,0,123456
F000457,N00029016,Al Franken (D),2012,Agribusiness,99306,19500,118806
F000457,N00029016,Al Franken (D),2012,Communic/Electronics,1700141,38750,1738891
F000457,N00029016,Al Franken (D),2012,Construction,145854,0,145854
F000457,N00029016,Al Franken (D),2012,Defense,23062,0,23062
F000457,N00029016,Al Franken (D),2012,Energy/Nat Resource,67313,36500,103813
F000457,N00029016,Al Franken (D),2012,Finance/Insur/RealEst,1459263,11510,1470773
F000457,N00029016,Al Franken (D),2012,Health,513592,53649,567241
F000457,N00029016,Al Franken (D),2012,Lawyers & Lobbyists,1611127,33146,1644273
F000457,N00029016,Al Franken (D),2012,Transportation,48675,1750,50425
F000457,N00029016,Al Franken (D),2012,Misc Business,1105624,24500,1130124
F000457,N00029016,Al Franken (D),2012,Labor,9350,385600,394950
F000457,N00029016,Al Franken (D),2012,Ideology/Single-Issue,792346,424232,1216578
F000457,N00029016,Al Franken (D),2012,Other,1961373,0,1961373
H001047,N00029070,Jim Himes (D),2012,Agribusiness,6750,1000,7750
H001047,N00029070,Jim Himes (D),2012,Communic/Electronics,61800,24000,85800
H001047,N00029070,Jim Himes (D),2012,Construction,30000,5000,35000
H001047,N00029070,Jim Himes (D),2012,Defense,500,24000,24500
H001047,N00029070,Jim Himes (D),2012,Energy/Nat Resource,13500,36000,49500
H001047,N00029070,Jim Himes (D),2012,Finance/Insur/RealEst,613745,633499,1247244
H001047,N00029070,Jim Himes (D),2012,Health,38850,81500,120350
H001047,N00029070,Jim Himes (D),2012,Lawyers & Lobbyists,221080,29250,250330
H001047,N00029070,Jim Himes (D),2012,Transportation,12425,9000,21425
H001047,N00029070,Jim Himes (D),2012,Misc Business,174200,79402,253602
H001047,N00029070,Jim Himes (D),2012,Labor,0,113000,113000
H001047,N00029070,Jim Himes (D),2012,Ideology/Single-Issue,59801,27000,86801
H001047,N00029070,Jim Himes (D),2012,Other,256402,500,256902
F000454,N00029139,Bill Foster (D),2012,Agribusiness,18500,7000,25500
F000454,N00029139,Bill Foster (D),2012,Communic/Electronics,105707,2500,108207
F000454,N00029139,Bill Foster (D),2012,Construction,16950,0,16950
F000454,N00029139,Bill Foster (D),2012,Defense,7900,2000,9900
F000454,N00029139,Bill Foster (D),2012,Energy/Nat Resource,15500,500,16000
F000454,N00029139,Bill Foster (D),2012,Finance/Insur/RealEst,220459,15000,235459
F000454,N00029139,Bill Foster (D),2012,Health,61049,6000,67049
F000454,N00029139,Bill Foster (D),2012,Lawyers & Lobbyists,243620,18000,261620
F000454,N00029139,Bill Foster (D),2012,Transportation,3650,0,3650
F000454,N00029139,Bill Foster (D),2012,Misc Business,136200,3500,139700
F000454,N00029139,Bill Foster (D),2012,Labor,1000,183000,184000
F000454,N00029139,Bill Foster (D),2012,Ideology/Single-Issue,285374,182644,468018
F000454,N00029139,Bill Foster (D),2012,Other,768470,0,768470
H001052,N00029147,Andy Harris (R),2012,Agribusiness,21679,25500,47179
H001052,N00029147,Andy Harris (R),2012,Communic/Electronics,12700,7000,19700
H001052,N00029147,Andy Harris (R),2012,Construction,25600,21000,46600
H001052,N00029147,Andy Harris (R),2012,Defense,500,5500,6000
H001052,N00029147,Andy Harris (R),2012,Energy/Nat Resource,12260,61000,73260
H001052,N00029147,Andy Harris (R),2012,Finance/Insur/RealEst,114250,28500,142750
H001052,N00029147,Andy Harris (R),2012,Health,292413,145500,437913
H001052,N00029147,Andy Harris (R),2012,Lawyers & Lobbyists,39750,1000,40750
H001052,N00029147,Andy Harris (R),2012,Transportation,9450,64999,74449
H001052,N00029147,Andy Harris (R),2012,Misc Business,73755,30500,104255
H001052,N00029147,Andy Harris (R),2012,Labor,0,1250,1250
H001052,N00029147,Andy Harris (R),2012,Ideology/Single-Issue,17550,35770,53320
H001052,N00029147,Andy Harris (R),2012,Other,123231,0,123231
H001048,N00029258,Duncan D Hunter (R),2012,Agribusiness,5500,26000,31500
H001048,N00029258,Duncan D Hunter (R),2012,Communic/Electronics,8950,32500,41450
H001048,N00029258,Duncan D Hunter (R),2012,Construction,36015,26500,62515
H001048,N00029258,Duncan D Hunter (R),2012,Defense,11750,139900,151650
H001048,N00029258,Duncan D Hunter (R),2012,Energy/Nat Resource,6450,6400,12850
H001048,N00029258,Duncan D Hunter (R),2012,Finance/Insur/RealEst,29580,52850,82430
H001048,N00029258,Duncan D Hunter (R),2012,Health,7650,40000,47650
H001048,N00029258,Duncan D Hunter (R),2012,Lawyers & Lobbyists,21350,22750,44100
H001048,N00029258,Duncan D Hunter (R),2012,Transportation,12000,101000,113000
H001048,N00029258,Duncan D Hunter (R),2012,Misc Business,50920,46500,97420
H001048,N00029258,Duncan D Hunter (R),2012,Labor,0,29000,29000
H001048,N00029258,Duncan D Hunter (R),2012,Ideology/Single-Issue,6200,36202,42402
H001048,N00029258,Duncan D Hunter (R),2012,Other,36102,19000,55102
C001072,N00029513,Andre Carson (D),2012,Agribusiness,2256,12000,14256
C001072,N00029513,Andre Carson (D),2012,Communic/Electronics,19950,13500,33450
C001072,N00029513,Andre Carson (D),2012,Construction,44285,2000,46285
C001072,N00029513,Andre Carson (D),2012,Defense,0,15500,15500
C001072,N00029513,Andre Carson (D),2012,Energy/Nat Resource,4300,4500,8800
C001072,N00029513,Andre Carson (D),2012,Finance/Insur/RealEst,54558,153869,208427
C001072,N00029513,Andre Carson (D),2012,Health,96129,37500,133629
C001072,N00029513,Andre Carson (D),2012,Lawyers & Lobbyists,87241,17500,104741
C001072,N00029513,Andre Carson (D),2012,Transportation,3250,18000,21250
C001072,N00029513,Andre Carson (D),2012,Misc Business,31610,27573,59183
C001072,N00029513,Andre Carson (D),2012,Labor,1250,165250,166500
C001072,N00029513,Andre Carson (D),2012,Ideology/Single-Issue,9800,14140,23940
C001072,N00029513,Andre Carson (D),2012,Other,53048,2000,55048
H001049,N00029617,Kay R Hagan (D),2012,Agribusiness,125921,115571,241492
H001049,N00029617,Kay R Hagan (D),2012,Communic/Electronics,387985,93978,481963
H001049,N00029617,Kay R Hagan (D),2012,Construction,108350,11500,119850
H001049,N00029617,Kay R Hagan (D),2012,Defense,15950,47000,62950
H001049,N00029617,Kay R Hagan (D),2012,Energy/Nat Resource,39099,46250,85349
H001049,N00029617,Kay R Hagan (D),2012,Finance/Insur/RealEst,932856,381050,1313906
H001049,N00029617,Kay R Hagan (D),2012,Health,274108,341809,615917
H001049,N00029617,Kay R Hagan (D),2012,Lawyers & Lobbyists,937021,76326,1013347
H001049,N00029617,Kay R Hagan (D),2012,Transportation,58050,37000,95050
H001049,N00029617,Kay R Hagan (D),2012,Misc Business,456000,112813,568813
H001049,N00029617,Kay R Hagan (D),2012,Labor,1500,287000,288500
H001049,N00029617,Kay R Hagan (D),2012,Ideology/Single-Issue,865126,490619,1355745
H001049,N00029617,Kay R Hagan (D),2012,Other,1148390,6500,1154890
H001045,N00029632,Gregg Harper (R),2012,Agribusiness,8250,33000,41250
H001045,N00029632,Gregg Harper (R),2012,Communic/Electronics,10250,51000,61250
H001045,N00029632,Gregg Harper (R),2012,Construction,38567,11000,49567
H001045,N00029632,Gregg Harper (R),2012,Defense,0,35500,35500
H001045,N00029632,Gregg Harper (R),2012,Energy/Nat Resource,54250,82500,136750
H001045,N00029632,Gregg Harper (R),2012,Finance/Insur/RealEst,56350,63200,119550
H001045,N00029632,Gregg Harper (R),2012,Health,31200,34999,66199
H001045,N00029632,Gregg Harper (R),2012,Lawyers & Lobbyists,52400,16000,68400
H001045,N00029632,Gregg Harper (R),2012,Transportation,10700,23000,33700
H001045,N00029632,Gregg Harper (R),2012,Misc Business,48350,26000,74350
H001045,N00029632,Gregg Harper (R),2012,Ideology/Single-Issue,11500,40150,51650
H001045,N00029632,Gregg Harper (R),2012,Other,34650,0,34650
G000558,N00029675,Brett Guthrie (R),2012,Agribusiness,11775,61000,72775
G000558,N00029675,Brett Guthrie (R),2012,Communic/Electronics,6000,112500,118500
G000558,N00029675,Brett Guthrie (R),2012,Construction,34400,43500,77900
G000558,N00029675,Brett Guthrie (R),2012,Defense,0,24500,24500
G000558,N00029675,Brett Guthrie (R),2012,Energy/Nat Resource,12500,103499,115999
G000558,N00029675,Brett Guthrie (R),2012,Finance/Insur/RealEst,33650,115500,149150
G000558,N00029675,Brett Guthrie (R),2012,Health,36500,367500,404000
G000558,N00029675,Brett Guthrie (R),2012,Lawyers & Lobbyists,42498,11191,53689
G000558,N00029675,Brett Guthrie (R),2012,Transportation,13050,60500,73550
G000558,N00029675,Brett Guthrie (R),2012,Misc Business,42550,132600,175150
G000558,N00029675,Brett Guthrie (R),2012,Labor,0,19000,19000
G000558,N00029675,Brett Guthrie (R),2012,Ideology/Single-Issue,1000,25750,26750
G000558,N00029675,Brett Guthrie (R),2012,Other,50150,23500,73650
F000456,N00029679,John Fleming (R),2012,Agribusiness,45200,28500,73700
F000456,N00029679,John Fleming (R),2012,Communic/Electronics,9300,8500,17800
F000456,N00029679,John Fleming (R),2012,Construction,86050,12500,98550
F000456,N00029679,John Fleming (R),2012,Defense,1000,52500,53500
F000456,N00029679,John Fleming (R),2012,Energy/Nat Resource,201775,48000,249775
F000456,N00029679,John Fleming (R),2012,Finance/Insur/RealEst,144126,14510,158636
F000456,N00029679,John Fleming (R),2012,Health,226951,71000,297951
F000456,N00029679,John Fleming (R),2012,Lawyers & Lobbyists,48050,6500,54550
F000456,N00029679,John Fleming (R),2012,Transportation,33900,18498,52398
F000456,N00029679,John Fleming (R),2012,Misc Business,66670,25500,92170
F000456,N00029679,John Fleming (R),2012,Labor,0,1000,1000
F000456,N00029679,John Fleming (R),2012,Ideology/Single-Issue,20650,34236,54886
F000456,N00029679,John Fleming (R),2012,Other,78700,0,78700
H001046,N00029835,Martin Heinrich (D),2012,Agribusiness,43333,18750,62083
H001046,N00029835,Martin Heinrich (D),2012,Communic/Electronics,166610,45200,211810
H001046,N00029835,Martin Heinrich (D),2012,Construction,56155,4000,60155
H001046,N00029835,Martin Heinrich (D),2012,Defense,22250,42500,64750
H001046,N00029835,Martin Heinrich (D),2012,Energy/Nat Resource,80600,37000,117600
H001046,N00029835,Martin Heinrich (D),2012,Finance/Insur/RealEst,296471,66260,362731
H001046,N00029835,Martin Heinrich (D),2012,Health,158666,139250,297916
H001046,N00029835,Martin Heinrich (D),2012,Lawyers & Lobbyists,762879,42649,805528
H001046,N00029835,Martin Heinrich (D),2012,Transportation,7550,4000,11550
H001046,N00029835,Martin Heinrich (D),2012,Misc Business,348217,43000,391217
H001046,N00029835,Martin Heinrich (D),2012,Labor,1797,285500,287297
H001046,N00029835,Martin Heinrich (D),2012,Ideology/Single-Issue,506966,385405,892371
H001046,N00029835,Martin Heinrich (D),2012,Other,762176,11000,773176
C001078,N00029891,Gerry Connolly (D),2012,Agribusiness,750,19250,20000
C001078,N00029891,Gerry Connolly (D),2012,Communic/Electronics,68379,108500,176879
C001078,N00029891,Gerry Connolly (D),2012,Construction,28300,51000,79300
C001078,N00029891,Gerry Connolly (D),2012,Defense,19750,116500,136250
C001078,N00029891,Gerry Connolly (D),2012,Energy/Nat Resource,4000,16500,20500
C001078,N00029891,Gerry Connolly (D),2012,Finance/Insur/RealEst,102187,85000,187187
C001078,N00029891,Gerry Connolly (D),2012,Health,22922,49500,72422
C001078,N00029891,Gerry Connolly (D),2012,Lawyers & Lobbyists,123503,27468,150971
C001078,N00029891,Gerry Connolly (D),2012,Transportation,8000,27500,35500
C001078,N00029891,Gerry Connolly (D),2012,Misc Business,67608,71081,138689
C001078,N00029891,Gerry Connolly (D),2012,Labor,750,263180,263930
C001078,N00029891,Gerry Connolly (D),2012,Ideology/Single-Issue,64400,159786,224186
C001078,N00029891,Gerry Connolly (D),2012,Other,157307,1500,158807
B001265,N00029901,Mark Begich (D),2012,Agribusiness,17381,5000,22381
B001265,N00029901,Mark Begich (D),2012,Communic/Electronics,295667,77250,372917
B001265,N00029901,Mark Begich (D),2012,Construction,84149,30500,114649
B001265,N00029901,Mark Begich (D),2012,Defense,1000,29000,30000
B001265,N00029901,Mark Begich (D),2012,Energy/Nat Resource,196262,153000,349262
B001265,N00029901,Mark Begich (D),2012,Finance/Insur/RealEst,550261,90500,640761
B001265,N00029901,Mark Begich (D),2012,Health,158274,43500,201774
B001265,N00029901,Mark Begich (D),2012,Lawyers & Lobbyists,844377,79345,923722
B001265,N00029901,Mark Begich (D),2012,Transportation,71041,162000,233041
B001265,N00029901,Mark Begich (D),2012,Misc Business,357626,58000,415626
B001265,N00029901,Mark Begich (D),2012,Labor,12900,290550,303450
B001265,N00029901,Mark Begich (D),2012,Ideology/Single-Issue,245809,439015,684824
B001265,N00029901,Mark Begich (D),2012,Other,484381,500,484881
G000573,N00029908,Joe Garcia (D),2012,Agribusiness,18075,1000,19075
G000573,N00029908,Joe Garcia (D),2012,Communic/Electronics,20000,7000,27000
G000573,N00029908,Joe Garcia (D),2012,Construction,48300,2000,50300
G000573,N00029908,Joe Garcia (D),2012,Energy/Nat Resource,1250,6750,8000
G000573,N00029908,Joe Garcia (D),2012,Finance/Insur/RealEst,118150,3500,121650
G000573,N00029908,Joe Garcia (D),2012,Health,54750,7500,62250
G000573,N00029908,Joe Garcia (D),2012,Lawyers & Lobbyists,155778,10000,165778
G000573,N00029908,Joe Garcia (D),2012,Transportation,10000,3500,13500
G000573,N00029908,Joe Garcia (D),2012,Misc Business,103650,6000,109650
G000573,N00029908,Joe Garcia (D),2012,Labor,0,111500,111500
G000573,N00029908,Joe Garcia (D),2012,Ideology/Single-Issue,57250,105139,162389
G000573,N00029908,Joe Garcia (D),2012,Other,97025,0,97025
H001051,N00030197,Richard Hanna (R),2012,Agribusiness,4250,10500,14750
H001051,N00030197,Richard Hanna (R),2012,Communic/Electronics,13800,19000,32800
H001051,N00030197,Richard Hanna (R),2012,Construction,50669,80253,130922
H001051,N00030197,Richard Hanna (R),2012,Defense,500,11000,11500
H001051,N00030197,Richard Hanna (R),2012,Energy/Nat Resource,4000,13000,17000
H001051,N00030197,Richard Hanna (R),2012,Finance/Insur/RealEst,109149,84000,193149
H001051,N00030197,Richard Hanna (R),2012,Health,12050,24000,36050
H001051,N00030197,Richard Hanna (R),2012,Lawyers & Lobbyists,43298,6000,49298
H001051,N00030197,Richard Hanna (R),2012,Transportation,3492,95999,99491
H001051,N00030197,Richard Hanna (R),2012,Misc Business,24875,54239,79114
H001051,N00030197,Richard Hanna (R),2012,Labor,0,49000,49000
H001051,N00030197,Richard Hanna (R),2012,Ideology/Single-Issue,15750,108883,124633
H001051,N00030197,Richard Hanna (R),2012,Other,36917,1500,38417
C001075,N00030245,Bill Cassidy (R),2012,Agribusiness,20000,29000,49000
C001075,N00030245,Bill Cassidy (R),2012,Communic/Electronics,31050,37500,68550
C001075,N00030245,Bill Cassidy (R),2012,Construction,96870,6500,103370
C001075,N00030245,Bill Cassidy (R),2012,Defense,500,4000,4500
C001075,N00030245,Bill Cassidy (R),2012,Energy/Nat Resource,82600,103250,185850
C001075,N00030245,Bill Cassidy (R),2012,Finance/Insur/RealEst,80581,55750,136331
C001075,N00030245,Bill Cassidy (R),2012,Health,177500,311941,489441
C001075,N00030245,Bill Cassidy (R),2012,Lawyers & Lobbyists,80365,15284,95649
C001075,N00030245,Bill Cassidy (R),2012,Transportation,33000,50997,83997
C001075,N00030245,Bill Cassidy (R),2012,Misc Business,110908,69500,180408
C001075,N00030245,Bill Cassidy (R),2012,Ideology/Single-Issue,34494,31000,65494
C001075,N00030245,Bill Cassidy (R),2012,Other,62500,0,62500
F000455,N00030490,Marcia L Fudge (D),2012,Agribusiness,500,75000,75500
F000455,N00030490,Marcia L Fudge (D),2012,Communic/Electronics,1850,17500,19350
F000455,N00030490,Marcia L Fudge (D),2012,Construction,8850,0,8850
F000455,N00030490,Marcia L Fudge (D),2012,Defense,0,11500,11500
F000455,N00030490,Marcia L Fudge (D),2012,Energy/Nat Resource,1250,20525,21775
F000455,N00030490,Marcia L Fudge (D),2012,Finance/Insur/RealEst,14525,48710,63235
F000455,N00030490,Marcia L Fudge (D),2012,Health,2300,40500,42800
F000455,N00030490,Marcia L Fudge (D),2012,Lawyers & Lobbyists,16685,21025,37710
F000455,N00030490,Marcia L Fudge (D),2012,Transportation,250,19500,19750
F000455,N00030490,Marcia L Fudge (D),2012,Misc Business,11150,63500,74650
F000455,N00030490,Marcia L Fudge (D),2012,Labor,0,151500,151500
F000455,N00030490,Marcia L Fudge (D),2012,Ideology/Single-Issue,10850,23000,33850
F000455,N00030490,Marcia L Fudge (D),2012,Other,14600,3250,17850
C001080,N00030600,Judy Chu (D),2012,Agribusiness,23100,0,23100
C001080,N00030600,Judy Chu (D),2012,Communic/Electronics,45500,43500,89000
C001080,N00030600,Judy Chu (D),2012,Construction,19300,3850,23150
C001080,N00030600,Judy Chu (D),2012,Defense,3000,5000,8000
C001080,N00030600,Judy Chu (D),2012,Energy/Nat Resource,4350,11000,15350
C001080,N00030600,Judy Chu (D),2012,Finance/Insur/RealEst,85360,22000,107360
C001080,N00030600,Judy Chu (D),2012,Health,58176,21600,79776
C001080,N00030600,Judy Chu (D),2012,Lawyers & Lobbyists,61033,18535,79568
C001080,N00030600,Judy Chu (D),2012,Transportation,10850,500,11350
C001080,N00030600,Judy Chu (D),2012,Misc Business,65750,16500,82250
C001080,N00030600,Judy Chu (D),2012,Labor,500,187450,187950
C001080,N00030600,Judy Chu (D),2012,Ideology/Single-Issue,37066,17500,54566
C001080,N00030600,Judy Chu (D),2012,Other,69940,1000,70940
B001267,N00030608,Michael F Bennet (D),2012,Agribusiness,122491,109000,231491
B001267,N00030608,Michael F Bennet (D),2012,Communic/Electronics,771231,154088,925319
B001267,N00030608,Michael F Bennet (D),2012,Construction,167965,16500,184465
B001267,N00030608,Michael F Bennet (D),2012,Defense,9900,44000,53900
B001267,N00030608,Michael F Bennet (D),2012,Energy/Nat Resource,179861,142995,322856
B001267,N00030608,Michael F Bennet (D),2012,Finance/Insur/RealEst,2273286,492385,2765671
B001267,N00030608,Michael F Bennet (D),2012,Health,338457,323200,661657
B001267,N00030608,Michael F Bennet (D),2012,Lawyers & Lobbyists,1603595,164401,1767996
B001267,N00030608,Michael F Bennet (D),2012,Transportation,64050,68299,132349
B001267,N00030608,Michael F Bennet (D),2012,Misc Business,685204,192771,877975
B001267,N00030608,Michael F Bennet (D),2012,Labor,2100,253500,255600
B001267,N00030608,Michael F Bennet (D),2012,Ideology/Single-Issue,486741,471983,958724
B001267,N00030608,Michael F Bennet (D),2012,Other,1400977,27100,1428077
H001058,N00030673,Bill Huizenga (R),2012,Agribusiness,14750,20500,35250
H001058,N00030673,Bill Huizenga (R),2012,Communic/Electronics,0,14000,14000
H001058,N00030673,Bill Huizenga (R),2012,Construction,9050,22500,31550
H001058,N00030673,Bill Huizenga (R),2012,Defense,5500,21000,26500
H001058,N00030673,Bill Huizenga (R),2012,Energy/Nat Resource,4850,40500,45350
H001058,N00030673,Bill Huizenga (R),2012,Finance/Insur/RealEst,120275,326576,446851
H001058,N00030673,Bill Huizenga (R),2012,Health,14000,16900,30900
H001058,N00030673,Bill Huizenga (R),2012,Lawyers & Lobbyists,23150,16348,39498
H001058,N00030673,Bill Huizenga (R),2012,Transportation,0,21000,21000
H001058,N00030673,Bill Huizenga (R),2012,Misc Business,85150,67235,152385
H001058,N00030673,Bill Huizenga (R),2012,Labor,0,1000,1000
H001058,N00030673,Bill Huizenga (R),2012,Ideology/Single-Issue,17900,51319,69219
H001058,N00030673,Bill Huizenga (R),2012,Other,26277,0,26277
D000617,N00030693,Suzan DelBene (D),2012,Agribusiness,1700,2500,4200
D000617,N00030693,Suzan DelBene (D),2012,Communic/Electronics,199100,1000,200100
D000617,N00030693,Suzan DelBene (D),2012,Construction,12650,0,12650
D000617,N00030693,Suzan DelBene (D),2012,Defense,1500,10000,11500
D000617,N00030693,Suzan DelBene (D),2012,Energy/Nat Resource,16000,3000,19000
D000617,N00030693,Suzan DelBene (D),2012,Finance/Insur/RealEst,52000,15000,67000
D000617,N00030693,Suzan DelBene (D),2012,Health,30480,9250,39730
D000617,N00030693,Suzan DelBene (D),2012,Lawyers & Lobbyists,70242,10000,80242
D000617,N00030693,Suzan DelBene (D),2012,Transportation,2750,5000,7750
D000617,N00030693,Suzan DelBene (D),2012,Misc Business,112833,12000,124833
D000617,N00030693,Suzan DelBene (D),2012,Labor,750,196000,196750
D000617,N00030693,Suzan DelBene (D),2012,Ideology/Single-Issue,123875,150394,274269
D000617,N00030693,Suzan DelBene (D),2012,Other,159625,0,159625
B001287,N00030717,Ami Bera (D),2012,Agribusiness,9750,0,9750
B001287,N00030717,Ami Bera (D),2012,Communic/Electronics,115900,5500,121400
B001287,N00030717,Ami Bera (D),2012,Construction,42400,0,42400
B001287,N00030717,Ami Bera (D),2012,Defense,12700,0,12700
B001287,N00030717,Ami Bera (D),2012,Energy/Nat Resource,38900,0,38900
B001287,N00030717,Ami Bera (D),2012,Finance/Insur/RealEst,145390,21000,166390
B001287,N00030717,Ami Bera (D),2012,Health,221976,162999,384975
B001287,N00030717,Ami Bera (D),2012,Lawyers & Lobbyists,146220,10000,156220
B001287,N00030717,Ami Bera (D),2012,Transportation,250,0,250
B001287,N00030717,Ami Bera (D),2012,Misc Business,199661,4500,204161
B001287,N00030717,Ami Bera (D),2012,Labor,750,258300,259050
B001287,N00030717,Ami Bera (D),2012,Ideology/Single-Issue,176309,262292,438601
B001287,N00030717,Ami Bera (D),2012,Other,496645,1000,497645
C001083,N00030736,John Carney (D),2012,Agribusiness,1250,6000,7250
C001083,N00030736,John Carney (D),2012,Communic/Electronics,4500,25000,29500
C001083,N00030736,John Carney (D),2012,Construction,7100,15500,22600
C001083,N00030736,John Carney (D),2012,Defense,0,9000,9000
C001083,N00030736,John Carney (D),2012,Energy/Nat Resource,750,6500,7250
C001083,N00030736,John Carney (D),2012,Finance/Insur/RealEst,76625,464500,541125
C001083,N00030736,John Carney (D),2012,Health,29475,89952,119427
C001083,N00030736,John Carney (D),2012,Lawyers & Lobbyists,206051,17100,223151
C001083,N00030736,John Carney (D),2012,Transportation,4250,11000,15250
C001083,N00030736,John Carney (D),2012,Misc Business,28300,49926,78226
C001083,N00030736,John Carney (D),2012,Labor,250,103300,103550
C001083,N00030736,John Carney (D),2012,Ideology/Single-Issue,2500,31250,33750
C001083,N00030736,John Carney (D),2012,Other,64690,0,64690
D000615,N00030752,Jeff Duncan (R),2012,Agribusiness,7250,38000,45250
D000615,N00030752,Jeff Duncan (R),2012,Communic/Electronics,5150,18500,23650
D000615,N00030752,Jeff Duncan (R),2012,Construction,9950,19500,29450
D000615,N00030752,Jeff Duncan (R),2012,Defense,0,27000,27000
D000615,N00030752,Jeff Duncan (R),2012,Energy/Nat Resource,6050,69500,75550
D000615,N00030752,Jeff Duncan (R),2012,Finance/Insur/RealEst,22350,56500,78850
D000615,N00030752,Jeff Duncan (R),2012,Health,9075,46000,55075
D000615,N00030752,Jeff Duncan (R),2012,Lawyers & Lobbyists,21200,9500,30700
D000615,N00030752,Jeff Duncan (R),2012,Transportation,7700,36000,43700
D000615,N00030752,Jeff Duncan (R),2012,Misc Business,23500,67250,90750
D000615,N00030752,Jeff Duncan (R),2012,Labor,0,2000,2000
D000615,N00030752,Jeff Duncan (R),2012,Ideology/Single-Issue,3500,38312,41812
D000615,N00030752,Jeff Duncan (R),2012,Other,19952,0,19952
C001087,N00030770,Rick Crawford (R),2012,Agribusiness,96350,120250,216600
C001087,N00030770,Rick Crawford (R),2012,Communic/Electronics,2650,18750,21400
C001087,N00030770,Rick Crawford (R),2012,Construction,42080,24000,66080
C001087,N00030770,Rick Crawford (R),2012,Defense,0,1000,1000
C001087,N00030770,Rick Crawford (R),2012,Energy/Nat Resource,17022,28000,45022
C001087,N00030770,Rick Crawford (R),2012,Finance/Insur/RealEst,83811,74500,158311
C001087,N00030770,Rick Crawford (R),2012,Health,53227,19000,72227
C001087,N00030770,Rick Crawford (R),2012,Lawyers & Lobbyists,20133,2386,22519
C001087,N00030770,Rick Crawford (R),2012,Transportation,12755,47500,60255
C001087,N00030770,Rick Crawford (R),2012,Misc Business,56700,55500,112200
C001087,N00030770,Rick Crawford (R),2012,Labor,0,10000,10000
C001087,N00030770,Rick Crawford (R),2012,Ideology/Single-Issue,7290,136100,143390
C001087,N00030770,Rick Crawford (R),2012,Other,49014,500,49514
G000565,N00030771,Paul Gosar (R),2012,Agribusiness,34949,39000,73949
G000565,N00030771,Paul Gosar (R),2012,Communic/Electronics,1250,9000,10250
G000565,N00030771,Paul Gosar (R),2012,Construction,11000,15500,26500
G000565,N00030771,Paul Gosar (R),2012,Defense,250,10500,10750
G000565,N00030771,Paul Gosar (R),2012,Energy/Nat Resource,8400,64500,72900
G000565,N00030771,Paul Gosar (R),2012,Finance/Insur/RealEst,37450,26250,63700
G000565,N00030771,Paul Gosar (R),2012,Health,226781,97000,323781
G000565,N00030771,Paul Gosar (R),2012,Lawyers & Lobbyists,38900,8250,47150
G000565,N00030771,Paul Gosar (R),2012,Transportation,24192,15500,39692
G000565,N00030771,Paul Gosar (R),2012,Misc Business,73750,46999,120749
G000565,N00030771,Paul Gosar (R),2012,Ideology/Single-Issue,15875,90055,105930
G000565,N00030771,Paul Gosar (R),2012,Other,41816,0,41816
G000562,N00030780,Cory Gardner (R),2012,Agribusiness,88081,107112,195193
G000562,N00030780,Cory Gardner (R),2012,Communic/Electronics,52370,108000,160370
G000562,N00030780,Cory Gardner (R),2012,Construction,54300,41500,95800
G000562,N00030780,Cory Gardner (R),2012,Defense,2500,14500,17000
G000562,N00030780,Cory Gardner (R),2012,Energy/Nat Resource,97550,240500,338050
G000562,N00030780,Cory Gardner (R),2012,Finance/Insur/RealEst,163281,112650,275931
G000562,N00030780,Cory Gardner (R),2012,Health,36322,183500,219822
G000562,N00030780,Cory Gardner (R),2012,Lawyers & Lobbyists,80639,23750,104389
G000562,N00030780,Cory Gardner (R),2012,Transportation,18250,41000,59250
G000562,N00030780,Cory Gardner (R),2012,Misc Business,85650,155750,241400
G000562,N00030780,Cory Gardner (R),2012,Ideology/Single-Issue,32200,60600,92800
G000562,N00030780,Cory Gardner (R),2012,Other,141279,2000,143279
G000560,N00030788,Tom Graves (R),2012,Agribusiness,22900,61250,84150
G000560,N00030788,Tom Graves (R),2012,Communic/Electronics,10750,46000,56750
G000560,N00030788,Tom Graves (R),2012,Construction,15016,9500,24516
G000560,N00030788,Tom Graves (R),2012,Defense,500,19000,19500
G000560,N00030788,Tom Graves (R),2012,Energy/Nat Resource,6000,49750,55750
G000560,N00030788,Tom Graves (R),2012,Finance/Insur/RealEst,77949,81000,158949
G000560,N00030788,Tom Graves (R),2012,Health,47400,54000,101400
G000560,N00030788,Tom Graves (R),2012,Lawyers & Lobbyists,36316,11000,47316
G000560,N00030788,Tom Graves (R),2012,Transportation,11333,32499,43832
G000560,N00030788,Tom Graves (R),2012,Misc Business,92851,84934,177785
G000560,N00030788,Tom Graves (R),2012,Labor,250,1000,1250
G000560,N00030788,Tom Graves (R),2012,Ideology/Single-Issue,5587,53667,59254
G000560,N00030788,Tom Graves (R),2012,Other,50593,0,50593
G000570,N00030801,Frank Guinta (R),2012,Agribusiness,13250,2000,15250
G000570,N00030801,Frank Guinta (R),2012,Communic/Electronics,22900,22000,44900
G000570,N00030801,Frank Guinta (R),2012,Construction,39800,46500,86300
G000570,N00030801,Frank Guinta (R),2012,Defense,6650,33000,39650
G000570,N00030801,Frank Guinta (R),2012,Energy/Nat Resource,14450,47500,61950
G000570,N00030801,Frank Guinta (R),2012,Finance/Insur/RealEst,208530,201000,409530
G000570,N00030801,Frank Guinta (R),2012,Health,30100,63500,93600
G000570,N00030801,Frank Guinta (R),2012,Lawyers & Lobbyists,55135,5916,61051
G000570,N00030801,Frank Guinta (R),2012,Transportation,34342,88884,123226
G000570,N00030801,Frank Guinta (R),2012,Misc Business,127660,98666,226326
G000570,N00030801,Frank Guinta (R),2012,Labor,0,7000,7000
G000570,N00030801,Frank Guinta (R),2012,Ideology/Single-Issue,34300,258058,292358
G000570,N00030801,Frank Guinta (R),2012,Other,95750,0,95750
F000459,N00030815,Chuck Fleischmann (R),2012,Agribusiness,21250,22000,43250
F000459,N00030815,Chuck Fleischmann (R),2012,Communic/Electronics,7000,12000,19000
F000459,N00030815,Chuck Fleischmann (R),2012,Construction,107500,38000,145500
F000459,N00030815,Chuck Fleischmann (R),2012,Defense,2500,12500,15000
F000459,N00030815,Chuck Fleischmann (R),2012,Energy/Nat Resource,29700,51000,80700
F000459,N00030815,Chuck Fleischmann (R),2012,Finance/Insur/RealEst,163359,56500,219859
F000459,N00030815,Chuck Fleischmann (R),2012,Health,48100,41000,89100
F000459,N00030815,Chuck Fleischmann (R),2012,Lawyers & Lobbyists,52350,15000,67350
F000459,N00030815,Chuck Fleischmann (R),2012,Transportation,36200,62499,98699
F000459,N00030815,Chuck Fleischmann (R),2012,Misc Business,49350,98870,148220
F000459,N00030815,Chuck Fleischmann (R),2012,Labor,0,7000,7000
F000459,N00030815,Chuck Fleischmann (R),2012,Ideology/Single-Issue,250,125500,125750
F000459,N00030815,Chuck Fleischmann (R),2012,Other,53250,2500,55750
G000559,N00030856,John Garamendi (D),2012,Agribusiness,15350,19500,34850
G000559,N00030856,John Garamendi (D),2012,Communic/Electronics,27250,32000,59250
G000559,N00030856,John Garamendi (D),2012,Construction,23000,29200,52200
G000559,N00030856,John Garamendi (D),2012,Defense,3750,37500,41250
G000559,N00030856,John Garamendi (D),2012,Energy/Nat Resource,14400,30500,44900
G000559,N00030856,John Garamendi (D),2012,Finance/Insur/RealEst,164015,39000,203015
G000559,N00030856,John Garamendi (D),2012,Health,56400,23000,79400
G000559,N00030856,John Garamendi (D),2012,Lawyers & Lobbyists,91491,30250,121741
G000559,N00030856,John Garamendi (D),2012,Transportation,1250,10500,11750
G000559,N00030856,John Garamendi (D),2012,Misc Business,144461,29000,173461
G000559,N00030856,John Garamendi (D),2012,Labor,0,287840,287840
G000559,N00030856,John Garamendi (D),2012,Ideology/Single-Issue,90200,207686,297886
G000559,N00030856,John Garamendi (D),2012,Other,112485,2100,114585
G000566,N00030880,Trey Gowdy (R),2012,Agribusiness,4500,19500,24000
G000566,N00030880,Trey Gowdy (R),2012,Communic/Electronics,5400,54500,59900
G000566,N00030880,Trey Gowdy (R),2012,Construction,12749,20500,33249
G000566,N00030880,Trey Gowdy (R),2012,Defense,0,14000,14000
G000566,N00030880,Trey Gowdy (R),2012,Energy/Nat Resource,1250,32000,33250
G000566,N00030880,Trey Gowdy (R),2012,Finance/Insur/RealEst,46350,91528,137878
G000566,N00030880,Trey Gowdy (R),2012,Health,23150,48250,71400
G000566,N00030880,Trey Gowdy (R),2012,Lawyers & Lobbyists,40150,3250,43400
G000566,N00030880,Trey Gowdy (R),2012,Transportation,2250,22999,25249
G000566,N00030880,Trey Gowdy (R),2012,Misc Business,29200,89000,118200
G000566,N00030880,Trey Gowdy (R),2012,Labor,0,1000,1000
G000566,N00030880,Trey Gowdy (R),2012,Ideology/Single-Issue,1500,40112,41612
G000566,N00030880,Trey Gowdy (R),2012,Other,19325,500,19825
B001274,N00030910,Mo Brooks (R),2012,Agribusiness,3750,25000,28750
B001274,N00030910,Mo Brooks (R),2012,Communic/Electronics,21830,25950,47780
B001274,N00030910,Mo Brooks (R),2012,Construction,10700,24000,34700
B001274,N00030910,Mo Brooks (R),2012,Defense,54520,158500,213020
B001274,N00030910,Mo Brooks (R),2012,Energy/Nat Resource,1750,21000,22750
B001274,N00030910,Mo Brooks (R),2012,Finance/Insur/RealEst,27700,47000,74700
B001274,N00030910,Mo Brooks (R),2012,Health,30334,36000,66334
B001274,N00030910,Mo Brooks (R),2012,Lawyers & Lobbyists,37560,20500,58060
B001274,N00030910,Mo Brooks (R),2012,Transportation,4800,17500,22300
B001274,N00030910,Mo Brooks (R),2012,Misc Business,20713,50000,70713
B001274,N00030910,Mo Brooks (R),2012,Ideology/Single-Issue,3000,43498,46498
B001274,N00030910,Mo Brooks (R),2012,Other,43167,0,43167
D000616,N00030957,Scott Desjarlais (R),2012,Agribusiness,34500,58500,93000
D000616,N00030957,Scott Desjarlais (R),2012,Communic/Electronics,15700,6000,21700
D000616,N00030957,Scott Desjarlais (R),2012,Construction,49200,7500,56700
D000616,N00030957,Scott Desjarlais (R),2012,Defense,0,4000,4000
D000616,N00030957,Scott Desjarlais (R),2012,Energy/Nat Resource,25500,13250,38750
D000616,N00030957,Scott Desjarlais (R),2012,Finance/Insur/RealEst,105100,61800,166900
D000616,N00030957,Scott Desjarlais (R),2012,Health,112999,70384,183383
D000616,N00030957,Scott Desjarlais (R),2012,Lawyers & Lobbyists,35550,2500,38050
D000616,N00030957,Scott Desjarlais (R),2012,Transportation,18000,32700,50700
D000616,N00030957,Scott Desjarlais (R),2012,Misc Business,85256,62372,147628
D000616,N00030957,Scott Desjarlais (R),2012,Ideology/Single-Issue,10000,160315,170315
D000616,N00030957,Scott Desjarlais (R),2012,Other,73610,1000,74610
D000614,N00030967,Sean P Duffy (R),2012,Agribusiness,101500,41000,142500
D000614,N00030967,Sean P Duffy (R),2012,Communic/Electronics,15000,31250,46250
D000614,N00030967,Sean P Duffy (R),2012,Construction,82473,43500,125973
D000614,N00030967,Sean P Duffy (R),2012,Defense,3000,9000,12000
D000614,N00030967,Sean P Duffy (R),2012,Energy/Nat Resource,24516,63500,88016
D000614,N00030967,Sean P Duffy (R),2012,Finance/Insur/RealEst,153883,387051,540934
D000614,N00030967,Sean P Duffy (R),2012,Health,99360,66750,166110
D000614,N00030967,Sean P Duffy (R),2012,Lawyers & Lobbyists,53554,7167,60721
D000614,N00030967,Sean P Duffy (R),2012,Transportation,46492,43500,89992
D000614,N00030967,Sean P Duffy (R),2012,Misc Business,141000,121613,262613
D000614,N00030967,Sean P Duffy (R),2012,Labor,0,18500,18500
D000614,N00030967,Sean P Duffy (R),2012,Ideology/Single-Issue,41140,298287,339427
D000614,N00030967,Sean P Duffy (R),2012,Other,143498,1000,144498
A000368,N00030980,Kelly Ayotte (R),2012,Agribusiness,39400,60050,99450
A000368,N00030980,Kelly Ayotte (R),2012,Communic/Electronics,165768,138501,304269
A000368,N00030980,Kelly Ayotte (R),2012,Construction,114638,42000,156638
A000368,N00030980,Kelly Ayotte (R),2012,Defense,9600,61000,70600
A000368,N00030980,Kelly Ayotte (R),2012,Energy/Nat Resource,179208,151150,330358
A000368,N00030980,Kelly Ayotte (R),2012,Finance/Insur/RealEst,1148283,323210,1471493
A000368,N00030980,Kelly Ayotte (R),2012,Health,169510,245749,415259
A000368,N00030980,Kelly Ayotte (R),2012,Lawyers & Lobbyists,475895,33500,509395
A000368,N00030980,Kelly Ayotte (R),2012,Transportation,70201,106500,176701
A000368,N00030980,Kelly Ayotte (R),2012,Misc Business,452458,243800,696258
A000368,N00030980,Kelly Ayotte (R),2012,Labor,0,5000,5000
A000368,N00030980,Kelly Ayotte (R),2012,Ideology/Single-Issue,181692,341529,523221
A000368,N00030980,Kelly Ayotte (R),2012,Other,452004,2000,454004
H001053,N00031005,Vicky Hartzler (R),2012,Agribusiness,85212,122082,207294
H001053,N00031005,Vicky Hartzler (R),2012,Communic/Electronics,19150,16500,35650
H001053,N00031005,Vicky Hartzler (R),2012,Construction,68850,10000,78850
H001053,N00031005,Vicky Hartzler (R),2012,Defense,5000,66134,71134
H001053,N00031005,Vicky Hartzler (R),2012,Energy/Nat Resource,26250,33250,59500
H001053,N00031005,Vicky Hartzler (R),2012,Finance/Insur/RealEst,105300,57000,162300
H001053,N00031005,Vicky Hartzler (R),2012,Health,41234,25500,66734
H001053,N00031005,Vicky Hartzler (R),2012,Lawyers & Lobbyists,26970,10000,36970
H001053,N00031005,Vicky Hartzler (R),2012,Transportation,38550,28500,67050
H001053,N00031005,Vicky Hartzler (R),2012,Misc Business,124314,17500,141814
H001053,N00031005,Vicky Hartzler (R),2012,Labor,0,1000,1000
H001053,N00031005,Vicky Hartzler (R),2012,Ideology/Single-Issue,22150,145494,167644
H001053,N00031005,Vicky Hartzler (R),2012,Other,85700,500,86200
D000613,N00031103,Robert Dold (R),2012,Agribusiness,31900,55597,87497
D000613,N00031103,Robert Dold (R),2012,Communic/Electronics,33600,22500,56100
D000613,N00031103,Robert Dold (R),2012,Construction,57350,37000,94350
D000613,N00031103,Robert Dold (R),2012,Defense,2500,15000,17500
D000613,N00031103,Robert Dold (R),2012,Energy/Nat Resource,25300,44500,69800
D000613,N00031103,Robert Dold (R),2012,Finance/Insur/RealEst,808344,477712,1286056
D000613,N00031103,Robert Dold (R),2012,Health,142099,107200,249299
D000613,N00031103,Robert Dold (R),2012,Lawyers & Lobbyists,294874,24500,319374
D000613,N00031103,Robert Dold (R),2012,Transportation,46942,60500,107442
D000613,N00031103,Robert Dold (R),2012,Misc Business,377257,174300,551557
D000613,N00031103,Robert Dold (R),2012,Labor,0,27500,27500
D000613,N00031103,Robert Dold (R),2012,Ideology/Single-Issue,186595,340349,526944
D000613,N00031103,Robert Dold (R),2012,Other,305925,8000,313925
H001059,N00031104,Randy Hultgren (R),2012,Agribusiness,10650,116808,127458
H001059,N00031104,Randy Hultgren (R),2012,Communic/Electronics,15200,15500,30700
H001059,N00031104,Randy Hultgren (R),2012,Construction,48000,44500,92500
H001059,N00031104,Randy Hultgren (R),2012,Defense,2500,4500,7000
H001059,N00031104,Randy Hultgren (R),2012,Energy/Nat Resource,11250,44500,55750
H001059,N00031104,Randy Hultgren (R),2012,Finance/Insur/RealEst,153050,78000,231050
H001059,N00031104,Randy Hultgren (R),2012,Health,34125,41000,75125
H001059,N00031104,Randy Hultgren (R),2012,Lawyers & Lobbyists,48150,10500,58650
H001059,N00031104,Randy Hultgren (R),2012,Transportation,3550,103850,107400
H001059,N00031104,Randy Hultgren (R),2012,Misc Business,70250,56166,126416
H001059,N00031104,Randy Hultgren (R),2012,Labor,0,46000,46000
H001059,N00031104,Randy Hultgren (R),2012,Ideology/Single-Issue,21900,49750,71650
H001059,N00031104,Randy Hultgren (R),2012,Other,73125,0,73125
G000563,N00031128,Bob Gibbs (R),2012,Agribusiness,18187,145400,163587
G000563,N00031128,Bob Gibbs (R),2012,Communic/Electronics,14000,16100,30100
G000563,N00031128,Bob Gibbs (R),2012,Construction,57700,49000,106700
G000563,N00031128,Bob Gibbs (R),2012,Defense,0,1000,1000
G000563,N00031128,Bob Gibbs (R),2012,Energy/Nat Resource,137950,98000,235950
G000563,N00031128,Bob Gibbs (R),2012,Finance/Insur/RealEst,32600,73750,106350
G000563,N00031128,Bob Gibbs (R),2012,Health,24100,22000,46100
G000563,N00031128,Bob Gibbs (R),2012,Lawyers & Lobbyists,29683,19250,48933
G000563,N00031128,Bob Gibbs (R),2012,Transportation,10996,96000,106996
G000563,N00031128,Bob Gibbs (R),2012,Misc Business,108450,80000,188450
G000563,N00031128,Bob Gibbs (R),2012,Labor,0,26000,26000
G000563,N00031128,Bob Gibbs (R),2012,Ideology/Single-Issue,8500,141507,150007
G000563,N00031128,Bob Gibbs (R),2012,Other,45025,1000,46025
F000458,N00031141,Steve Fincher (R),2012,Agribusiness,247350,182715,430065
F000458,N00031141,Steve Fincher (R),2012,Communic/Electronics,13700,10500,24200
F000458,N00031141,Steve Fincher (R),2012,Construction,96550,42500,139050
F000458,N00031141,Steve Fincher (R),2012,Energy/Nat Resource,33200,33000,66200
F000458,N00031141,Steve Fincher (R),2012,Finance/Insur/RealEst,215594,315150,530744
F000458,N00031141,Steve Fincher (R),2012,Health,60300,30500,90800
F000458,N00031141,Steve Fincher (R),2012,Lawyers & Lobbyists,53259,7254,60513
F000458,N00031141,Steve Fincher (R),2012,Transportation,18250,72749,90999
F000458,N00031141,Steve Fincher (R),2012,Misc Business,64050,94447,158497
F000458,N00031141,Steve Fincher (R),2012,Labor,0,8000,8000
F000458,N00031141,Steve Fincher (R),2012,Ideology/Single-Issue,2000,98410,100410
F000458,N00031141,Steve Fincher (R),2012,Other,142550,0,142550
A000369,N00031177,Mark Amodei (R),2012,Agribusiness,16323,19500,35823
A000369,N00031177,Mark Amodei (R),2012,Communic/Electronics,9987,54750,64737
A000369,N00031177,Mark Amodei (R),2012,Construction,32099,43500,75599
A000369,N00031177,Mark Amodei (R),2012,Defense,250,12000,12250
A000369,N00031177,Mark Amodei (R),2012,Energy/Nat Resource,8750,81000,89750
A000369,N00031177,Mark Amodei (R),2012,Finance/Insur/RealEst,39600,86428,126028
A000369,N00031177,Mark Amodei (R),2012,Health,31750,54000,85750
A000369,N00031177,Mark Amodei (R),2012,Lawyers & Lobbyists,81615,22750,104365
A000369,N00031177,Mark Amodei (R),2012,Transportation,11050,33000,44050
A000369,N00031177,Mark Amodei (R),2012,Misc Business,98934,120101,219035
A000369,N00031177,Mark Amodei (R),2012,Labor,0,3500,3500
A000369,N00031177,Mark Amodei (R),2012,Ideology/Single-Issue,9000,148842,157842
A000369,N00031177,Mark Amodei (R),2012,Other,59292,0,59292
B001275,N00031227,Larry Bucshon (R),2012,Agribusiness,26300,18500,44800
B001275,N00031227,Larry Bucshon (R),2012,Communic/Electronics,6565,11500,18065
B001275,N00031227,Larry Bucshon (R),2012,Construction,79522,31500,111022
B001275,N00031227,Larry Bucshon (R),2012,Defense,5250,2000,7250
B001275,N00031227,Larry Bucshon (R),2012,Energy/Nat Resource,49375,69050,118425
B001275,N00031227,Larry Bucshon (R),2012,Finance/Insur/RealEst,78240,74750,152990
B001275,N00031227,Larry Bucshon (R),2012,Health,90797,188650,279447
B001275,N00031227,Larry Bucshon (R),2012,Lawyers & Lobbyists,27547,6500,34047
B001275,N00031227,Larry Bucshon (R),2012,Transportation,12246,49875,62121
B001275,N00031227,Larry Bucshon (R),2012,Misc Business,79450,33634,113084
B001275,N00031227,Larry Bucshon (R),2012,Ideology/Single-Issue,13250,127626,140876
B001275,N00031227,Larry Bucshon (R),2012,Other,40047,0,40047
B001282,N00031233,Andy Barr (R),2012,Agribusiness,116150,19500,135650
B001282,N00031233,Andy Barr (R),2012,Communic/Electronics,13800,4000,17800
B001282,N00031233,Andy Barr (R),2012,Construction,102527,22500,125027
B001282,N00031233,Andy Barr (R),2012,Energy/Nat Resource,199732,68500,268232
B001282,N00031233,Andy Barr (R),2012,Finance/Insur/RealEst,234329,41500,275829
B001282,N00031233,Andy Barr (R),2012,Health,67700,54750,122450
B001282,N00031233,Andy Barr (R),2012,Lawyers & Lobbyists,64663,2500,67163
B001282,N00031233,Andy Barr (R),2012,Transportation,24650,14000,38650
B001282,N00031233,Andy Barr (R),2012,Misc Business,150410,10916,161326
B001282,N00031233,Andy Barr (R),2012,Ideology/Single-Issue,30100,197458,227558
B001282,N00031233,Andy Barr (R),2012,Other,229792,0,229792
H001055,N00031244,Joe Heck (R),2012,Agribusiness,4500,13000,17500
H001055,N00031244,Joe Heck (R),2012,Communic/Electronics,29750,22000,51750
H001055,N00031244,Joe Heck (R),2012,Construction,68290,32000,100290
H001055,N00031244,Joe Heck (R),2012,Defense,23200,70999,94199
H001055,N00031244,Joe Heck (R),2012,Energy/Nat Resource,29100,88750,117850
H001055,N00031244,Joe Heck (R),2012,Finance/Insur/RealEst,154711,128250,282961
H001055,N00031244,Joe Heck (R),2012,Health,186001,250745,436746
H001055,N00031244,Joe Heck (R),2012,Lawyers & Lobbyists,63050,15797,78847
H001055,N00031244,Joe Heck (R),2012,Transportation,47092,24500,71592
H001055,N00031244,Joe Heck (R),2012,Misc Business,262080,132890,394970
H001055,N00031244,Joe Heck (R),2012,Labor,0,22500,22500
H001055,N00031244,Joe Heck (R),2012,Ideology/Single-Issue,31900,215870,247770
H001055,N00031244,Joe Heck (R),2012,Other,117200,14500,131700
H001060,N00031265,Robert Hurt (R),2012,Agribusiness,44250,64500,108750
H001060,N00031265,Robert Hurt (R),2012,Communic/Electronics,15750,25000,40750
H001060,N00031265,Robert Hurt (R),2012,Construction,39950,20000,59950
H001060,N00031265,Robert Hurt (R),2012,Defense,8400,34000,42400
H001060,N00031265,Robert Hurt (R),2012,Energy/Nat Resource,35250,79000,114250
H001060,N00031265,Robert Hurt (R),2012,Finance/Insur/RealEst,169501,393306,562807
H001060,N00031265,Robert Hurt (R),2012,Health,22650,55500,78150
H001060,N00031265,Robert Hurt (R),2012,Lawyers & Lobbyists,80606,20200,100806
H001060,N00031265,Robert Hurt (R),2012,Transportation,21500,33000,54500
H001060,N00031265,Robert Hurt (R),2012,Misc Business,76425,63130,139555
H001060,N00031265,Robert Hurt (R),2012,Ideology/Single-Issue,21500,107783,129283
H001060,N00031265,Robert Hurt (R),2012,Other,178100,2000,180100
G000567,N00031297,Tim Griffin (R),2012,Agribusiness,32550,18500,51050
G000567,N00031297,Tim Griffin (R),2012,Communic/Electronics,18900,50000,68900
G000567,N00031297,Tim Griffin (R),2012,Construction,58000,26000,84000
G000567,N00031297,Tim Griffin (R),2012,Defense,0,47134,47134
G000567,N00031297,Tim Griffin (R),2012,Energy/Nat Resource,55150,57500,112650
G000567,N00031297,Tim Griffin (R),2012,Finance/Insur/RealEst,165500,95000,260500
G000567,N00031297,Tim Griffin (R),2012,Health,90126,55500,145626
G000567,N00031297,Tim Griffin (R),2012,Lawyers & Lobbyists,67150,15664,82814
G000567,N00031297,Tim Griffin (R),2012,Transportation,26250,23500,49750
G000567,N00031297,Tim Griffin (R),2012,Misc Business,115268,59550,174818
G000567,N00031297,Tim Griffin (R),2012,Labor,0,9000,9000
G000567,N00031297,Tim Griffin (R),2012,Ideology/Single-Issue,12475,69794,82269
G000567,N00031297,Tim Griffin (R),2012,Other,107179,1000,108179
D000610,N00031317,Ted Deutch (D),2012,Agribusiness,19750,4750,24500
D000610,N00031317,Ted Deutch (D),2012,Communic/Electronics,12550,51000,63550
D000610,N00031317,Ted Deutch (D),2012,Construction,41400,10750,52150
D000610,N00031317,Ted Deutch (D),2012,Defense,0,2000,2000
D000610,N00031317,Ted Deutch (D),2012,Energy/Nat Resource,2650,11000,13650
D000610,N00031317,Ted Deutch (D),2012,Finance/Insur/RealEst,195285,22500,217785
D000610,N00031317,Ted Deutch (D),2012,Health,49750,35500,85250
D000610,N00031317,Ted Deutch (D),2012,Lawyers & Lobbyists,117400,24212,141612
D000610,N00031317,Ted Deutch (D),2012,Transportation,5250,4500,9750
D000610,N00031317,Ted Deutch (D),2012,Misc Business,60755,60500,121255
D000610,N00031317,Ted Deutch (D),2012,Labor,0,104500,104500
D000610,N00031317,Ted Deutch (D),2012,Ideology/Single-Issue,72440,33750,106190
D000610,N00031317,Ted Deutch (D),2012,Other,113085,500,113585
G000569,N00031401,Michael Grimm (R),2012,Agribusiness,16750,23000,39750
G000569,N00031401,Michael Grimm (R),2012,Communic/Electronics,33495,37000,70495
G000569,N00031401,Michael Grimm (R),2012,Construction,38000,24500,62500
G000569,N00031401,Michael Grimm (R),2012,Defense,750,9000,9750
G000569,N00031401,Michael Grimm (R),2012,Energy/Nat Resource,11800,31250,43050
G000569,N00031401,Michael Grimm (R),2012,Finance/Insur/RealEst,243865,413155,657020
G000569,N00031401,Michael Grimm (R),2012,Health,42842,47000,89842
G000569,N00031401,Michael Grimm (R),2012,Lawyers & Lobbyists,119908,10000,129908
G000569,N00031401,Michael Grimm (R),2012,Transportation,18000,19500,37500
G000569,N00031401,Michael Grimm (R),2012,Misc Business,82531,107590,190121
G000569,N00031401,Michael Grimm (R),2012,Labor,0,231200,231200
G000569,N00031401,Michael Grimm (R),2012,Ideology/Single-Issue,12500,224480,236980
G000569,N00031401,Michael Grimm (R),2012,Other,60490,0,60490
E000291,N00031513,Renee Ellmers (R),2012,Agribusiness,24950,139500,164450
E000291,N00031513,Renee Ellmers (R),2012,Communic/Electronics,3750,21500,25250
E000291,N00031513,Renee Ellmers (R),2012,Construction,25900,21325,47225
E000291,N00031513,Renee Ellmers (R),2012,Defense,1000,10500,11500
E000291,N00031513,Renee Ellmers (R),2012,Energy/Nat Resource,6700,22000,28700
E000291,N00031513,Renee Ellmers (R),2012,Finance/Insur/RealEst,51450,78800,130250
E000291,N00031513,Renee Ellmers (R),2012,Health,24350,95250,119600
E000291,N00031513,Renee Ellmers (R),2012,Lawyers & Lobbyists,14175,11750,25925
E000291,N00031513,Renee Ellmers (R),2012,Transportation,1500,26500,28000
E000291,N00031513,Renee Ellmers (R),2012,Misc Business,35607,67499,103106
E000291,N00031513,Renee Ellmers (R),2012,Labor,0,14500,14500
E000291,N00031513,Renee Ellmers (R),2012,Ideology/Single-Issue,4950,90947,95897
E000291,N00031513,Renee Ellmers (R),2012,Other,38600,2000,40600
B001273,N00031539,Diane Black (R),2012,Agribusiness,31500,48500,80000
B001273,N00031539,Diane Black (R),2012,Communic/Electronics,15500,25500,41000
B001273,N00031539,Diane Black (R),2012,Construction,63250,38000,101250
B001273,N00031539,Diane Black (R),2012,Defense,500,16500,17000
B001273,N00031539,Diane Black (R),2012,Energy/Nat Resource,14605,70000,84605
B001273,N00031539,Diane Black (R),2012,Finance/Insur/RealEst,118257,253528,371785
B001273,N00031539,Diane Black (R),2012,Health,131995,346235,478230
B001273,N00031539,Diane Black (R),2012,Lawyers & Lobbyists,65575,31749,97324
B001273,N00031539,Diane Black (R),2012,Transportation,23250,54500,77750
B001273,N00031539,Diane Black (R),2012,Misc Business,71100,172038,243138
B001273,N00031539,Diane Black (R),2012,Labor,0,1000,1000
B001273,N00031539,Diane Black (R),2012,Ideology/Single-Issue,5750,118113,123863
B001273,N00031539,Diane Black (R),2012,Other,60100,0,60100
F000461,N00031545,Bill Flores (R),2012,Agribusiness,21530,65525,87055
F000461,N00031545,Bill Flores (R),2012,Communic/Electronics,6200,16500,22700
F000461,N00031545,Bill Flores (R),2012,Construction,53015,11000,64015
F000461,N00031545,Bill Flores (R),2012,Defense,500,13000,13500
F000461,N00031545,Bill Flores (R),2012,Energy/Nat Resource,137089,97827,234916
F000461,N00031545,Bill Flores (R),2012,Finance/Insur/RealEst,73450,97000,170450
F000461,N00031545,Bill Flores (R),2012,Health,34196,37000,71196
F000461,N00031545,Bill Flores (R),2012,Lawyers & Lobbyists,42515,13000,55515
F000461,N00031545,Bill Flores (R),2012,Transportation,8750,52000,60750
F000461,N00031545,Bill Flores (R),2012,Misc Business,56250,46134,102384
F000461,N00031545,Bill Flores (R),2012,Labor,0,1000,1000
F000461,N00031545,Bill Flores (R),2012,Ideology/Single-Issue,14250,57272,71522
F000461,N00031545,Bill Flores (R),2012,Other,157163,0,157163
H001064,N00031557,Dennis Heck (D),2012,Agribusiness,14100,17500,31600
H001064,N00031557,Dennis Heck (D),2012,Communic/Electronics,45935,16000,61935
H001064,N00031557,Dennis Heck (D),2012,Construction,11450,9000,20450
H001064,N00031557,Dennis Heck (D),2012,Defense,8450,22000,30450
H001064,N00031557,Dennis Heck (D),2012,Energy/Nat Resource,11025,7550,18575
H001064,N00031557,Dennis Heck (D),2012,Finance/Insur/RealEst,64970,51750,116720
H001064,N00031557,Dennis Heck (D),2012,Health,49932,88500,138432
H001064,N00031557,Dennis Heck (D),2012,Lawyers & Lobbyists,146919,13500,160419
H001064,N00031557,Dennis Heck (D),2012,Transportation,22100,24500,46600
H001064,N00031557,Dennis Heck (D),2012,Misc Business,96750,24500,121250
H001064,N00031557,Dennis Heck (D),2012,Labor,4025,264500,268525
H001064,N00031557,Dennis Heck (D),2012,Ideology/Single-Issue,52200,158067,210267
H001064,N00031557,Dennis Heck (D),2012,Other,215897,1500,217397
H001056,N00031559,Jaime Herrera Beutler (R),2012,Agribusiness,37554,29000,66554
H001056,N00031559,Jaime Herrera Beutler (R),2012,Communic/Electronics,24000,32100,56100
H001056,N00031559,Jaime Herrera Beutler (R),2012,Construction,41150,28500,69650
H001056,N00031559,Jaime Herrera Beutler (R),2012,Defense,2359,3500,5859
H001056,N00031559,Jaime Herrera Beutler (R),2012,Energy/Nat Resource,17900,30000,47900
H001056,N00031559,Jaime Herrera Beutler (R),2012,Finance/Insur/RealEst,189790,93000,282790
H001056,N00031559,Jaime Herrera Beutler (R),2012,Health,34200,37000,71200
H001056,N00031559,Jaime Herrera Beutler (R),2012,Lawyers & Lobbyists,19750,8000,27750
H001056,N00031559,Jaime Herrera Beutler (R),2012,Transportation,22850,81500,104350
H001056,N00031559,Jaime Herrera Beutler (R),2012,Misc Business,114792,67500,182292
H001056,N00031559,Jaime Herrera Beutler (R),2012,Labor,0,10500,10500
H001056,N00031559,Jaime Herrera Beutler (R),2012,Ideology/Single-Issue,35285,88759,124044
H001056,N00031559,Jaime Herrera Beutler (R),2012,Other,144538,0,144538
D000612,N00031593,Jeff Denham (R),2012,Agribusiness,479295,173558,652853
D000612,N00031593,Jeff Denham (R),2012,Communic/Electronics,8012,45500,53512
D000612,N00031593,Jeff Denham (R),2012,Construction,70686,39075,109761
D000612,N00031593,Jeff Denham (R),2012,Defense,1250,6000,7250
D000612,N00031593,Jeff Denham (R),2012,Energy/Nat Resource,27150,87333,114483
D000612,N00031593,Jeff Denham (R),2012,Finance/Insur/RealEst,143588,145800,289388
D000612,N00031593,Jeff Denham (R),2012,Health,46600,95211,141811
D000612,N00031593,Jeff Denham (R),2012,Lawyers & Lobbyists,85283,27783,113066
D000612,N00031593,Jeff Denham (R),2012,Transportation,52942,119999,172941
D000612,N00031593,Jeff Denham (R),2012,Misc Business,224959,115750,340709
D000612,N00031593,Jeff Denham (R),2012,Labor,0,5500,5500
D000612,N00031593,Jeff Denham (R),2012,Ideology/Single-Issue,34000,313810,347810
D000612,N00031593,Jeff Denham (R),2012,Other,51124,3500,54624
F000460,N00031672,Blake Farenthold (R),2012,Agribusiness,50977,41147,92124
F000460,N00031672,Blake Farenthold (R),2012,Communic/Electronics,2250,13000,15250
F000460,N00031672,Blake Farenthold (R),2012,Construction,65716,25500,91216
F000460,N00031672,Blake Farenthold (R),2012,Defense,250,4000,4250
F000460,N00031672,Blake Farenthold (R),2012,Energy/Nat Resource,59835,63500,123335
F000460,N00031672,Blake Farenthold (R),2012,Finance/Insur/RealEst,78610,54750,133360
F000460,N00031672,Blake Farenthold (R),2012,Health,37316,17500,54816
F000460,N00031672,Blake Farenthold (R),2012,Lawyers & Lobbyists,39293,1000,40293
F000460,N00031672,Blake Farenthold (R),2012,Transportation,22898,99633,122531
F000460,N00031672,Blake Farenthold (R),2012,Misc Business,28625,35540,64165
F000460,N00031672,Blake Farenthold (R),2012,Labor,0,5500,5500
F000460,N00031672,Blake Farenthold (R),2012,Ideology/Single-Issue,2950,104735,107685
F000460,N00031672,Blake Farenthold (R),2012,Other,58458,0,58458
B001277,N00031685,Richard Blumenthal (D),2012,Agribusiness,14650,11500,26150
B001277,N00031685,Richard Blumenthal (D),2012,Communic/Electronics,232349,63000,295349
B001277,N00031685,Richard Blumenthal (D),2012,Construction,95300,0,95300
B001277,N00031685,Richard Blumenthal (D),2012,Defense,2052,20000,22052
B001277,N00031685,Richard Blumenthal (D),2012,Energy/Nat Resource,39050,8000,47050
B001277,N00031685,Richard Blumenthal (D),2012,Finance/Insur/RealEst,1259227,116740,1375967
B001277,N00031685,Richard Blumenthal (D),2012,Health,226043,170750,396793
B001277,N00031685,Richard Blumenthal (D),2012,Lawyers & Lobbyists,721176,54500,775676
B001277,N00031685,Richard Blumenthal (D),2012,Transportation,37100,6000,43100
B001277,N00031685,Richard Blumenthal (D),2012,Misc Business,328375,78483,406858
B001277,N00031685,Richard Blumenthal (D),2012,Labor,0,287000,287000
B001277,N00031685,Richard Blumenthal (D),2012,Ideology/Single-Issue,164750,293130,457880
B001277,N00031685,Richard Blumenthal (D),2012,Other,855691,1000,856691
H001061,N00031688,John Hoeven (R),2012,Agribusiness,71450,155800,227250
H001061,N00031688,John Hoeven (R),2012,Communic/Electronics,45365,89100,134465
H001061,N00031688,John Hoeven (R),2012,Construction,140200,56500,196700
H001061,N00031688,John Hoeven (R),2012,Defense,4800,32000,36800
H001061,N00031688,John Hoeven (R),2012,Energy/Nat Resource,349596,258073,607669
H001061,N00031688,John Hoeven (R),2012,Finance/Insur/RealEst,364570,243050,607620
H001061,N00031688,John Hoeven (R),2012,Health,93360,163450,256810
H001061,N00031688,John Hoeven (R),2012,Lawyers & Lobbyists,114488,31137,145625
H001061,N00031688,John Hoeven (R),2012,Transportation,38350,75400,113750
H001061,N00031688,John Hoeven (R),2012,Misc Business,249599,157042,406641
H001061,N00031688,John Hoeven (R),2012,Labor,0,19600,19600
H001061,N00031688,John Hoeven (R),2012,Ideology/Single-Issue,63935,199975,263910
H001061,N00031688,John Hoeven (R),2012,Other,265760,0,265760
C001088,N00031820,Chris Coons (D),2012,Agribusiness,22450,12500,34950
C001088,N00031820,Chris Coons (D),2012,Communic/Electronics,146050,78000,224050
C001088,N00031820,Chris Coons (D),2012,Construction,22300,11000,33300
C001088,N00031820,Chris Coons (D),2012,Defense,1000,18500,19500
C001088,N00031820,Chris Coons (D),2012,Energy/Nat Resource,22623,44000,66623
C001088,N00031820,Chris Coons (D),2012,Finance/Insur/RealEst,403525,264155,667680
C001088,N00031820,Chris Coons (D),2012,Health,143050,163500,306550
C001088,N00031820,Chris Coons (D),2012,Lawyers & Lobbyists,967958,96480,1064438
C001088,N00031820,Chris Coons (D),2012,Transportation,12600,27500,40100
C001088,N00031820,Chris Coons (D),2012,Misc Business,191650,102500,294150
C001088,N00031820,Chris Coons (D),2012,Labor,1750,243500,245250
C001088,N00031820,Chris Coons (D),2012,Ideology/Single-Issue,123090,391908,514998
C001088,N00031820,Chris Coons (D),2012,Other,304763,3000,307763
B001270,N00031877,Karen Bass (D),2012,Agribusiness,0,7500,7500
B001270,N00031877,Karen Bass (D),2012,Communic/Electronics,24000,41248,65248
B001270,N00031877,Karen Bass (D),2012,Construction,13050,7000,20050
B001270,N00031877,Karen Bass (D),2012,Defense,500,14000,14500
B001270,N00031877,Karen Bass (D),2012,Energy/Nat Resource,0,11900,11900
B001270,N00031877,Karen Bass (D),2012,Finance/Insur/RealEst,22550,53500,76050
B001270,N00031877,Karen Bass (D),2012,Health,20050,68500,88550
B001270,N00031877,Karen Bass (D),2012,Lawyers & Lobbyists,41402,15488,56890
B001270,N00031877,Karen Bass (D),2012,Transportation,0,18500,18500
B001270,N00031877,Karen Bass (D),2012,Misc Business,27250,28500,55750
B001270,N00031877,Karen Bass (D),2012,Labor,0,155000,155000
B001270,N00031877,Karen Bass (D),2012,Ideology/Single-Issue,7250,20000,27250
B001270,N00031877,Karen Bass (D),2012,Other,13500,3000,16500
B001271,N00031934,Dan Benishek (R),2012,Agribusiness,8850,46000,54850
B001271,N00031934,Dan Benishek (R),2012,Communic/Electronics,10850,29500,40350
B001271,N00031934,Dan Benishek (R),2012,Construction,17100,46000,63100
B001271,N00031934,Dan Benishek (R),2012,Defense,5500,11000,16500
B001271,N00031934,Dan Benishek (R),2012,Energy/Nat Resource,54450,141000,195450
B001271,N00031934,Dan Benishek (R),2012,Finance/Insur/RealEst,79075,116500,195575
B001271,N00031934,Dan Benishek (R),2012,Health,96025,183000,279025
B001271,N00031934,Dan Benishek (R),2012,Lawyers & Lobbyists,25000,13250,38250
B001271,N00031934,Dan Benishek (R),2012,Transportation,37197,31200,68397
B001271,N00031934,Dan Benishek (R),2012,Misc Business,159949,79868,239817
B001271,N00031934,Dan Benishek (R),2012,Labor,0,2000,2000
B001271,N00031934,Dan Benishek (R),2012,Ideology/Single-Issue,35001,393719,428720
B001271,N00031934,Dan Benishek (R),2012,Other,90951,1000,91951
A000367,N00031938,Justin Amash (R),2012,Agribusiness,38151,1950,40101
A000367,N00031938,Justin Amash (R),2012,Communic/Electronics,27550,4000,31550
A000367,N00031938,Justin Amash (R),2012,Construction,27450,3000,30450
A000367,N00031938,Justin Amash (R),2012,Defense,400,1000,1400
A000367,N00031938,Justin Amash (R),2012,Energy/Nat Resource,21250,24000,45250
A000367,N00031938,Justin Amash (R),2012,Finance/Insur/RealEst,101650,38000,139650
A000367,N00031938,Justin Amash (R),2012,Health,81100,11000,92100
A000367,N00031938,Justin Amash (R),2012,Lawyers & Lobbyists,38525,3000,41525
A000367,N00031938,Justin Amash (R),2012,Transportation,33150,8000,41150
A000367,N00031938,Justin Amash (R),2012,Misc Business,202481,16750,219231
A000367,N00031938,Justin Amash (R),2012,Labor,0,500,500
A000367,N00031938,Justin Amash (R),2012,Ideology/Single-Issue,16450,60936,77386
A000367,N00031938,Justin Amash (R),2012,Other,87561,0,87561
G000564,N00031998,Chris Gibson (R),2012,Agribusiness,38575,113844,152419
G000564,N00031998,Chris Gibson (R),2012,Communic/Electronics,21250,37000,58250
G000564,N00031998,Chris Gibson (R),2012,Construction,76160,66500,142660
G000564,N00031998,Chris Gibson (R),2012,Defense,0,80498,80498
G000564,N00031998,Chris Gibson (R),2012,Energy/Nat Resource,3750,46000,49750
G000564,N00031998,Chris Gibson (R),2012,Finance/Insur/RealEst,179799,130750,310549
G000564,N00031998,Chris Gibson (R),2012,Health,32950,65000,97950
G000564,N00031998,Chris Gibson (R),2012,Lawyers & Lobbyists,79376,11500,90876
G000564,N00031998,Chris Gibson (R),2012,Transportation,13346,33000,46346
G000564,N00031998,Chris Gibson (R),2012,Misc Business,72335,91500,163835
G000564,N00031998,Chris Gibson (R),2012,Labor,200,111000,111200
G000564,N00031998,Chris Gibson (R),2012,Ideology/Single-Issue,3564,308250,311814
G000564,N00031998,Chris Gibson (R),2012,Other,91919,1500,93419
C001084,N00032019,David Cicilline (D),2012,Agribusiness,250,13000,13250
C001084,N00032019,David Cicilline (D),2012,Communic/Electronics,107400,24500,131900
C001084,N00032019,David Cicilline (D),2012,Construction,51750,7500,59250
C001084,N00032019,David Cicilline (D),2012,Defense,5000,29999,34999
C001084,N00032019,David Cicilline (D),2012,Energy/Nat Resource,18200,5750,23950
C001084,N00032019,David Cicilline (D),2012,Finance/Insur/RealEst,223262,50250,273512
C001084,N00032019,David Cicilline (D),2012,Health,46300,30500,76800
C001084,N00032019,David Cicilline (D),2012,Lawyers & Lobbyists,246198,21181,267379
C001084,N00032019,David Cicilline (D),2012,Transportation,29450,7500,36950
C001084,N00032019,David Cicilline (D),2012,Misc Business,153328,32000,185328
C001084,N00032019,David Cicilline (D),2012,Labor,1100,184600,185700
C001084,N00032019,David Cicilline (D),2012,Ideology/Single-Issue,89850,221265,311115
C001084,N00032019,David Cicilline (D),2012,Other,241010,6500,247510
G000568,N00032029,Morgan Griffith (R),2012,Agribusiness,10735,65399,76134
G000568,N00032029,Morgan Griffith (R),2012,Communic/Electronics,7500,65500,73000
G000568,N00032029,Morgan Griffith (R),2012,Construction,46850,10000,56850
G000568,N00032029,Morgan Griffith (R),2012,Defense,0,24000,24000
G000568,N00032029,Morgan Griffith (R),2012,Energy/Nat Resource,111638,162250,273888
G000568,N00032029,Morgan Griffith (R),2012,Finance/Insur/RealEst,53570,43000,96570
G000568,N00032029,Morgan Griffith (R),2012,Health,35158,81250,116408
G000568,N00032029,Morgan Griffith (R),2012,Lawyers & Lobbyists,37400,16500,53900
G000568,N00032029,Morgan Griffith (R),2012,Transportation,22350,33000,55350
G000568,N00032029,Morgan Griffith (R),2012,Misc Business,89200,82469,171669
G000568,N00032029,Morgan Griffith (R),2012,Labor,0,1000,1000
G000568,N00032029,Morgan Griffith (R),2012,Ideology/Single-Issue,20850,46225,67075
G000568,N00032029,Morgan Griffith (R),2012,Other,77054,1000,78054
D000618,N00033054,Steven Daines (R),2012,Agribusiness,95281,20000,115281
D000618,N00033054,Steven Daines (R),2012,Communic/Electronics,31735,14000,45735
D000618,N00033054,Steven Daines (R),2012,Construction,66300,29500,95800
D000618,N00033054,Steven Daines (R),2012,Defense,6000,10000,16000
D000618,N00033054,Steven Daines (R),2012,Energy/Nat Resource,86770,81500,168270
D000618,N00033054,Steven Daines (R),2012,Finance/Insur/RealEst,116792,43000,159792
D000618,N00033054,Steven Daines (R),2012,Health,23885,17750,41635
D000618,N00033054,Steven Daines (R),2012,Lawyers & Lobbyists,25070,2500,27570
D000618,N00033054,Steven Daines (R),2012,Transportation,29450,27000,56450
D000618,N00033054,Steven Daines (R),2012,Misc Business,80157,45500,125657
D000618,N00033054,Steven Daines (R),2012,Ideology/Single-Issue,33500,125622,159122
D000618,N00033054,Steven Daines (R),2012,Other,172309,1000,173309
C001098,N00033085,Ted Cruz (R),2012,Agribusiness,172950,82000,254950
C001098,N00033085,Ted Cruz (R),2012,Communic/Electronics,130600,86500,217100
C001098,N00033085,Ted Cruz (R),2012,Construction,304810,49000,353810
C001098,N00033085,Ted Cruz (R),2012,Defense,6200,34500,40700
C001098,N00033085,Ted Cruz (R),2012,Energy/Nat Resource,876014,247000,1123014
C001098,N00033085,Ted Cruz (R),2012,Finance/Insur/RealEst,1638844,175678,1814522
C001098,N00033085,Ted Cruz (R),2012,Health,371776,102500,474276
C001098,N00033085,Ted Cruz (R),2012,Lawyers & Lobbyists,861570,54250,915820
C001098,N00033085,Ted Cruz (R),2012,Transportation,157964,87500,245464
C001098,N00033085,Ted Cruz (R),2012,Misc Business,931981,176250,1108231
C001098,N00033085,Ted Cruz (R),2012,Labor,0,1000,1000
C001098,N00033085,Ted Cruz (R),2012,Ideology/Single-Issue,1412250,394326,1806576
C001098,N00033085,Ted Cruz (R),2012,Other,840239,7500,847739
E000293,N00033217,Elizabeth Esty (D),2012,Agribusiness,18500,0,18500
E000293,N00033217,Elizabeth Esty (D),2012,Communic/Electronics,80173,10500,90673
E000293,N00033217,Elizabeth Esty (D),2012,Construction,31550,0,31550
E000293,N00033217,Elizabeth Esty (D),2012,Defense,250,8000,8250
E000293,N00033217,Elizabeth Esty (D),2012,Energy/Nat Resource,37400,3000,40400
E000293,N00033217,Elizabeth Esty (D),2012,Finance/Insur/RealEst,287783,8000,295783
E000293,N00033217,Elizabeth Esty (D),2012,Health,93404,39500,132904
E000293,N00033217,Elizabeth Esty (D),2012,Lawyers & Lobbyists,305278,12886,318164
E000293,N00033217,Elizabeth Esty (D),2012,Transportation,5374,0,5374
E000293,N00033217,Elizabeth Esty (D),2012,Misc Business,171427,5500,176927
E000293,N00033217,Elizabeth Esty (D),2012,Labor,750,163500,164250
E000293,N00033217,Elizabeth Esty (D),2012,Ideology/Single-Issue,218689,149500,368189
E000293,N00033217,Elizabeth Esty (D),2012,Other,421937,1500,423437
G000571,N00033281,Tulsi Gabbard (D),2012,Agribusiness,4983,500,5483
G000571,N00033281,Tulsi Gabbard (D),2012,Communic/Electronics,51324,6500,57824
G000571,N00033281,Tulsi Gabbard (D),2012,Construction,110601,3500,114101
G000571,N00033281,Tulsi Gabbard (D),2012,Defense,7000,9000,16000
G000571,N00033281,Tulsi Gabbard (D),2012,Energy/Nat Resource,28250,6500,34750
G000571,N00033281,Tulsi Gabbard (D),2012,Finance/Insur/RealEst,100438,14500,114938
G000571,N00033281,Tulsi Gabbard (D),2012,Health,40101,20750,60851
G000571,N00033281,Tulsi Gabbard (D),2012,Lawyers & Lobbyists,55983,7500,63483
G000571,N00033281,Tulsi Gabbard (D),2012,Transportation,14150,25000,39150
G000571,N00033281,Tulsi Gabbard (D),2012,Misc Business,87347,12500,99847
G000571,N00033281,Tulsi Gabbard (D),2012,Labor,1400,156000,157400
G000571,N00033281,Tulsi Gabbard (D),2012,Ideology/Single-Issue,56411,107235,163646
G000571,N00033281,Tulsi Gabbard (D),2012,Other,167739,0,167739
C001091,N00033316,Joaquin Castro (D),2012,Agribusiness,10000,11508,21508
C001091,N00033316,Joaquin Castro (D),2012,Communic/Electronics,41114,21500,62614
C001091,N00033316,Joaquin Castro (D),2012,Construction,57913,20500,78413
C001091,N00033316,Joaquin Castro (D),2012,Defense,1500,16000,17500
C001091,N00033316,Joaquin Castro (D),2012,Energy/Nat Resource,37350,47500,84850
C001091,N00033316,Joaquin Castro (D),2012,Finance/Insur/RealEst,97553,72750,170303
C001091,N00033316,Joaquin Castro (D),2012,Health,51698,76000,127698
C001091,N00033316,Joaquin Castro (D),2012,Lawyers & Lobbyists,163585,21999,185584
C001091,N00033316,Joaquin Castro (D),2012,Transportation,5500,28000,33500
C001091,N00033316,Joaquin Castro (D),2012,Misc Business,106883,37000,143883
C001091,N00033316,Joaquin Castro (D),2012,Labor,0,135500,135500
C001091,N00033316,Joaquin Castro (D),2012,Ideology/Single-Issue,12751,60000,72751
C001091,N00033316,Joaquin Castro (D),2012,Other,62826,4000,66826
C001095,N00033363,Tom Cotton (R),2012,Agribusiness,58014,41677,99691
C001095,N00033363,Tom Cotton (R),2012,Communic/Electronics,54300,6500,60800
C001095,N00033363,Tom Cotton (R),2012,Construction,76125,20000,96125
C001095,N00033363,Tom Cotton (R),2012,Defense,8250,15500,23750
C001095,N00033363,Tom Cotton (R),2012,Energy/Nat Resource,71125,47500,118625
C001095,N00033363,Tom Cotton (R),2012,Finance/Insur/RealEst,236100,63000,299100
C001095,N00033363,Tom Cotton (R),2012,Health,63286,77750,141036
C001095,N00033363,Tom Cotton (R),2012,Lawyers & Lobbyists,145457,12740,158197
C001095,N00033363,Tom Cotton (R),2012,Transportation,13700,22250,35950
C001095,N00033363,Tom Cotton (R),2012,Misc Business,124705,51000,175705
C001095,N00033363,Tom Cotton (R),2012,Ideology/Single-Issue,269983,117148,387131
C001095,N00033363,Tom Cotton (R),2012,Other,145673,0,145673
C001097,N00033373,Tony Cardenas (D),2012,Agribusiness,11100,7000,18100
C001097,N00033373,Tony Cardenas (D),2012,Communic/Electronics,16750,21500,38250
C001097,N00033373,Tony Cardenas (D),2012,Construction,11450,7250,18700
C001097,N00033373,Tony Cardenas (D),2012,Defense,0,3000,3000
C001097,N00033373,Tony Cardenas (D),2012,Energy/Nat Resource,9000,17500,26500
C001097,N00033373,Tony Cardenas (D),2012,Finance/Insur/RealEst,59950,36000,95950
C001097,N00033373,Tony Cardenas (D),2012,Health,11250,62000,73250
C001097,N00033373,Tony Cardenas (D),2012,Lawyers & Lobbyists,64340,5477,69817
C001097,N00033373,Tony Cardenas (D),2012,Transportation,8750,22000,30750
C001097,N00033373,Tony Cardenas (D),2012,Misc Business,65550,25500,91050
C001097,N00033373,Tony Cardenas (D),2012,Labor,0,109500,109500
C001097,N00033373,Tony Cardenas (D),2012,Ideology/Single-Issue,11000,61600,72600
C001097,N00033373,Tony Cardenas (D),2012,Other,35650,0,35650
B001286,N00033390,Cheri Bustos (D),2012,Agribusiness,18600,0,18600
B001286,N00033390,Cheri Bustos (D),2012,Communic/Electronics,19800,0,19800
B001286,N00033390,Cheri Bustos (D),2012,Construction,15849,1000,16849
B001286,N00033390,Cheri Bustos (D),2012,Defense,1500,0,1500
B001286,N00033390,Cheri Bustos (D),2012,Energy/Nat Resource,7700,1000,8700
B001286,N00033390,Cheri Bustos (D),2012,Finance/Insur/RealEst,76454,7000,83454
B001286,N00033390,Cheri Bustos (D),2012,Health,53965,25000,78965
B001286,N00033390,Cheri Bustos (D),2012,Lawyers & Lobbyists,184217,12250,196467
B001286,N00033390,Cheri Bustos (D),2012,Transportation,8250,0,8250
B001286,N00033390,Cheri Bustos (D),2012,Misc Business,42696,2000,44696
B001286,N00033390,Cheri Bustos (D),2012,Labor,4250,236000,240250
B001286,N00033390,Cheri Bustos (D),2012,Ideology/Single-Issue,286478,233987,520465
B001286,N00033390,Cheri Bustos (D),2012,Other,172510,1000,173510
H001065,N00033399,George Holding (R),2012,Agribusiness,38450,33500,71950
H001065,N00033399,George Holding (R),2012,Communic/Electronics,4000,17500,21500
H001065,N00033399,George Holding (R),2012,Construction,33430,16000,49430
H001065,N00033399,George Holding (R),2012,Defense,0,2000,2000
H001065,N00033399,George Holding (R),2012,Energy/Nat Resource,17500,15500,33000
H001065,N00033399,George Holding (R),2012,Finance/Insur/RealEst,134375,42324,176699
H001065,N00033399,George Holding (R),2012,Health,47614,43000,90614
H001065,N00033399,George Holding (R),2012,Lawyers & Lobbyists,122937,10750,133687
H001065,N00033399,George Holding (R),2012,Transportation,7950,13500,21450
H001065,N00033399,George Holding (R),2012,Misc Business,98958,37000,135958
H001065,N00033399,George Holding (R),2012,Ideology/Single-Issue,11400,54750,66150
H001065,N00033399,George Holding (R),2012,Other,139490,0,139490
F000463,N00033443,Deb Fischer (R),2012,Agribusiness,273610,141000,414610
F000463,N00033443,Deb Fischer (R),2012,Communic/Electronics,73928,40500,114428
F000463,N00033443,Deb Fischer (R),2012,Construction,141685,63078,204763
F000463,N00033443,Deb Fischer (R),2012,Defense,0,10000,10000
F000463,N00033443,Deb Fischer (R),2012,Energy/Nat Resource,161101,95500,256601
F000463,N00033443,Deb Fischer (R),2012,Finance/Insur/RealEst,424078,195000,619078
F000463,N00033443,Deb Fischer (R),2012,Health,154690,85500,240190
F000463,N00033443,Deb Fischer (R),2012,Lawyers & Lobbyists,107487,28250,135737
F000463,N00033443,Deb Fischer (R),2012,Transportation,76316,63300,139616
F000463,N00033443,Deb Fischer (R),2012,Misc Business,284922,130500,415422
F000463,N00033443,Deb Fischer (R),2012,Ideology/Single-Issue,211350,336550,547900
F000463,N00033443,Deb Fischer (R),2012,Other,386770,7500,394270
D000627,N00033449,Val Demings (D),2012,Agribusiness,5000,0,5000
D000627,N00033449,Val Demings (D),2012,Communic/Electronics,27435,0,27435
D000627,N00033449,Val Demings (D),2012,Construction,6750,0,6750
D000627,N00033449,Val Demings (D),2012,Defense,1500,0,1500
D000627,N00033449,Val Demings (D),2012,Energy/Nat Resource,500,0,500
D000627,N00033449,Val Demings (D),2012,Finance/Insur/RealEst,54026,0,54026
D000627,N00033449,Val Demings (D),2012,Health,28550,2000,30550
D000627,N00033449,Val Demings (D),2012,Lawyers & Lobbyists,97429,10000,107429
D000627,N00033449,Val Demings (D),2012,Transportation,9612,600,10212
D000627,N00033449,Val Demings (D),2012,Misc Business,81642,2000,83642
D000627,N00033449,Val Demings (D),2012,Labor,0,219750,219750
D000627,N00033449,Val Demings (D),2012,Ideology/Single-Issue,225680,221030,446710
D000627,N00033449,Val Demings (D),2012,Other,150492,0,150492
B001278,N00033474,Suzanne Bonamici (D),2012,Agribusiness,10300,24500,34800
B001278,N00033474,Suzanne Bonamici (D),2012,Communic/Electronics,60655,22000,82655
B001278,N00033474,Suzanne Bonamici (D),2012,Construction,9000,16000,25000
B001278,N00033474,Suzanne Bonamici (D),2012,Defense,1250,14500,15750
B001278,N00033474,Suzanne Bonamici (D),2012,Energy/Nat Resource,9250,9500,18750
B001278,N00033474,Suzanne Bonamici (D),2012,Finance/Insur/RealEst,61495,45500,106995
B001278,N00033474,Suzanne Bonamici (D),2012,Health,50800,49000,99800
B001278,N00033474,Suzanne Bonamici (D),2012,Lawyers & Lobbyists,293080,25414,318494
B001278,N00033474,Suzanne Bonamici (D),2012,Transportation,15000,18000,33000
B001278,N00033474,Suzanne Bonamici (D),2012,Misc Business,91607,27000,118607
B001278,N00033474,Suzanne Bonamici (D),2012,Labor,1000,263000,264000
B001278,N00033474,Suzanne Bonamici (D),2012,Ideology/Single-Issue,97991,218585,316576
B001278,N00033474,Suzanne Bonamici (D),2012,Other,190467,0,190467
B001284,N00033495,Susan Brooks (R),2012,Agribusiness,12550,16000,28550
B001284,N00033495,Susan Brooks (R),2012,Communic/Electronics,26500,6500,33000
B001284,N00033495,Susan Brooks (R),2012,Construction,60300,3500,63800
B001284,N00033495,Susan Brooks (R),2012,Defense,0,1000,1000
B001284,N00033495,Susan Brooks (R),2012,Energy/Nat Resource,6750,14000,20750
B001284,N00033495,Susan Brooks (R),2012,Finance/Insur/RealEst,146850,37000,183850
B001284,N00033495,Susan Brooks (R),2012,Health,101928,32500,134428
B001284,N00033495,Susan Brooks (R),2012,Lawyers & Lobbyists,160538,7000,167538
B001284,N00033495,Susan Brooks (R),2012,Transportation,22500,8500,31000
B001284,N00033495,Susan Brooks (R),2012,Misc Business,59605,26850,86455
B001284,N00033495,Susan Brooks (R),2012,Labor,0,5000,5000
B001284,N00033495,Susan Brooks (R),2012,Ideology/Single-Issue,13150,64025,77175
B001284,N00033495,Susan Brooks (R),2012,Other,108109,5500,113609
C001093,N00033518,Doug Collins (R),2012,Agribusiness,15200,2000,17200
C001093,N00033518,Doug Collins (R),2012,Communic/Electronics,3500,10500,14000
C001093,N00033518,Doug Collins (R),2012,Construction,10500,14000,24500
C001093,N00033518,Doug Collins (R),2012,Defense,0,1000,1000
C001093,N00033518,Doug Collins (R),2012,Energy/Nat Resource,9500,23500,33000
C001093,N00033518,Doug Collins (R),2012,Finance/Insur/RealEst,45620,33500,79120
C001093,N00033518,Doug Collins (R),2012,Health,27100,28500,55600
C001093,N00033518,Doug Collins (R),2012,Lawyers & Lobbyists,56730,8500,65230
C001093,N00033518,Doug Collins (R),2012,Transportation,5500,26000,31500
C001093,N00033518,Doug Collins (R),2012,Misc Business,33450,18000,51450
C001093,N00033518,Doug Collins (R),2012,Labor,0,2500,2500
C001093,N00033518,Doug Collins (R),2012,Ideology/Single-Issue,6800,68000,74800
C001093,N00033518,Doug Collins (R),2012,Other,45935,0,45935
B001283,N00033532,James Bridenstine (R),2012,Agribusiness,2400,1500,3900
B001283,N00033532,James Bridenstine (R),2012,Communic/Electronics,13325,1000,14325
B001283,N00033532,James Bridenstine (R),2012,Construction,8500,10500,19000
B001283,N00033532,James Bridenstine (R),2012,Defense,1000,4000,5000
B001283,N00033532,James Bridenstine (R),2012,Energy/Nat Resource,27500,53500,81000
B001283,N00033532,James Bridenstine (R),2012,Finance/Insur/RealEst,25800,24500,50300
B001283,N00033532,James Bridenstine (R),2012,Health,103665,18000,121665
B001283,N00033532,James Bridenstine (R),2012,Lawyers & Lobbyists,25300,0,25300
B001283,N00033532,James Bridenstine (R),2012,Transportation,10250,18000,28250
B001283,N00033532,James Bridenstine (R),2012,Misc Business,38739,9500,48239
B001283,N00033532,James Bridenstine (R),2012,Labor,0,4000,4000
B001283,N00033532,James Bridenstine (R),2012,Ideology/Single-Issue,13750,54546,68296
B001283,N00033532,James Bridenstine (R),2012,Other,81250,0,81250
G000572,N00033541,Pete Gallego (D),2012,Agribusiness,41750,3500,45250
G000572,N00033541,Pete Gallego (D),2012,Communic/Electronics,47250,3500,50750
G000572,N00033541,Pete Gallego (D),2012,Construction,32450,0,32450
G000572,N00033541,Pete Gallego (D),2012,Defense,500,3000,3500
G000572,N00033541,Pete Gallego (D),2012,Energy/Nat Resource,24700,12000,36700
G000572,N00033541,Pete Gallego (D),2012,Finance/Insur/RealEst,140725,8000,148725
G000572,N00033541,Pete Gallego (D),2012,Health,45850,18000,63850
G000572,N00033541,Pete Gallego (D),2012,Lawyers & Lobbyists,285244,18000,303244
G000572,N00033541,Pete Gallego (D),2012,Transportation,5280,0,5280
G000572,N00033541,Pete Gallego (D),2012,Misc Business,151300,4500,155800
G000572,N00033541,Pete Gallego (D),2012,Labor,1250,197000,198250
G000572,N00033541,Pete Gallego (D),2012,Ideology/Single-Issue,46803,163205,210008
G000572,N00033541,Pete Gallego (D),2012,Other,78420,0,78420
B001280,N00033625,Kerry Bentivolio (R),2012,Agribusiness,0,2500,2500
B001280,N00033625,Kerry Bentivolio (R),2012,Communic/Electronics,250,1000,1250
B001280,N00033625,Kerry Bentivolio (R),2012,Construction,6350,2500,8850
B001280,N00033625,Kerry Bentivolio (R),2012,Defense,0,1000,1000
B001280,N00033625,Kerry Bentivolio (R),2012,Energy/Nat Resource,0,17000,17000
B001280,N00033625,Kerry Bentivolio (R),2012,Finance/Insur/RealEst,26750,24500,51250
B001280,N00033625,Kerry Bentivolio (R),2012,Health,6100,0,6100
B001280,N00033625,Kerry Bentivolio (R),2012,Lawyers & Lobbyists,13000,3000,16000
B001280,N00033625,Kerry Bentivolio (R),2012,Transportation,12750,10500,23250
B001280,N00033625,Kerry Bentivolio (R),2012,Misc Business,16550,4000,20550
B001280,N00033625,Kerry Bentivolio (R),2012,Ideology/Single-Issue,6750,135324,142074
B001280,N00033625,Kerry Bentivolio (R),2012,Other,18701,0,18701
D000620,N00033897,John K Delaney (D),2012,Agribusiness,12500,0,12500
D000620,N00033897,John K Delaney (D),2012,Communic/Electronics,45594,5500,51094
D000620,N00033897,John K Delaney (D),2012,Construction,6750,5000,11750
D000620,N00033897,John K Delaney (D),2012,Defense,1000,2500,3500
D000620,N00033897,John K Delaney (D),2012,Energy/Nat Resource,8000,7000,15000
D000620,N00033897,John K Delaney (D),2012,Finance/Insur/RealEst,646949,22500,669449
D000620,N00033897,John K Delaney (D),2012,Health,54010,29500,83510
D000620,N00033897,John K Delaney (D),2012,Lawyers & Lobbyists,238339,13000,251339
D000620,N00033897,John K Delaney (D),2012,Transportation,9250,2000,11250
D000620,N00033897,John K Delaney (D),2012,Misc Business,137093,6500,143593
D000620,N00033897,John K Delaney (D),2012,Labor,250,166500,166750
D000620,N00033897,John K Delaney (D),2012,Ideology/Single-Issue,35803,121197,157000
D000620,N00033897,John K Delaney (D),2012,Other,141040,0,141040
B001281,N00033904,Joyce Beatty (D),2012,Agribusiness,2500,500,3000
B001281,N00033904,Joyce Beatty (D),2012,Communic/Electronics,4409,7000,11409
B001281,N00033904,Joyce Beatty (D),2012,Construction,32700,3750,36450
B001281,N00033904,Joyce Beatty (D),2012,Defense,2250,0,2250
B001281,N00033904,Joyce Beatty (D),2012,Energy/Nat Resource,10500,19500,30000
B001281,N00033904,Joyce Beatty (D),2012,Finance/Insur/RealEst,36150,93000,129150
B001281,N00033904,Joyce Beatty (D),2012,Health,17875,42000,59875
B001281,N00033904,Joyce Beatty (D),2012,Lawyers & Lobbyists,28750,22750,51500
B001281,N00033904,Joyce Beatty (D),2012,Transportation,1750,19000,20750
B001281,N00033904,Joyce Beatty (D),2012,Misc Business,21322,50750,72072
B001281,N00033904,Joyce Beatty (D),2012,Labor,1000,95500,96500
B001281,N00033904,Joyce Beatty (D),2012,Ideology/Single-Issue,8050,62458,70508
B001281,N00033904,Joyce Beatty (D),2012,Other,59000,1000,60000
B001279,N00033981,Ron Barber (D),2012,Agribusiness,42750,16750,59500
B001279,N00033981,Ron Barber (D),2012,Communic/Electronics,25000,12000,37000
B001279,N00033981,Ron Barber (D),2012,Construction,14150,0,14150
B001279,N00033981,Ron Barber (D),2012,Defense,7000,28500,35500
B001279,N00033981,Ron Barber (D),2012,Energy/Nat Resource,2750,19000,21750
B001279,N00033981,Ron Barber (D),2012,Finance/Insur/RealEst,67900,57500,125400
B001279,N00033981,Ron Barber (D),2012,Health,55851,72000,127851
B001279,N00033981,Ron Barber (D),2012,Lawyers & Lobbyists,90274,24500,114774
B001279,N00033981,Ron Barber (D),2012,Transportation,4200,2500,6700
B001279,N00033981,Ron Barber (D),2012,Misc Business,83540,22500,106040
B001279,N00033981,Ron Barber (D),2012,Labor,1500,371500,373000
B001279,N00033981,Ron Barber (D),2012,Ideology/Single-Issue,118452,317378,435830
B001279,N00033981,Ron Barber (D),2012,Other,401038,0,401038
C001090,N00034128,Matt Cartwright (D),2012,Agribusiness,1750,1000,2750
C001090,N00034128,Matt Cartwright (D),2012,Communic/Electronics,1500,4500,6000
C001090,N00034128,Matt Cartwright (D),2012,Construction,10000,0,10000
C001090,N00034128,Matt Cartwright (D),2012,Defense,1250,2000,3250
C001090,N00034128,Matt Cartwright (D),2012,Energy/Nat Resource,2500,0,2500
C001090,N00034128,Matt Cartwright (D),2012,Finance/Insur/RealEst,24150,3500,27650
C001090,N00034128,Matt Cartwright (D),2012,Health,10950,12100,23050
C001090,N00034128,Matt Cartwright (D),2012,Lawyers & Lobbyists,362125,11500,373625
C001090,N00034128,Matt Cartwright (D),2012,Transportation,3500,0,3500
C001090,N00034128,Matt Cartwright (D),2012,Misc Business,23900,5500,29400
C001090,N00034128,Matt Cartwright (D),2012,Labor,0,145000,145000
C001090,N00034128,Matt Cartwright (D),2012,Ideology/Single-Issue,3000,21197,24197
C001090,N00034128,Matt Cartwright (D),2012,Other,38650,0,38650
C001094,N00034224,Paul Cook (R),2012,Agribusiness,13800,3000,16800
C001094,N00034224,Paul Cook (R),2012,Communic/Electronics,9800,2000,11800
C001094,N00034224,Paul Cook (R),2012,Construction,31000,9500,40500
C001094,N00034224,Paul Cook (R),2012,Defense,500,4000,4500
C001094,N00034224,Paul Cook (R),2012,Energy/Nat Resource,14500,20000,34500
C001094,N00034224,Paul Cook (R),2012,Finance/Insur/RealEst,45359,24500,69859
C001094,N00034224,Paul Cook (R),2012,Health,17850,31000,48850
C001094,N00034224,Paul Cook (R),2012,Lawyers & Lobbyists,20250,0,20250
C001094,N00034224,Paul Cook (R),2012,Transportation,750,19500,20250
C001094,N00034224,Paul Cook (R),2012,Misc Business,66106,11500,77606
C001094,N00034224,Paul Cook (R),2012,Labor,250,62500,62750
C001094,N00034224,Paul Cook (R),2012,Ideology/Single-Issue,4750,31000,35750
C001094,N00034224,Paul Cook (R),2012,Other,30600,0,30600
B001285,N00034254,Julia Brownley (D),2012,Agribusiness,9100,0,9100
B001285,N00034254,Julia Brownley (D),2012,Communic/Electronics,78829,1000,79829
B001285,N00034254,Julia Brownley (D),2012,Construction,13700,0,13700
B001285,N00034254,Julia Brownley (D),2012,Energy/Nat Resource,1450,0,1450
B001285,N00034254,Julia Brownley (D),2012,Finance/Insur/RealEst,67455,0,67455
B001285,N00034254,Julia Brownley (D),2012,Health,29950,1000,30950
B001285,N00034254,Julia Brownley (D),2012,Lawyers & Lobbyists,109315,11000,120315
B001285,N00034254,Julia Brownley (D),2012,Transportation,750,0,750
B001285,N00034254,Julia Brownley (D),2012,Misc Business,60986,1000,61986
B001285,N00034254,Julia Brownley (D),2012,Labor,0,208000,208000
B001285,N00034254,Julia Brownley (D),2012,Ideology/Single-Issue,263640,248237,511877
B001285,N00034254,Julia Brownley (D),2012,Other,296646,1000,297646
D000621,N00034746,Ron DeSantis (R),2012,Agribusiness,41000,26000,67000
D000621,N00034746,Ron DeSantis (R),2012,Communic/Electronics,8947,12000,20947
D000621,N00034746,Ron DeSantis (R),2012,Construction,39176,9500,48676
D000621,N00034746,Ron DeSantis (R),2012,Defense,7500,5000,12500
D000621,N00034746,Ron DeSantis (R),2012,Energy/Nat Resource,28500,22500,51000
D000621,N00034746,Ron DeSantis (R),2012,Finance/Insur/RealEst,169085,34500,203585
D000621,N00034746,Ron DeSantis (R),2012,Health,43200,14500,57700
D000621,N00034746,Ron DeSantis (R),2012,Lawyers & Lobbyists,61500,3500,65000
D000621,N00034746,Ron DeSantis (R),2012,Transportation,15750,9000,24750
D000621,N00034746,Ron DeSantis (R),2012,Misc Business,64250,24000,88250
D000621,N00034746,Ron DeSantis (R),2012,Ideology/Single-Issue,44061,84888,128949
D000621,N00034746,Ron DeSantis (R),2012,Other,163458,0,163458
D000619,N00034784,Rodney Davis (R),2012,Agribusiness,60454,45193,105647
D000619,N00034784,Rodney Davis (R),2012,Communic/Electronics,12000,25500,37500
D000619,N00034784,Rodney Davis (R),2012,Construction,22750,30700,53450
D000619,N00034784,Rodney Davis (R),2012,Defense,250,2000,2250
D000619,N00034784,Rodney Davis (R),2012,Energy/Nat Resource,17200,53000,70200
D000619,N00034784,Rodney Davis (R),2012,Finance/Insur/RealEst,91200,72500,163700
D000619,N00034784,Rodney Davis (R),2012,Health,40082,60500,100582
D000619,N00034784,Rodney Davis (R),2012,Lawyers & Lobbyists,33250,5500,38750
D000619,N00034784,Rodney Davis (R),2012,Transportation,17750,27400,45150
D000619,N00034784,Rodney Davis (R),2012,Misc Business,112283,69400,181683
D000619,N00034784,Rodney Davis (R),2012,Labor,0,14500,14500
D000619,N00034784,Rodney Davis (R),2012,Ideology/Single-Issue,14300,206050,220350
D000619,N00034784,Rodney Davis (R),2012,Other,60064,1000,61064
E000292,N00034884,William Enyart (D),2012,Agribusiness,1300,5000,6300
E000292,N00034884,William Enyart (D),2012,Communic/Electronics,20500,3500,24000
E000292,N00034884,William Enyart (D),2012,Construction,7500,1450,8950
E000292,N00034884,William Enyart (D),2012,Defense,0,3000,3000
E000292,N00034884,William Enyart (D),2012,Energy/Nat Resource,2950,1500,4450
E000292,N00034884,William Enyart (D),2012,Finance/Insur/RealEst,33682,10800,44482
E000292,N00034884,William Enyart (D),2012,Health,3300,7000,10300
E000292,N00034884,William Enyart (D),2012,Lawyers & Lobbyists,138832,6500,145332
E000292,N00034884,William Enyart (D),2012,Transportation,3400,4000,7400
E000292,N00034884,William Enyart (D),2012,Misc Business,21578,10000,31578
E000292,N00034884,William Enyart (D),2012,Labor,1800,170000,171800
E000292,N00034884,William Enyart (D),2012,Ideology/Single-Issue,12400,157000,169400
E000292,N00034884,William Enyart (D),2012,Other,69883,500,70383
C000380,N00000133,Donna Christian-Christensen (D),2014,Communic/Electronics,6100,25500,31600
C000380,N00000133,Donna Christian-Christensen (D),2014,Construction,500,0,500
C000380,N00000133,Donna Christian-Christensen (D),2014,Defense,0,1000,1000
C000380,N00000133,Donna Christian-Christensen (D),2014,Energy/Nat Resource,1000,6500,7500
C000380,N00000133,Donna Christian-Christensen (D),2014,Finance/Insur/RealEst,6650,2500,9150
C000380,N00000133,Donna Christian-Christensen (D),2014,Health,6800,61848,68648
C000380,N00000133,Donna Christian-Christensen (D),2014,Lawyers & Lobbyists,23000,9250,32250
C000380,N00000133,Donna Christian-Christensen (D),2014,Misc Business,18950,6519,25469
C000380,N00000133,Donna Christian-Christensen (D),2014,Labor,0,11500,11500
C000380,N00000133,Donna Christian-Christensen (D),2014,Ideology/Single-Issue,0,17500,17500
C000380,N00000133,Donna Christian-Christensen (D),2014,Other,6500,0,6500
C001037,N00000267,Michael E Capuano (D),2014,Agribusiness,300,7250,7550
C001037,N00000267,Michael E Capuano (D),2014,Communic/Electronics,8200,7500,15700
C001037,N00000267,Michael E Capuano (D),2014,Construction,8550,36000,44550
C001037,N00000267,Michael E Capuano (D),2014,Defense,0,8500,8500
C001037,N00000267,Michael E Capuano (D),2014,Energy/Nat Resource,28500,3500,32000
C001037,N00000267,Michael E Capuano (D),2014,Finance/Insur/RealEst,68500,264000,332500
C001037,N00000267,Michael E Capuano (D),2014,Health,27600,31500,59100
C001037,N00000267,Michael E Capuano (D),2014,Lawyers & Lobbyists,50150,10500,60650
C001037,N00000267,Michael E Capuano (D),2014,Transportation,250,25500,25750
C001037,N00000267,Michael E Capuano (D),2014,Misc Business,12072,19000,31072
C001037,N00000267,Michael E Capuano (D),2014,Labor,0,122000,122000
C001037,N00000267,Michael E Capuano (D),2014,Ideology/Single-Issue,3400,19500,22900
C001037,N00000267,Michael E Capuano (D),2014,Other,18200,0,18200
C001035,N00000491,Susan Collins (R),2014,Agribusiness,47000,107040,154040
C001035,N00000491,Susan Collins (R),2014,Communic/Electronics,120850,192000,312850
C001035,N00000491,Susan Collins (R),2014,Construction,65000,108500,173500
C001035,N00000491,Susan Collins (R),2014,Defense,74550,146500,221050
C001035,N00000491,Susan Collins (R),2014,Energy/Nat Resource,84580,104833,189413
C001035,N00000491,Susan Collins (R),2014,Finance/Insur/RealEst,626794,447600,1074394
C001035,N00000491,Susan Collins (R),2014,Health,122250,477673,599923
C001035,N00000491,Susan Collins (R),2014,Lawyers & Lobbyists,550266,140250,690516
C001035,N00000491,Susan Collins (R),2014,Transportation,60283,165500,225783
C001035,N00000491,Susan Collins (R),2014,Misc Business,279000,335500,614500
C001035,N00000491,Susan Collins (R),2014,Labor,0,133600,133600
C001035,N00000491,Susan Collins (R),2014,Ideology/Single-Issue,135335,461786,597121
C001035,N00000491,Susan Collins (R),2014,Other,519710,9000,528710
D000216,N00000615,Rosa L DeLauro (D),2014,Agribusiness,1000,19500,20500
D000216,N00000615,Rosa L DeLauro (D),2014,Communic/Electronics,7800,15710,23510
D000216,N00000615,Rosa L DeLauro (D),2014,Construction,8950,11000,19950
D000216,N00000615,Rosa L DeLauro (D),2014,Defense,0,28000,28000
D000216,N00000615,Rosa L DeLauro (D),2014,Energy/Nat Resource,1000,4000,5000
D000216,N00000615,Rosa L DeLauro (D),2014,Finance/Insur/RealEst,27950,33100,61050
D000216,N00000615,Rosa L DeLauro (D),2014,Health,23921,137199,161120
D000216,N00000615,Rosa L DeLauro (D),2014,Lawyers & Lobbyists,81677,27628,109305
D000216,N00000615,Rosa L DeLauro (D),2014,Transportation,7350,5500,12850
D000216,N00000615,Rosa L DeLauro (D),2014,Misc Business,37595,32500,70095
D000216,N00000615,Rosa L DeLauro (D),2014,Labor,0,241000,241000
D000216,N00000615,Rosa L DeLauro (D),2014,Ideology/Single-Issue,249804,43097,292901
D000216,N00000615,Rosa L DeLauro (D),2014,Other,59356,6250,65606
F000372,N00000684,Rodney Frelinghuysen (R),2014,Agribusiness,8550,8500,17050
F000372,N00000684,Rodney Frelinghuysen (R),2014,Communic/Electronics,1300,23600,24900
F000372,N00000684,Rodney Frelinghuysen (R),2014,Construction,30235,59200,89435
F000372,N00000684,Rodney Frelinghuysen (R),2014,Defense,120881,151500,272381
F000372,N00000684,Rodney Frelinghuysen (R),2014,Energy/Nat Resource,5400,70479,75879
F000372,N00000684,Rodney Frelinghuysen (R),2014,Finance/Insur/RealEst,85700,60000,145700
F000372,N00000684,Rodney Frelinghuysen (R),2014,Health,29400,70500,99900
F000372,N00000684,Rodney Frelinghuysen (R),2014,Lawyers & Lobbyists,77280,32125,109405
F000372,N00000684,Rodney Frelinghuysen (R),2014,Transportation,9885,53500,63385
F000372,N00000684,Rodney Frelinghuysen (R),2014,Misc Business,40400,61000,101400
F000372,N00000684,Rodney Frelinghuysen (R),2014,Labor,0,3500,3500
F000372,N00000684,Rodney Frelinghuysen (R),2014,Ideology/Single-Issue,7000,36500,43500
F000372,N00000684,Rodney Frelinghuysen (R),2014,Other,107750,2000,109750
G000548,N00000743,Scott Garrett (R),2014,Agribusiness,3000,12000,15000
G000548,N00000743,Scott Garrett (R),2014,Communic/Electronics,32300,17000,49300
G000548,N00000743,Scott Garrett (R),2014,Construction,7150,12000,19150
G000548,N00000743,Scott Garrett (R),2014,Defense,0,10500,10500
G000548,N00000743,Scott Garrett (R),2014,Energy/Nat Resource,27850,32500,60350
G000548,N00000743,Scott Garrett (R),2014,Finance/Insur/RealEst,397880,761699,1159579
G000548,N00000743,Scott Garrett (R),2014,Health,28100,27250,55350
G000548,N00000743,Scott Garrett (R),2014,Lawyers & Lobbyists,59989,19250,79239
G000548,N00000743,Scott Garrett (R),2014,Transportation,18730,20500,39230
G000548,N00000743,Scott Garrett (R),2014,Misc Business,40940,20000,60940
G000548,N00000743,Scott Garrett (R),2014,Labor,0,2000,2000
G000548,N00000743,Scott Garrett (R),2014,Ideology/Single-Issue,46025,30350,76375
G000548,N00000743,Scott Garrett (R),2014,Other,79859,0,79859
A000210,N00000826,Robert E Andrews (D),2014,Agribusiness,16600,14500,31100
A000210,N00000826,Robert E Andrews (D),2014,Communic/Electronics,2400,9000,11400
A000210,N00000826,Robert E Andrews (D),2014,Construction,5600,20500,26100
A000210,N00000826,Robert E Andrews (D),2014,Defense,4350,34000,38350
A000210,N00000826,Robert E Andrews (D),2014,Energy/Nat Resource,1000,16500,17500
A000210,N00000826,Robert E Andrews (D),2014,Finance/Insur/RealEst,25750,43761,69511
A000210,N00000826,Robert E Andrews (D),2014,Health,15825,32000,47825
A000210,N00000826,Robert E Andrews (D),2014,Lawyers & Lobbyists,62516,43500,106016
A000210,N00000826,Robert E Andrews (D),2014,Transportation,8800,11000,19800
A000210,N00000826,Robert E Andrews (D),2014,Misc Business,28164,20500,48664
A000210,N00000826,Robert E Andrews (D),2014,Labor,0,98500,98500
A000210,N00000826,Robert E Andrews (D),2014,Ideology/Single-Issue,10400,15000,25400
A000210,N00000826,Robert E Andrews (D),2014,Other,45950,26499,72449
H001032,N00000860,Rush Holt (D),2014,Agribusiness,14950,1000,15950
H001032,N00000860,Rush Holt (D),2014,Communic/Electronics,52180,4750,56930
H001032,N00000860,Rush Holt (D),2014,Construction,11350,1000,12350
H001032,N00000860,Rush Holt (D),2014,Defense,1950,2000,3950
H001032,N00000860,Rush Holt (D),2014,Energy/Nat Resource,9700,5000,14700
H001032,N00000860,Rush Holt (D),2014,Finance/Insur/RealEst,87300,98000,185300
H001032,N00000860,Rush Holt (D),2014,Health,33150,34500,67650
H001032,N00000860,Rush Holt (D),2014,Lawyers & Lobbyists,62699,8500,71199
H001032,N00000860,Rush Holt (D),2014,Transportation,3600,1500,5100
H001032,N00000860,Rush Holt (D),2014,Misc Business,65942,22500,88442
H001032,N00000860,Rush Holt (D),2014,Labor,0,67500,67500
H001032,N00000860,Rush Holt (D),2014,Ideology/Single-Issue,76950,18947,95897
H001032,N00000860,Rush Holt (D),2014,Other,489827,7500,497327
E000179,N00001003,Eliot L Engel (D),2014,Agribusiness,15400,25000,40400
E000179,N00001003,Eliot L Engel (D),2014,Communic/Electronics,34550,49500,84050
E000179,N00001003,Eliot L Engel (D),2014,Construction,19600,6000,25600
E000179,N00001003,Eliot L Engel (D),2014,Defense,0,45000,45000
E000179,N00001003,Eliot L Engel (D),2014,Energy/Nat Resource,2000,26000,28000
E000179,N00001003,Eliot L Engel (D),2014,Finance/Insur/RealEst,145195,23500,168695
E000179,N00001003,Eliot L Engel (D),2014,Health,75482,103500,178982
E000179,N00001003,Eliot L Engel (D),2014,Lawyers & Lobbyists,60900,21500,82400
E000179,N00001003,Eliot L Engel (D),2014,Transportation,16200,6500,22700
E000179,N00001003,Eliot L Engel (D),2014,Misc Business,61750,14000,75750
E000179,N00001003,Eliot L Engel (D),2014,Labor,0,87000,87000
E000179,N00001003,Eliot L Engel (D),2014,Ideology/Single-Issue,95700,66700,162400
E000179,N00001003,Eliot L Engel (D),2014,Other,92100,2000,94100
C001038,N00001127,Joseph Crowley (D),2014,Agribusiness,22350,36500,58850
C001038,N00001127,Joseph Crowley (D),2014,Communic/Electronics,61250,139305,200555
C001038,N00001127,Joseph Crowley (D),2014,Construction,34000,26000,60000
C001038,N00001127,Joseph Crowley (D),2014,Defense,12689,43500,56189
C001038,N00001127,Joseph Crowley (D),2014,Energy/Nat Resource,15075,52000,67075
C001038,N00001127,Joseph Crowley (D),2014,Finance/Insur/RealEst,493958,690775,1184733
C001038,N00001127,Joseph Crowley (D),2014,Health,61200,235500,296700
C001038,N00001127,Joseph Crowley (D),2014,Lawyers & Lobbyists,221267,58300,279567
C001038,N00001127,Joseph Crowley (D),2014,Transportation,11400,77000,88400
C001038,N00001127,Joseph Crowley (D),2014,Misc Business,125700,159059,284759
C001038,N00001127,Joseph Crowley (D),2014,Labor,250,183050,183300
C001038,N00001127,Joseph Crowley (D),2014,Ideology/Single-Issue,42246,16300,58546
C001038,N00001127,Joseph Crowley (D),2014,Other,66860,500,67360
C001092,N00001285,Chris Collins (R),2014,Agribusiness,12150,64429,76579
C001092,N00001285,Chris Collins (R),2014,Communic/Electronics,700,18060,18760
C001092,N00001285,Chris Collins (R),2014,Construction,25050,15500,40550
C001092,N00001285,Chris Collins (R),2014,Defense,0,29500,29500
C001092,N00001285,Chris Collins (R),2014,Energy/Nat Resource,45450,14500,59950
C001092,N00001285,Chris Collins (R),2014,Finance/Insur/RealEst,28550,69500,98050
C001092,N00001285,Chris Collins (R),2014,Health,25100,38600,63700
C001092,N00001285,Chris Collins (R),2014,Lawyers & Lobbyists,26500,5500,32000
C001092,N00001285,Chris Collins (R),2014,Transportation,14850,24000,38850
C001092,N00001285,Chris Collins (R),2014,Misc Business,93437,66672,160109
C001092,N00001285,Chris Collins (R),2014,Labor,0,19000,19000
C001092,N00001285,Chris Collins (R),2014,Ideology/Single-Issue,0,62000,62000
C001092,N00001285,Chris Collins (R),2014,Other,33450,0,33450
D000482,N00001373,Mike Doyle (D),2014,Agribusiness,4100,14500,18600
D000482,N00001373,Mike Doyle (D),2014,Communic/Electronics,4000,108500,112500
D000482,N00001373,Mike Doyle (D),2014,Construction,19250,9000,28250
D000482,N00001373,Mike Doyle (D),2014,Defense,1200,12000,13200
D000482,N00001373,Mike Doyle (D),2014,Energy/Nat Resource,4500,128500,133000
D000482,N00001373,Mike Doyle (D),2014,Finance/Insur/RealEst,30750,41000,71750
D000482,N00001373,Mike Doyle (D),2014,Health,14000,49000,63000
D000482,N00001373,Mike Doyle (D),2014,Lawyers & Lobbyists,31932,32500,64432
D000482,N00001373,Mike Doyle (D),2014,Transportation,500,33011,33511
D000482,N00001373,Mike Doyle (D),2014,Misc Business,15300,35000,50300
D000482,N00001373,Mike Doyle (D),2014,Labor,0,185000,185000
D000482,N00001373,Mike Doyle (D),2014,Ideology/Single-Issue,3500,10301,13801
D000482,N00001373,Mike Doyle (D),2014,Other,12000,2500,14500
B001227,N00001619,Robert A Brady (D),2014,Agribusiness,7000,3500,10500
B001227,N00001619,Robert A Brady (D),2014,Communic/Electronics,5500,24000,29500
B001227,N00001619,Robert A Brady (D),2014,Construction,40700,7500,48200
B001227,N00001619,Robert A Brady (D),2014,Defense,0,10500,10500
B001227,N00001619,Robert A Brady (D),2014,Energy/Nat Resource,13025,13500,26525
B001227,N00001619,Robert A Brady (D),2014,Finance/Insur/RealEst,42300,17750,60050
B001227,N00001619,Robert A Brady (D),2014,Health,6250,10850,17100
B001227,N00001619,Robert A Brady (D),2014,Lawyers & Lobbyists,67500,15600,83100
B001227,N00001619,Robert A Brady (D),2014,Transportation,8200,20500,28700
B001227,N00001619,Robert A Brady (D),2014,Misc Business,35100,0,35100
B001227,N00001619,Robert A Brady (D),2014,Labor,0,204800,204800
B001227,N00001619,Robert A Brady (D),2014,Ideology/Single-Issue,0,1000,1000
B001227,N00001619,Robert A Brady (D),2014,Other,16700,0,16700
F000043,N00001746,Chaka Fattah (D),2014,Agribusiness,0,4500,4500
F000043,N00001746,Chaka Fattah (D),2014,Communic/Electronics,14750,32500,47250
F000043,N00001746,Chaka Fattah (D),2014,Construction,1000,3500,4500
F000043,N00001746,Chaka Fattah (D),2014,Defense,0,43000,43000
F000043,N00001746,Chaka Fattah (D),2014,Energy/Nat Resource,1000,9500,10500
F000043,N00001746,Chaka Fattah (D),2014,Finance/Insur/RealEst,15850,19000,34850
F000043,N00001746,Chaka Fattah (D),2014,Health,6500,25550,32050
F000043,N00001746,Chaka Fattah (D),2014,Lawyers & Lobbyists,44700,32053,76753
F000043,N00001746,Chaka Fattah (D),2014,Transportation,2500,10500,13000
F000043,N00001746,Chaka Fattah (D),2014,Misc Business,16700,11500,28200
F000043,N00001746,Chaka Fattah (D),2014,Labor,0,126000,126000
F000043,N00001746,Chaka Fattah (D),2014,Ideology/Single-Issue,1000,24000,25000
F000043,N00001746,Chaka Fattah (D),2014,Other,13650,0,13650
G000386,N00001758,Chuck Grassley (R),2014,Agribusiness,119500,359250,478750
G000386,N00001758,Chuck Grassley (R),2014,Communic/Electronics,72650,330326,402976
G000386,N00001758,Chuck Grassley (R),2014,Construction,91548,99000,190548
G000386,N00001758,Chuck Grassley (R),2014,Defense,1000,58000,59000
G000386,N00001758,Chuck Grassley (R),2014,Energy/Nat Resource,133406,299400,432806
G000386,N00001758,Chuck Grassley (R),2014,Finance/Insur/RealEst,415802,584449,1000251
G000386,N00001758,Chuck Grassley (R),2014,Health,261060,531210,792270
G000386,N00001758,Chuck Grassley (R),2014,Lawyers & Lobbyists,380785,138979,519764
G000386,N00001758,Chuck Grassley (R),2014,Transportation,51824,153399,205223
G000386,N00001758,Chuck Grassley (R),2014,Misc Business,160542,306500,467042
G000386,N00001758,Chuck Grassley (R),2014,Labor,1000,22000,23000
G000386,N00001758,Chuck Grassley (R),2014,Ideology/Single-Issue,111690,395250,506940
G000386,N00001758,Chuck Grassley (R),2014,Other,247057,12000,259057
D000355,N00001783,John D Dingell (D),2014,Agribusiness,0,21500,21500
D000355,N00001783,John D Dingell (D),2014,Communic/Electronics,1300,46000,47300
D000355,N00001783,John D Dingell (D),2014,Construction,600,0,600
D000355,N00001783,John D Dingell (D),2014,Defense,0,4000,4000
D000355,N00001783,John D Dingell (D),2014,Energy/Nat Resource,0,53600,53600
D000355,N00001783,John D Dingell (D),2014,Finance/Insur/RealEst,600,20300,20900
D000355,N00001783,John D Dingell (D),2014,Health,900,58850,59750
D000355,N00001783,John D Dingell (D),2014,Lawyers & Lobbyists,14375,17070,31445
D000355,N00001783,John D Dingell (D),2014,Transportation,1500,16700,18200
D000355,N00001783,John D Dingell (D),2014,Misc Business,3400,23500,26900
D000355,N00001783,John D Dingell (D),2014,Labor,300,69233,69533
D000355,N00001783,John D Dingell (D),2014,Ideology/Single-Issue,1100,10200,11300
D000355,N00001783,John D Dingell (D),2014,Other,9100,0,9100
H000874,N00001821,Steny H Hoyer (D),2014,Agribusiness,23381,73000,96381
H000874,N00001821,Steny H Hoyer (D),2014,Communic/Electronics,97150,172000,269150
H000874,N00001821,Steny H Hoyer (D),2014,Construction,21300,72500,93800
H000874,N00001821,Steny H Hoyer (D),2014,Defense,5500,117500,123000
H000874,N00001821,Steny H Hoyer (D),2014,Energy/Nat Resource,28500,256250,284750
H000874,N00001821,Steny H Hoyer (D),2014,Finance/Insur/RealEst,245250,563500,808750
H000874,N00001821,Steny H Hoyer (D),2014,Health,89870,405000,494870
H000874,N00001821,Steny H Hoyer (D),2014,Lawyers & Lobbyists,204145,56500,260645
H000874,N00001821,Steny H Hoyer (D),2014,Transportation,33500,147500,181000
H000874,N00001821,Steny H Hoyer (D),2014,Misc Business,103200,231500,334700
H000874,N00001821,Steny H Hoyer (D),2014,Labor,350,309665,310015
H000874,N00001821,Steny H Hoyer (D),2014,Ideology/Single-Issue,165450,54000,219450
H000874,N00001821,Steny H Hoyer (D),2014,Other,123520,10000,133520
C000141,N00001955,Ben Cardin (D),2014,Agribusiness,18250,35500,53750
C000141,N00001955,Ben Cardin (D),2014,Communic/Electronics,216625,110446,327071
C000141,N00001955,Ben Cardin (D),2014,Construction,81172,115500,196672
C000141,N00001955,Ben Cardin (D),2014,Defense,12550,72500,85050
C000141,N00001955,Ben Cardin (D),2014,Energy/Nat Resource,65650,116750,182400
C000141,N00001955,Ben Cardin (D),2014,Finance/Insur/RealEst,793153,537999,1331152
C000141,N00001955,Ben Cardin (D),2014,Health,318040,567618,885658
C000141,N00001955,Ben Cardin (D),2014,Lawyers & Lobbyists,624069,135016,759085
C000141,N00001955,Ben Cardin (D),2014,Transportation,35150,85500,120650
C000141,N00001955,Ben Cardin (D),2014,Misc Business,279979,239041,519020
C000141,N00001955,Ben Cardin (D),2014,Labor,1500,302500,304000
C000141,N00001955,Ben Cardin (D),2014,Ideology/Single-Issue,253213,307780,560993
C000141,N00001955,Ben Cardin (D),2014,Other,458282,12000,470282
C000984,N00001971,Elijah E Cummings (D),2014,Agribusiness,1000,23500,24500
C000984,N00001971,Elijah E Cummings (D),2014,Communic/Electronics,15500,12000,27500
C000984,N00001971,Elijah E Cummings (D),2014,Construction,7250,13000,20250
C000984,N00001971,Elijah E Cummings (D),2014,Defense,2500,8500,11000
C000984,N00001971,Elijah E Cummings (D),2014,Energy/Nat Resource,37050,13600,50650
C000984,N00001971,Elijah E Cummings (D),2014,Finance/Insur/RealEst,17750,44200,61950
C000984,N00001971,Elijah E Cummings (D),2014,Health,42000,38500,80500
C000984,N00001971,Elijah E Cummings (D),2014,Lawyers & Lobbyists,32830,12500,45330
C000984,N00001971,Elijah E Cummings (D),2014,Transportation,14200,117000,131200
C000984,N00001971,Elijah E Cummings (D),2014,Misc Business,8000,31000,39000
C000984,N00001971,Elijah E Cummings (D),2014,Labor,400,273500,273900
C000984,N00001971,Elijah E Cummings (D),2014,Ideology/Single-Issue,13050,13000,26050
C000984,N00001971,Elijah E Cummings (D),2014,Other,33050,1000,34050
B001135,N00002221,Richard Burr (R),2014,Agribusiness,253852,282982,536834
B001135,N00002221,Richard Burr (R),2014,Communic/Electronics,95078,159500,254578
B001135,N00002221,Richard Burr (R),2014,Construction,203295,87500,290795
B001135,N00002221,Richard Burr (R),2014,Defense,29097,136000,165097
B001135,N00002221,Richard Burr (R),2014,Energy/Nat Resource,255747,376799,632546
B001135,N00002221,Richard Burr (R),2014,Finance/Insur/RealEst,938188,543149,1481337
B001135,N00002221,Richard Burr (R),2014,Health,523769,710820,1234589
B001135,N00002221,Richard Burr (R),2014,Lawyers & Lobbyists,575844,136250,712094
B001135,N00002221,Richard Burr (R),2014,Transportation,143001,113000,256001
B001135,N00002221,Richard Burr (R),2014,Misc Business,634259,459989,1094248
B001135,N00002221,Richard Burr (R),2014,Labor,0,8500,8500
B001135,N00002221,Richard Burr (R),2014,Ideology/Single-Issue,122375,399178,521553
B001135,N00002221,Richard Burr (R),2014,Other,626058,28000,654058
C000556,N00002247,Howard Coble (R),2014,Agribusiness,500,8000,8500
C000556,N00002247,Howard Coble (R),2014,Communic/Electronics,0,12500,12500
C000556,N00002247,Howard Coble (R),2014,Construction,0,1000,1000
C000556,N00002247,Howard Coble (R),2014,Defense,0,1000,1000
C000556,N00002247,Howard Coble (R),2014,Energy/Nat Resource,0,5000,5000
C000556,N00002247,Howard Coble (R),2014,Finance/Insur/RealEst,2250,6000,8250
C000556,N00002247,Howard Coble (R),2014,Health,0,8000,8000
C000556,N00002247,Howard Coble (R),2014,Lawyers & Lobbyists,2250,1000,3250
C000556,N00002247,Howard Coble (R),2014,Transportation,0,20000,20000
C000556,N00002247,Howard Coble (R),2014,Misc Business,2500,6000,8500
C000556,N00002247,Howard Coble (R),2014,Labor,0,2000,2000
C000556,N00002247,Howard Coble (R),2014,Other,3950,0,3950
C000537,N00002408,James E Clyburn (D),2014,Agribusiness,4500,77500,82000
C000537,N00002408,James E Clyburn (D),2014,Communic/Electronics,9000,155500,164500
C000537,N00002408,James E Clyburn (D),2014,Construction,14600,78250,92850
C000537,N00002408,James E Clyburn (D),2014,Defense,750,66500,67250
C000537,N00002408,James E Clyburn (D),2014,Energy/Nat Resource,6250,137500,143750
C000537,N00002408,James E Clyburn (D),2014,Finance/Insur/RealEst,51050,347411,398461
C000537,N00002408,James E Clyburn (D),2014,Health,30700,255210,285910
C000537,N00002408,James E Clyburn (D),2014,Lawyers & Lobbyists,104443,61699,166142
C000537,N00002408,James E Clyburn (D),2014,Transportation,1000,117600,118600
C000537,N00002408,James E Clyburn (D),2014,Misc Business,23300,173338,196638
C000537,N00002408,James E Clyburn (D),2014,Labor,0,295500,295500
C000537,N00002408,James E Clyburn (D),2014,Ideology/Single-Issue,14200,29440,43640
C000537,N00002408,James E Clyburn (D),2014,Other,35309,3500,38809
B000490,N00002674,Sanford Bishop (D),2014,Agribusiness,12500,180988,193488
B000490,N00002674,Sanford Bishop (D),2014,Communic/Electronics,10850,48500,59350
B000490,N00002674,Sanford Bishop (D),2014,Construction,14300,9500,23800
B000490,N00002674,Sanford Bishop (D),2014,Defense,250,48000,48250
B000490,N00002674,Sanford Bishop (D),2014,Energy/Nat Resource,6500,41000,47500
B000490,N00002674,Sanford Bishop (D),2014,Finance/Insur/RealEst,24550,107140,131690
B000490,N00002674,Sanford Bishop (D),2014,Health,24550,43000,67550
B000490,N00002674,Sanford Bishop (D),2014,Lawyers & Lobbyists,54350,33944,88294
B000490,N00002674,Sanford Bishop (D),2014,Transportation,10100,35500,45600
B000490,N00002674,Sanford Bishop (D),2014,Misc Business,51100,86000,137100
B000490,N00002674,Sanford Bishop (D),2014,Labor,0,157800,157800
B000490,N00002674,Sanford Bishop (D),2014,Ideology/Single-Issue,5720,52303,58023
B000490,N00002674,Sanford Bishop (D),2014,Other,37300,0,37300
C000286,N00002685,Saxby Chambliss (R),2014,Agribusiness,118250,176111,294361
C000286,N00002685,Saxby Chambliss (R),2014,Communic/Electronics,13000,53000,66000
C000286,N00002685,Saxby Chambliss (R),2014,Construction,55450,12000,67450
C000286,N00002685,Saxby Chambliss (R),2014,Defense,7300,51500,58800
C000286,N00002685,Saxby Chambliss (R),2014,Energy/Nat Resource,55253,56500,111753
C000286,N00002685,Saxby Chambliss (R),2014,Finance/Insur/RealEst,163230,112500,275730
C000286,N00002685,Saxby Chambliss (R),2014,Health,75075,66500,141575
C000286,N00002685,Saxby Chambliss (R),2014,Lawyers & Lobbyists,126743,32000,158743
C000286,N00002685,Saxby Chambliss (R),2014,Transportation,32400,42000,74400
C000286,N00002685,Saxby Chambliss (R),2014,Misc Business,134250,77200,211450
C000286,N00002685,Saxby Chambliss (R),2014,Labor,0,4500,4500
C000286,N00002685,Saxby Chambliss (R),2014,Ideology/Single-Issue,14750,15300,30050
C000286,N00002685,Saxby Chambliss (R),2014,Other,118715,1500,120215
B000911,N00002713,Corrine Brown (D),2014,Agribusiness,10300,17000,27300
B000911,N00002713,Corrine Brown (D),2014,Communic/Electronics,2800,14000,16800
B000911,N00002713,Corrine Brown (D),2014,Construction,28650,5000,33650
B000911,N00002713,Corrine Brown (D),2014,Defense,0,2000,2000
B000911,N00002713,Corrine Brown (D),2014,Energy/Nat Resource,8500,2500,11000
B000911,N00002713,Corrine Brown (D),2014,Finance/Insur/RealEst,28900,12500,41400
B000911,N00002713,Corrine Brown (D),2014,Health,13500,11500,25000
B000911,N00002713,Corrine Brown (D),2014,Lawyers & Lobbyists,44650,19600,64250
B000911,N00002713,Corrine Brown (D),2014,Transportation,11700,93975,105675
B000911,N00002713,Corrine Brown (D),2014,Misc Business,20600,21000,41600
B000911,N00002713,Corrine Brown (D),2014,Labor,0,102000,102000
B000911,N00002713,Corrine Brown (D),2014,Ideology/Single-Issue,1000,16800,17800
B000911,N00002713,Corrine Brown (D),2014,Other,6100,0,6100
H000324,N00002884,Alcee L Hastings (D),2014,Agribusiness,12300,34500,46800
H000324,N00002884,Alcee L Hastings (D),2014,Communic/Electronics,2000,39000,41000
H000324,N00002884,Alcee L Hastings (D),2014,Construction,5405,0,5405
H000324,N00002884,Alcee L Hastings (D),2014,Defense,1000,0,1000
H000324,N00002884,Alcee L Hastings (D),2014,Energy/Nat Resource,500,10000,10500
H000324,N00002884,Alcee L Hastings (D),2014,Finance/Insur/RealEst,59000,38000,97000
H000324,N00002884,Alcee L Hastings (D),2014,Health,14300,12500,26800
H000324,N00002884,Alcee L Hastings (D),2014,Lawyers & Lobbyists,68360,15000,83360
H000324,N00002884,Alcee L Hastings (D),2014,Transportation,7200,19000,26200
H000324,N00002884,Alcee L Hastings (D),2014,Misc Business,33400,7000,40400
H000324,N00002884,Alcee L Hastings (D),2014,Labor,0,95500,95500
H000324,N00002884,Alcee L Hastings (D),2014,Ideology/Single-Issue,2000,69770,71770
H000324,N00002884,Alcee L Hastings (D),2014,Other,52910,30500,83410
F000462,N00002893,Lois J Frankel (D),2014,Agribusiness,20550,15000,35550
F000462,N00002893,Lois J Frankel (D),2014,Communic/Electronics,14650,20000,34650
F000462,N00002893,Lois J Frankel (D),2014,Construction,10550,7000,17550
F000462,N00002893,Lois J Frankel (D),2014,Defense,5100,4000,9100
F000462,N00002893,Lois J Frankel (D),2014,Energy/Nat Resource,5350,2250,7600
F000462,N00002893,Lois J Frankel (D),2014,Finance/Insur/RealEst,135400,23000,158400
F000462,N00002893,Lois J Frankel (D),2014,Health,17300,21000,38300
F000462,N00002893,Lois J Frankel (D),2014,Lawyers & Lobbyists,101423,21000,122423
F000462,N00002893,Lois J Frankel (D),2014,Transportation,3000,55370,58370
F000462,N00002893,Lois J Frankel (D),2014,Misc Business,92500,31713,124213
F000462,N00002893,Lois J Frankel (D),2014,Labor,2000,184500,186500
F000462,N00002893,Lois J Frankel (D),2014,Ideology/Single-Issue,22550,15500,38050
F000462,N00002893,Lois J Frankel (D),2014,Other,143100,1500,144600
A000055,N00003028,Robert B Aderholt (R),2014,Agribusiness,26585,209000,235585
A000055,N00003028,Robert B Aderholt (R),2014,Communic/Electronics,14997,38600,53597
A000055,N00003028,Robert B Aderholt (R),2014,Construction,32397,17500,49897
A000055,N00003028,Robert B Aderholt (R),2014,Defense,36145,96000,132145
A000055,N00003028,Robert B Aderholt (R),2014,Energy/Nat Resource,11244,59000,70244
A000055,N00003028,Robert B Aderholt (R),2014,Finance/Insur/RealEst,21847,111500,133347
A000055,N00003028,Robert B Aderholt (R),2014,Health,16544,43000,59544
A000055,N00003028,Robert B Aderholt (R),2014,Lawyers & Lobbyists,50365,30119,80484
A000055,N00003028,Robert B Aderholt (R),2014,Transportation,26946,49000,75946
A000055,N00003028,Robert B Aderholt (R),2014,Misc Business,25596,55000,80596
A000055,N00003028,Robert B Aderholt (R),2014,Labor,0,22000,22000
A000055,N00003028,Robert B Aderholt (R),2014,Ideology/Single-Issue,3048,23000,26048
A000055,N00003028,Robert B Aderholt (R),2014,Other,15445,2000,17445
B001243,N00003105,Marsha Blackburn (R),2014,Agribusiness,12000,29500,41500
B001243,N00003105,Marsha Blackburn (R),2014,Communic/Electronics,27500,149600,177100
B001243,N00003105,Marsha Blackburn (R),2014,Construction,19050,26500,45550
B001243,N00003105,Marsha Blackburn (R),2014,Defense,500,38000,38500
B001243,N00003105,Marsha Blackburn (R),2014,Energy/Nat Resource,23600,121500,145100
B001243,N00003105,Marsha Blackburn (R),2014,Finance/Insur/RealEst,86576,124750,211326
B001243,N00003105,Marsha Blackburn (R),2014,Health,64700,452750,517450
B001243,N00003105,Marsha Blackburn (R),2014,Lawyers & Lobbyists,57950,40291,98241
B001243,N00003105,Marsha Blackburn (R),2014,Transportation,39650,72700,112350
B001243,N00003105,Marsha Blackburn (R),2014,Misc Business,79834,135346,215180
B001243,N00003105,Marsha Blackburn (R),2014,Labor,0,7000,7000
B001243,N00003105,Marsha Blackburn (R),2014,Ideology/Single-Issue,13400,29500,42900
B001243,N00003105,Marsha Blackburn (R),2014,Other,45100,3000,48100
C000754,N00003132,Jim Cooper (D),2014,Agribusiness,1450,5250,6700
C000754,N00003132,Jim Cooper (D),2014,Communic/Electronics,10000,8500,18500
C000754,N00003132,Jim Cooper (D),2014,Construction,14400,15500,29900
C000754,N00003132,Jim Cooper (D),2014,Defense,0,46500,46500
C000754,N00003132,Jim Cooper (D),2014,Energy/Nat Resource,6700,2000,8700
C000754,N00003132,Jim Cooper (D),2014,Finance/Insur/RealEst,99750,69000,168750
C000754,N00003132,Jim Cooper (D),2014,Health,21400,24000,45400
C000754,N00003132,Jim Cooper (D),2014,Lawyers & Lobbyists,70600,14500,85100
C000754,N00003132,Jim Cooper (D),2014,Transportation,3600,30500,34100
C000754,N00003132,Jim Cooper (D),2014,Misc Business,46700,37500,84200
C000754,N00003132,Jim Cooper (D),2014,Labor,0,33500,33500
C000754,N00003132,Jim Cooper (D),2014,Ideology/Single-Issue,1000,20500,21500
C000754,N00003132,Jim Cooper (D),2014,Other,63850,5000,68850
D000533,N00003209,John J Duncan Jr (R),2014,Agribusiness,1250,3000,4250
D000533,N00003209,John J Duncan Jr (R),2014,Communic/Electronics,0,5500,5500
D000533,N00003209,John J Duncan Jr (R),2014,Construction,11000,59000,70000
D000533,N00003209,John J Duncan Jr (R),2014,Defense,0,10000,10000
D000533,N00003209,John J Duncan Jr (R),2014,Energy/Nat Resource,6750,15000,21750
D000533,N00003209,John J Duncan Jr (R),2014,Finance/Insur/RealEst,4250,24500,28750
D000533,N00003209,John J Duncan Jr (R),2014,Health,27300,3500,30800
D000533,N00003209,John J Duncan Jr (R),2014,Lawyers & Lobbyists,30150,15500,45650
D000533,N00003209,John J Duncan Jr (R),2014,Transportation,4750,145500,150250
D000533,N00003209,John J Duncan Jr (R),2014,Misc Business,1750,25500,27250
D000533,N00003209,John J Duncan Jr (R),2014,Labor,0,26000,26000
D000533,N00003209,John J Duncan Jr (R),2014,Ideology/Single-Issue,1000,4500,5500
D000533,N00003209,John J Duncan Jr (R),2014,Other,6256,0,6256
C001068,N00003225,Steve Cohen (D),2014,Agribusiness,2000,23500,25500
C001068,N00003225,Steve Cohen (D),2014,Communic/Electronics,2500,58500,61000
C001068,N00003225,Steve Cohen (D),2014,Construction,3600,3000,6600
C001068,N00003225,Steve Cohen (D),2014,Defense,250,0,250
C001068,N00003225,Steve Cohen (D),2014,Energy/Nat Resource,250,2500,2750
C001068,N00003225,Steve Cohen (D),2014,Finance/Insur/RealEst,55450,18500,73950
C001068,N00003225,Steve Cohen (D),2014,Health,15100,26000,41100
C001068,N00003225,Steve Cohen (D),2014,Lawyers & Lobbyists,27050,23500,50550
C001068,N00003225,Steve Cohen (D),2014,Transportation,7600,65000,72600
C001068,N00003225,Steve Cohen (D),2014,Misc Business,16000,49000,65000
C001068,N00003225,Steve Cohen (D),2014,Labor,0,158000,158000
C001068,N00003225,Steve Cohen (D),2014,Ideology/Single-Issue,9300,42224,51524
C001068,N00003225,Steve Cohen (D),2014,Other,35450,1000,36450
C000567,N00003328,Thad Cochran (R),2014,Agribusiness,357579,690037,1047616
C000567,N00003328,Thad Cochran (R),2014,Communic/Electronics,83850,157300,241150
C000567,N00003328,Thad Cochran (R),2014,Construction,139700,103700,243400
C000567,N00003328,Thad Cochran (R),2014,Defense,113150,333100,446250
C000567,N00003328,Thad Cochran (R),2014,Energy/Nat Resource,139355,277000,416355
C000567,N00003328,Thad Cochran (R),2014,Finance/Insur/RealEst,308939,372300,681239
C000567,N00003328,Thad Cochran (R),2014,Health,105259,227300,332559
C000567,N00003328,Thad Cochran (R),2014,Lawyers & Lobbyists,372475,144501,516976
C000567,N00003328,Thad Cochran (R),2014,Transportation,120250,178100,298350
C000567,N00003328,Thad Cochran (R),2014,Misc Business,201827,210473,412300
C000567,N00003328,Thad Cochran (R),2014,Labor,0,47500,47500
C000567,N00003328,Thad Cochran (R),2014,Ideology/Single-Issue,86600,558350,644950
C000567,N00003328,Thad Cochran (R),2014,Other,263342,6500,269842
B000944,N00003535,Sherrod Brown (D),2014,Agribusiness,127375,101500,228875
B000944,N00003535,Sherrod Brown (D),2014,Communic/Electronics,493879,116000,609879
B000944,N00003535,Sherrod Brown (D),2014,Construction,188672,89300,277972
B000944,N00003535,Sherrod Brown (D),2014,Defense,25600,72000,97600
B000944,N00003535,Sherrod Brown (D),2014,Energy/Nat Resource,136210,147500,283710
B000944,N00003535,Sherrod Brown (D),2014,Finance/Insur/RealEst,1305138,526649,1831787
B000944,N00003535,Sherrod Brown (D),2014,Health,910985,484950,1395935
B000944,N00003535,Sherrod Brown (D),2014,Lawyers & Lobbyists,2253252,224473,2477725
B000944,N00003535,Sherrod Brown (D),2014,Transportation,97750,74000,171750
B000944,N00003535,Sherrod Brown (D),2014,Misc Business,735532,292300,1027832
B000944,N00003535,Sherrod Brown (D),2014,Labor,31406,434550,465956
B000944,N00003535,Sherrod Brown (D),2014,Ideology/Single-Issue,1361983,572740,1934723
B000944,N00003535,Sherrod Brown (D),2014,Other,2263346,29550,2292896
B000589,N00003675,John Boehner (R),2014,Agribusiness,616208,189650,805858
B000589,N00003675,John Boehner (R),2014,Communic/Electronics,394000,166950,560950
B000589,N00003675,John Boehner (R),2014,Construction,701008,84750,785758
B000589,N00003675,John Boehner (R),2014,Defense,31101,87000,118101
B000589,N00003675,John Boehner (R),2014,Energy/Nat Resource,1382912,348550,1731462
B000589,N00003675,John Boehner (R),2014,Finance/Insur/RealEst,2635071,647000,3282071
B000589,N00003675,John Boehner (R),2014,Health,668107,402375,1070482
B000589,N00003675,John Boehner (R),2014,Lawyers & Lobbyists,800382,48400,848782
B000589,N00003675,John Boehner (R),2014,Transportation,427800,144500,572300
B000589,N00003675,John Boehner (R),2014,Misc Business,1423050,391715,1814765
B000589,N00003675,John Boehner (R),2014,Labor,0,42500,42500
B000589,N00003675,John Boehner (R),2014,Ideology/Single-Issue,430969,27150,458119
B000589,N00003675,John Boehner (R),2014,Other,1402283,14500,1416783
C000266,N00003689,Steve Chabot (R),2014,Agribusiness,22200,9500,31700
C000266,N00003689,Steve Chabot (R),2014,Communic/Electronics,19550,54500,74050
C000266,N00003689,Steve Chabot (R),2014,Construction,20500,18000,38500
C000266,N00003689,Steve Chabot (R),2014,Defense,0,20000,20000
C000266,N00003689,Steve Chabot (R),2014,Energy/Nat Resource,2550,28500,31050
C000266,N00003689,Steve Chabot (R),2014,Finance/Insur/RealEst,78400,70700,149100
C000266,N00003689,Steve Chabot (R),2014,Health,35350,12000,47350
C000266,N00003689,Steve Chabot (R),2014,Lawyers & Lobbyists,38700,13221,51921
C000266,N00003689,Steve Chabot (R),2014,Transportation,9000,31000,40000
C000266,N00003689,Steve Chabot (R),2014,Misc Business,100450,70685,171135
C000266,N00003689,Steve Chabot (R),2014,Labor,0,1000,1000
C000266,N00003689,Steve Chabot (R),2014,Ideology/Single-Issue,2200,44850,47050
C000266,N00003689,Steve Chabot (R),2014,Other,49300,0,49300
C000542,N00003845,Dan Coats (R),2014,Agribusiness,66250,85550,151800
C000542,N00003845,Dan Coats (R),2014,Communic/Electronics,67364,83100,150464
C000542,N00003845,Dan Coats (R),2014,Construction,97150,70500,167650
C000542,N00003845,Dan Coats (R),2014,Defense,27875,134550,162425
C000542,N00003845,Dan Coats (R),2014,Energy/Nat Resource,106933,216350,323283
C000542,N00003845,Dan Coats (R),2014,Finance/Insur/RealEst,577291,303847,881138
C000542,N00003845,Dan Coats (R),2014,Health,128250,290798,419048
C000542,N00003845,Dan Coats (R),2014,Lawyers & Lobbyists,332187,80350,412537
C000542,N00003845,Dan Coats (R),2014,Transportation,53200,136400,189600
C000542,N00003845,Dan Coats (R),2014,Misc Business,246723,256050,502773
C000542,N00003845,Dan Coats (R),2014,Labor,250,6500,6750
C000542,N00003845,Dan Coats (R),2014,Ideology/Single-Issue,69850,354358,424208
C000542,N00003845,Dan Coats (R),2014,Other,247074,7000,254074
C000714,N00004029,John Conyers Jr (D),2014,Agribusiness,0,9500,9500
C000714,N00004029,John Conyers Jr (D),2014,Communic/Electronics,30250,150590,180840
C000714,N00004029,John Conyers Jr (D),2014,Defense,0,1000,1000
C000714,N00004029,John Conyers Jr (D),2014,Energy/Nat Resource,1000,15000,16000
C000714,N00004029,John Conyers Jr (D),2014,Finance/Insur/RealEst,13400,6000,19400
C000714,N00004029,John Conyers Jr (D),2014,Health,8800,26400,35200
C000714,N00004029,John Conyers Jr (D),2014,Lawyers & Lobbyists,41350,46392,87742
C000714,N00004029,John Conyers Jr (D),2014,Transportation,0,24500,24500
C000714,N00004029,John Conyers Jr (D),2014,Misc Business,17650,68500,86150
C000714,N00004029,John Conyers Jr (D),2014,Labor,0,161500,161500
C000714,N00004029,John Conyers Jr (D),2014,Ideology/Single-Issue,1250,57595,58845
C000714,N00004029,John Conyers Jr (D),2014,Other,8450,1000,9450
H000206,N00004207,Tom Harkin (D),2014,Agribusiness,30100,62067,92167
H000206,N00004207,Tom Harkin (D),2014,Communic/Electronics,39600,9300,48900
H000206,N00004207,Tom Harkin (D),2014,Construction,11800,21500,33300
H000206,N00004207,Tom Harkin (D),2014,Defense,5500,12500,18000
H000206,N00004207,Tom Harkin (D),2014,Energy/Nat Resource,7250,30500,37750
H000206,N00004207,Tom Harkin (D),2014,Finance/Insur/RealEst,112960,53500,166460
H000206,N00004207,Tom Harkin (D),2014,Health,186000,321384,507384
H000206,N00004207,Tom Harkin (D),2014,Lawyers & Lobbyists,191484,56207,247691
H000206,N00004207,Tom Harkin (D),2014,Transportation,5650,5200,10850
H000206,N00004207,Tom Harkin (D),2014,Misc Business,55450,50400,105850
H000206,N00004207,Tom Harkin (D),2014,Labor,200,60430,60630
H000206,N00004207,Tom Harkin (D),2014,Ideology/Single-Issue,24403,23145,47548
H000206,N00004207,Tom Harkin (D),2014,Other,172171,11000,183171
B001230,N00004367,Tammy Baldwin (D),2014,Agribusiness,62309,34000,96309
B001230,N00004367,Tammy Baldwin (D),2014,Communic/Electronics,409066,33000,442066
B001230,N00004367,Tammy Baldwin (D),2014,Construction,53980,9600,63580
B001230,N00004367,Tammy Baldwin (D),2014,Defense,5450,1000,6450
B001230,N00004367,Tammy Baldwin (D),2014,Energy/Nat Resource,39262,58500,97762
B001230,N00004367,Tammy Baldwin (D),2014,Finance/Insur/RealEst,425740,47500,473240
B001230,N00004367,Tammy Baldwin (D),2014,Health,334224,95011,429235
B001230,N00004367,Tammy Baldwin (D),2014,Lawyers & Lobbyists,759403,28709,788112
B001230,N00004367,Tammy Baldwin (D),2014,Transportation,21585,18250,39835
B001230,N00004367,Tammy Baldwin (D),2014,Misc Business,425540,37000,462540
B001230,N00004367,Tammy Baldwin (D),2014,Labor,23280,378250,401530
B001230,N00004367,Tammy Baldwin (D),2014,Ideology/Single-Issue,1868745,671650,2540395
B001230,N00004367,Tammy Baldwin (D),2014,Other,1450192,6250,1456442
C001096,N00004614,Kevin Cramer (R),2014,Agribusiness,90883,120100,210983
C001096,N00004614,Kevin Cramer (R),2014,Communic/Electronics,1250,29000,30250
C001096,N00004614,Kevin Cramer (R),2014,Construction,47750,32750,80500
C001096,N00004614,Kevin Cramer (R),2014,Defense,0,22000,22000
C001096,N00004614,Kevin Cramer (R),2014,Energy/Nat Resource,172750,129100,301850
C001096,N00004614,Kevin Cramer (R),2014,Finance/Insur/RealEst,86900,61500,148400
C001096,N00004614,Kevin Cramer (R),2014,Health,12950,11000,23950
C001096,N00004614,Kevin Cramer (R),2014,Lawyers & Lobbyists,24700,1500,26200
C001096,N00004614,Kevin Cramer (R),2014,Transportation,9950,28000,37950
C001096,N00004614,Kevin Cramer (R),2014,Misc Business,47425,38555,85980
C001096,N00004614,Kevin Cramer (R),2014,Labor,0,4000,4000
C001096,N00004614,Kevin Cramer (R),2014,Ideology/Single-Issue,11600,50613,62213
C001096,N00004614,Kevin Cramer (R),2014,Other,74520,0,74520
B000243,N00004643,Max Baucus (D),2014,Agribusiness,54296,133500,187796
B000243,N00004643,Max Baucus (D),2014,Communic/Electronics,84246,123750,207996
B000243,N00004643,Max Baucus (D),2014,Construction,26525,58750,85275
B000243,N00004643,Max Baucus (D),2014,Defense,3500,23500,27000
B000243,N00004643,Max Baucus (D),2014,Energy/Nat Resource,94800,264750,359550
B000243,N00004643,Max Baucus (D),2014,Finance/Insur/RealEst,652523,404900,1057423
B000243,N00004643,Max Baucus (D),2014,Health,264328,579418,843746
B000243,N00004643,Max Baucus (D),2014,Lawyers & Lobbyists,436926,117049,553975
B000243,N00004643,Max Baucus (D),2014,Transportation,40394,70750,111144
B000243,N00004643,Max Baucus (D),2014,Misc Business,158356,225750,384106
B000243,N00004643,Max Baucus (D),2014,Labor,2400,66900,69300
B000243,N00004643,Max Baucus (D),2014,Ideology/Single-Issue,39499,39450,78949
B000243,N00004643,Max Baucus (D),2014,Other,101479,2000,103479
G000535,N00004874,Luis V Gutierrez (D),2014,Agribusiness,0,2000,2000
G000535,N00004874,Luis V Gutierrez (D),2014,Communic/Electronics,3100,31000,34100
G000535,N00004874,Luis V Gutierrez (D),2014,Construction,5200,5500,10700
G000535,N00004874,Luis V Gutierrez (D),2014,Energy/Nat Resource,500,2500,3000
G000535,N00004874,Luis V Gutierrez (D),2014,Finance/Insur/RealEst,2500,49440,51940
G000535,N00004874,Luis V Gutierrez (D),2014,Health,0,15500,15500
G000535,N00004874,Luis V Gutierrez (D),2014,Lawyers & Lobbyists,9250,8000,17250
G000535,N00004874,Luis V Gutierrez (D),2014,Transportation,0,1500,1500
G000535,N00004874,Luis V Gutierrez (D),2014,Misc Business,2300,19000,21300
G000535,N00004874,Luis V Gutierrez (D),2014,Labor,0,54500,54500
G000535,N00004874,Luis V Gutierrez (D),2014,Ideology/Single-Issue,1950,19250,21200
G000535,N00004874,Luis V Gutierrez (D),2014,Other,0,1500,1500
D000096,N00004884,Danny K Davis (D),2014,Agribusiness,250,20000,20250
D000096,N00004884,Danny K Davis (D),2014,Communic/Electronics,0,24400,24400
D000096,N00004884,Danny K Davis (D),2014,Construction,2250,6000,8250
D000096,N00004884,Danny K Davis (D),2014,Defense,0,11000,11000
D000096,N00004884,Danny K Davis (D),2014,Energy/Nat Resource,0,22500,22500
D000096,N00004884,Danny K Davis (D),2014,Finance/Insur/RealEst,550,105500,106050
D000096,N00004884,Danny K Davis (D),2014,Health,5850,70500,76350
D000096,N00004884,Danny K Davis (D),2014,Lawyers & Lobbyists,8750,15000,23750
D000096,N00004884,Danny K Davis (D),2014,Transportation,1500,19500,21000
D000096,N00004884,Danny K Davis (D),2014,Misc Business,2700,59000,61700
D000096,N00004884,Danny K Davis (D),2014,Labor,0,84000,84000
D000096,N00004884,Danny K Davis (D),2014,Ideology/Single-Issue,0,7000,7000
D000096,N00004884,Danny K Davis (D),2014,Other,7320,1000,8320
D000563,N00004981,Dick Durbin (D),2014,Agribusiness,45905,114450,160355
D000563,N00004981,Dick Durbin (D),2014,Communic/Electronics,190424,139550,329974
D000563,N00004981,Dick Durbin (D),2014,Construction,114730,78700,193430
D000563,N00004981,Dick Durbin (D),2014,Defense,240800,127499,368299
D000563,N00004981,Dick Durbin (D),2014,Energy/Nat Resource,67750,119100,186850
D000563,N00004981,Dick Durbin (D),2014,Finance/Insur/RealEst,807576,237400,1044976
D000563,N00004981,Dick Durbin (D),2014,Health,254836,373460,628296
D000563,N00004981,Dick Durbin (D),2014,Lawyers & Lobbyists,1507203,127420,1634623
D000563,N00004981,Dick Durbin (D),2014,Transportation,111800,198509,310309
D000563,N00004981,Dick Durbin (D),2014,Misc Business,336940,409805,746745
D000563,N00004981,Dick Durbin (D),2014,Labor,25750,293000,318750
D000563,N00004981,Dick Durbin (D),2014,Ideology/Single-Issue,317301,275419,592720
D000563,N00004981,Dick Durbin (D),2014,Other,608983,8500,617483
E000172,N00005090,Jo Ann Emerson (R),2014,Agribusiness,0,-2500,-2500
E000172,N00005090,Jo Ann Emerson (R),2014,Health,0,-3500,-3500
E000172,N00005090,Jo Ann Emerson (R),2014,Labor,0,-7000,-7000
E000172,N00005090,Jo Ann Emerson (R),2014,Ideology/Single-Issue,0,-1500,-1500
B000575,N00005195,Roy Blunt (R),2014,Agribusiness,524950,377191,902141
B000575,N00005195,Roy Blunt (R),2014,Communic/Electronics,301901,325336,627237
B000575,N00005195,Roy Blunt (R),2014,Construction,372735,135350,508085
B000575,N00005195,Roy Blunt (R),2014,Defense,66166,117000,183166
B000575,N00005195,Roy Blunt (R),2014,Energy/Nat Resource,582108,437750,1019858
B000575,N00005195,Roy Blunt (R),2014,Finance/Insur/RealEst,2259650,716000,2975650
B000575,N00005195,Roy Blunt (R),2014,Health,649122,549850,1198972
B000575,N00005195,Roy Blunt (R),2014,Lawyers & Lobbyists,874124,184038,1058162
B000575,N00005195,Roy Blunt (R),2014,Transportation,479686,298950,778636
B000575,N00005195,Roy Blunt (R),2014,Misc Business,1402186,590750,1992936
B000575,N00005195,Roy Blunt (R),2014,Labor,2900,30250,33150
B000575,N00005195,Roy Blunt (R),2014,Ideology/Single-Issue,242544,871230,1113774
B000575,N00005195,Roy Blunt (R),2014,Other,898085,6000,904085
A000373,N00005293,Brad Ashford (D),2014,Agribusiness,9500,1500,11000
A000373,N00005293,Brad Ashford (D),2014,Communic/Electronics,18500,11500,30000
A000373,N00005293,Brad Ashford (D),2014,Construction,14150,5250,19400
A000373,N00005293,Brad Ashford (D),2014,Defense,250,0,250
A000373,N00005293,Brad Ashford (D),2014,Energy/Nat Resource,9200,0,9200
A000373,N00005293,Brad Ashford (D),2014,Finance/Insur/RealEst,91750,17500,109250
A000373,N00005293,Brad Ashford (D),2014,Health,42500,7500,50000
A000373,N00005293,Brad Ashford (D),2014,Lawyers & Lobbyists,75545,16500,92045
A000373,N00005293,Brad Ashford (D),2014,Transportation,9000,0,9000
A000373,N00005293,Brad Ashford (D),2014,Misc Business,24355,2500,26855
A000373,N00005293,Brad Ashford (D),2014,Labor,250,120000,120250
A000373,N00005293,Brad Ashford (D),2014,Ideology/Single-Issue,14105,155828,169933
A000373,N00005293,Brad Ashford (D),2014,Other,137165,0,137165
C000560,N00005601,Tom Coburn (R),2014,Agribusiness,30125,64000,94125
C000560,N00005601,Tom Coburn (R),2014,Communic/Electronics,18480,86500,104980
C000560,N00005601,Tom Coburn (R),2014,Construction,28600,30500,59100
C000560,N00005601,Tom Coburn (R),2014,Defense,15650,21000,36650
C000560,N00005601,Tom Coburn (R),2014,Energy/Nat Resource,85550,118500,204050
C000560,N00005601,Tom Coburn (R),2014,Finance/Insur/RealEst,202725,228510,431235
C000560,N00005601,Tom Coburn (R),2014,Health,101214,251750,352964
C000560,N00005601,Tom Coburn (R),2014,Lawyers & Lobbyists,111150,47213,158363
C000560,N00005601,Tom Coburn (R),2014,Transportation,7700,55500,63200
C000560,N00005601,Tom Coburn (R),2014,Misc Business,77800,101400,179200
C000560,N00005601,Tom Coburn (R),2014,Labor,0,5000,5000
C000560,N00005601,Tom Coburn (R),2014,Ideology/Single-Issue,106695,159985,266680
C000560,N00005601,Tom Coburn (R),2014,Other,102600,0,102600
H000067,N00005645,Ralph Hall (R),2014,Agribusiness,5000,40118,45118
H000067,N00005645,Ralph Hall (R),2014,Communic/Electronics,5100,22500,27600
H000067,N00005645,Ralph Hall (R),2014,Construction,10400,7500,17900
H000067,N00005645,Ralph Hall (R),2014,Defense,0,47500,47500
H000067,N00005645,Ralph Hall (R),2014,Energy/Nat Resource,20750,64000,84750
H000067,N00005645,Ralph Hall (R),2014,Finance/Insur/RealEst,36450,44500,80950
H000067,N00005645,Ralph Hall (R),2014,Health,18100,49000,67100
H000067,N00005645,Ralph Hall (R),2014,Lawyers & Lobbyists,59378,17191,76569
H000067,N00005645,Ralph Hall (R),2014,Transportation,11900,26500,38400
H000067,N00005645,Ralph Hall (R),2014,Misc Business,15350,37000,52350
H000067,N00005645,Ralph Hall (R),2014,Ideology/Single-Issue,3000,179667,182667
H000067,N00005645,Ralph Hall (R),2014,Other,48250,0,48250
B000213,N00005656,Joe Barton (R),2014,Agribusiness,6600,11000,17600
B000213,N00005656,Joe Barton (R),2014,Communic/Electronics,16200,70600,86800
B000213,N00005656,Joe Barton (R),2014,Construction,16400,35000,51400
B000213,N00005656,Joe Barton (R),2014,Defense,0,29600,29600
B000213,N00005656,Joe Barton (R),2014,Energy/Nat Resource,56350,209500,265850
B000213,N00005656,Joe Barton (R),2014,Finance/Insur/RealEst,43550,45000,88550
B000213,N00005656,Joe Barton (R),2014,Health,29250,66250,95500
B000213,N00005656,Joe Barton (R),2014,Lawyers & Lobbyists,19325,25125,44450
B000213,N00005656,Joe Barton (R),2014,Transportation,3000,49000,52000
B000213,N00005656,Joe Barton (R),2014,Misc Business,52400,81355,133755
B000213,N00005656,Joe Barton (R),2014,Labor,0,1500,1500
B000213,N00005656,Joe Barton (R),2014,Ideology/Single-Issue,1000,13600,14600
B000213,N00005656,Joe Barton (R),2014,Other,20350,0,20350
B001291,N00005736,Brian Babin (R),2014,Agribusiness,11533,35032,46565
B001291,N00005736,Brian Babin (R),2014,Communic/Electronics,4800,10000,14800
B001291,N00005736,Brian Babin (R),2014,Construction,30215,25000,55215
B001291,N00005736,Brian Babin (R),2014,Defense,1750,14000,15750
B001291,N00005736,Brian Babin (R),2014,Energy/Nat Resource,16600,30000,46600
B001291,N00005736,Brian Babin (R),2014,Finance/Insur/RealEst,112000,20250,132250
B001291,N00005736,Brian Babin (R),2014,Health,106076,82500,188576
B001291,N00005736,Brian Babin (R),2014,Lawyers & Lobbyists,26048,3552,29600
B001291,N00005736,Brian Babin (R),2014,Transportation,14600,21500,36100
B001291,N00005736,Brian Babin (R),2014,Misc Business,78500,14000,92500
B001291,N00005736,Brian Babin (R),2014,Ideology/Single-Issue,1750,108576,110326
B001291,N00005736,Brian Babin (R),2014,Other,52350,0,52350
G000410,N00005870,Gene Green (D),2014,Agribusiness,1000,4000,5000
G000410,N00005870,Gene Green (D),2014,Communic/Electronics,8750,69500,78250
G000410,N00005870,Gene Green (D),2014,Construction,13600,10000,23600
G000410,N00005870,Gene Green (D),2014,Defense,0,7500,7500
G000410,N00005870,Gene Green (D),2014,Energy/Nat Resource,1450,158850,160300
G000410,N00005870,Gene Green (D),2014,Finance/Insur/RealEst,15450,38000,53450
G000410,N00005870,Gene Green (D),2014,Health,19600,204044,223644
G000410,N00005870,Gene Green (D),2014,Lawyers & Lobbyists,33750,21500,55250
G000410,N00005870,Gene Green (D),2014,Transportation,12000,62199,74199
G000410,N00005870,Gene Green (D),2014,Misc Business,19450,77000,96450
G000410,N00005870,Gene Green (D),2014,Labor,0,159300,159300
G000410,N00005870,Gene Green (D),2014,Other,6400,0,6400
B000755,N00005883,Kevin Brady (R),2014,Agribusiness,17700,53132,70832
B000755,N00005883,Kevin Brady (R),2014,Communic/Electronics,8200,62230,70430
B000755,N00005883,Kevin Brady (R),2014,Construction,17750,61500,79250
B000755,N00005883,Kevin Brady (R),2014,Defense,0,42000,42000
B000755,N00005883,Kevin Brady (R),2014,Energy/Nat Resource,157150,203600,360750
B000755,N00005883,Kevin Brady (R),2014,Finance/Insur/RealEst,160856,339500,500356
B000755,N00005883,Kevin Brady (R),2014,Health,160245,510932,671177
B000755,N00005883,Kevin Brady (R),2014,Lawyers & Lobbyists,86750,61500,148250
B000755,N00005883,Kevin Brady (R),2014,Transportation,3500,63500,67000
B000755,N00005883,Kevin Brady (R),2014,Misc Business,69800,176000,245800
B000755,N00005883,Kevin Brady (R),2014,Labor,0,1000,1000
B000755,N00005883,Kevin Brady (R),2014,Ideology/Single-Issue,75375,17000,92375
B000755,N00005883,Kevin Brady (R),2014,Other,9000,2000,11000
H000636,N00006008,Ruben Hinojosa (D),2014,Agribusiness,4000,32061,36061
H000636,N00006008,Ruben Hinojosa (D),2014,Communic/Electronics,4500,36000,40500
H000636,N00006008,Ruben Hinojosa (D),2014,Construction,0,2000,2000
H000636,N00006008,Ruben Hinojosa (D),2014,Defense,0,9000,9000
H000636,N00006008,Ruben Hinojosa (D),2014,Energy/Nat Resource,1500,21000,22500
H000636,N00006008,Ruben Hinojosa (D),2014,Finance/Insur/RealEst,14300,87500,101800
H000636,N00006008,Ruben Hinojosa (D),2014,Health,61700,29500,91200
H000636,N00006008,Ruben Hinojosa (D),2014,Lawyers & Lobbyists,10350,7500,17850
H000636,N00006008,Ruben Hinojosa (D),2014,Transportation,0,24000,24000
H000636,N00006008,Ruben Hinojosa (D),2014,Misc Business,22450,41500,63950
H000636,N00006008,Ruben Hinojosa (D),2014,Labor,0,75000,75000
H000636,N00006008,Ruben Hinojosa (D),2014,Ideology/Single-Issue,0,1000,1000
H000636,N00006008,Ruben Hinojosa (D),2014,Other,8700,0,8700
D000399,N00006023,Lloyd Doggett (D),2014,Agribusiness,4350,0,4350
D000399,N00006023,Lloyd Doggett (D),2014,Communic/Electronics,26250,8000,34250
D000399,N00006023,Lloyd Doggett (D),2014,Construction,15150,3500,18650
D000399,N00006023,Lloyd Doggett (D),2014,Defense,0,3000,3000
D000399,N00006023,Lloyd Doggett (D),2014,Energy/Nat Resource,13650,4500,18150
D000399,N00006023,Lloyd Doggett (D),2014,Finance/Insur/RealEst,51400,43000,94400
D000399,N00006023,Lloyd Doggett (D),2014,Health,21550,66500,88050
D000399,N00006023,Lloyd Doggett (D),2014,Lawyers & Lobbyists,149850,35500,185350
D000399,N00006023,Lloyd Doggett (D),2014,Transportation,3750,6500,10250
D000399,N00006023,Lloyd Doggett (D),2014,Misc Business,34350,11500,45850
D000399,N00006023,Lloyd Doggett (D),2014,Labor,0,173000,173000
D000399,N00006023,Lloyd Doggett (D),2014,Ideology/Single-Issue,11600,10500,22100
D000399,N00006023,Lloyd Doggett (D),2014,Other,128900,0,128900
D000197,N00006134,Diana DeGette (D),2014,Agribusiness,9050,36000,45050
D000197,N00006134,Diana DeGette (D),2014,Communic/Electronics,11542,105500,117042
D000197,N00006134,Diana DeGette (D),2014,Construction,1000,0,1000
D000197,N00006134,Diana DeGette (D),2014,Defense,0,6000,6000
D000197,N00006134,Diana DeGette (D),2014,Energy/Nat Resource,1000,17000,18000
D000197,N00006134,Diana DeGette (D),2014,Finance/Insur/RealEst,21000,42000,63000
D000197,N00006134,Diana DeGette (D),2014,Health,16800,221449,238249
D000197,N00006134,Diana DeGette (D),2014,Lawyers & Lobbyists,42896,29000,71896
D000197,N00006134,Diana DeGette (D),2014,Transportation,500,18000,18500
D000197,N00006134,Diana DeGette (D),2014,Misc Business,22040,23000,45040
D000197,N00006134,Diana DeGette (D),2014,Labor,250,101250,101500
D000197,N00006134,Diana DeGette (D),2014,Ideology/Single-Issue,109100,18179,127279
D000197,N00006134,Diana DeGette (D),2014,Other,50800,0,50800
B001261,N00006236,John A Barrasso (R),2014,Agribusiness,27450,84000,111450
B001261,N00006236,John A Barrasso (R),2014,Communic/Electronics,66050,159000,225050
B001261,N00006236,John A Barrasso (R),2014,Construction,96333,98750,195083
B001261,N00006236,John A Barrasso (R),2014,Defense,10500,71000,81500
B001261,N00006236,John A Barrasso (R),2014,Energy/Nat Resource,370722,567150,937872
B001261,N00006236,John A Barrasso (R),2014,Finance/Insur/RealEst,351816,335445,687261
B001261,N00006236,John A Barrasso (R),2014,Health,452826,551250,1004076
B001261,N00006236,John A Barrasso (R),2014,Lawyers & Lobbyists,263007,68500,331507
B001261,N00006236,John A Barrasso (R),2014,Transportation,54666,132499,187165
B001261,N00006236,John A Barrasso (R),2014,Misc Business,195367,260498,455865
B001261,N00006236,John A Barrasso (R),2014,Labor,0,27500,27500
B001261,N00006236,John A Barrasso (R),2014,Ideology/Single-Issue,81559,273832,355391
B001261,N00006236,John A Barrasso (R),2014,Other,141349,12000,153349
E000285,N00006249,Mike Enzi (R),2014,Agribusiness,53250,62937,116187
E000285,N00006249,Mike Enzi (R),2014,Communic/Electronics,34300,97000,131300
E000285,N00006249,Mike Enzi (R),2014,Construction,26150,69500,95650
E000285,N00006249,Mike Enzi (R),2014,Defense,0,43500,43500
E000285,N00006249,Mike Enzi (R),2014,Energy/Nat Resource,73950,263833,337783
E000285,N00006249,Mike Enzi (R),2014,Finance/Insur/RealEst,204500,413394,617894
E000285,N00006249,Mike Enzi (R),2014,Health,105325,545250,650575
E000285,N00006249,Mike Enzi (R),2014,Lawyers & Lobbyists,124192,40427,164619
E000285,N00006249,Mike Enzi (R),2014,Transportation,8500,104000,112500
E000285,N00006249,Mike Enzi (R),2014,Misc Business,104550,295500,400050
E000285,N00006249,Mike Enzi (R),2014,Labor,0,18500,18500
E000285,N00006249,Mike Enzi (R),2014,Ideology/Single-Issue,49525,343522,393047
E000285,N00006249,Mike Enzi (R),2014,Other,88223,12000,100223
C000880,N00006267,Mike Crapo (R),2014,Agribusiness,76250,210385,286635
C000880,N00006267,Mike Crapo (R),2014,Communic/Electronics,22500,112020,134520
C000880,N00006267,Mike Crapo (R),2014,Construction,42020,81000,123020
C000880,N00006267,Mike Crapo (R),2014,Defense,1000,44000,45000
C000880,N00006267,Mike Crapo (R),2014,Energy/Nat Resource,71156,223672,294828
C000880,N00006267,Mike Crapo (R),2014,Finance/Insur/RealEst,439690,1071333,1511023
C000880,N00006267,Mike Crapo (R),2014,Health,133894,405921,539815
C000880,N00006267,Mike Crapo (R),2014,Lawyers & Lobbyists,228568,83472,312040
C000880,N00006267,Mike Crapo (R),2014,Transportation,10950,112977,123927
C000880,N00006267,Mike Crapo (R),2014,Misc Business,130867,212880,343747
C000880,N00006267,Mike Crapo (R),2014,Labor,0,11750,11750
C000880,N00006267,Mike Crapo (R),2014,Ideology/Single-Issue,51250,354934,406184
C000880,N00006267,Mike Crapo (R),2014,Other,135527,0,135527
F000448,N00006423,Trent Franks (R),2014,Agribusiness,7300,1000,8300
F000448,N00006423,Trent Franks (R),2014,Communic/Electronics,9250,40100,49350
F000448,N00006423,Trent Franks (R),2014,Construction,6950,8000,14950
F000448,N00006423,Trent Franks (R),2014,Defense,750,53600,54350
F000448,N00006423,Trent Franks (R),2014,Energy/Nat Resource,2600,33100,35700
F000448,N00006423,Trent Franks (R),2014,Finance/Insur/RealEst,32400,12000,44400
F000448,N00006423,Trent Franks (R),2014,Health,3000,17500,20500
F000448,N00006423,Trent Franks (R),2014,Lawyers & Lobbyists,22373,2500,24873
F000448,N00006423,Trent Franks (R),2014,Transportation,7250,2000,9250
F000448,N00006423,Trent Franks (R),2014,Misc Business,25267,9500,34767
F000448,N00006423,Trent Franks (R),2014,Ideology/Single-Issue,21900,23733,45633
F000448,N00006423,Trent Franks (R),2014,Other,16651,1000,17651
B000711,N00006692,Barbara Boxer (D),2014,Agribusiness,75800,91300,167100
B000711,N00006692,Barbara Boxer (D),2014,Communic/Electronics,1211075,174683,1385758
B000711,N00006692,Barbara Boxer (D),2014,Construction,189038,142117,331155
B000711,N00006692,Barbara Boxer (D),2014,Defense,14400,6500,20900
B000711,N00006692,Barbara Boxer (D),2014,Energy/Nat Resource,160750,103699,264449
B000711,N00006692,Barbara Boxer (D),2014,Finance/Insur/RealEst,1186744,74941,1261685
B000711,N00006692,Barbara Boxer (D),2014,Health,523215,116150,639365
B000711,N00006692,Barbara Boxer (D),2014,Lawyers & Lobbyists,1855560,118322,1973882
B000711,N00006692,Barbara Boxer (D),2014,Transportation,51349,104200,155549
B000711,N00006692,Barbara Boxer (D),2014,Misc Business,1006369,87202,1093571
B000711,N00006692,Barbara Boxer (D),2014,Labor,13400,321100,334500
B000711,N00006692,Barbara Boxer (D),2014,Ideology/Single-Issue,1850424,527268,2377692
B000711,N00006692,Barbara Boxer (D),2014,Other,2087070,3500,2090570
H001063,N00006806,Janice Hahn (D),2014,Agribusiness,2000,18500,20500
H001063,N00006806,Janice Hahn (D),2014,Communic/Electronics,3500,10500,14000
H001063,N00006806,Janice Hahn (D),2014,Construction,1000,21500,22500
H001063,N00006806,Janice Hahn (D),2014,Defense,0,10000,10000
H001063,N00006806,Janice Hahn (D),2014,Energy/Nat Resource,500,16000,16500
H001063,N00006806,Janice Hahn (D),2014,Finance/Insur/RealEst,21950,25500,47450
H001063,N00006806,Janice Hahn (D),2014,Health,3150,14000,17150
H001063,N00006806,Janice Hahn (D),2014,Lawyers & Lobbyists,37314,21447,58761
H001063,N00006806,Janice Hahn (D),2014,Transportation,8500,111000,119500
H001063,N00006806,Janice Hahn (D),2014,Misc Business,26900,25000,51900
H001063,N00006806,Janice Hahn (D),2014,Labor,0,206250,206250
H001063,N00006806,Janice Hahn (D),2014,Ideology/Single-Issue,7000,5285,12285
H001063,N00006806,Janice Hahn (D),2014,Other,8675,0,8675
C000059,N00007099,Ken Calvert (R),2014,Agribusiness,21000,70100,91100
C000059,N00007099,Ken Calvert (R),2014,Communic/Electronics,14800,29500,44300
C000059,N00007099,Ken Calvert (R),2014,Construction,37025,56000,93025
C000059,N00007099,Ken Calvert (R),2014,Defense,6500,113600,120100
C000059,N00007099,Ken Calvert (R),2014,Energy/Nat Resource,6000,98500,104500
C000059,N00007099,Ken Calvert (R),2014,Finance/Insur/RealEst,36650,48500,85150
C000059,N00007099,Ken Calvert (R),2014,Health,6775,16500,23275
C000059,N00007099,Ken Calvert (R),2014,Lawyers & Lobbyists,71858,17988,89846
C000059,N00007099,Ken Calvert (R),2014,Transportation,18450,50500,68950
C000059,N00007099,Ken Calvert (R),2014,Misc Business,134722,57032,191754
C000059,N00007099,Ken Calvert (R),2014,Labor,0,16500,16500
C000059,N00007099,Ken Calvert (R),2014,Ideology/Single-Issue,31550,58500,90050
C000059,N00007099,Ken Calvert (R),2014,Other,23850,6000,29850
C001036,N00007232,Lois Capps (D),2014,Agribusiness,8700,17000,25700
C001036,N00007232,Lois Capps (D),2014,Communic/Electronics,95350,71500,166850
C001036,N00007232,Lois Capps (D),2014,Construction,8910,0,8910
C001036,N00007232,Lois Capps (D),2014,Defense,250,19500,19750
C001036,N00007232,Lois Capps (D),2014,Energy/Nat Resource,550,17000,17550
C001036,N00007232,Lois Capps (D),2014,Finance/Insur/RealEst,62100,46490,108590
C001036,N00007232,Lois Capps (D),2014,Health,61834,271400,333234
C001036,N00007232,Lois Capps (D),2014,Lawyers & Lobbyists,74450,27750,102200
C001036,N00007232,Lois Capps (D),2014,Transportation,0,5000,5000
C001036,N00007232,Lois Capps (D),2014,Misc Business,53300,29807,83107
C001036,N00007232,Lois Capps (D),2014,Labor,4100,177120,181220
C001036,N00007232,Lois Capps (D),2014,Ideology/Single-Issue,181025,316546,497571
C001036,N00007232,Lois Capps (D),2014,Other,265264,0,265264
F000030,N00007312,Sam Farr (D),2014,Agribusiness,50331,105850,156181
F000030,N00007312,Sam Farr (D),2014,Communic/Electronics,9550,2000,11550
F000030,N00007312,Sam Farr (D),2014,Construction,4100,4500,8600
F000030,N00007312,Sam Farr (D),2014,Defense,0,5500,5500
F000030,N00007312,Sam Farr (D),2014,Energy/Nat Resource,5200,25500,30700
F000030,N00007312,Sam Farr (D),2014,Finance/Insur/RealEst,14000,22000,36000
F000030,N00007312,Sam Farr (D),2014,Health,12000,52500,64500
F000030,N00007312,Sam Farr (D),2014,Lawyers & Lobbyists,16450,16000,32450
F000030,N00007312,Sam Farr (D),2014,Transportation,1250,24532,25782
F000030,N00007312,Sam Farr (D),2014,Misc Business,36423,60042,96465
F000030,N00007312,Sam Farr (D),2014,Labor,0,77000,77000
F000030,N00007312,Sam Farr (D),2014,Ideology/Single-Issue,14900,20850,35750
F000030,N00007312,Sam Farr (D),2014,Other,53051,1000,54051
E000215,N00007335,Anna Eshoo (D),2014,Agribusiness,1000,0,1000
E000215,N00007335,Anna Eshoo (D),2014,Communic/Electronics,94850,252833,347683
E000215,N00007335,Anna Eshoo (D),2014,Construction,11550,1000,12550
E000215,N00007335,Anna Eshoo (D),2014,Defense,0,24500,24500
E000215,N00007335,Anna Eshoo (D),2014,Energy/Nat Resource,6700,29350,36050
E000215,N00007335,Anna Eshoo (D),2014,Finance/Insur/RealEst,124850,85200,210050
E000215,N00007335,Anna Eshoo (D),2014,Health,77050,249909,326959
E000215,N00007335,Anna Eshoo (D),2014,Lawyers & Lobbyists,75125,35000,110125
E000215,N00007335,Anna Eshoo (D),2014,Transportation,5950,19000,24950
E000215,N00007335,Anna Eshoo (D),2014,Misc Business,49552,36000,85552
E000215,N00007335,Anna Eshoo (D),2014,Labor,0,57600,57600
E000215,N00007335,Anna Eshoo (D),2014,Ideology/Single-Issue,29010,11500,40510
E000215,N00007335,Anna Eshoo (D),2014,Other,131700,0,131700
F000062,N00007364,Dianne Feinstein (D),2014,Agribusiness,355733,236333,592066
F000062,N00007364,Dianne Feinstein (D),2014,Communic/Electronics,345791,286189,631980
F000062,N00007364,Dianne Feinstein (D),2014,Construction,108900,77500,186400
F000062,N00007364,Dianne Feinstein (D),2014,Defense,93300,104500,197800
F000062,N00007364,Dianne Feinstein (D),2014,Energy/Nat Resource,265400,185250,450650
F000062,N00007364,Dianne Feinstein (D),2014,Finance/Insur/RealEst,850937,220250,1071187
F000062,N00007364,Dianne Feinstein (D),2014,Health,195292,256500,451792
F000062,N00007364,Dianne Feinstein (D),2014,Lawyers & Lobbyists,752301,158374,910675
F000062,N00007364,Dianne Feinstein (D),2014,Transportation,44550,72000,116550
F000062,N00007364,Dianne Feinstein (D),2014,Misc Business,421036,264000,685036
F000062,N00007364,Dianne Feinstein (D),2014,Labor,2500,228700,231200
F000062,N00007364,Dianne Feinstein (D),2014,Ideology/Single-Issue,399225,225396,624621
F000062,N00007364,Dianne Feinstein (D),2014,Other,671716,2000,673716
F000010,N00007632,Eni F H Faleomavaega (D),2014,Finance/Insur/RealEst,2600,0,2600
F000010,N00007632,Eni F H Faleomavaega (D),2014,Health,3000,0,3000
F000010,N00007632,Eni F H Faleomavaega (D),2014,Lawyers & Lobbyists,3000,1500,4500
F000010,N00007632,Eni F H Faleomavaega (D),2014,Transportation,2500,0,2500
F000010,N00007632,Eni F H Faleomavaega (D),2014,Misc Business,6000,0,6000
F000010,N00007632,Eni F H Faleomavaega (D),2014,Labor,0,5000,5000
F000010,N00007632,Eni F H Faleomavaega (D),2014,Other,3000,0,3000
B000574,N00007727,Earl Blumenauer (D),2014,Agribusiness,3910,15750,19660
B000574,N00007727,Earl Blumenauer (D),2014,Communic/Electronics,11100,20000,31100
B000574,N00007727,Earl Blumenauer (D),2014,Construction,23000,110500,133500
B000574,N00007727,Earl Blumenauer (D),2014,Defense,0,3000,3000
B000574,N00007727,Earl Blumenauer (D),2014,Energy/Nat Resource,6000,20842,26842
B000574,N00007727,Earl Blumenauer (D),2014,Finance/Insur/RealEst,53125,108500,161625
B000574,N00007727,Earl Blumenauer (D),2014,Health,6000,151000,157000
B000574,N00007727,Earl Blumenauer (D),2014,Lawyers & Lobbyists,47191,31606,78797
B000574,N00007727,Earl Blumenauer (D),2014,Transportation,16450,86900,103350
B000574,N00007727,Earl Blumenauer (D),2014,Misc Business,71098,76025,147123
B000574,N00007727,Earl Blumenauer (D),2014,Labor,0,174125,174125
B000574,N00007727,Earl Blumenauer (D),2014,Ideology/Single-Issue,19550,27511,47061
B000574,N00007727,Earl Blumenauer (D),2014,Other,34813,0,34813
D000191,N00007781,Peter DeFazio (D),2014,Agribusiness,19570,25850,45420
D000191,N00007781,Peter DeFazio (D),2014,Communic/Electronics,1050,23000,24050
D000191,N00007781,Peter DeFazio (D),2014,Construction,17650,84000,101650
D000191,N00007781,Peter DeFazio (D),2014,Defense,0,5000,5000
D000191,N00007781,Peter DeFazio (D),2014,Energy/Nat Resource,4750,23000,27750
D000191,N00007781,Peter DeFazio (D),2014,Finance/Insur/RealEst,8100,16000,24100
D000191,N00007781,Peter DeFazio (D),2014,Health,9300,9000,18300
D000191,N00007781,Peter DeFazio (D),2014,Lawyers & Lobbyists,42737,26388,69125
D000191,N00007781,Peter DeFazio (D),2014,Transportation,24300,155750,180050
D000191,N00007781,Peter DeFazio (D),2014,Misc Business,78990,13500,92490
D000191,N00007781,Peter DeFazio (D),2014,Labor,0,207500,207500
D000191,N00007781,Peter DeFazio (D),2014,Ideology/Single-Issue,4000,34240,38240
D000191,N00007781,Peter DeFazio (D),2014,Other,58640,0,58640
C000127,N00007836,Maria Cantwell (D),2014,Agribusiness,79333,7000,86333
C000127,N00007836,Maria Cantwell (D),2014,Communic/Electronics,443846,10512,454358
C000127,N00007836,Maria Cantwell (D),2014,Construction,87173,3000,90173
C000127,N00007836,Maria Cantwell (D),2014,Defense,38975,1500,40475
C000127,N00007836,Maria Cantwell (D),2014,Energy/Nat Resource,318389,14750,333139
C000127,N00007836,Maria Cantwell (D),2014,Finance/Insur/RealEst,817604,13000,830604
C000127,N00007836,Maria Cantwell (D),2014,Health,419159,20250,439409
C000127,N00007836,Maria Cantwell (D),2014,Lawyers & Lobbyists,1340241,10750,1350991
C000127,N00007836,Maria Cantwell (D),2014,Transportation,163491,23000,186491
C000127,N00007836,Maria Cantwell (D),2014,Misc Business,811584,7500,819084
C000127,N00007836,Maria Cantwell (D),2014,Labor,5900,11200,17100
C000127,N00007836,Maria Cantwell (D),2014,Ideology/Single-Issue,432408,67687,500095
C000127,N00007836,Maria Cantwell (D),2014,Other,1019389,0,1019389
C000071,N00008086,Dave Camp (R),2014,Agribusiness,1000,61200,62200
C000071,N00008086,Dave Camp (R),2014,Communic/Electronics,7900,77600,85500
C000071,N00008086,Dave Camp (R),2014,Construction,3000,49500,52500
C000071,N00008086,Dave Camp (R),2014,Defense,0,28000,28000
C000071,N00008086,Dave Camp (R),2014,Energy/Nat Resource,11500,168399,179899
C000071,N00008086,Dave Camp (R),2014,Finance/Insur/RealEst,84650,312560,397210
C000071,N00008086,Dave Camp (R),2014,Health,55950,443000,498950
C000071,N00008086,Dave Camp (R),2014,Lawyers & Lobbyists,101600,32149,133749
C000071,N00008086,Dave Camp (R),2014,Transportation,6000,59500,65500
C000071,N00008086,Dave Camp (R),2014,Misc Business,58650,223000,281650
C000071,N00008086,Dave Camp (R),2014,Labor,0,4500,4500
C000071,N00008086,Dave Camp (R),2014,Ideology/Single-Issue,67725,14400,82125
C000071,N00008086,Dave Camp (R),2014,Other,9100,600,9700
B000013,N00008091,Spencer Bachus (R),2014,Agribusiness,0,2000,2000
B000013,N00008091,Spencer Bachus (R),2014,Communic/Electronics,2500,27000,29500
B000013,N00008091,Spencer Bachus (R),2014,Construction,0,-1000,-1000
B000013,N00008091,Spencer Bachus (R),2014,Defense,0,1000,1000
B000013,N00008091,Spencer Bachus (R),2014,Energy/Nat Resource,0,0,0
B000013,N00008091,Spencer Bachus (R),2014,Finance/Insur/RealEst,5000,133000,138000
B000013,N00008091,Spencer Bachus (R),2014,Health,0,1000,1000
B000013,N00008091,Spencer Bachus (R),2014,Lawyers & Lobbyists,11750,18500,30250
B000013,N00008091,Spencer Bachus (R),2014,Transportation,500,25176,25676
B000013,N00008091,Spencer Bachus (R),2014,Misc Business,2600,21555,24155
B000013,N00008091,Spencer Bachus (R),2014,Labor,0,0,0
B000013,N00008091,Spencer Bachus (R),2014,Ideology/Single-Issue,0,9500,9500
G000377,N00008799,Kay Granger (R),2014,Agribusiness,7200,30314,37514
G000377,N00008799,Kay Granger (R),2014,Communic/Electronics,5550,16000,21550
G000377,N00008799,Kay Granger (R),2014,Construction,32950,16000,48950
G000377,N00008799,Kay Granger (R),2014,Defense,63850,130500,194350
G000377,N00008799,Kay Granger (R),2014,Energy/Nat Resource,74700,33000,107700
G000377,N00008799,Kay Granger (R),2014,Finance/Insur/RealEst,144380,78800,223180
G000377,N00008799,Kay Granger (R),2014,Health,31950,32500,64450
G000377,N00008799,Kay Granger (R),2014,Lawyers & Lobbyists,59793,31500,91293
G000377,N00008799,Kay Granger (R),2014,Transportation,21600,72000,93600
G000377,N00008799,Kay Granger (R),2014,Misc Business,72160,39500,111660
G000377,N00008799,Kay Granger (R),2014,Labor,0,5000,5000
G000377,N00008799,Kay Granger (R),2014,Ideology/Single-Issue,15250,39586,54836
G000377,N00008799,Kay Granger (R),2014,Other,81310,0,81310
G000289,N00009154,Bob Goodlatte (R),2014,Agribusiness,32762,172999,205761
G000289,N00009154,Bob Goodlatte (R),2014,Communic/Electronics,218505,303440,521945
G000289,N00009154,Bob Goodlatte (R),2014,Construction,18790,20000,38790
G000289,N00009154,Bob Goodlatte (R),2014,Defense,0,30500,30500
G000289,N00009154,Bob Goodlatte (R),2014,Energy/Nat Resource,8750,73000,81750
G000289,N00009154,Bob Goodlatte (R),2014,Finance/Insur/RealEst,64150,153600,217750
G000289,N00009154,Bob Goodlatte (R),2014,Health,12200,75850,88050
G000289,N00009154,Bob Goodlatte (R),2014,Lawyers & Lobbyists,158849,62807,221656
G000289,N00009154,Bob Goodlatte (R),2014,Transportation,19200,112000,131200
G000289,N00009154,Bob Goodlatte (R),2014,Misc Business,63900,218667,282567
G000289,N00009154,Bob Goodlatte (R),2014,Labor,0,13000,13000
G000289,N00009154,Bob Goodlatte (R),2014,Ideology/Single-Issue,7450,46253,53703
G000289,N00009154,Bob Goodlatte (R),2014,Other,83850,2000,85850
H000329,N00009157,Doc Hastings (R),2014,Agribusiness,25800,34750,60550
H000329,N00009157,Doc Hastings (R),2014,Communic/Electronics,1500,28000,29500
H000329,N00009157,Doc Hastings (R),2014,Construction,12250,10500,22750
H000329,N00009157,Doc Hastings (R),2014,Defense,0,13000,13000
H000329,N00009157,Doc Hastings (R),2014,Energy/Nat Resource,12850,75350,88200
H000329,N00009157,Doc Hastings (R),2014,Finance/Insur/RealEst,4800,7000,11800
H000329,N00009157,Doc Hastings (R),2014,Health,4700,1000,5700
H000329,N00009157,Doc Hastings (R),2014,Lawyers & Lobbyists,15550,12500,28050
H000329,N00009157,Doc Hastings (R),2014,Transportation,7000,8000,15000
H000329,N00009157,Doc Hastings (R),2014,Misc Business,28700,10000,38700
H000329,N00009157,Doc Hastings (R),2014,Ideology/Single-Issue,3250,3500,6750
H000329,N00009157,Doc Hastings (R),2014,Other,21008,0,21008
F000444,N00009573,Jeff Flake (R),2014,Agribusiness,200377,110500,310877
F000444,N00009573,Jeff Flake (R),2014,Communic/Electronics,106800,117150,223950
F000444,N00009573,Jeff Flake (R),2014,Construction,191200,66500,257700
F000444,N00009573,Jeff Flake (R),2014,Defense,5050,19500,24550
F000444,N00009573,Jeff Flake (R),2014,Energy/Nat Resource,281794,210750,492544
F000444,N00009573,Jeff Flake (R),2014,Finance/Insur/RealEst,991933,170000,1161933
F000444,N00009573,Jeff Flake (R),2014,Health,308332,149000,457332
F000444,N00009573,Jeff Flake (R),2014,Lawyers & Lobbyists,262402,43250,305652
F000444,N00009573,Jeff Flake (R),2014,Transportation,198450,93500,291950
F000444,N00009573,Jeff Flake (R),2014,Misc Business,514410,198500,712910
F000444,N00009573,Jeff Flake (R),2014,Labor,0,3500,3500
F000444,N00009573,Jeff Flake (R),2014,Ideology/Single-Issue,1380037,453646,1833683
F000444,N00009573,Jeff Flake (R),2014,Other,765369,23000,788369
D000598,N00009604,Susan A Davis (D),2014,Agribusiness,9600,16000,25600
D000598,N00009604,Susan A Davis (D),2014,Communic/Electronics,12600,26000,38600
D000598,N00009604,Susan A Davis (D),2014,Construction,0,7500,7500
D000598,N00009604,Susan A Davis (D),2014,Defense,9250,61500,70750
D000598,N00009604,Susan A Davis (D),2014,Energy/Nat Resource,5450,4000,9450
D000598,N00009604,Susan A Davis (D),2014,Finance/Insur/RealEst,25600,26000,51600
D000598,N00009604,Susan A Davis (D),2014,Health,6250,40625,46875
D000598,N00009604,Susan A Davis (D),2014,Lawyers & Lobbyists,9450,10500,19950
D000598,N00009604,Susan A Davis (D),2014,Transportation,500,5000,5500
D000598,N00009604,Susan A Davis (D),2014,Misc Business,32500,12500,45000
D000598,N00009604,Susan A Davis (D),2014,Labor,0,61350,61350
D000598,N00009604,Susan A Davis (D),2014,Ideology/Single-Issue,21950,10199,32149
D000598,N00009604,Susan A Davis (D),2014,Other,51000,5000,56000
C001048,N00009738,John Culberson (R),2014,Agribusiness,2850,8814,11664
C001048,N00009738,John Culberson (R),2014,Communic/Electronics,17600,13500,31100
C001048,N00009738,John Culberson (R),2014,Construction,16650,18500,35150
C001048,N00009738,John Culberson (R),2014,Defense,0,50500,50500
C001048,N00009738,John Culberson (R),2014,Energy/Nat Resource,26050,67500,93550
C001048,N00009738,John Culberson (R),2014,Finance/Insur/RealEst,64750,50000,114750
C001048,N00009738,John Culberson (R),2014,Health,10400,8500,18900
C001048,N00009738,John Culberson (R),2014,Lawyers & Lobbyists,25300,6750,32050
C001048,N00009738,John Culberson (R),2014,Transportation,14750,43998,58748
C001048,N00009738,John Culberson (R),2014,Misc Business,40500,36000,76500
C001048,N00009738,John Culberson (R),2014,Labor,0,10500,10500
C001048,N00009738,John Culberson (R),2014,Ideology/Single-Issue,750,4000,4750
C001048,N00009738,John Culberson (R),2014,Other,71500,0,71500
C001047,N00009771,Shelley Moore Capito (R),2014,Agribusiness,53450,123500,176950
C001047,N00009771,Shelley Moore Capito (R),2014,Communic/Electronics,61950,65500,127450
C001047,N00009771,Shelley Moore Capito (R),2014,Construction,222333,113500,335833
C001047,N00009771,Shelley Moore Capito (R),2014,Defense,3050,3500,6550
C001047,N00009771,Shelley Moore Capito (R),2014,Energy/Nat Resource,427840,302875,730715
C001047,N00009771,Shelley Moore Capito (R),2014,Finance/Insur/RealEst,839156,540700,1379856
C001047,N00009771,Shelley Moore Capito (R),2014,Health,192557,207850,400407
C001047,N00009771,Shelley Moore Capito (R),2014,Lawyers & Lobbyists,388224,50013,438237
C001047,N00009771,Shelley Moore Capito (R),2014,Transportation,79000,168999,247999
C001047,N00009771,Shelley Moore Capito (R),2014,Misc Business,288899,271450,560349
C001047,N00009771,Shelley Moore Capito (R),2014,Labor,0,79500,79500
C001047,N00009771,Shelley Moore Capito (R),2014,Ideology/Single-Issue,105575,427750,533325
C001047,N00009771,Shelley Moore Capito (R),2014,Other,495819,20500,516319
B000287,N00009774,Xavier Becerra (D),2014,Agribusiness,500,27000,27500
B000287,N00009774,Xavier Becerra (D),2014,Communic/Electronics,40131,100590,140721
B000287,N00009774,Xavier Becerra (D),2014,Construction,32304,17000,49304
B000287,N00009774,Xavier Becerra (D),2014,Defense,0,40000,40000
B000287,N00009774,Xavier Becerra (D),2014,Energy/Nat Resource,0,35750,35750
B000287,N00009774,Xavier Becerra (D),2014,Finance/Insur/RealEst,109549,319700,429249
B000287,N00009774,Xavier Becerra (D),2014,Health,48900,277000,325900
B000287,N00009774,Xavier Becerra (D),2014,Lawyers & Lobbyists,99833,43500,143333
B000287,N00009774,Xavier Becerra (D),2014,Transportation,2310,54500,56810
B000287,N00009774,Xavier Becerra (D),2014,Misc Business,78400,106600,185000
B000287,N00009774,Xavier Becerra (D),2014,Labor,0,155000,155000
B000287,N00009774,Xavier Becerra (D),2014,Ideology/Single-Issue,50250,13500,63750
B000287,N00009774,Xavier Becerra (D),2014,Other,24950,750,25700
H000338,N00009869,Orrin G Hatch (R),2014,Agribusiness,51683,169500,221183
H000338,N00009869,Orrin G Hatch (R),2014,Communic/Electronics,287081,341631,628712
H000338,N00009869,Orrin G Hatch (R),2014,Construction,103286,129250,232536
H000338,N00009869,Orrin G Hatch (R),2014,Defense,12250,98500,110750
H000338,N00009869,Orrin G Hatch (R),2014,Energy/Nat Resource,255368,470600,725968
H000338,N00009869,Orrin G Hatch (R),2014,Finance/Insur/RealEst,1819797,968145,2787942
H000338,N00009869,Orrin G Hatch (R),2014,Health,721157,1392641,2113798
H000338,N00009869,Orrin G Hatch (R),2014,Lawyers & Lobbyists,755632,236285,991917
H000338,N00009869,Orrin G Hatch (R),2014,Transportation,47466,170100,217566
H000338,N00009869,Orrin G Hatch (R),2014,Misc Business,630309,566545,1196854
H000338,N00009869,Orrin G Hatch (R),2014,Labor,0,34500,34500
H000338,N00009869,Orrin G Hatch (R),2014,Ideology/Single-Issue,145800,442878,588678
H000338,N00009869,Orrin G Hatch (R),2014,Other,237490,13500,250990
A000360,N00009888,Lamar Alexander (R),2014,Agribusiness,102250,153436,255686
A000360,N00009888,Lamar Alexander (R),2014,Communic/Electronics,94300,122000,216300
A000360,N00009888,Lamar Alexander (R),2014,Construction,186067,87950,274017
A000360,N00009888,Lamar Alexander (R),2014,Defense,14450,107500,121950
A000360,N00009888,Lamar Alexander (R),2014,Energy/Nat Resource,149260,304683,453943
A000360,N00009888,Lamar Alexander (R),2014,Finance/Insur/RealEst,602450,422500,1024950
A000360,N00009888,Lamar Alexander (R),2014,Health,256200,657467,913667
A000360,N00009888,Lamar Alexander (R),2014,Lawyers & Lobbyists,250882,116988,367870
A000360,N00009888,Lamar Alexander (R),2014,Transportation,77083,180000,257083
A000360,N00009888,Lamar Alexander (R),2014,Misc Business,326660,365728,692388
A000360,N00009888,Lamar Alexander (R),2014,Labor,0,10000,10000
A000360,N00009888,Lamar Alexander (R),2014,Ideology/Single-Issue,60600,358515,419115
A000360,N00009888,Lamar Alexander (R),2014,Other,412653,64400,477053
G000359,N00009975,Lindsey Graham (R),2014,Agribusiness,177142,151787,328929
G000359,N00009975,Lindsey Graham (R),2014,Communic/Electronics,175262,189376,364638
G000359,N00009975,Lindsey Graham (R),2014,Construction,280885,93850,374735
G000359,N00009975,Lindsey Graham (R),2014,Defense,69293,177000,246293
G000359,N00009975,Lindsey Graham (R),2014,Energy/Nat Resource,341213,232750,573963
G000359,N00009975,Lindsey Graham (R),2014,Finance/Insur/RealEst,1797654,269932,2067586
G000359,N00009975,Lindsey Graham (R),2014,Health,364092,120250,484342
G000359,N00009975,Lindsey Graham (R),2014,Lawyers & Lobbyists,1161063,97750,1258813
G000359,N00009975,Lindsey Graham (R),2014,Transportation,188800,166800,355600
G000359,N00009975,Lindsey Graham (R),2014,Misc Business,767336,300700,1068036
G000359,N00009975,Lindsey Graham (R),2014,Labor,0,17500,17500
G000359,N00009975,Lindsey Graham (R),2014,Ideology/Single-Issue,327888,407891,735779
G000359,N00009975,Lindsey Graham (R),2014,Other,776293,4000,780293
C001049,N00012460,William L Clay Jr (D),2014,Agribusiness,850,12500,13350
C001049,N00012460,William L Clay Jr (D),2014,Communic/Electronics,1740,24750,26490
C001049,N00012460,William L Clay Jr (D),2014,Construction,500,4000,4500
C001049,N00012460,William L Clay Jr (D),2014,Defense,0,17500,17500
C001049,N00012460,William L Clay Jr (D),2014,Energy/Nat Resource,1000,11000,12000
C001049,N00012460,William L Clay Jr (D),2014,Finance/Insur/RealEst,4000,126500,130500
C001049,N00012460,William L Clay Jr (D),2014,Health,8250,38000,46250
C001049,N00012460,William L Clay Jr (D),2014,Lawyers & Lobbyists,17055,21000,38055
C001049,N00012460,William L Clay Jr (D),2014,Transportation,600,37325,37925
C001049,N00012460,William L Clay Jr (D),2014,Misc Business,8000,39000,47000
C001049,N00012460,William L Clay Jr (D),2014,Labor,0,135000,135000
C001049,N00012460,William L Clay Jr (D),2014,Ideology/Single-Issue,0,15932,15932
C001049,N00012460,William L Clay Jr (D),2014,Other,9550,0,9550
C000174,N00012508,Tom Carper (D),2014,Agribusiness,20285,71000,91285
C000174,N00012508,Tom Carper (D),2014,Communic/Electronics,69016,192444,261460
C000174,N00012508,Tom Carper (D),2014,Construction,23760,65640,89400
C000174,N00012508,Tom Carper (D),2014,Defense,1800,68160,69960
C000174,N00012508,Tom Carper (D),2014,Energy/Nat Resource,30250,169280,199530
C000174,N00012508,Tom Carper (D),2014,Finance/Insur/RealEst,475520,831860,1307380
C000174,N00012508,Tom Carper (D),2014,Health,108917,486250,595167
C000174,N00012508,Tom Carper (D),2014,Lawyers & Lobbyists,397907,133841,531748
C000174,N00012508,Tom Carper (D),2014,Transportation,11070,77410,88480
C000174,N00012508,Tom Carper (D),2014,Misc Business,187485,372050,559535
C000174,N00012508,Tom Carper (D),2014,Labor,0,171440,171440
C000174,N00012508,Tom Carper (D),2014,Ideology/Single-Issue,53900,238299,292199
C000174,N00012508,Tom Carper (D),2014,Other,190770,13500,204270
H001034,N00012611,Mike Honda (D),2014,Agribusiness,28083,11000,39083
H001034,N00012611,Mike Honda (D),2014,Communic/Electronics,112880,60340,173220
H001034,N00012611,Mike Honda (D),2014,Construction,18350,18949,37299
H001034,N00012611,Mike Honda (D),2014,Defense,6300,19750,26050
H001034,N00012611,Mike Honda (D),2014,Energy/Nat Resource,23100,8250,31350
H001034,N00012611,Mike Honda (D),2014,Finance/Insur/RealEst,237829,18000,255829
H001034,N00012611,Mike Honda (D),2014,Health,100190,94350,194540
H001034,N00012611,Mike Honda (D),2014,Lawyers & Lobbyists,192879,15500,208379
H001034,N00012611,Mike Honda (D),2014,Transportation,11375,12500,23875
H001034,N00012611,Mike Honda (D),2014,Misc Business,197554,25500,223054
H001034,N00012611,Mike Honda (D),2014,Labor,1500,257340,258840
H001034,N00012611,Mike Honda (D),2014,Ideology/Single-Issue,122701,296520,419221
H001034,N00012611,Mike Honda (D),2014,Other,400622,7000,407622
C001045,N00012739,Ander Crenshaw (R),2014,Agribusiness,4750,33000,37750
C001045,N00012739,Ander Crenshaw (R),2014,Communic/Electronics,12700,50000,62700
C001045,N00012739,Ander Crenshaw (R),2014,Construction,16500,31000,47500
C001045,N00012739,Ander Crenshaw (R),2014,Defense,56900,152918,209818
C001045,N00012739,Ander Crenshaw (R),2014,Energy/Nat Resource,14750,28500,43250
C001045,N00012739,Ander Crenshaw (R),2014,Finance/Insur/RealEst,60400,214500,274900
C001045,N00012739,Ander Crenshaw (R),2014,Health,13950,21250,35200
C001045,N00012739,Ander Crenshaw (R),2014,Lawyers & Lobbyists,64600,34320,98920
C001045,N00012739,Ander Crenshaw (R),2014,Transportation,45682,53500,99182
C001045,N00012739,Ander Crenshaw (R),2014,Misc Business,21500,81100,102600
C001045,N00012739,Ander Crenshaw (R),2014,Labor,0,3000,3000
C001045,N00012739,Ander Crenshaw (R),2014,Ideology/Single-Issue,1500,48000,49500
C001045,N00012739,Ander Crenshaw (R),2014,Other,57750,1000,58750
C001046,N00013131,Eric Cantor (R),2014,Agribusiness,56920,109375,166295
C001046,N00013131,Eric Cantor (R),2014,Communic/Electronics,99417,161750,261167
C001046,N00013131,Eric Cantor (R),2014,Construction,54499,61250,115749
C001046,N00013131,Eric Cantor (R),2014,Defense,11380,58400,69780
C001046,N00013131,Eric Cantor (R),2014,Energy/Nat Resource,58348,210575,268923
C001046,N00013131,Eric Cantor (R),2014,Finance/Insur/RealEst,1129116,446972,1576088
C001046,N00013131,Eric Cantor (R),2014,Health,199394,313980,513374
C001046,N00013131,Eric Cantor (R),2014,Lawyers & Lobbyists,321756,61750,383506
C001046,N00013131,Eric Cantor (R),2014,Transportation,87283,128425,215708
C001046,N00013131,Eric Cantor (R),2014,Misc Business,293320,258335,551655
C001046,N00013131,Eric Cantor (R),2014,Labor,0,11750,11750
C001046,N00013131,Eric Cantor (R),2014,Ideology/Single-Issue,207373,372849,580222
C001046,N00013131,Eric Cantor (R),2014,Other,270379,3500,273879
G000546,N00013323,Sam Graves (R),2014,Agribusiness,11250,126901,138151
G000546,N00013323,Sam Graves (R),2014,Communic/Electronics,6350,72750,79100
G000546,N00013323,Sam Graves (R),2014,Construction,18400,102500,120900
G000546,N00013323,Sam Graves (R),2014,Defense,0,17500,17500
G000546,N00013323,Sam Graves (R),2014,Energy/Nat Resource,0,54750,54750
G000546,N00013323,Sam Graves (R),2014,Finance/Insur/RealEst,8049,106000,114049
G000546,N00013323,Sam Graves (R),2014,Health,2150,83000,85150
G000546,N00013323,Sam Graves (R),2014,Lawyers & Lobbyists,14750,15000,29750
G000546,N00013323,Sam Graves (R),2014,Transportation,16950,253250,270200
G000546,N00013323,Sam Graves (R),2014,Misc Business,17200,132750,149950
G000546,N00013323,Sam Graves (R),2014,Labor,0,96500,96500
G000546,N00013323,Sam Graves (R),2014,Ideology/Single-Issue,750,20500,21250
G000546,N00013323,Sam Graves (R),2014,Other,7100,3000,10100
F000445,N00013799,Randy Forbes (R),2014,Agribusiness,18700,28000,46700
F000445,N00013799,Randy Forbes (R),2014,Communic/Electronics,18900,40680,59580
F000445,N00013799,Randy Forbes (R),2014,Construction,56864,19000,75864
F000445,N00013799,Randy Forbes (R),2014,Defense,50706,152500,203206
F000445,N00013799,Randy Forbes (R),2014,Energy/Nat Resource,20600,18000,38600
F000445,N00013799,Randy Forbes (R),2014,Finance/Insur/RealEst,122147,54500,176647
F000445,N00013799,Randy Forbes (R),2014,Health,32421,17650,50071
F000445,N00013799,Randy Forbes (R),2014,Lawyers & Lobbyists,69242,3000,72242
F000445,N00013799,Randy Forbes (R),2014,Transportation,35900,43000,78900
F000445,N00013799,Randy Forbes (R),2014,Misc Business,48900,38000,86900
F000445,N00013799,Randy Forbes (R),2014,Labor,0,21500,21500
F000445,N00013799,Randy Forbes (R),2014,Ideology/Single-Issue,4098,21000,25098
F000445,N00013799,Randy Forbes (R),2014,Other,96820,2500,99320
B001236,N00013873,John Boozman (R),2014,Agribusiness,135319,98200,233519
B001236,N00013873,John Boozman (R),2014,Communic/Electronics,26196,47750,73946
B001236,N00013873,John Boozman (R),2014,Construction,104800,83000,187800
B001236,N00013873,John Boozman (R),2014,Defense,1250,10500,11750
B001236,N00013873,John Boozman (R),2014,Energy/Nat Resource,126150,67500,193650
B001236,N00013873,John Boozman (R),2014,Finance/Insur/RealEst,489874,114000,603874
B001236,N00013873,John Boozman (R),2014,Health,251014,106500,357514
B001236,N00013873,John Boozman (R),2014,Lawyers & Lobbyists,150984,27716,178700
B001236,N00013873,John Boozman (R),2014,Transportation,63795,135400,199195
B001236,N00013873,John Boozman (R),2014,Misc Business,301326,94800,396126
B001236,N00013873,John Boozman (R),2014,Labor,0,14000,14000
B001236,N00013873,John Boozman (R),2014,Ideology/Single-Issue,91748,288021,379769
B001236,N00013873,John Boozman (R),2014,Other,404554,7500,412054
C001077,N00024753,Mike Coffman (R),2014,Agribusiness,50198,27000,77198
C001077,N00024753,Mike Coffman (R),2014,Communic/Electronics,90825,57612,148437
C001077,N00024753,Mike Coffman (R),2014,Construction,65488,59000,124488
C001077,N00024753,Mike Coffman (R),2014,Defense,5300,93000,98300
C001077,N00024753,Mike Coffman (R),2014,Energy/Nat Resource,321886,145100,466986
C001077,N00024753,Mike Coffman (R),2014,Finance/Insur/RealEst,535568,161250,696818
C001077,N00024753,Mike Coffman (R),2014,Health,74250,104500,178750
C001077,N00024753,Mike Coffman (R),2014,Lawyers & Lobbyists,141611,16180,157791
C001077,N00024753,Mike Coffman (R),2014,Transportation,82509,44000,126509
C001077,N00024753,Mike Coffman (R),2014,Misc Business,170705,103600,274305
C001077,N00024753,Mike Coffman (R),2014,Labor,0,5000,5000
C001077,N00024753,Mike Coffman (R),2014,Ideology/Single-Issue,100918,539611,640529
C001077,N00024753,Mike Coffman (R),2014,Other,573219,5000,578219
G000550,N00024760,Phil Gingrey (R),2014,Agribusiness,15650,4500,20150
G000550,N00024760,Phil Gingrey (R),2014,Communic/Electronics,20428,29000,49428
G000550,N00024760,Phil Gingrey (R),2014,Construction,61402,1000,62402
G000550,N00024760,Phil Gingrey (R),2014,Defense,6850,12500,19350
G000550,N00024760,Phil Gingrey (R),2014,Energy/Nat Resource,16050,15000,31050
G000550,N00024760,Phil Gingrey (R),2014,Finance/Insur/RealEst,186883,21390,208273
G000550,N00024760,Phil Gingrey (R),2014,Health,394060,147700,541760
G000550,N00024760,Phil Gingrey (R),2014,Lawyers & Lobbyists,90574,5000,95574
G000550,N00024760,Phil Gingrey (R),2014,Transportation,41050,9500,50550
G000550,N00024760,Phil Gingrey (R),2014,Misc Business,110457,28050,138507
G000550,N00024760,Phil Gingrey (R),2014,Ideology/Single-Issue,2600,16000,18600
G000550,N00024760,Phil Gingrey (R),2014,Other,191674,2000,193674
C001069,N00024842,Joe Courtney (D),2014,Agribusiness,8150,61250,69400
C001069,N00024842,Joe Courtney (D),2014,Communic/Electronics,5000,18000,23000
C001069,N00024842,Joe Courtney (D),2014,Construction,5500,17500,23000
C001069,N00024842,Joe Courtney (D),2014,Defense,28150,124500,152650
C001069,N00024842,Joe Courtney (D),2014,Energy/Nat Resource,2250,23500,25750
C001069,N00024842,Joe Courtney (D),2014,Finance/Insur/RealEst,47500,106500,154000
C001069,N00024842,Joe Courtney (D),2014,Health,24762,121500,146262
C001069,N00024842,Joe Courtney (D),2014,Lawyers & Lobbyists,91587,15500,107087
C001069,N00024842,Joe Courtney (D),2014,Transportation,7200,20000,27200
C001069,N00024842,Joe Courtney (D),2014,Misc Business,43225,33500,76725
C001069,N00024842,Joe Courtney (D),2014,Labor,0,236000,236000
C001069,N00024842,Joe Courtney (D),2014,Ideology/Single-Issue,11655,17500,29155
C001069,N00024842,Joe Courtney (D),2014,Other,68850,500,69350
C001056,N00024852,John Cornyn (R),2014,Agribusiness,350209,200639,550848
C001056,N00024852,John Cornyn (R),2014,Communic/Electronics,296698,310593,607291
C001056,N00024852,John Cornyn (R),2014,Construction,424975,154650,579625
C001056,N00024852,John Cornyn (R),2014,Defense,38850,143000,181850
C001056,N00024852,John Cornyn (R),2014,Energy/Nat Resource,1273181,449400,1722581
C001056,N00024852,John Cornyn (R),2014,Finance/Insur/RealEst,2483482,750464,3233946
C001056,N00024852,John Cornyn (R),2014,Health,938164,722496,1660660
C001056,N00024852,John Cornyn (R),2014,Lawyers & Lobbyists,831440,179800,1011240
C001056,N00024852,John Cornyn (R),2014,Transportation,229695,249400,479095
C001056,N00024852,John Cornyn (R),2014,Misc Business,927357,513625,1440982
C001056,N00024852,John Cornyn (R),2014,Labor,0,11000,11000
C001056,N00024852,John Cornyn (R),2014,Ideology/Single-Issue,317124,421441,738565
C001056,N00024852,John Cornyn (R),2014,Other,869992,3500,873492
B001245,N00024866,Madeleine Z Bordallo (D),2014,Agribusiness,9400,0,9400
B001245,N00024866,Madeleine Z Bordallo (D),2014,Defense,2500,14000,16500
B001245,N00024866,Madeleine Z Bordallo (D),2014,Finance/Insur/RealEst,11550,2000,13550
B001245,N00024866,Madeleine Z Bordallo (D),2014,Lawyers & Lobbyists,9450,500,9950
B001245,N00024866,Madeleine Z Bordallo (D),2014,Transportation,1800,6000,7800
B001245,N00024866,Madeleine Z Bordallo (D),2014,Misc Business,15090,0,15090
B001245,N00024866,Madeleine Z Bordallo (D),2014,Ideology/Single-Issue,0,6000,6000
B001245,N00024866,Madeleine Z Bordallo (D),2014,Other,4540,0,4540
H001036,N00024922,Jeb Hensarling (R),2014,Agribusiness,18700,19000,37700
H001036,N00024922,Jeb Hensarling (R),2014,Communic/Electronics,14400,55000,69400
H001036,N00024922,Jeb Hensarling (R),2014,Construction,58250,22000,80250
H001036,N00024922,Jeb Hensarling (R),2014,Defense,500,30500,31000
H001036,N00024922,Jeb Hensarling (R),2014,Energy/Nat Resource,43400,65000,108400
H001036,N00024922,Jeb Hensarling (R),2014,Finance/Insur/RealEst,577787,1052649,1630436
H001036,N00024922,Jeb Hensarling (R),2014,Health,45153,37100,82253
H001036,N00024922,Jeb Hensarling (R),2014,Lawyers & Lobbyists,115799,58000,173799
H001036,N00024922,Jeb Hensarling (R),2014,Transportation,41000,45000,86000
H001036,N00024922,Jeb Hensarling (R),2014,Misc Business,100750,100500,201250
H001036,N00024922,Jeb Hensarling (R),2014,Labor,0,6000,6000
H001036,N00024922,Jeb Hensarling (R),2014,Ideology/Single-Issue,15300,14109,29409
H001036,N00024922,Jeb Hensarling (R),2014,Other,109980,1000,110980
C001063,N00024978,Henry Cuellar (D),2014,Agribusiness,25900,105164,131064
C001063,N00024978,Henry Cuellar (D),2014,Communic/Electronics,15950,37500,53450
C001063,N00024978,Henry Cuellar (D),2014,Construction,45250,48500,93750
C001063,N00024978,Henry Cuellar (D),2014,Defense,1250,60500,61750
C001063,N00024978,Henry Cuellar (D),2014,Energy/Nat Resource,45450,128500,173950
C001063,N00024978,Henry Cuellar (D),2014,Finance/Insur/RealEst,60750,75000,135750
C001063,N00024978,Henry Cuellar (D),2014,Health,40050,59000,99050
C001063,N00024978,Henry Cuellar (D),2014,Lawyers & Lobbyists,56825,18625,75450
C001063,N00024978,Henry Cuellar (D),2014,Transportation,15700,69500,85200
C001063,N00024978,Henry Cuellar (D),2014,Misc Business,101283,100000,201283
C001063,N00024978,Henry Cuellar (D),2014,Labor,0,50500,50500
C001063,N00024978,Henry Cuellar (D),2014,Ideology/Single-Issue,3600,21500,25100
C001063,N00024978,Henry Cuellar (D),2014,Other,41700,3750,45450
G000549,N00025025,Jim Gerlach (R),2014,Agribusiness,9950,7000,16950
G000549,N00025025,Jim Gerlach (R),2014,Communic/Electronics,11600,29000,40600
G000549,N00025025,Jim Gerlach (R),2014,Construction,15500,25000,40500
G000549,N00025025,Jim Gerlach (R),2014,Defense,0,13000,13000
G000549,N00025025,Jim Gerlach (R),2014,Energy/Nat Resource,7350,57250,64600
G000549,N00025025,Jim Gerlach (R),2014,Finance/Insur/RealEst,71999,174000,245999
G000549,N00025025,Jim Gerlach (R),2014,Health,22400,195974,218374
G000549,N00025025,Jim Gerlach (R),2014,Lawyers & Lobbyists,42741,24700,67441
G000549,N00025025,Jim Gerlach (R),2014,Transportation,9400,24000,33400
G000549,N00025025,Jim Gerlach (R),2014,Misc Business,35300,64499,99799
G000549,N00025025,Jim Gerlach (R),2014,Labor,0,17500,17500
G000549,N00025025,Jim Gerlach (R),2014,Ideology/Single-Issue,8600,21437,30037
G000549,N00025025,Jim Gerlach (R),2014,Other,38900,2000,40900
C001051,N00025095,John Carter (R),2014,Agribusiness,18050,45314,63364
C001051,N00025095,John Carter (R),2014,Communic/Electronics,500,45000,45500
C001051,N00025095,John Carter (R),2014,Construction,44900,42500,87400
C001051,N00025095,John Carter (R),2014,Defense,500,97500,98000
C001051,N00025095,John Carter (R),2014,Energy/Nat Resource,14700,53649,68349
C001051,N00025095,John Carter (R),2014,Finance/Insur/RealEst,74450,46000,120450
C001051,N00025095,John Carter (R),2014,Health,36315,14500,50815
C001051,N00025095,John Carter (R),2014,Lawyers & Lobbyists,64300,14250,78550
C001051,N00025095,John Carter (R),2014,Transportation,33750,73500,107250
C001051,N00025095,John Carter (R),2014,Misc Business,49100,46872,95972
C001051,N00025095,John Carter (R),2014,Labor,0,6000,6000
C001051,N00025095,John Carter (R),2014,Ideology/Single-Issue,0,25100,25100
C001051,N00025095,John Carter (R),2014,Other,43400,0,43400
B001248,N00025219,Michael Burgess (R),2014,Agribusiness,1250,7000,8250
B001248,N00025219,Michael Burgess (R),2014,Communic/Electronics,1750,44500,46250
B001248,N00025219,Michael Burgess (R),2014,Construction,10800,6000,16800
B001248,N00025219,Michael Burgess (R),2014,Defense,250,25000,25250
B001248,N00025219,Michael Burgess (R),2014,Energy/Nat Resource,1650,99000,100650
B001248,N00025219,Michael Burgess (R),2014,Finance/Insur/RealEst,18400,78600,97000
B001248,N00025219,Michael Burgess (R),2014,Health,68696,538643,607339
B001248,N00025219,Michael Burgess (R),2014,Lawyers & Lobbyists,30375,27000,57375
B001248,N00025219,Michael Burgess (R),2014,Transportation,2000,32000,34000
B001248,N00025219,Michael Burgess (R),2014,Misc Business,22000,28555,50555
B001248,N00025219,Michael Burgess (R),2014,Labor,0,1000,1000
B001248,N00025219,Michael Burgess (R),2014,Ideology/Single-Issue,7006,18500,25506
B001248,N00025219,Michael Burgess (R),2014,Other,31100,0,31100
G000551,N00025284,Raul M Grijalva (D),2014,Agribusiness,11650,11000,22650
G000551,N00025284,Raul M Grijalva (D),2014,Communic/Electronics,1950,13500,15450
G000551,N00025284,Raul M Grijalva (D),2014,Construction,1000,4000,5000
G000551,N00025284,Raul M Grijalva (D),2014,Defense,0,-2000,-2000
G000551,N00025284,Raul M Grijalva (D),2014,Energy/Nat Resource,300,10500,10800
G000551,N00025284,Raul M Grijalva (D),2014,Finance/Insur/RealEst,12750,28500,41250
G000551,N00025284,Raul M Grijalva (D),2014,Health,4000,19000,23000
G000551,N00025284,Raul M Grijalva (D),2014,Lawyers & Lobbyists,38092,6000,44092
G000551,N00025284,Raul M Grijalva (D),2014,Transportation,250,3000,3250
G000551,N00025284,Raul M Grijalva (D),2014,Misc Business,47714,12500,60214
G000551,N00025284,Raul M Grijalva (D),2014,Labor,0,147250,147250
G000551,N00025284,Raul M Grijalva (D),2014,Ideology/Single-Issue,12500,30301,42801
G000551,N00025284,Raul M Grijalva (D),2014,Other,29591,1500,31091
B001250,N00025292,Rob Bishop (R),2014,Agribusiness,4099,22500,26599
B001250,N00025292,Rob Bishop (R),2014,Communic/Electronics,500,6500,7000
B001250,N00025292,Rob Bishop (R),2014,Construction,2000,13000,15000
B001250,N00025292,Rob Bishop (R),2014,Defense,0,91000,91000
B001250,N00025292,Rob Bishop (R),2014,Energy/Nat Resource,19399,131100,150499
B001250,N00025292,Rob Bishop (R),2014,Finance/Insur/RealEst,13350,22500,35850
B001250,N00025292,Rob Bishop (R),2014,Health,1000,17500,18500
B001250,N00025292,Rob Bishop (R),2014,Lawyers & Lobbyists,32298,11250,43548
B001250,N00025292,Rob Bishop (R),2014,Transportation,1000,20500,21500
B001250,N00025292,Rob Bishop (R),2014,Misc Business,44600,12500,57100
B001250,N00025292,Rob Bishop (R),2014,Labor,0,10000,10000
B001250,N00025292,Rob Bishop (R),2014,Ideology/Single-Issue,2750,27600,30350
B001250,N00025292,Rob Bishop (R),2014,Other,1000,0,1000
B001244,N00025330,Jo Bonner (R),2014,Agribusiness,1500,6500,8000
B001244,N00025330,Jo Bonner (R),2014,Communic/Electronics,0,2000,2000
B001244,N00025330,Jo Bonner (R),2014,Construction,4250,1000,5250
B001244,N00025330,Jo Bonner (R),2014,Defense,0,13000,13000
B001244,N00025330,Jo Bonner (R),2014,Energy/Nat Resource,0,3000,3000
B001244,N00025330,Jo Bonner (R),2014,Finance/Insur/RealEst,4250,2000,6250
B001244,N00025330,Jo Bonner (R),2014,Health,750,1000,1750
B001244,N00025330,Jo Bonner (R),2014,Lawyers & Lobbyists,4650,4000,8650
B001244,N00025330,Jo Bonner (R),2014,Transportation,0,7000,7000
B001244,N00025330,Jo Bonner (R),2014,Misc Business,4750,5500,10250
B001244,N00025330,Jo Bonner (R),2014,Ideology/Single-Issue,0,3000,3000
B001244,N00025330,Jo Bonner (R),2014,Other,12250,0,12250
D000600,N00025337,Mario Diaz-Balart (R),2014,Agribusiness,22823,38159,60982
D000600,N00025337,Mario Diaz-Balart (R),2014,Communic/Electronics,5350,40000,45350
D000600,N00025337,Mario Diaz-Balart (R),2014,Construction,18600,38500,57100
D000600,N00025337,Mario Diaz-Balart (R),2014,Defense,0,52500,52500
D000600,N00025337,Mario Diaz-Balart (R),2014,Energy/Nat Resource,6500,13500,20000
D000600,N00025337,Mario Diaz-Balart (R),2014,Finance/Insur/RealEst,57723,69000,126723
D000600,N00025337,Mario Diaz-Balart (R),2014,Health,21750,17500,39250
D000600,N00025337,Mario Diaz-Balart (R),2014,Lawyers & Lobbyists,57250,7250,64500
D000600,N00025337,Mario Diaz-Balart (R),2014,Transportation,18200,57000,75200
D000600,N00025337,Mario Diaz-Balart (R),2014,Misc Business,35196,85000,120196
D000600,N00025337,Mario Diaz-Balart (R),2014,Labor,0,107000,107000
D000600,N00025337,Mario Diaz-Balart (R),2014,Ideology/Single-Issue,27950,52832,80782
D000600,N00025337,Mario Diaz-Balart (R),2014,Other,3550,0,3550
B001242,N00025413,Timothy H Bishop (D),2014,Agribusiness,3800,17750,21550
B001242,N00025413,Timothy H Bishop (D),2014,Communic/Electronics,59500,40640,100140
B001242,N00025413,Timothy H Bishop (D),2014,Construction,25650,56000,81650
B001242,N00025413,Timothy H Bishop (D),2014,Defense,0,5000,5000
B001242,N00025413,Timothy H Bishop (D),2014,Energy/Nat Resource,17700,15498,33198
B001242,N00025413,Timothy H Bishop (D),2014,Finance/Insur/RealEst,161049,114050,275099
B001242,N00025413,Timothy H Bishop (D),2014,Health,50750,111750,162500
B001242,N00025413,Timothy H Bishop (D),2014,Lawyers & Lobbyists,86760,25250,112010
B001242,N00025413,Timothy H Bishop (D),2014,Transportation,12800,82998,95798
B001242,N00025413,Timothy H Bishop (D),2014,Misc Business,101800,15093,116893
B001242,N00025413,Timothy H Bishop (D),2014,Labor,1950,362000,363950
B001242,N00025413,Timothy H Bishop (D),2014,Ideology/Single-Issue,78208,379546,457754
B001242,N00025413,Timothy H Bishop (D),2014,Other,257140,12500,269640
A000361,N00025464,Rodney Alexander (R),2014,Agribusiness,16799,0,16799
A000361,N00025464,Rodney Alexander (R),2014,Communic/Electronics,2000,4500,6500
A000361,N00025464,Rodney Alexander (R),2014,Construction,25850,2500,28350
A000361,N00025464,Rodney Alexander (R),2014,Defense,0,5000,5000
A000361,N00025464,Rodney Alexander (R),2014,Energy/Nat Resource,13500,10500,24000
A000361,N00025464,Rodney Alexander (R),2014,Finance/Insur/RealEst,24400,6500,30900
A000361,N00025464,Rodney Alexander (R),2014,Health,13500,4500,18000
A000361,N00025464,Rodney Alexander (R),2014,Lawyers & Lobbyists,14860,2500,17360
A000361,N00025464,Rodney Alexander (R),2014,Transportation,18350,6000,24350
A000361,N00025464,Rodney Alexander (R),2014,Misc Business,8900,1000,9900
A000361,N00025464,Rodney Alexander (R),2014,Labor,0,5000,5000
A000361,N00025464,Rodney Alexander (R),2014,Ideology/Single-Issue,0,-5000,-5000
A000361,N00025464,Rodney Alexander (R),2014,Other,10750,0,10750
B001269,N00025495,Lou Barletta (R),2014,Agribusiness,2700,9593,12293
B001269,N00025495,Lou Barletta (R),2014,Communic/Electronics,6200,27000,33200
B001269,N00025495,Lou Barletta (R),2014,Construction,42675,80250,122925
B001269,N00025495,Lou Barletta (R),2014,Defense,250,1000,1250
B001269,N00025495,Lou Barletta (R),2014,Energy/Nat Resource,3200,56500,59700
B001269,N00025495,Lou Barletta (R),2014,Finance/Insur/RealEst,107438,35875,143313
B001269,N00025495,Lou Barletta (R),2014,Health,22247,27100,49347
B001269,N00025495,Lou Barletta (R),2014,Lawyers & Lobbyists,47171,8250,55421
B001269,N00025495,Lou Barletta (R),2014,Transportation,25200,152950,178150
B001269,N00025495,Lou Barletta (R),2014,Misc Business,39646,56344,95990
B001269,N00025495,Lou Barletta (R),2014,Labor,0,67000,67000
B001269,N00025495,Lou Barletta (R),2014,Ideology/Single-Issue,9700,54000,63700
B001269,N00025495,Lou Barletta (R),2014,Other,47497,15000,62497
C001053,N00025726,Tom Cole (R),2014,Agribusiness,13350,48824,62174
C001053,N00025726,Tom Cole (R),2014,Communic/Electronics,5850,17000,22850
C001053,N00025726,Tom Cole (R),2014,Construction,14300,18500,32800
C001053,N00025726,Tom Cole (R),2014,Defense,500,96500,97000
C001053,N00025726,Tom Cole (R),2014,Energy/Nat Resource,56850,97400,154250
C001053,N00025726,Tom Cole (R),2014,Finance/Insur/RealEst,118150,96600,214750
C001053,N00025726,Tom Cole (R),2014,Health,11550,36000,47550
C001053,N00025726,Tom Cole (R),2014,Lawyers & Lobbyists,78748,12750,91498
C001053,N00025726,Tom Cole (R),2014,Transportation,19600,47303,66903
C001053,N00025726,Tom Cole (R),2014,Misc Business,43300,60639,103939
C001053,N00025726,Tom Cole (R),2014,Labor,0,11500,11500
C001053,N00025726,Tom Cole (R),2014,Ideology/Single-Issue,159725,33000,192725
C001053,N00025726,Tom Cole (R),2014,Other,41275,0,41275
H001050,N00025881,Colleen Hanabusa (D),2014,Agribusiness,14950,9000,23950
H001050,N00025881,Colleen Hanabusa (D),2014,Communic/Electronics,62800,9000,71800
H001050,N00025881,Colleen Hanabusa (D),2014,Construction,110145,0,110145
H001050,N00025881,Colleen Hanabusa (D),2014,Defense,21200,32000,53200
H001050,N00025881,Colleen Hanabusa (D),2014,Energy/Nat Resource,22950,5000,27950
H001050,N00025881,Colleen Hanabusa (D),2014,Finance/Insur/RealEst,258333,21500,279833
H001050,N00025881,Colleen Hanabusa (D),2014,Health,71450,19500,90950
H001050,N00025881,Colleen Hanabusa (D),2014,Lawyers & Lobbyists,154050,7500,161550
H001050,N00025881,Colleen Hanabusa (D),2014,Transportation,55550,20000,75550
H001050,N00025881,Colleen Hanabusa (D),2014,Misc Business,148513,7500,156013
H001050,N00025881,Colleen Hanabusa (D),2014,Labor,4350,65000,69350
H001050,N00025881,Colleen Hanabusa (D),2014,Ideology/Single-Issue,230698,76375,307073
H001050,N00025881,Colleen Hanabusa (D),2014,Other,336103,3000,339103
C001062,N00026041,Mike Conaway (R),2014,Agribusiness,195300,409332,604632
C001062,N00026041,Mike Conaway (R),2014,Communic/Electronics,500,34280,34780
C001062,N00026041,Mike Conaway (R),2014,Construction,25550,15000,40550
C001062,N00026041,Mike Conaway (R),2014,Defense,0,67500,67500
C001062,N00026041,Mike Conaway (R),2014,Energy/Nat Resource,212786,92000,304786
C001062,N00026041,Mike Conaway (R),2014,Finance/Insur/RealEst,115600,199000,314600
C001062,N00026041,Mike Conaway (R),2014,Health,41150,25500,66650
C001062,N00026041,Mike Conaway (R),2014,Lawyers & Lobbyists,66863,17500,84363
C001062,N00026041,Mike Conaway (R),2014,Transportation,5250,38999,44249
C001062,N00026041,Mike Conaway (R),2014,Misc Business,50850,43660,94510
C001062,N00026041,Mike Conaway (R),2014,Labor,0,3000,3000
C001062,N00026041,Mike Conaway (R),2014,Ideology/Single-Issue,14450,27348,41798
C001062,N00026041,Mike Conaway (R),2014,Other,65700,1000,66700
B001252,N00026080,John Barrow (D),2014,Agribusiness,25900,146000,171900
B001252,N00026080,John Barrow (D),2014,Communic/Electronics,56750,151020,207770
B001252,N00026080,John Barrow (D),2014,Construction,6050,34250,40300
B001252,N00026080,John Barrow (D),2014,Defense,0,49500,49500
B001252,N00026080,John Barrow (D),2014,Energy/Nat Resource,24950,261000,285950
B001252,N00026080,John Barrow (D),2014,Finance/Insur/RealEst,118671,280500,399171
B001252,N00026080,John Barrow (D),2014,Health,77340,409000,486340
B001252,N00026080,John Barrow (D),2014,Lawyers & Lobbyists,432786,49750,482536
B001252,N00026080,John Barrow (D),2014,Transportation,19100,99500,118600
B001252,N00026080,John Barrow (D),2014,Misc Business,80370,199055,279425
B001252,N00026080,John Barrow (D),2014,Labor,1000,173500,174500
B001252,N00026080,John Barrow (D),2014,Ideology/Single-Issue,28651,322600,351251
B001252,N00026080,John Barrow (D),2014,Other,155278,5000,160278
G000552,N00026148,Louis B Gohmert Jr (R),2014,Agribusiness,26050,25014,51064
G000552,N00026148,Louis B Gohmert Jr (R),2014,Communic/Electronics,10550,17000,27550
G000552,N00026148,Louis B Gohmert Jr (R),2014,Construction,21250,4250,25500
G000552,N00026148,Louis B Gohmert Jr (R),2014,Defense,0,4000,4000
G000552,N00026148,Louis B Gohmert Jr (R),2014,Energy/Nat Resource,32850,26000,58850
G000552,N00026148,Louis B Gohmert Jr (R),2014,Finance/Insur/RealEst,105838,15500,121338
G000552,N00026148,Louis B Gohmert Jr (R),2014,Health,47500,17100,64600
G000552,N00026148,Louis B Gohmert Jr (R),2014,Lawyers & Lobbyists,14550,4000,18550
G000552,N00026148,Louis B Gohmert Jr (R),2014,Transportation,6600,13000,19600
G000552,N00026148,Louis B Gohmert Jr (R),2014,Misc Business,23200,20000,43200
G000552,N00026148,Louis B Gohmert Jr (R),2014,Ideology/Single-Issue,27200,44591,71791
G000552,N00026148,Louis B Gohmert Jr (R),2014,Other,83000,0,83000
F000450,N00026166,Virginia Foxx (R),2014,Agribusiness,17000,64850,81850
F000450,N00026166,Virginia Foxx (R),2014,Communic/Electronics,16150,23000,39150
F000450,N00026166,Virginia Foxx (R),2014,Construction,18900,22000,40900
F000450,N00026166,Virginia Foxx (R),2014,Defense,0,3000,3000
F000450,N00026166,Virginia Foxx (R),2014,Energy/Nat Resource,12500,24000,36500
F000450,N00026166,Virginia Foxx (R),2014,Finance/Insur/RealEst,48110,83500,131610
F000450,N00026166,Virginia Foxx (R),2014,Health,42305,33000,75305
F000450,N00026166,Virginia Foxx (R),2014,Lawyers & Lobbyists,42550,29551,72101
F000450,N00026166,Virginia Foxx (R),2014,Transportation,14600,38500,53100
F000450,N00026166,Virginia Foxx (R),2014,Misc Business,89221,62500,151721
F000450,N00026166,Virginia Foxx (R),2014,Ideology/Single-Issue,26550,42427,68977
F000450,N00026166,Virginia Foxx (R),2014,Other,220530,40500,261030
D000604,N00026171,Charlie Dent (R),2014,Agribusiness,36642,10500,47142
D000604,N00026171,Charlie Dent (R),2014,Communic/Electronics,9750,46500,56250
D000604,N00026171,Charlie Dent (R),2014,Construction,14965,75000,89965
D000604,N00026171,Charlie Dent (R),2014,Defense,0,34500,34500
D000604,N00026171,Charlie Dent (R),2014,Energy/Nat Resource,51699,100750,152449
D000604,N00026171,Charlie Dent (R),2014,Finance/Insur/RealEst,98956,82100,181056
D000604,N00026171,Charlie Dent (R),2014,Health,53950,227000,280950
D000604,N00026171,Charlie Dent (R),2014,Lawyers & Lobbyists,74805,22685,97490
D000604,N00026171,Charlie Dent (R),2014,Transportation,36950,61750,98700
D000604,N00026171,Charlie Dent (R),2014,Misc Business,112461,109349,221810
D000604,N00026171,Charlie Dent (R),2014,Labor,0,45500,45500
D000604,N00026171,Charlie Dent (R),2014,Ideology/Single-Issue,84750,85074,169824
D000604,N00026171,Charlie Dent (R),2014,Other,98165,6000,104165
C001059,N00026341,Jim Costa (D),2014,Agribusiness,205600,261850,467450
C001059,N00026341,Jim Costa (D),2014,Communic/Electronics,9600,28000,37600
C001059,N00026341,Jim Costa (D),2014,Construction,37035,25000,62035
C001059,N00026341,Jim Costa (D),2014,Defense,0,4000,4000
C001059,N00026341,Jim Costa (D),2014,Energy/Nat Resource,13750,137749,151499
C001059,N00026341,Jim Costa (D),2014,Finance/Insur/RealEst,81906,27990,109896
C001059,N00026341,Jim Costa (D),2014,Health,41550,16000,57550
C001059,N00026341,Jim Costa (D),2014,Lawyers & Lobbyists,64700,7750,72450
C001059,N00026341,Jim Costa (D),2014,Transportation,17850,15000,32850
C001059,N00026341,Jim Costa (D),2014,Misc Business,76750,58500,135250
C001059,N00026341,Jim Costa (D),2014,Labor,250,97000,97250
C001059,N00026341,Jim Costa (D),2014,Ideology/Single-Issue,19950,42020,61970
C001059,N00026341,Jim Costa (D),2014,Other,37835,2000,39835
D000607,N00026586,Joe Donnelly (D),2014,Agribusiness,59241,121250,180491
D000607,N00026586,Joe Donnelly (D),2014,Communic/Electronics,128512,5250,133762
D000607,N00026586,Joe Donnelly (D),2014,Construction,147348,24500,171848
D000607,N00026586,Joe Donnelly (D),2014,Defense,31733,20000,51733
D000607,N00026586,Joe Donnelly (D),2014,Energy/Nat Resource,61650,80000,141650
D000607,N00026586,Joe Donnelly (D),2014,Finance/Insur/RealEst,424124,238360,662484
D000607,N00026586,Joe Donnelly (D),2014,Health,215712,136571,352283
D000607,N00026586,Joe Donnelly (D),2014,Lawyers & Lobbyists,870386,65500,935886
D000607,N00026586,Joe Donnelly (D),2014,Transportation,28150,52834,80984
D000607,N00026586,Joe Donnelly (D),2014,Misc Business,319954,90500,410454
D000607,N00026586,Joe Donnelly (D),2014,Labor,6290,363750,370040
D000607,N00026586,Joe Donnelly (D),2014,Ideology/Single-Issue,130581,511972,642553
D000607,N00026586,Joe Donnelly (D),2014,Other,534866,4500,539366
B001255,N00026595,Charles W Boustany Jr (R),2014,Agribusiness,41260,67000,108260
B001255,N00026595,Charles W Boustany Jr (R),2014,Communic/Electronics,25750,40100,65850
B001255,N00026595,Charles W Boustany Jr (R),2014,Construction,34150,39000,73150
B001255,N00026595,Charles W Boustany Jr (R),2014,Defense,300,48500,48800
B001255,N00026595,Charles W Boustany Jr (R),2014,Energy/Nat Resource,81050,201350,282400
B001255,N00026595,Charles W Boustany Jr (R),2014,Finance/Insur/RealEst,100007,308940,408947
B001255,N00026595,Charles W Boustany Jr (R),2014,Health,98850,319940,418790
B001255,N00026595,Charles W Boustany Jr (R),2014,Lawyers & Lobbyists,84449,26498,110947
B001255,N00026595,Charles W Boustany Jr (R),2014,Transportation,50199,43550,93749
B001255,N00026595,Charles W Boustany Jr (R),2014,Misc Business,86625,135999,222624
B001255,N00026595,Charles W Boustany Jr (R),2014,Labor,0,5000,5000
B001255,N00026595,Charles W Boustany Jr (R),2014,Ideology/Single-Issue,3250,14500,17750
B001255,N00026595,Charles W Boustany Jr (R),2014,Other,61642,50,61692
F000449,N00026631,Jeff Fortenberry (R),2014,Agribusiness,15900,52000,67900
F000449,N00026631,Jeff Fortenberry (R),2014,Communic/Electronics,17900,10500,28400
F000449,N00026631,Jeff Fortenberry (R),2014,Construction,6000,9500,15500
F000449,N00026631,Jeff Fortenberry (R),2014,Defense,250,34500,34750
F000449,N00026631,Jeff Fortenberry (R),2014,Energy/Nat Resource,1300,18000,19300
F000449,N00026631,Jeff Fortenberry (R),2014,Finance/Insur/RealEst,71800,82750,154550
F000449,N00026631,Jeff Fortenberry (R),2014,Health,60272,20000,80272
F000449,N00026631,Jeff Fortenberry (R),2014,Lawyers & Lobbyists,24950,12500,37450
F000449,N00026631,Jeff Fortenberry (R),2014,Transportation,2500,29498,31998
F000449,N00026631,Jeff Fortenberry (R),2014,Misc Business,44112,21000,65112
F000449,N00026631,Jeff Fortenberry (R),2014,Labor,0,4500,4500
F000449,N00026631,Jeff Fortenberry (R),2014,Ideology/Single-Issue,500,37300,37800
F000449,N00026631,Jeff Fortenberry (R),2014,Other,29750,0,29750
G000553,N00026686,Al Green (D),2014,Agribusiness,2850,2000,4850
G000553,N00026686,Al Green (D),2014,Communic/Electronics,4600,7000,11600
G000553,N00026686,Al Green (D),2014,Construction,14850,1000,15850
G000553,N00026686,Al Green (D),2014,Defense,0,2000,2000
G000553,N00026686,Al Green (D),2014,Energy/Nat Resource,5000,7500,12500
G000553,N00026686,Al Green (D),2014,Finance/Insur/RealEst,45325,53000,98325
G000553,N00026686,Al Green (D),2014,Health,3950,4000,7950
G000553,N00026686,Al Green (D),2014,Lawyers & Lobbyists,93118,9500,102618
G000553,N00026686,Al Green (D),2014,Transportation,6550,3000,9550
G000553,N00026686,Al Green (D),2014,Misc Business,11950,3000,14950
G000553,N00026686,Al Green (D),2014,Labor,0,87000,87000
G000553,N00026686,Al Green (D),2014,Ideology/Single-Issue,2000,3000,5000
G000553,N00026686,Al Green (D),2014,Other,27350,0,27350
C001061,N00026790,Emanuel Cleaver (D),2014,Agribusiness,300,20000,20300
C001061,N00026790,Emanuel Cleaver (D),2014,Communic/Electronics,5710,41000,46710
C001061,N00026790,Emanuel Cleaver (D),2014,Construction,8750,26600,35350
C001061,N00026790,Emanuel Cleaver (D),2014,Defense,2000,23500,25500
C001061,N00026790,Emanuel Cleaver (D),2014,Energy/Nat Resource,250,16000,16250
C001061,N00026790,Emanuel Cleaver (D),2014,Finance/Insur/RealEst,13550,223150,236700
C001061,N00026790,Emanuel Cleaver (D),2014,Health,15150,39000,54150
C001061,N00026790,Emanuel Cleaver (D),2014,Lawyers & Lobbyists,58400,37500,95900
C001061,N00026790,Emanuel Cleaver (D),2014,Transportation,1750,16500,18250
C001061,N00026790,Emanuel Cleaver (D),2014,Misc Business,19450,34500,53950
C001061,N00026790,Emanuel Cleaver (D),2014,Labor,250,190716,190966
C001061,N00026790,Emanuel Cleaver (D),2014,Ideology/Single-Issue,7100,53000,60100
C001061,N00026790,Emanuel Cleaver (D),2014,Other,33900,1500,35400
C001067,N00026961,Yvette D Clarke (D),2014,Agribusiness,3600,7500,11100
C001067,N00026961,Yvette D Clarke (D),2014,Communic/Electronics,1450,50000,51450
C001067,N00026961,Yvette D Clarke (D),2014,Construction,10500,2000,12500
C001067,N00026961,Yvette D Clarke (D),2014,Defense,0,32000,32000
C001067,N00026961,Yvette D Clarke (D),2014,Energy/Nat Resource,1000,2000,3000
C001067,N00026961,Yvette D Clarke (D),2014,Finance/Insur/RealEst,28455,42850,71305
C001067,N00026961,Yvette D Clarke (D),2014,Health,15690,12000,27690
C001067,N00026961,Yvette D Clarke (D),2014,Lawyers & Lobbyists,11700,9250,20950
C001067,N00026961,Yvette D Clarke (D),2014,Transportation,2500,13500,16000
C001067,N00026961,Yvette D Clarke (D),2014,Misc Business,15760,27500,43260
C001067,N00026961,Yvette D Clarke (D),2014,Labor,0,143065,143065
C001067,N00026961,Yvette D Clarke (D),2014,Ideology/Single-Issue,1000,25000,26000
C001067,N00026961,Yvette D Clarke (D),2014,Other,24315,0,24315
B001251,N00027035,G K Butterfield (D),2014,Agribusiness,1750,71000,72750
B001251,N00027035,G K Butterfield (D),2014,Communic/Electronics,6500,109004,115504
B001251,N00027035,G K Butterfield (D),2014,Construction,2000,2000,4000
B001251,N00027035,G K Butterfield (D),2014,Defense,0,26500,26500
B001251,N00027035,G K Butterfield (D),2014,Energy/Nat Resource,4000,53250,57250
B001251,N00027035,G K Butterfield (D),2014,Finance/Insur/RealEst,14166,46600,60766
B001251,N00027035,G K Butterfield (D),2014,Health,9916,151000,160916
B001251,N00027035,G K Butterfield (D),2014,Lawyers & Lobbyists,29150,26536,55686
B001251,N00027035,G K Butterfield (D),2014,Transportation,2500,55500,58000
B001251,N00027035,G K Butterfield (D),2014,Misc Business,11700,70097,81797
B001251,N00027035,G K Butterfield (D),2014,Labor,0,63000,63000
B001251,N00027035,G K Butterfield (D),2014,Ideology/Single-Issue,0,9000,9000
B001251,N00027035,G K Butterfield (D),2014,Other,24064,0,24064
H001038,N00027060,Brian M Higgins (D),2014,Agribusiness,250,11500,11750
H001038,N00027060,Brian M Higgins (D),2014,Communic/Electronics,600,10000,10600
H001038,N00027060,Brian M Higgins (D),2014,Construction,22700,4000,26700
H001038,N00027060,Brian M Higgins (D),2014,Defense,0,22500,22500
H001038,N00027060,Brian M Higgins (D),2014,Energy/Nat Resource,3000,8000,11000
H001038,N00027060,Brian M Higgins (D),2014,Finance/Insur/RealEst,56200,29500,85700
H001038,N00027060,Brian M Higgins (D),2014,Health,51950,12750,64700
H001038,N00027060,Brian M Higgins (D),2014,Lawyers & Lobbyists,83423,11000,94423
H001038,N00027060,Brian M Higgins (D),2014,Transportation,0,7000,7000
H001038,N00027060,Brian M Higgins (D),2014,Misc Business,34410,30000,64410
H001038,N00027060,Brian M Higgins (D),2014,Labor,0,158500,158500
H001038,N00027060,Brian M Higgins (D),2014,Ideology/Single-Issue,0,6550,6550
H001038,N00027060,Brian M Higgins (D),2014,Other,25450,0,25450
F000451,N00027229,Michael G Fitzpatrick (R),2014,Agribusiness,41750,18500,60250
F000451,N00027229,Michael G Fitzpatrick (R),2014,Communic/Electronics,53400,39200,92600
F000451,N00027229,Michael G Fitzpatrick (R),2014,Construction,123945,38100,162045
F000451,N00027229,Michael G Fitzpatrick (R),2014,Defense,16160,29000,45160
F000451,N00027229,Michael G Fitzpatrick (R),2014,Energy/Nat Resource,27900,56200,84100
F000451,N00027229,Michael G Fitzpatrick (R),2014,Finance/Insur/RealEst,348245,404740,752985
F000451,N00027229,Michael G Fitzpatrick (R),2014,Health,58475,97700,156175
F000451,N00027229,Michael G Fitzpatrick (R),2014,Lawyers & Lobbyists,131958,35300,167258
F000451,N00027229,Michael G Fitzpatrick (R),2014,Transportation,40759,29000,69759
F000451,N00027229,Michael G Fitzpatrick (R),2014,Misc Business,132819,71000,203819
F000451,N00027229,Michael G Fitzpatrick (R),2014,Labor,0,53000,53000
F000451,N00027229,Michael G Fitzpatrick (R),2014,Ideology/Single-Issue,95600,241985,337585
F000451,N00027229,Michael G Fitzpatrick (R),2014,Other,128937,10500,139437
C001071,N00027441,Bob Corker (R),2014,Agribusiness,182336,114850,297186
C001071,N00027441,Bob Corker (R),2014,Communic/Electronics,219286,130251,349537
C001071,N00027441,Bob Corker (R),2014,Construction,443100,60750,503850
C001071,N00027441,Bob Corker (R),2014,Defense,8170,50500,58670
C001071,N00027441,Bob Corker (R),2014,Energy/Nat Resource,276975,265061,542036
C001071,N00027441,Bob Corker (R),2014,Finance/Insur/RealEst,2463429,980770,3444199
C001071,N00027441,Bob Corker (R),2014,Health,666506,360400,1026906
C001071,N00027441,Bob Corker (R),2014,Lawyers & Lobbyists,645163,115765,760928
C001071,N00027441,Bob Corker (R),2014,Transportation,255195,116500,371695
C001071,N00027441,Bob Corker (R),2014,Misc Business,899159,316345,1215504
C001071,N00027441,Bob Corker (R),2014,Labor,0,12000,12000
C001071,N00027441,Bob Corker (R),2014,Ideology/Single-Issue,121160,299000,420160
C001071,N00027441,Bob Corker (R),2014,Other,639909,3500,643409
B001257,N00027462,Gus Bilirakis (R),2014,Agribusiness,2800,18000,20800
B001257,N00027462,Gus Bilirakis (R),2014,Communic/Electronics,2750,60000,62750
B001257,N00027462,Gus Bilirakis (R),2014,Construction,2750,13500,16250
B001257,N00027462,Gus Bilirakis (R),2014,Defense,300,21000,21300
B001257,N00027462,Gus Bilirakis (R),2014,Energy/Nat Resource,10000,58500,68500
B001257,N00027462,Gus Bilirakis (R),2014,Finance/Insur/RealEst,60747,76500,137247
B001257,N00027462,Gus Bilirakis (R),2014,Health,53629,251950,305579
B001257,N00027462,Gus Bilirakis (R),2014,Lawyers & Lobbyists,45485,13750,59235
B001257,N00027462,Gus Bilirakis (R),2014,Transportation,2200,25000,27200
B001257,N00027462,Gus Bilirakis (R),2014,Misc Business,53341,95500,148841
B001257,N00027462,Gus Bilirakis (R),2014,Labor,0,2000,2000
B001257,N00027462,Gus Bilirakis (R),2014,Ideology/Single-Issue,3700,19050,22750
B001257,N00027462,Gus Bilirakis (R),2014,Other,25765,3000,28765
B001259,N00027464,Bruce Braley (D),2014,Agribusiness,18100,53100,71200
B001259,N00027464,Bruce Braley (D),2014,Communic/Electronics,119080,77504,196584
B001259,N00027464,Bruce Braley (D),2014,Construction,24900,26800,51700
B001259,N00027464,Bruce Braley (D),2014,Defense,500,25000,25500
B001259,N00027464,Bruce Braley (D),2014,Energy/Nat Resource,10575,54150,64725
B001259,N00027464,Bruce Braley (D),2014,Finance/Insur/RealEst,222150,74600,296750
B001259,N00027464,Bruce Braley (D),2014,Health,169200,247560,416760
B001259,N00027464,Bruce Braley (D),2014,Lawyers & Lobbyists,1685465,47000,1732465
B001259,N00027464,Bruce Braley (D),2014,Transportation,1800,34000,35800
B001259,N00027464,Bruce Braley (D),2014,Misc Business,100249,51413,151662
B001259,N00027464,Bruce Braley (D),2014,Labor,1850,350500,352350
B001259,N00027464,Bruce Braley (D),2014,Ideology/Single-Issue,347034,716987,1064021
B001259,N00027464,Bruce Braley (D),2014,Other,372744,10000,382744
B001256,N00027493,Michele Bachmann (R),2014,Agribusiness,7300,0,7300
B001256,N00027493,Michele Bachmann (R),2014,Communic/Electronics,3000,0,3000
B001256,N00027493,Michele Bachmann (R),2014,Construction,9880,-2500,7380
B001256,N00027493,Michele Bachmann (R),2014,Defense,2300,0,2300
B001256,N00027493,Michele Bachmann (R),2014,Energy/Nat Resource,12400,0,12400
B001256,N00027493,Michele Bachmann (R),2014,Finance/Insur/RealEst,20502,2000,22502
B001256,N00027493,Michele Bachmann (R),2014,Health,6576,0,6576
B001256,N00027493,Michele Bachmann (R),2014,Lawyers & Lobbyists,2451,0,2451
B001256,N00027493,Michele Bachmann (R),2014,Transportation,1751,0,1751
B001256,N00027493,Michele Bachmann (R),2014,Misc Business,13432,0,13432
B001256,N00027493,Michele Bachmann (R),2014,Ideology/Single-Issue,16426,7800,24226
B001256,N00027493,Michele Bachmann (R),2014,Other,88117,0,88117
C001070,N00027503,Bob Casey (D),2014,Agribusiness,74200,183500,257700
C001070,N00027503,Bob Casey (D),2014,Communic/Electronics,310430,144250,454680
C001070,N00027503,Bob Casey (D),2014,Construction,190826,45000,235826
C001070,N00027503,Bob Casey (D),2014,Defense,28925,106500,135425
C001070,N00027503,Bob Casey (D),2014,Energy/Nat Resource,151000,173400,324400
C001070,N00027503,Bob Casey (D),2014,Finance/Insur/RealEst,1066178,458550,1524728
C001070,N00027503,Bob Casey (D),2014,Health,649032,656479,1305511
C001070,N00027503,Bob Casey (D),2014,Lawyers & Lobbyists,2277371,245308,2522679
C001070,N00027503,Bob Casey (D),2014,Transportation,93250,97897,191147
C001070,N00027503,Bob Casey (D),2014,Misc Business,533431,252537,785968
C001070,N00027503,Bob Casey (D),2014,Labor,51179,373449,424628
C001070,N00027503,Bob Casey (D),2014,Ideology/Single-Issue,182543,431934,614477
C001070,N00027503,Bob Casey (D),2014,Other,716425,20000,736425
C001066,N00027514,Kathy Castor (D),2014,Agribusiness,11250,16100,27350
C001066,N00027514,Kathy Castor (D),2014,Communic/Electronics,6500,66500,73000
C001066,N00027514,Kathy Castor (D),2014,Construction,7500,12500,20000
C001066,N00027514,Kathy Castor (D),2014,Defense,0,12000,12000
C001066,N00027514,Kathy Castor (D),2014,Energy/Nat Resource,500,10000,10500
C001066,N00027514,Kathy Castor (D),2014,Finance/Insur/RealEst,27200,33000,60200
C001066,N00027514,Kathy Castor (D),2014,Health,20700,85000,105700
C001066,N00027514,Kathy Castor (D),2014,Lawyers & Lobbyists,32443,18500,50943
C001066,N00027514,Kathy Castor (D),2014,Transportation,9750,10500,20250
C001066,N00027514,Kathy Castor (D),2014,Misc Business,15000,40000,55000
C001066,N00027514,Kathy Castor (D),2014,Labor,500,79000,79500
C001066,N00027514,Kathy Castor (D),2014,Ideology/Single-Issue,2250,12700,14950
C001066,N00027514,Kathy Castor (D),2014,Other,29250,1000,30250
H001041,N00027522,Dean Heller (R),2014,Agribusiness,58840,121500,180340
H001041,N00027522,Dean Heller (R),2014,Communic/Electronics,152000,259000,411000
H001041,N00027522,Dean Heller (R),2014,Construction,196007,98000,294007
H001041,N00027522,Dean Heller (R),2014,Defense,8250,23000,31250
H001041,N00027522,Dean Heller (R),2014,Energy/Nat Resource,303889,378075,681964
H001041,N00027522,Dean Heller (R),2014,Finance/Insur/RealEst,917228,632350,1549578
H001041,N00027522,Dean Heller (R),2014,Health,202279,293350,495629
H001041,N00027522,Dean Heller (R),2014,Lawyers & Lobbyists,337432,74895,412327
H001041,N00027522,Dean Heller (R),2014,Transportation,151160,184499,335659
H001041,N00027522,Dean Heller (R),2014,Misc Business,691867,416424,1108291
H001041,N00027522,Dean Heller (R),2014,Ideology/Single-Issue,159629,563983,723612
H001041,N00027522,Dean Heller (R),2014,Other,594982,10500,605482
C001064,N00027565,John Campbell (R),2014,Communic/Electronics,0,6500,6500
C001064,N00027565,John Campbell (R),2014,Construction,3900,0,3900
C001064,N00027565,John Campbell (R),2014,Defense,0,3000,3000
C001064,N00027565,John Campbell (R),2014,Energy/Nat Resource,0,2000,2000
C001064,N00027565,John Campbell (R),2014,Finance/Insur/RealEst,21150,83850,105000
C001064,N00027565,John Campbell (R),2014,Health,300,1000,1300
C001064,N00027565,John Campbell (R),2014,Lawyers & Lobbyists,3850,1000,4850
C001064,N00027565,John Campbell (R),2014,Transportation,6200,5000,11200
C001064,N00027565,John Campbell (R),2014,Misc Business,3100,6202,9302
C001064,N00027565,John Campbell (R),2014,Ideology/Single-Issue,0,1000,1000
C001064,N00027565,John Campbell (R),2014,Other,8754,0,8754
B001260,N00027626,Vernon Buchanan (R),2014,Agribusiness,31100,38500,69600
B001260,N00027626,Vernon Buchanan (R),2014,Communic/Electronics,23000,31090,54090
B001260,N00027626,Vernon Buchanan (R),2014,Construction,58352,25500,83852
B001260,N00027626,Vernon Buchanan (R),2014,Defense,0,4000,4000
B001260,N00027626,Vernon Buchanan (R),2014,Energy/Nat Resource,0,16000,16000
B001260,N00027626,Vernon Buchanan (R),2014,Finance/Insur/RealEst,132200,148500,280700
B001260,N00027626,Vernon Buchanan (R),2014,Health,202300,198918,401218
B001260,N00027626,Vernon Buchanan (R),2014,Lawyers & Lobbyists,50000,16750,66750
B001260,N00027626,Vernon Buchanan (R),2014,Transportation,37350,53000,90350
B001260,N00027626,Vernon Buchanan (R),2014,Misc Business,147750,110202,257952
B001260,N00027626,Vernon Buchanan (R),2014,Labor,0,2500,2500
B001260,N00027626,Vernon Buchanan (R),2014,Ideology/Single-Issue,500,18065,18565
B001260,N00027626,Vernon Buchanan (R),2014,Other,152625,1000,153625
H001057,N00027649,Tim Huelskamp (R),2014,Agribusiness,39775,16500,56275
H001057,N00027649,Tim Huelskamp (R),2014,Communic/Electronics,1726,22050,23776
H001057,N00027649,Tim Huelskamp (R),2014,Construction,16250,13500,29750
H001057,N00027649,Tim Huelskamp (R),2014,Energy/Nat Resource,52600,29250,81850
H001057,N00027649,Tim Huelskamp (R),2014,Finance/Insur/RealEst,29300,28500,57800
H001057,N00027649,Tim Huelskamp (R),2014,Health,14550,21000,35550
H001057,N00027649,Tim Huelskamp (R),2014,Lawyers & Lobbyists,11700,0,11700
H001057,N00027649,Tim Huelskamp (R),2014,Transportation,20350,29498,49848
H001057,N00027649,Tim Huelskamp (R),2014,Misc Business,58650,7000,65650
H001057,N00027649,Tim Huelskamp (R),2014,Labor,0,3000,3000
H001057,N00027649,Tim Huelskamp (R),2014,Ideology/Single-Issue,20800,50175,70975
H001057,N00027649,Tim Huelskamp (R),2014,Other,37250,-500,36750
G000555,N00027658,Kirsten Gillibrand (D),2014,Agribusiness,166533,300233,466766
G000555,N00027658,Kirsten Gillibrand (D),2014,Communic/Electronics,1550124,361358,1911482
G000555,N00027658,Kirsten Gillibrand (D),2014,Construction,299033,140541,439574
G000555,N00027658,Kirsten Gillibrand (D),2014,Defense,51764,228400,280164
G000555,N00027658,Kirsten Gillibrand (D),2014,Energy/Nat Resource,158148,258750,416898
G000555,N00027658,Kirsten Gillibrand (D),2014,Finance/Insur/RealEst,5493673,1007516,6501189
G000555,N00027658,Kirsten Gillibrand (D),2014,Health,667724,544610,1212334
G000555,N00027658,Kirsten Gillibrand (D),2014,Lawyers & Lobbyists,4756103,353616,5109719
G000555,N00027658,Kirsten Gillibrand (D),2014,Transportation,102934,194000,296934
G000555,N00027658,Kirsten Gillibrand (D),2014,Misc Business,1828381,439110,2267491
G000555,N00027658,Kirsten Gillibrand (D),2014,Labor,1250,572250,573500
G000555,N00027658,Kirsten Gillibrand (D),2014,Ideology/Single-Issue,1820076,592810,2412886
G000555,N00027658,Kirsten Gillibrand (D),2014,Other,1832258,26250,1858508
D000622,N00027860,Tammy Duckworth (D),2014,Agribusiness,1500,37000,38500
D000622,N00027860,Tammy Duckworth (D),2014,Communic/Electronics,59259,27500,86759
D000622,N00027860,Tammy Duckworth (D),2014,Construction,7250,8500,15750
D000622,N00027860,Tammy Duckworth (D),2014,Defense,7250,106498,113748
D000622,N00027860,Tammy Duckworth (D),2014,Energy/Nat Resource,5500,20250,25750
D000622,N00027860,Tammy Duckworth (D),2014,Finance/Insur/RealEst,145906,114000,259906
D000622,N00027860,Tammy Duckworth (D),2014,Health,56094,160626,216720
D000622,N00027860,Tammy Duckworth (D),2014,Lawyers & Lobbyists,155417,24500,179917
D000622,N00027860,Tammy Duckworth (D),2014,Transportation,9210,39500,48710
D000622,N00027860,Tammy Duckworth (D),2014,Misc Business,75900,64000,139900
D000622,N00027860,Tammy Duckworth (D),2014,Labor,1000,266000,267000
D000622,N00027860,Tammy Duckworth (D),2014,Ideology/Single-Issue,231776,71399,303175
D000622,N00027860,Tammy Duckworth (D),2014,Other,140931,13500,154431
H001042,N00028139,Mazie K Hirono (D),2014,Agribusiness,16500,14000,30500
H001042,N00028139,Mazie K Hirono (D),2014,Communic/Electronics,120461,51500,171961
H001042,N00028139,Mazie K Hirono (D),2014,Construction,148548,26500,175048
H001042,N00028139,Mazie K Hirono (D),2014,Defense,28150,6500,34650
H001042,N00028139,Mazie K Hirono (D),2014,Energy/Nat Resource,37125,15000,52125
H001042,N00028139,Mazie K Hirono (D),2014,Finance/Insur/RealEst,320040,77500,397540
H001042,N00028139,Mazie K Hirono (D),2014,Health,89218,31300,120518
H001042,N00028139,Mazie K Hirono (D),2014,Lawyers & Lobbyists,727513,51000,778513
H001042,N00028139,Mazie K Hirono (D),2014,Transportation,85835,111000,196835
H001042,N00028139,Mazie K Hirono (D),2014,Misc Business,244548,34000,278548
H001042,N00028139,Mazie K Hirono (D),2014,Labor,1700,396900,398600
H001042,N00028139,Mazie K Hirono (D),2014,Ideology/Single-Issue,509739,359369,869108
H001042,N00028139,Mazie K Hirono (D),2014,Other,372511,6000,378511
E000290,N00028249,Donna Edwards (D),2014,Agribusiness,0,4500,4500
E000290,N00028249,Donna Edwards (D),2014,Communic/Electronics,5400,7000,12400
E000290,N00028249,Donna Edwards (D),2014,Construction,11400,2000,13400
E000290,N00028249,Donna Edwards (D),2014,Defense,6200,17500,23700
E000290,N00028249,Donna Edwards (D),2014,Energy/Nat Resource,0,8000,8000
E000290,N00028249,Donna Edwards (D),2014,Finance/Insur/RealEst,25150,11000,36150
E000290,N00028249,Donna Edwards (D),2014,Health,5200,10500,15700
E000290,N00028249,Donna Edwards (D),2014,Lawyers & Lobbyists,21750,12000,33750
E000290,N00028249,Donna Edwards (D),2014,Transportation,3000,89500,92500
E000290,N00028249,Donna Edwards (D),2014,Misc Business,15600,24000,39600
E000290,N00028249,Donna Edwards (D),2014,Labor,250,182250,182500
E000290,N00028249,Donna Edwards (D),2014,Ideology/Single-Issue,17300,26800,44100
E000290,N00028249,Donna Edwards (D),2014,Other,38950,0,38950
E000288,N00028257,Keith Ellison (D),2014,Agribusiness,7275,26000,33275
E000288,N00028257,Keith Ellison (D),2014,Communic/Electronics,28650,2000,30650
E000288,N00028257,Keith Ellison (D),2014,Construction,22300,0,22300
E000288,N00028257,Keith Ellison (D),2014,Defense,750,1000,1750
E000288,N00028257,Keith Ellison (D),2014,Energy/Nat Resource,3250,2000,5250
E000288,N00028257,Keith Ellison (D),2014,Finance/Insur/RealEst,101800,60000,161800
E000288,N00028257,Keith Ellison (D),2014,Health,148716,13000,161716
E000288,N00028257,Keith Ellison (D),2014,Lawyers & Lobbyists,50600,32730,83330
E000288,N00028257,Keith Ellison (D),2014,Transportation,4500,3000,7500
E000288,N00028257,Keith Ellison (D),2014,Misc Business,49869,17500,67369
E000288,N00028257,Keith Ellison (D),2014,Labor,0,168750,168750
E000288,N00028257,Keith Ellison (D),2014,Ideology/Single-Issue,46430,17261,63691
E000288,N00028257,Keith Ellison (D),2014,Other,103616,500,104116
G000556,N00028418,Alan Grayson (D),2014,Agribusiness,5500,14500,20000
G000556,N00028418,Alan Grayson (D),2014,Communic/Electronics,39177,14500,53677
G000556,N00028418,Alan Grayson (D),2014,Construction,5600,0,5600
G000556,N00028418,Alan Grayson (D),2014,Defense,200,8500,8700
G000556,N00028418,Alan Grayson (D),2014,Energy/Nat Resource,2500,0,2500
G000556,N00028418,Alan Grayson (D),2014,Finance/Insur/RealEst,55017,19000,74017
G000556,N00028418,Alan Grayson (D),2014,Health,15349,7500,22849
G000556,N00028418,Alan Grayson (D),2014,Lawyers & Lobbyists,29800,21500,51300
G000556,N00028418,Alan Grayson (D),2014,Transportation,6300,2000,8300
G000556,N00028418,Alan Grayson (D),2014,Misc Business,30750,13000,43750
G000556,N00028418,Alan Grayson (D),2014,Labor,0,186000,186000
G000556,N00028418,Alan Grayson (D),2014,Ideology/Single-Issue,43322,22900,66222
G000556,N00028418,Alan Grayson (D),2014,Other,153782,1000,154782
C001076,N00028958,Jason Chaffetz (R),2014,Agribusiness,4350,13000,17350
C001076,N00028958,Jason Chaffetz (R),2014,Communic/Electronics,18300,115088,133388
C001076,N00028958,Jason Chaffetz (R),2014,Construction,0,15000,15000
C001076,N00028958,Jason Chaffetz (R),2014,Defense,500,29500,30000
C001076,N00028958,Jason Chaffetz (R),2014,Energy/Nat Resource,14100,48500,62600
C001076,N00028958,Jason Chaffetz (R),2014,Finance/Insur/RealEst,46943,102650,149593
C001076,N00028958,Jason Chaffetz (R),2014,Health,33150,60014,93164
C001076,N00028958,Jason Chaffetz (R),2014,Lawyers & Lobbyists,54646,18500,73146
C001076,N00028958,Jason Chaffetz (R),2014,Transportation,4600,36998,41598
C001076,N00028958,Jason Chaffetz (R),2014,Misc Business,56900,116999,173899
C001076,N00028958,Jason Chaffetz (R),2014,Labor,0,15500,15500
C001076,N00028958,Jason Chaffetz (R),2014,Ideology/Single-Issue,6500,29747,36247
C001076,N00028958,Jason Chaffetz (R),2014,Other,10600,500,11100
B001262,N00028986,Paul Broun (R),2014,Agribusiness,38199,0,38199
B001262,N00028986,Paul Broun (R),2014,Communic/Electronics,18250,3000,21250
B001262,N00028986,Paul Broun (R),2014,Construction,34751,0,34751
B001262,N00028986,Paul Broun (R),2014,Defense,1000,0,1000
B001262,N00028986,Paul Broun (R),2014,Energy/Nat Resource,39800,7000,46800
B001262,N00028986,Paul Broun (R),2014,Finance/Insur/RealEst,149213,7000,156213
B001262,N00028986,Paul Broun (R),2014,Health,74056,8000,82056
B001262,N00028986,Paul Broun (R),2014,Lawyers & Lobbyists,23700,5000,28700
B001262,N00028986,Paul Broun (R),2014,Transportation,24900,0,24900
B001262,N00028986,Paul Broun (R),2014,Misc Business,100001,5000,105001
B001262,N00028986,Paul Broun (R),2014,Labor,0,1000,1000
B001262,N00028986,Paul Broun (R),2014,Ideology/Single-Issue,124304,39186,163490
B001262,N00028986,Paul Broun (R),2014,Other,165100,0,165100
F000457,N00029016,Al Franken (D),2014,Agribusiness,87292,113249,200541
F000457,N00029016,Al Franken (D),2014,Communic/Electronics,1050451,128254,1178705
F000457,N00029016,Al Franken (D),2014,Construction,81616,10950,92566
F000457,N00029016,Al Franken (D),2014,Defense,12050,10000,22050
F000457,N00029016,Al Franken (D),2014,Energy/Nat Resource,54733,101250,155983
F000457,N00029016,Al Franken (D),2014,Finance/Insur/RealEst,1069839,89610,1159449
F000457,N00029016,Al Franken (D),2014,Health,345798,183148,528946
F000457,N00029016,Al Franken (D),2014,Lawyers & Lobbyists,1551073,101488,1652561
F000457,N00029016,Al Franken (D),2014,Transportation,42350,10000,52350
F000457,N00029016,Al Franken (D),2014,Misc Business,744217,98854,843071
F000457,N00029016,Al Franken (D),2014,Labor,3850,340750,344600
F000457,N00029016,Al Franken (D),2014,Ideology/Single-Issue,558277,538380,1096657
F000457,N00029016,Al Franken (D),2014,Other,1852860,13000,1865860
H001047,N00029070,Jim Himes (D),2014,Agribusiness,5200,6500,11700
H001047,N00029070,Jim Himes (D),2014,Communic/Electronics,35750,36500,72250
H001047,N00029070,Jim Himes (D),2014,Construction,17650,7500,25150
H001047,N00029070,Jim Himes (D),2014,Defense,0,29000,29000
H001047,N00029070,Jim Himes (D),2014,Energy/Nat Resource,8100,23500,31600
H001047,N00029070,Jim Himes (D),2014,Finance/Insur/RealEst,504838,639000,1143838
H001047,N00029070,Jim Himes (D),2014,Health,28350,84000,112350
H001047,N00029070,Jim Himes (D),2014,Lawyers & Lobbyists,126536,26000,152536
H001047,N00029070,Jim Himes (D),2014,Transportation,15500,8000,23500
H001047,N00029070,Jim Himes (D),2014,Misc Business,142300,71647,213947
H001047,N00029070,Jim Himes (D),2014,Labor,250,100000,100250
H001047,N00029070,Jim Himes (D),2014,Ideology/Single-Issue,22000,21000,43000
H001047,N00029070,Jim Himes (D),2014,Other,279820,0,279820
F000454,N00029139,Bill Foster (D),2014,Agribusiness,250,26441,26691
F000454,N00029139,Bill Foster (D),2014,Communic/Electronics,51600,25090,76690
F000454,N00029139,Bill Foster (D),2014,Construction,13250,3000,16250
F000454,N00029139,Bill Foster (D),2014,Defense,16500,9000,25500
F000454,N00029139,Bill Foster (D),2014,Energy/Nat Resource,32200,24000,56200
F000454,N00029139,Bill Foster (D),2014,Finance/Insur/RealEst,193450,301400,494850
F000454,N00029139,Bill Foster (D),2014,Health,65950,29500,95450
F000454,N00029139,Bill Foster (D),2014,Lawyers & Lobbyists,175312,27499,202811
F000454,N00029139,Bill Foster (D),2014,Transportation,3750,10000,13750
F000454,N00029139,Bill Foster (D),2014,Misc Business,84126,30104,114230
F000454,N00029139,Bill Foster (D),2014,Labor,2300,186500,188800
F000454,N00029139,Bill Foster (D),2014,Ideology/Single-Issue,189063,113838,302901
F000454,N00029139,Bill Foster (D),2014,Other,629917,0,629917
H001052,N00029147,Andy Harris (R),2014,Agribusiness,23250,25700,48950
H001052,N00029147,Andy Harris (R),2014,Communic/Electronics,1950,9500,11450
H001052,N00029147,Andy Harris (R),2014,Construction,16600,18000,34600
H001052,N00029147,Andy Harris (R),2014,Defense,7000,29019,36019
H001052,N00029147,Andy Harris (R),2014,Energy/Nat Resource,8450,61000,69450
H001052,N00029147,Andy Harris (R),2014,Finance/Insur/RealEst,72943,27000,99943
H001052,N00029147,Andy Harris (R),2014,Health,223954,149500,373454
H001052,N00029147,Andy Harris (R),2014,Lawyers & Lobbyists,30850,4500,35350
H001052,N00029147,Andy Harris (R),2014,Transportation,7400,39500,46900
H001052,N00029147,Andy Harris (R),2014,Misc Business,45585,48776,94361
H001052,N00029147,Andy Harris (R),2014,Labor,0,3500,3500
H001052,N00029147,Andy Harris (R),2014,Ideology/Single-Issue,15950,36756,52706
H001052,N00029147,Andy Harris (R),2014,Other,103815,1000,104815
H001048,N00029258,Duncan D Hunter (R),2014,Agribusiness,2500,33000,35500
H001048,N00029258,Duncan D Hunter (R),2014,Communic/Electronics,16550,33750,50300
H001048,N00029258,Duncan D Hunter (R),2014,Construction,14600,42000,56600
H001048,N00029258,Duncan D Hunter (R),2014,Defense,5500,193365,198865
H001048,N00029258,Duncan D Hunter (R),2014,Energy/Nat Resource,44400,20500,64900
H001048,N00029258,Duncan D Hunter (R),2014,Finance/Insur/RealEst,35700,68000,103700
H001048,N00029258,Duncan D Hunter (R),2014,Health,2400,37000,39400
H001048,N00029258,Duncan D Hunter (R),2014,Lawyers & Lobbyists,42441,24073,66514
H001048,N00029258,Duncan D Hunter (R),2014,Transportation,60300,184250,244550
H001048,N00029258,Duncan D Hunter (R),2014,Misc Business,38550,75500,114050
H001048,N00029258,Duncan D Hunter (R),2014,Labor,0,59000,59000
H001048,N00029258,Duncan D Hunter (R),2014,Ideology/Single-Issue,6550,38600,45150
H001048,N00029258,Duncan D Hunter (R),2014,Other,17350,17000,34350
C001072,N00029513,Andre Carson (D),2014,Agribusiness,250,9500,9750
C001072,N00029513,Andre Carson (D),2014,Communic/Electronics,11400,15500,26900
C001072,N00029513,Andre Carson (D),2014,Construction,29850,11500,41350
C001072,N00029513,Andre Carson (D),2014,Defense,250,64500,64750
C001072,N00029513,Andre Carson (D),2014,Energy/Nat Resource,3500,12000,15500
C001072,N00029513,Andre Carson (D),2014,Finance/Insur/RealEst,55700,50000,105700
C001072,N00029513,Andre Carson (D),2014,Health,113980,29500,143480
C001072,N00029513,Andre Carson (D),2014,Lawyers & Lobbyists,81571,26800,108371
C001072,N00029513,Andre Carson (D),2014,Transportation,4800,83621,88421
C001072,N00029513,Andre Carson (D),2014,Misc Business,30184,24000,54184
C001072,N00029513,Andre Carson (D),2014,Labor,650,183250,183900
C001072,N00029513,Andre Carson (D),2014,Ideology/Single-Issue,15145,38437,53582
C001072,N00029513,Andre Carson (D),2014,Other,45700,2000,47700
H001049,N00029617,Kay R Hagan (D),2014,Agribusiness,165624,252306,417930
H001049,N00029617,Kay R Hagan (D),2014,Communic/Electronics,408425,234516,642941
H001049,N00029617,Kay R Hagan (D),2014,Construction,107010,31500,138510
H001049,N00029617,Kay R Hagan (D),2014,Defense,29302,117000,146302
H001049,N00029617,Kay R Hagan (D),2014,Energy/Nat Resource,76314,103000,179314
H001049,N00029617,Kay R Hagan (D),2014,Finance/Insur/RealEst,861506,920633,1782139
H001049,N00029617,Kay R Hagan (D),2014,Health,427240,653259,1080499
H001049,N00029617,Kay R Hagan (D),2014,Lawyers & Lobbyists,1035642,183500,1219142
H001049,N00029617,Kay R Hagan (D),2014,Transportation,67482,78500,145982
H001049,N00029617,Kay R Hagan (D),2014,Misc Business,393019,287613,680632
H001049,N00029617,Kay R Hagan (D),2014,Labor,1500,271000,272500
H001049,N00029617,Kay R Hagan (D),2014,Ideology/Single-Issue,1287838,776188,2064026
H001049,N00029617,Kay R Hagan (D),2014,Other,1898009,19500,1917509
H001045,N00029632,Gregg Harper (R),2014,Agribusiness,17300,64000,81300
H001045,N00029632,Gregg Harper (R),2014,Communic/Electronics,10000,57000,67000
H001045,N00029632,Gregg Harper (R),2014,Construction,57750,6250,64000
H001045,N00029632,Gregg Harper (R),2014,Defense,5000,47000,52000
H001045,N00029632,Gregg Harper (R),2014,Energy/Nat Resource,75300,121000,196300
H001045,N00029632,Gregg Harper (R),2014,Finance/Insur/RealEst,102450,62500,164950
H001045,N00029632,Gregg Harper (R),2014,Health,74250,66000,140250
H001045,N00029632,Gregg Harper (R),2014,Lawyers & Lobbyists,61150,15000,76150
H001045,N00029632,Gregg Harper (R),2014,Transportation,45050,27500,72550
H001045,N00029632,Gregg Harper (R),2014,Misc Business,60750,36100,96850
H001045,N00029632,Gregg Harper (R),2014,Ideology/Single-Issue,3000,23275,26275
H001045,N00029632,Gregg Harper (R),2014,Other,53850,1000,54850
G000558,N00029675,Brett Guthrie (R),2014,Agribusiness,23500,74865,98365
G000558,N00029675,Brett Guthrie (R),2014,Communic/Electronics,6200,149000,155200
G000558,N00029675,Brett Guthrie (R),2014,Construction,32949,53600,86549
G000558,N00029675,Brett Guthrie (R),2014,Defense,0,32500,32500
G000558,N00029675,Brett Guthrie (R),2014,Energy/Nat Resource,5350,127000,132350
G000558,N00029675,Brett Guthrie (R),2014,Finance/Insur/RealEst,36850,152000,188850
G000558,N00029675,Brett Guthrie (R),2014,Health,48607,436450,485057
G000558,N00029675,Brett Guthrie (R),2014,Lawyers & Lobbyists,67700,10000,77700
G000558,N00029675,Brett Guthrie (R),2014,Transportation,10150,62500,72650
G000558,N00029675,Brett Guthrie (R),2014,Misc Business,48650,142903,191553
G000558,N00029675,Brett Guthrie (R),2014,Labor,0,13000,13000
G000558,N00029675,Brett Guthrie (R),2014,Ideology/Single-Issue,250,19437,19687
G000558,N00029675,Brett Guthrie (R),2014,Other,62145,19500,81645
F000456,N00029679,John Fleming (R),2014,Agribusiness,54750,22500,77250
F000456,N00029679,John Fleming (R),2014,Communic/Electronics,17400,8000,25400
F000456,N00029679,John Fleming (R),2014,Construction,49377,13000,62377
F000456,N00029679,John Fleming (R),2014,Defense,0,37500,37500
F000456,N00029679,John Fleming (R),2014,Energy/Nat Resource,161550,50000,211550
F000456,N00029679,John Fleming (R),2014,Finance/Insur/RealEst,149971,22500,172471
F000456,N00029679,John Fleming (R),2014,Health,197677,72000,269677
F000456,N00029679,John Fleming (R),2014,Lawyers & Lobbyists,35150,2000,37150
F000456,N00029679,John Fleming (R),2014,Transportation,46300,22000,68300
F000456,N00029679,John Fleming (R),2014,Misc Business,59000,23052,82052
F000456,N00029679,John Fleming (R),2014,Ideology/Single-Issue,29000,31937,60937
F000456,N00029679,John Fleming (R),2014,Other,63750,500,64250
H001046,N00029835,Martin Heinrich (D),2014,Agribusiness,48333,31250,79583
H001046,N00029835,Martin Heinrich (D),2014,Communic/Electronics,174610,62200,236810
H001046,N00029835,Martin Heinrich (D),2014,Construction,59655,4000,63655
H001046,N00029835,Martin Heinrich (D),2014,Defense,22750,50500,73250
H001046,N00029835,Martin Heinrich (D),2014,Energy/Nat Resource,90450,86000,176450
H001046,N00029835,Martin Heinrich (D),2014,Finance/Insur/RealEst,316071,76760,392831
H001046,N00029835,Martin Heinrich (D),2014,Health,177916,176000,353916
H001046,N00029835,Martin Heinrich (D),2014,Lawyers & Lobbyists,869284,60399,929683
H001046,N00029835,Martin Heinrich (D),2014,Transportation,9050,10500,19550
H001046,N00029835,Martin Heinrich (D),2014,Misc Business,401217,53250,454467
H001046,N00029835,Martin Heinrich (D),2014,Labor,1797,287500,289297
H001046,N00029835,Martin Heinrich (D),2014,Ideology/Single-Issue,516466,395399,911865
H001046,N00029835,Martin Heinrich (D),2014,Other,826163,14000,840163
C001078,N00029891,Gerry Connolly (D),2014,Agribusiness,1750,22500,24250
C001078,N00029891,Gerry Connolly (D),2014,Communic/Electronics,61817,131004,192821
C001078,N00029891,Gerry Connolly (D),2014,Construction,26550,52000,78550
C001078,N00029891,Gerry Connolly (D),2014,Defense,15480,127500,142980
C001078,N00029891,Gerry Connolly (D),2014,Energy/Nat Resource,5400,19000,24400
C001078,N00029891,Gerry Connolly (D),2014,Finance/Insur/RealEst,83950,98500,182450
C001078,N00029891,Gerry Connolly (D),2014,Health,26750,64000,90750
C001078,N00029891,Gerry Connolly (D),2014,Lawyers & Lobbyists,87017,25750,112767
C001078,N00029891,Gerry Connolly (D),2014,Transportation,11700,29000,40700
C001078,N00029891,Gerry Connolly (D),2014,Misc Business,71923,65000,136923
C001078,N00029891,Gerry Connolly (D),2014,Labor,1300,249000,250300
C001078,N00029891,Gerry Connolly (D),2014,Ideology/Single-Issue,33850,50900,84750
C001078,N00029891,Gerry Connolly (D),2014,Other,125803,1000,126803
B001265,N00029901,Mark Begich (D),2014,Agribusiness,50450,47500,97950
B001265,N00029901,Mark Begich (D),2014,Communic/Electronics,409648,261834,671482
B001265,N00029901,Mark Begich (D),2014,Construction,89300,91000,180300
B001265,N00029901,Mark Begich (D),2014,Defense,750,86500,87250
B001265,N00029901,Mark Begich (D),2014,Energy/Nat Resource,327811,368600,696411
B001265,N00029901,Mark Begich (D),2014,Finance/Insur/RealEst,743100,360721,1103821
B001265,N00029901,Mark Begich (D),2014,Health,230851,256150,487001
B001265,N00029901,Mark Begich (D),2014,Lawyers & Lobbyists,1219530,193343,1412873
B001265,N00029901,Mark Begich (D),2014,Transportation,142127,288750,430877
B001265,N00029901,Mark Begich (D),2014,Misc Business,529065,222050,751115
B001265,N00029901,Mark Begich (D),2014,Labor,13727,380000,393727
B001265,N00029901,Mark Begich (D),2014,Ideology/Single-Issue,619565,734921,1354486
B001265,N00029901,Mark Begich (D),2014,Other,636335,7500,643835
G000573,N00029908,Joe Garcia (D),2014,Agribusiness,55150,21979,77129
G000573,N00029908,Joe Garcia (D),2014,Communic/Electronics,100573,84500,185073
G000573,N00029908,Joe Garcia (D),2014,Construction,116144,2000,118144
G000573,N00029908,Joe Garcia (D),2014,Defense,500,6500,7000
G000573,N00029908,Joe Garcia (D),2014,Energy/Nat Resource,9000,23250,32250
G000573,N00029908,Joe Garcia (D),2014,Finance/Insur/RealEst,402072,67500,469572
G000573,N00029908,Joe Garcia (D),2014,Health,124750,82600,207350
G000573,N00029908,Joe Garcia (D),2014,Lawyers & Lobbyists,438558,44345,482903
G000573,N00029908,Joe Garcia (D),2014,Transportation,35600,27500,63100
G000573,N00029908,Joe Garcia (D),2014,Misc Business,276706,48405,325111
G000573,N00029908,Joe Garcia (D),2014,Labor,0,215000,215000
G000573,N00029908,Joe Garcia (D),2014,Ideology/Single-Issue,133738,377965,511703
G000573,N00029908,Joe Garcia (D),2014,Other,317085,2000,319085
H001051,N00030197,Richard Hanna (R),2014,Agribusiness,1500,14500,16000
H001051,N00030197,Richard Hanna (R),2014,Communic/Electronics,4500,21200,25700
H001051,N00030197,Richard Hanna (R),2014,Construction,32490,84000,116490
H001051,N00030197,Richard Hanna (R),2014,Defense,0,15500,15500
H001051,N00030197,Richard Hanna (R),2014,Energy/Nat Resource,3100,17500,20600
H001051,N00030197,Richard Hanna (R),2014,Finance/Insur/RealEst,72802,65500,138302
H001051,N00030197,Richard Hanna (R),2014,Health,6500,39000,45500
H001051,N00030197,Richard Hanna (R),2014,Lawyers & Lobbyists,41247,4750,45997
H001051,N00030197,Richard Hanna (R),2014,Transportation,4750,94500,99250
H001051,N00030197,Richard Hanna (R),2014,Misc Business,26745,46000,72745
H001051,N00030197,Richard Hanna (R),2014,Labor,0,71840,71840
H001051,N00030197,Richard Hanna (R),2014,Ideology/Single-Issue,8800,129699,138499
H001051,N00030197,Richard Hanna (R),2014,Other,26350,0,26350
C001075,N00030245,Bill Cassidy (R),2014,Agribusiness,249583,89800,339383
C001075,N00030245,Bill Cassidy (R),2014,Communic/Electronics,197774,41250,239024
C001075,N00030245,Bill Cassidy (R),2014,Construction,481275,44300,525575
C001075,N00030245,Bill Cassidy (R),2014,Defense,4600,0,4600
C001075,N00030245,Bill Cassidy (R),2014,Energy/Nat Resource,895670,170500,1066170
C001075,N00030245,Bill Cassidy (R),2014,Finance/Insur/RealEst,1956135,134975,2091110
C001075,N00030245,Bill Cassidy (R),2014,Health,1099015,487606,1586621
C001075,N00030245,Bill Cassidy (R),2014,Lawyers & Lobbyists,369785,17000,386785
C001075,N00030245,Bill Cassidy (R),2014,Transportation,398740,104250,502990
C001075,N00030245,Bill Cassidy (R),2014,Misc Business,936766,142100,1078866
C001075,N00030245,Bill Cassidy (R),2014,Labor,0,4500,4500
C001075,N00030245,Bill Cassidy (R),2014,Ideology/Single-Issue,361861,797667,1159528
C001075,N00030245,Bill Cassidy (R),2014,Other,1238566,5500,1244066
F000455,N00030490,Marcia L Fudge (D),2014,Agribusiness,1250,113286,114536
F000455,N00030490,Marcia L Fudge (D),2014,Communic/Electronics,2600,45000,47600
F000455,N00030490,Marcia L Fudge (D),2014,Construction,1800,5500,7300
F000455,N00030490,Marcia L Fudge (D),2014,Defense,0,15500,15500
F000455,N00030490,Marcia L Fudge (D),2014,Energy/Nat Resource,6450,53500,59950
F000455,N00030490,Marcia L Fudge (D),2014,Finance/Insur/RealEst,21900,97500,119400
F000455,N00030490,Marcia L Fudge (D),2014,Health,1250,66000,67250
F000455,N00030490,Marcia L Fudge (D),2014,Lawyers & Lobbyists,27719,27850,55569
F000455,N00030490,Marcia L Fudge (D),2014,Transportation,250,42000,42250
F000455,N00030490,Marcia L Fudge (D),2014,Misc Business,9400,91250,100650
F000455,N00030490,Marcia L Fudge (D),2014,Labor,0,177100,177100
F000455,N00030490,Marcia L Fudge (D),2014,Ideology/Single-Issue,38452,27599,66051
F000455,N00030490,Marcia L Fudge (D),2014,Other,22775,7000,29775
C001080,N00030600,Judy Chu (D),2014,Agribusiness,11500,17000,28500
C001080,N00030600,Judy Chu (D),2014,Communic/Electronics,22500,65590,88090
C001080,N00030600,Judy Chu (D),2014,Construction,6300,3550,9850
C001080,N00030600,Judy Chu (D),2014,Defense,0,7000,7000
C001080,N00030600,Judy Chu (D),2014,Energy/Nat Resource,8500,5600,14100
C001080,N00030600,Judy Chu (D),2014,Finance/Insur/RealEst,82975,23500,106475
C001080,N00030600,Judy Chu (D),2014,Health,63608,22500,86108
C001080,N00030600,Judy Chu (D),2014,Lawyers & Lobbyists,51290,16000,67290
C001080,N00030600,Judy Chu (D),2014,Transportation,10500,7500,18000
C001080,N00030600,Judy Chu (D),2014,Misc Business,40100,19600,59700
C001080,N00030600,Judy Chu (D),2014,Labor,250,160500,160750
C001080,N00030600,Judy Chu (D),2014,Ideology/Single-Issue,8250,13650,21900
C001080,N00030600,Judy Chu (D),2014,Other,53794,1000,54794
B001267,N00030608,Michael F Bennet (D),2014,Agribusiness,134591,155270,289861
B001267,N00030608,Michael F Bennet (D),2014,Communic/Electronics,818031,192088,1010119
B001267,N00030608,Michael F Bennet (D),2014,Construction,177965,22500,200465
B001267,N00030608,Michael F Bennet (D),2014,Defense,10400,62000,72400
B001267,N00030608,Michael F Bennet (D),2014,Energy/Nat Resource,186761,162995,349756
B001267,N00030608,Michael F Bennet (D),2014,Finance/Insur/RealEst,2562186,650885,3213071
B001267,N00030608,Michael F Bennet (D),2014,Health,385207,492200,877407
B001267,N00030608,Michael F Bennet (D),2014,Lawyers & Lobbyists,1741020,215201,1956221
B001267,N00030608,Michael F Bennet (D),2014,Transportation,64300,78299,142599
B001267,N00030608,Michael F Bennet (D),2014,Misc Business,746362,235021,981383
B001267,N00030608,Michael F Bennet (D),2014,Labor,2100,268000,270100
B001267,N00030608,Michael F Bennet (D),2014,Ideology/Single-Issue,493941,491983,985924
B001267,N00030608,Michael F Bennet (D),2014,Other,1452593,42600,1495193
H001058,N00030673,Bill Huizenga (R),2014,Agribusiness,32800,24000,56800
H001058,N00030673,Bill Huizenga (R),2014,Communic/Electronics,8950,11500,20450
H001058,N00030673,Bill Huizenga (R),2014,Construction,11050,22500,33550
H001058,N00030673,Bill Huizenga (R),2014,Defense,5700,20000,25700
H001058,N00030673,Bill Huizenga (R),2014,Energy/Nat Resource,2150,34500,36650
H001058,N00030673,Bill Huizenga (R),2014,Finance/Insur/RealEst,80600,459580,540180
H001058,N00030673,Bill Huizenga (R),2014,Health,17950,14000,31950
H001058,N00030673,Bill Huizenga (R),2014,Lawyers & Lobbyists,23623,22003,45626
H001058,N00030673,Bill Huizenga (R),2014,Transportation,17600,18000,35600
H001058,N00030673,Bill Huizenga (R),2014,Misc Business,138363,49692,188055
H001058,N00030673,Bill Huizenga (R),2014,Ideology/Single-Issue,30300,41700,72000
H001058,N00030673,Bill Huizenga (R),2014,Other,49180,0,49180
D000617,N00030693,Suzan DelBene (D),2014,Agribusiness,8100,90750,98850
D000617,N00030693,Suzan DelBene (D),2014,Communic/Electronics,153650,129135,282785
D000617,N00030693,Suzan DelBene (D),2014,Construction,4500,5000,9500
D000617,N00030693,Suzan DelBene (D),2014,Defense,500,27500,28000
D000617,N00030693,Suzan DelBene (D),2014,Energy/Nat Resource,22850,27999,50849
D000617,N00030693,Suzan DelBene (D),2014,Finance/Insur/RealEst,54225,122000,176225
D000617,N00030693,Suzan DelBene (D),2014,Health,33525,66000,99525
D000617,N00030693,Suzan DelBene (D),2014,Lawyers & Lobbyists,103500,24750,128250
D000617,N00030693,Suzan DelBene (D),2014,Transportation,7600,20500,28100
D000617,N00030693,Suzan DelBene (D),2014,Misc Business,115119,103307,218426
D000617,N00030693,Suzan DelBene (D),2014,Labor,0,244000,244000
D000617,N00030693,Suzan DelBene (D),2014,Ideology/Single-Issue,157125,255215,412340
D000617,N00030693,Suzan DelBene (D),2014,Other,197375,0,197375
D000623,N00030709,Mark Desaulnier (D),2014,Agribusiness,500,13000,13500
D000623,N00030709,Mark Desaulnier (D),2014,Communic/Electronics,1250,6500,7750
D000623,N00030709,Mark Desaulnier (D),2014,Construction,13273,14500,27773
D000623,N00030709,Mark Desaulnier (D),2014,Defense,0,2000,2000
D000623,N00030709,Mark Desaulnier (D),2014,Energy/Nat Resource,10000,11000,21000
D000623,N00030709,Mark Desaulnier (D),2014,Finance/Insur/RealEst,15050,16000,31050
D000623,N00030709,Mark Desaulnier (D),2014,Health,3250,24000,27250
D000623,N00030709,Mark Desaulnier (D),2014,Lawyers & Lobbyists,26150,11000,37150
D000623,N00030709,Mark Desaulnier (D),2014,Transportation,0,11000,11000
D000623,N00030709,Mark Desaulnier (D),2014,Misc Business,10550,7500,18050
D000623,N00030709,Mark Desaulnier (D),2014,Labor,0,171700,171700
D000623,N00030709,Mark Desaulnier (D),2014,Ideology/Single-Issue,2500,43965,46465
D000623,N00030709,Mark Desaulnier (D),2014,Other,24332,0,24332
B001287,N00030717,Ami Bera (D),2014,Agribusiness,13300,36200,49500
B001287,N00030717,Ami Bera (D),2014,Communic/Electronics,120950,54590,175540
B001287,N00030717,Ami Bera (D),2014,Construction,37901,1000,38901
B001287,N00030717,Ami Bera (D),2014,Defense,10700,23000,33700
B001287,N00030717,Ami Bera (D),2014,Energy/Nat Resource,28000,9500,37500
B001287,N00030717,Ami Bera (D),2014,Finance/Insur/RealEst,269697,129911,399608
B001287,N00030717,Ami Bera (D),2014,Health,189294,345250,534544
B001287,N00030717,Ami Bera (D),2014,Lawyers & Lobbyists,151981,18750,170731
B001287,N00030717,Ami Bera (D),2014,Transportation,1500,8500,10000
B001287,N00030717,Ami Bera (D),2014,Misc Business,153000,73026,226026
B001287,N00030717,Ami Bera (D),2014,Labor,500,265740,266240
B001287,N00030717,Ami Bera (D),2014,Ideology/Single-Issue,295930,499926,795856
B001287,N00030717,Ami Bera (D),2014,Other,569003,1000,570003
C001083,N00030736,John Carney (D),2014,Agribusiness,0,5250,5250
C001083,N00030736,John Carney (D),2014,Communic/Electronics,250,22500,22750
C001083,N00030736,John Carney (D),2014,Construction,5450,9000,14450
C001083,N00030736,John Carney (D),2014,Defense,275,19000,19275
C001083,N00030736,John Carney (D),2014,Energy/Nat Resource,0,18750,18750
C001083,N00030736,John Carney (D),2014,Finance/Insur/RealEst,66429,553949,620378
C001083,N00030736,John Carney (D),2014,Health,11120,83448,94568
C001083,N00030736,John Carney (D),2014,Lawyers & Lobbyists,101400,23750,125150
C001083,N00030736,John Carney (D),2014,Transportation,550,4000,4550
C001083,N00030736,John Carney (D),2014,Misc Business,30725,45004,75729
C001083,N00030736,John Carney (D),2014,Labor,0,54000,54000
C001083,N00030736,John Carney (D),2014,Ideology/Single-Issue,3600,10000,13600
C001083,N00030736,John Carney (D),2014,Other,27780,0,27780
D000615,N00030752,Jeff Duncan (R),2014,Agribusiness,7755,36500,44255
D000615,N00030752,Jeff Duncan (R),2014,Communic/Electronics,2000,17000,19000
D000615,N00030752,Jeff Duncan (R),2014,Construction,8850,13500,22350
D000615,N00030752,Jeff Duncan (R),2014,Defense,0,19500,19500
D000615,N00030752,Jeff Duncan (R),2014,Energy/Nat Resource,5150,64500,69650
D000615,N00030752,Jeff Duncan (R),2014,Finance/Insur/RealEst,31375,35500,66875
D000615,N00030752,Jeff Duncan (R),2014,Health,14700,61500,76200
D000615,N00030752,Jeff Duncan (R),2014,Lawyers & Lobbyists,16000,3500,19500
D000615,N00030752,Jeff Duncan (R),2014,Transportation,9100,28000,37100
D000615,N00030752,Jeff Duncan (R),2014,Misc Business,17445,35878,53323
D000615,N00030752,Jeff Duncan (R),2014,Labor,0,1000,1000
D000615,N00030752,Jeff Duncan (R),2014,Ideology/Single-Issue,6350,36850,43200
D000615,N00030752,Jeff Duncan (R),2014,Other,19350,0,19350
C001087,N00030770,Rick Crawford (R),2014,Agribusiness,71616,174330,245946
C001087,N00030770,Rick Crawford (R),2014,Communic/Electronics,1300,23000,24300
C001087,N00030770,Rick Crawford (R),2014,Construction,8250,19000,27250
C001087,N00030770,Rick Crawford (R),2014,Energy/Nat Resource,6800,19000,25800
C001087,N00030770,Rick Crawford (R),2014,Finance/Insur/RealEst,44673,42250,86923
C001087,N00030770,Rick Crawford (R),2014,Health,43897,18500,62397
C001087,N00030770,Rick Crawford (R),2014,Lawyers & Lobbyists,6100,9407,15507
C001087,N00030770,Rick Crawford (R),2014,Transportation,10364,61554,71918
C001087,N00030770,Rick Crawford (R),2014,Misc Business,27100,50500,77600
C001087,N00030770,Rick Crawford (R),2014,Labor,250,3000,3250
C001087,N00030770,Rick Crawford (R),2014,Ideology/Single-Issue,550,52100,52650
C001087,N00030770,Rick Crawford (R),2014,Other,22750,1000,23750
G000565,N00030771,Paul Gosar (R),2014,Agribusiness,6949,20750,27699
G000565,N00030771,Paul Gosar (R),2014,Communic/Electronics,2000,1000,3000
G000565,N00030771,Paul Gosar (R),2014,Construction,3766,9000,12766
G000565,N00030771,Paul Gosar (R),2014,Defense,250,8000,8250
G000565,N00030771,Paul Gosar (R),2014,Energy/Nat Resource,7350,55000,62350
G000565,N00030771,Paul Gosar (R),2014,Finance/Insur/RealEst,11550,13000,24550
G000565,N00030771,Paul Gosar (R),2014,Health,76150,83000,159150
G000565,N00030771,Paul Gosar (R),2014,Lawyers & Lobbyists,18800,2750,21550
G000565,N00030771,Paul Gosar (R),2014,Transportation,8700,6300,15000
G000565,N00030771,Paul Gosar (R),2014,Misc Business,39900,12052,51952
G000565,N00030771,Paul Gosar (R),2014,Ideology/Single-Issue,9000,20500,29500
G000565,N00030771,Paul Gosar (R),2014,Other,10500,0,10500
G000562,N00030780,Cory Gardner (R),2014,Agribusiness,349332,221800,571132
G000562,N00030780,Cory Gardner (R),2014,Communic/Electronics,197898,193200,391098
G000562,N00030780,Cory Gardner (R),2014,Construction,284110,87100,371210
G000562,N00030780,Cory Gardner (R),2014,Defense,17400,20500,37900
G000562,N00030780,Cory Gardner (R),2014,Energy/Nat Resource,703263,435950,1139213
G000562,N00030780,Cory Gardner (R),2014,Finance/Insur/RealEst,1803383,203600,2006983
G000562,N00030780,Cory Gardner (R),2014,Health,229558,230000,459558
G000562,N00030780,Cory Gardner (R),2014,Lawyers & Lobbyists,380998,30602,411600
G000562,N00030780,Cory Gardner (R),2014,Transportation,154290,63500,217790
G000562,N00030780,Cory Gardner (R),2014,Misc Business,735071,286307,1021378
G000562,N00030780,Cory Gardner (R),2014,Labor,0,5000,5000
G000562,N00030780,Cory Gardner (R),2014,Ideology/Single-Issue,409349,544732,954081
G000562,N00030780,Cory Gardner (R),2014,Other,1531341,24000,1555341
G000560,N00030788,Tom Graves (R),2014,Agribusiness,12300,52200,64500
G000560,N00030788,Tom Graves (R),2014,Communic/Electronics,1250,41000,42250
G000560,N00030788,Tom Graves (R),2014,Construction,17800,25000,42800
G000560,N00030788,Tom Graves (R),2014,Defense,500,27000,27500
G000560,N00030788,Tom Graves (R),2014,Energy/Nat Resource,7700,32000,39700
G000560,N00030788,Tom Graves (R),2014,Finance/Insur/RealEst,79450,118500,197950
G000560,N00030788,Tom Graves (R),2014,Health,33450,29000,62450
G000560,N00030788,Tom Graves (R),2014,Lawyers & Lobbyists,19300,8000,27300
G000560,N00030788,Tom Graves (R),2014,Transportation,37800,30000,67800
G000560,N00030788,Tom Graves (R),2014,Misc Business,81900,79250,161150
G000560,N00030788,Tom Graves (R),2014,Labor,0,5000,5000
G000560,N00030788,Tom Graves (R),2014,Ideology/Single-Issue,3800,37100,40900
G000560,N00030788,Tom Graves (R),2014,Other,42600,0,42600
G000570,N00030801,Frank Guinta (R),2014,Agribusiness,9100,5250,14350
G000570,N00030801,Frank Guinta (R),2014,Communic/Electronics,17050,8000,25050
G000570,N00030801,Frank Guinta (R),2014,Construction,16750,21500,38250
G000570,N00030801,Frank Guinta (R),2014,Defense,2600,22000,24600
G000570,N00030801,Frank Guinta (R),2014,Energy/Nat Resource,14200,23000,37200
G000570,N00030801,Frank Guinta (R),2014,Finance/Insur/RealEst,165400,64000,229400
G000570,N00030801,Frank Guinta (R),2014,Health,18550,26500,45050
G000570,N00030801,Frank Guinta (R),2014,Lawyers & Lobbyists,39425,1000,40425
G000570,N00030801,Frank Guinta (R),2014,Transportation,13500,13500,27000
G000570,N00030801,Frank Guinta (R),2014,Misc Business,90408,24500,114908
G000570,N00030801,Frank Guinta (R),2014,Ideology/Single-Issue,20000,340293,360293
G000570,N00030801,Frank Guinta (R),2014,Other,85900,0,85900
F000459,N00030815,Chuck Fleischmann (R),2014,Agribusiness,27950,36000,63950
F000459,N00030815,Chuck Fleischmann (R),2014,Communic/Electronics,8400,18500,26900
F000459,N00030815,Chuck Fleischmann (R),2014,Construction,108300,51500,159800
F000459,N00030815,Chuck Fleischmann (R),2014,Defense,3500,45500,49000
F000459,N00030815,Chuck Fleischmann (R),2014,Energy/Nat Resource,25900,51500,77400
F000459,N00030815,Chuck Fleischmann (R),2014,Finance/Insur/RealEst,157300,77400,234700
F000459,N00030815,Chuck Fleischmann (R),2014,Health,83550,72500,156050
F000459,N00030815,Chuck Fleischmann (R),2014,Lawyers & Lobbyists,51500,16500,68000
F000459,N00030815,Chuck Fleischmann (R),2014,Transportation,20250,64000,84250
F000459,N00030815,Chuck Fleischmann (R),2014,Misc Business,60450,73956,134406
F000459,N00030815,Chuck Fleischmann (R),2014,Labor,0,9000,9000
F000459,N00030815,Chuck Fleischmann (R),2014,Ideology/Single-Issue,500,159074,159574
F000459,N00030815,Chuck Fleischmann (R),2014,Other,61150,1000,62150
B001297,N00030829,Ken Buck (R),2014,Agribusiness,47100,26500,73600
B001297,N00030829,Ken Buck (R),2014,Communic/Electronics,52150,14000,66150
B001297,N00030829,Ken Buck (R),2014,Construction,64663,10500,75163
B001297,N00030829,Ken Buck (R),2014,Defense,3050,0,3050
B001297,N00030829,Ken Buck (R),2014,Energy/Nat Resource,81550,62300,143850
B001297,N00030829,Ken Buck (R),2014,Finance/Insur/RealEst,140500,31500,172000
B001297,N00030829,Ken Buck (R),2014,Health,42230,19500,61730
B001297,N00030829,Ken Buck (R),2014,Lawyers & Lobbyists,17565,2000,19565
B001297,N00030829,Ken Buck (R),2014,Transportation,40150,14000,54150
B001297,N00030829,Ken Buck (R),2014,Misc Business,83875,18500,102375
B001297,N00030829,Ken Buck (R),2014,Ideology/Single-Issue,51210,101741,152951
B001297,N00030829,Ken Buck (R),2014,Other,157500,0,157500
G000559,N00030856,John Garamendi (D),2014,Agribusiness,36375,75124,111499
G000559,N00030856,John Garamendi (D),2014,Communic/Electronics,9100,27250,36350
G000559,N00030856,John Garamendi (D),2014,Construction,26220,31000,57220
G000559,N00030856,John Garamendi (D),2014,Defense,500,59500,60000
G000559,N00030856,John Garamendi (D),2014,Energy/Nat Resource,10500,15000,25500
G000559,N00030856,John Garamendi (D),2014,Finance/Insur/RealEst,83785,45487,129272
G000559,N00030856,John Garamendi (D),2014,Health,26500,23250,49750
G000559,N00030856,John Garamendi (D),2014,Lawyers & Lobbyists,57986,23500,81486
G000559,N00030856,John Garamendi (D),2014,Transportation,12950,92427,105377
G000559,N00030856,John Garamendi (D),2014,Misc Business,58226,25500,83726
G000559,N00030856,John Garamendi (D),2014,Labor,520,284900,285420
G000559,N00030856,John Garamendi (D),2014,Ideology/Single-Issue,30950,62344,93294
G000559,N00030856,John Garamendi (D),2014,Other,37040,5000,42040
G000566,N00030880,Trey Gowdy (R),2014,Agribusiness,13800,24000,37800
G000566,N00030880,Trey Gowdy (R),2014,Communic/Electronics,9450,72750,82200
G000566,N00030880,Trey Gowdy (R),2014,Construction,6500,14500,21000
G000566,N00030880,Trey Gowdy (R),2014,Defense,250,15000,15250
G000566,N00030880,Trey Gowdy (R),2014,Energy/Nat Resource,2000,41500,43500
G000566,N00030880,Trey Gowdy (R),2014,Finance/Insur/RealEst,52100,94500,146600
G000566,N00030880,Trey Gowdy (R),2014,Health,14450,23000,37450
G000566,N00030880,Trey Gowdy (R),2014,Lawyers & Lobbyists,30000,6000,36000
G000566,N00030880,Trey Gowdy (R),2014,Transportation,7200,24000,31200
G000566,N00030880,Trey Gowdy (R),2014,Misc Business,17600,84554,102154
G000566,N00030880,Trey Gowdy (R),2014,Labor,0,3000,3000
G000566,N00030880,Trey Gowdy (R),2014,Ideology/Single-Issue,3500,24100,27600
G000566,N00030880,Trey Gowdy (R),2014,Other,14950,5500,20450
B001274,N00030910,Mo Brooks (R),2014,Agribusiness,5065,19000,24065
B001274,N00030910,Mo Brooks (R),2014,Communic/Electronics,20250,13200,33450
B001274,N00030910,Mo Brooks (R),2014,Construction,14450,7000,21450
B001274,N00030910,Mo Brooks (R),2014,Defense,39900,105600,145500
B001274,N00030910,Mo Brooks (R),2014,Energy/Nat Resource,0,26500,26500
B001274,N00030910,Mo Brooks (R),2014,Finance/Insur/RealEst,35600,26500,62100
B001274,N00030910,Mo Brooks (R),2014,Health,20250,31500,51750
B001274,N00030910,Mo Brooks (R),2014,Lawyers & Lobbyists,18010,15000,33010
B001274,N00030910,Mo Brooks (R),2014,Transportation,3600,10500,14100
B001274,N00030910,Mo Brooks (R),2014,Misc Business,15470,17500,32970
B001274,N00030910,Mo Brooks (R),2014,Ideology/Single-Issue,500,12500,13000
B001274,N00030910,Mo Brooks (R),2014,Other,34668,1000,35668
D000616,N00030957,Scott Desjarlais (R),2014,Agribusiness,22350,12000,34350
D000616,N00030957,Scott Desjarlais (R),2014,Communic/Electronics,5900,0,5900
D000616,N00030957,Scott Desjarlais (R),2014,Construction,25250,2500,27750
D000616,N00030957,Scott Desjarlais (R),2014,Defense,1000,0,1000
D000616,N00030957,Scott Desjarlais (R),2014,Energy/Nat Resource,4000,0,4000
D000616,N00030957,Scott Desjarlais (R),2014,Finance/Insur/RealEst,43799,8000,51799
D000616,N00030957,Scott Desjarlais (R),2014,Health,93000,7500,100500
D000616,N00030957,Scott Desjarlais (R),2014,Lawyers & Lobbyists,21590,0,21590
D000616,N00030957,Scott Desjarlais (R),2014,Transportation,12000,8000,20000
D000616,N00030957,Scott Desjarlais (R),2014,Misc Business,51900,6788,58688
D000616,N00030957,Scott Desjarlais (R),2014,Ideology/Single-Issue,8550,86250,94800
D000616,N00030957,Scott Desjarlais (R),2014,Other,57091,750,57841
D000614,N00030967,Sean P Duffy (R),2014,Agribusiness,72850,62450,135300
D000614,N00030967,Sean P Duffy (R),2014,Communic/Electronics,22350,34500,56850
D000614,N00030967,Sean P Duffy (R),2014,Construction,51900,27000,78900
D000614,N00030967,Sean P Duffy (R),2014,Defense,0,15000,15000
D000614,N00030967,Sean P Duffy (R),2014,Energy/Nat Resource,15000,58000,73000
D000614,N00030967,Sean P Duffy (R),2014,Finance/Insur/RealEst,208254,542600,750854
D000614,N00030967,Sean P Duffy (R),2014,Health,86739,94894,181633
D000614,N00030967,Sean P Duffy (R),2014,Lawyers & Lobbyists,54083,9500,63583
D000614,N00030967,Sean P Duffy (R),2014,Transportation,29950,44600,74550
D000614,N00030967,Sean P Duffy (R),2014,Misc Business,142675,103206,245881
D000614,N00030967,Sean P Duffy (R),2014,Labor,0,28500,28500
D000614,N00030967,Sean P Duffy (R),2014,Ideology/Single-Issue,32235,139839,172074
D000614,N00030967,Sean P Duffy (R),2014,Other,157025,1000,158025
A000368,N00030980,Kelly Ayotte (R),2014,Agribusiness,44900,75550,120450
A000368,N00030980,Kelly Ayotte (R),2014,Communic/Electronics,219493,254594,474087
A000368,N00030980,Kelly Ayotte (R),2014,Construction,128788,47000,175788
A000368,N00030980,Kelly Ayotte (R),2014,Defense,12300,144400,156700
A000368,N00030980,Kelly Ayotte (R),2014,Energy/Nat Resource,222108,197800,419908
A000368,N00030980,Kelly Ayotte (R),2014,Finance/Insur/RealEst,1386233,461650,1847883
A000368,N00030980,Kelly Ayotte (R),2014,Health,218610,372999,591609
A000368,N00030980,Kelly Ayotte (R),2014,Lawyers & Lobbyists,610298,78087,688385
A000368,N00030980,Kelly Ayotte (R),2014,Transportation,95851,221700,317551
A000368,N00030980,Kelly Ayotte (R),2014,Misc Business,609658,321800,931458
A000368,N00030980,Kelly Ayotte (R),2014,Labor,0,36500,36500
A000368,N00030980,Kelly Ayotte (R),2014,Ideology/Single-Issue,255291,430129,685420
A000368,N00030980,Kelly Ayotte (R),2014,Other,601886,6000,607886
H001053,N00031005,Vicky Hartzler (R),2014,Agribusiness,62650,79550,142200
H001053,N00031005,Vicky Hartzler (R),2014,Communic/Electronics,1950,14000,15950
H001053,N00031005,Vicky Hartzler (R),2014,Construction,26900,6500,33400
H001053,N00031005,Vicky Hartzler (R),2014,Defense,7800,55000,62800
H001053,N00031005,Vicky Hartzler (R),2014,Energy/Nat Resource,17400,30000,47400
H001053,N00031005,Vicky Hartzler (R),2014,Finance/Insur/RealEst,87700,33000,120700
H001053,N00031005,Vicky Hartzler (R),2014,Health,40350,22000,62350
H001053,N00031005,Vicky Hartzler (R),2014,Lawyers & Lobbyists,30350,10000,40350
H001053,N00031005,Vicky Hartzler (R),2014,Transportation,14900,22500,37400
H001053,N00031005,Vicky Hartzler (R),2014,Misc Business,81900,21552,103452
H001053,N00031005,Vicky Hartzler (R),2014,Labor,0,1000,1000
H001053,N00031005,Vicky Hartzler (R),2014,Ideology/Single-Issue,16300,36995,53295
H001053,N00031005,Vicky Hartzler (R),2014,Other,60500,0,60500
C001106,N00031064,Ryan Costello (R),2014,Agribusiness,13900,19600,33500
C001106,N00031064,Ryan Costello (R),2014,Communic/Electronics,32500,23500,56000
C001106,N00031064,Ryan Costello (R),2014,Construction,75304,50000,125304
C001106,N00031064,Ryan Costello (R),2014,Defense,250,14000,14250
C001106,N00031064,Ryan Costello (R),2014,Energy/Nat Resource,11850,54750,66600
C001106,N00031064,Ryan Costello (R),2014,Finance/Insur/RealEst,140400,90600,231000
C001106,N00031064,Ryan Costello (R),2014,Health,27500,135450,162950
C001106,N00031064,Ryan Costello (R),2014,Lawyers & Lobbyists,95912,36999,132911
C001106,N00031064,Ryan Costello (R),2014,Transportation,29900,25000,54900
C001106,N00031064,Ryan Costello (R),2014,Misc Business,55200,89050,144250
C001106,N00031064,Ryan Costello (R),2014,Labor,0,29500,29500
C001106,N00031064,Ryan Costello (R),2014,Ideology/Single-Issue,37500,235899,273399
C001106,N00031064,Ryan Costello (R),2014,Other,88606,0,88606
D000613,N00031103,Bob Dold (R),2014,Agribusiness,52600,24500,77100
D000613,N00031103,Bob Dold (R),2014,Communic/Electronics,48600,14000,62600
D000613,N00031103,Bob Dold (R),2014,Construction,44500,35500,80000
D000613,N00031103,Bob Dold (R),2014,Defense,7800,6000,13800
D000613,N00031103,Bob Dold (R),2014,Energy/Nat Resource,24600,27000,51600
D000613,N00031103,Bob Dold (R),2014,Finance/Insur/RealEst,784600,100400,885000
D000613,N00031103,Bob Dold (R),2014,Health,137975,44000,181975
D000613,N00031103,Bob Dold (R),2014,Lawyers & Lobbyists,278733,1500,280233
D000613,N00031103,Bob Dold (R),2014,Transportation,30900,31000,61900
D000613,N00031103,Bob Dold (R),2014,Misc Business,332053,79500,411553
D000613,N00031103,Bob Dold (R),2014,Labor,0,12500,12500
D000613,N00031103,Bob Dold (R),2014,Ideology/Single-Issue,142670,414550,557220
D000613,N00031103,Bob Dold (R),2014,Other,340524,3000,343524
H001059,N00031104,Randy Hultgren (R),2014,Agribusiness,2200,38208,40408
H001059,N00031104,Randy Hultgren (R),2014,Communic/Electronics,9750,7770,17520
H001059,N00031104,Randy Hultgren (R),2014,Construction,9250,41000,50250
H001059,N00031104,Randy Hultgren (R),2014,Defense,0,32000,32000
H001059,N00031104,Randy Hultgren (R),2014,Energy/Nat Resource,5000,49000,54000
H001059,N00031104,Randy Hultgren (R),2014,Finance/Insur/RealEst,85577,414000,499577
H001059,N00031104,Randy Hultgren (R),2014,Health,18600,37500,56100
H001059,N00031104,Randy Hultgren (R),2014,Lawyers & Lobbyists,24890,6000,30890
H001059,N00031104,Randy Hultgren (R),2014,Transportation,3850,23400,27250
H001059,N00031104,Randy Hultgren (R),2014,Misc Business,41350,38307,79657
H001059,N00031104,Randy Hultgren (R),2014,Labor,0,55000,55000
H001059,N00031104,Randy Hultgren (R),2014,Ideology/Single-Issue,7910,44488,52398
H001059,N00031104,Randy Hultgren (R),2014,Other,32150,750,32900
G000563,N00031128,Bob Gibbs (R),2014,Agribusiness,9400,146024,155424
G000563,N00031128,Bob Gibbs (R),2014,Communic/Electronics,23300,18000,41300
G000563,N00031128,Bob Gibbs (R),2014,Construction,43250,58000,101250
G000563,N00031128,Bob Gibbs (R),2014,Defense,500,0,500
G000563,N00031128,Bob Gibbs (R),2014,Energy/Nat Resource,36050,87000,123050
G000563,N00031128,Bob Gibbs (R),2014,Finance/Insur/RealEst,21922,60500,82422
G000563,N00031128,Bob Gibbs (R),2014,Health,8300,10500,18800
G000563,N00031128,Bob Gibbs (R),2014,Lawyers & Lobbyists,21000,14000,35000
G000563,N00031128,Bob Gibbs (R),2014,Transportation,10100,108000,118100
G000563,N00031128,Bob Gibbs (R),2014,Misc Business,63408,60302,123710
G000563,N00031128,Bob Gibbs (R),2014,Labor,0,33500,33500
G000563,N00031128,Bob Gibbs (R),2014,Ideology/Single-Issue,9500,105445,114945
G000563,N00031128,Bob Gibbs (R),2014,Other,25650,0,25650
F000458,N00031141,Steve Fincher (R),2014,Agribusiness,221465,149100,370565
F000458,N00031141,Steve Fincher (R),2014,Communic/Electronics,3000,13500,16500
F000458,N00031141,Steve Fincher (R),2014,Construction,112450,20000,132450
F000458,N00031141,Steve Fincher (R),2014,Defense,0,20000,20000
F000458,N00031141,Steve Fincher (R),2014,Energy/Nat Resource,15700,33500,49200
F000458,N00031141,Steve Fincher (R),2014,Finance/Insur/RealEst,128583,365911,494494
F000458,N00031141,Steve Fincher (R),2014,Health,53350,39000,92350
F000458,N00031141,Steve Fincher (R),2014,Lawyers & Lobbyists,33300,10035,43335
F000458,N00031141,Steve Fincher (R),2014,Transportation,10000,57500,67500
F000458,N00031141,Steve Fincher (R),2014,Misc Business,51700,68552,120252
F000458,N00031141,Steve Fincher (R),2014,Labor,0,16000,16000
F000458,N00031141,Steve Fincher (R),2014,Ideology/Single-Issue,2500,29362,31862
F000458,N00031141,Steve Fincher (R),2014,Other,43133,0,43133
A000369,N00031177,Mark Amodei (R),2014,Agribusiness,16800,14500,31300
A000369,N00031177,Mark Amodei (R),2014,Communic/Electronics,8600,34000,42600
A000369,N00031177,Mark Amodei (R),2014,Construction,21100,23000,44100
A000369,N00031177,Mark Amodei (R),2014,Defense,500,19500,20000
A000369,N00031177,Mark Amodei (R),2014,Energy/Nat Resource,2750,51750,54500
A000369,N00031177,Mark Amodei (R),2014,Finance/Insur/RealEst,25800,32999,58799
A000369,N00031177,Mark Amodei (R),2014,Health,5000,28500,33500
A000369,N00031177,Mark Amodei (R),2014,Lawyers & Lobbyists,45250,9000,54250
A000369,N00031177,Mark Amodei (R),2014,Transportation,13550,23500,37050
A000369,N00031177,Mark Amodei (R),2014,Misc Business,39400,68500,107900
A000369,N00031177,Mark Amodei (R),2014,Labor,0,3000,3000
A000369,N00031177,Mark Amodei (R),2014,Ideology/Single-Issue,20950,26550,47500
A000369,N00031177,Mark Amodei (R),2014,Other,34050,0,34050
B001275,N00031227,Larry Bucshon (R),2014,Agribusiness,13250,25500,38750
B001275,N00031227,Larry Bucshon (R),2014,Communic/Electronics,4900,13750,18650
B001275,N00031227,Larry Bucshon (R),2014,Construction,89452,29500,118952
B001275,N00031227,Larry Bucshon (R),2014,Defense,0,5500,5500
B001275,N00031227,Larry Bucshon (R),2014,Energy/Nat Resource,71050,64250,135300
B001275,N00031227,Larry Bucshon (R),2014,Finance/Insur/RealEst,64092,54600,118692
B001275,N00031227,Larry Bucshon (R),2014,Health,24601,168500,193101
B001275,N00031227,Larry Bucshon (R),2014,Lawyers & Lobbyists,29600,11826,41426
B001275,N00031227,Larry Bucshon (R),2014,Transportation,22450,72055,94505
B001275,N00031227,Larry Bucshon (R),2014,Misc Business,79400,30500,109900
B001275,N00031227,Larry Bucshon (R),2014,Labor,0,3500,3500
B001275,N00031227,Larry Bucshon (R),2014,Ideology/Single-Issue,1250,49778,51028
B001275,N00031227,Larry Bucshon (R),2014,Other,27450,0,27450
B001282,N00031233,Andy Barr (R),2014,Agribusiness,113730,42910,156640
B001282,N00031233,Andy Barr (R),2014,Communic/Electronics,8900,22000,30900
B001282,N00031233,Andy Barr (R),2014,Construction,93666,42000,135666
B001282,N00031233,Andy Barr (R),2014,Defense,0,9000,9000
B001282,N00031233,Andy Barr (R),2014,Energy/Nat Resource,170260,123500,293760
B001282,N00031233,Andy Barr (R),2014,Finance/Insur/RealEst,283783,454390,738173
B001282,N00031233,Andy Barr (R),2014,Health,66305,120250,186555
B001282,N00031233,Andy Barr (R),2014,Lawyers & Lobbyists,103475,16750,120225
B001282,N00031233,Andy Barr (R),2014,Transportation,45525,44500,90025
B001282,N00031233,Andy Barr (R),2014,Misc Business,127539,98200,225739
B001282,N00031233,Andy Barr (R),2014,Labor,0,2000,2000
B001282,N00031233,Andy Barr (R),2014,Ideology/Single-Issue,17550,134226,151776
B001282,N00031233,Andy Barr (R),2014,Other,179120,0,179120
H001055,N00031244,Joe Heck (R),2014,Agribusiness,5100,6000,11100
H001055,N00031244,Joe Heck (R),2014,Communic/Electronics,27550,40640,68190
H001055,N00031244,Joe Heck (R),2014,Construction,62009,36500,98509
H001055,N00031244,Joe Heck (R),2014,Defense,5250,84498,89748
H001055,N00031244,Joe Heck (R),2014,Energy/Nat Resource,17000,63000,80000
H001055,N00031244,Joe Heck (R),2014,Finance/Insur/RealEst,148048,127890,275938
H001055,N00031244,Joe Heck (R),2014,Health,181295,233349,414644
H001055,N00031244,Joe Heck (R),2014,Lawyers & Lobbyists,45960,27100,73060
H001055,N00031244,Joe Heck (R),2014,Transportation,28059,35199,63258
H001055,N00031244,Joe Heck (R),2014,Misc Business,235377,133722,369099
H001055,N00031244,Joe Heck (R),2014,Labor,0,30500,30500
H001055,N00031244,Joe Heck (R),2014,Ideology/Single-Issue,78650,250594,329244
H001055,N00031244,Joe Heck (R),2014,Other,120585,8000,128585
H001060,N00031265,Robert Hurt (R),2014,Agribusiness,20425,24500,44925
H001060,N00031265,Robert Hurt (R),2014,Communic/Electronics,2750,20500,23250
H001060,N00031265,Robert Hurt (R),2014,Construction,15200,7500,22700
H001060,N00031265,Robert Hurt (R),2014,Defense,3800,28000,31800
H001060,N00031265,Robert Hurt (R),2014,Energy/Nat Resource,13613,52000,65613
H001060,N00031265,Robert Hurt (R),2014,Finance/Insur/RealEst,60400,402099,462499
H001060,N00031265,Robert Hurt (R),2014,Health,16000,38500,54500
H001060,N00031265,Robert Hurt (R),2014,Lawyers & Lobbyists,46888,11750,58638
H001060,N00031265,Robert Hurt (R),2014,Transportation,10150,26500,36650
H001060,N00031265,Robert Hurt (R),2014,Misc Business,35400,27632,63032
H001060,N00031265,Robert Hurt (R),2014,Labor,0,2500,2500
H001060,N00031265,Robert Hurt (R),2014,Ideology/Single-Issue,3750,48852,52602
H001060,N00031265,Robert Hurt (R),2014,Other,96102,2000,98102
G000567,N00031297,Tim Griffin (R),2014,Agribusiness,10600,11500,22100
G000567,N00031297,Tim Griffin (R),2014,Communic/Electronics,0,13000,13000
G000567,N00031297,Tim Griffin (R),2014,Construction,6250,11500,17750
G000567,N00031297,Tim Griffin (R),2014,Defense,0,15000,15000
G000567,N00031297,Tim Griffin (R),2014,Energy/Nat Resource,12450,45000,57450
G000567,N00031297,Tim Griffin (R),2014,Finance/Insur/RealEst,48150,87500,135650
G000567,N00031297,Tim Griffin (R),2014,Health,16425,68500,84925
G000567,N00031297,Tim Griffin (R),2014,Lawyers & Lobbyists,24400,4750,29150
G000567,N00031297,Tim Griffin (R),2014,Transportation,8000,14100,22100
G000567,N00031297,Tim Griffin (R),2014,Misc Business,12560,36419,48979
G000567,N00031297,Tim Griffin (R),2014,Ideology/Single-Issue,1250,43017,44267
G000567,N00031297,Tim Griffin (R),2014,Other,14965,0,14965
D000610,N00031317,Ted Deutch (D),2014,Agribusiness,5000,3000,8000
D000610,N00031317,Ted Deutch (D),2014,Communic/Electronics,37350,80500,117850
D000610,N00031317,Ted Deutch (D),2014,Construction,6250,5000,11250
D000610,N00031317,Ted Deutch (D),2014,Defense,0,7000,7000
D000610,N00031317,Ted Deutch (D),2014,Energy/Nat Resource,500,13000,13500
D000610,N00031317,Ted Deutch (D),2014,Finance/Insur/RealEst,198037,37500,235537
D000610,N00031317,Ted Deutch (D),2014,Health,21750,24500,46250
D000610,N00031317,Ted Deutch (D),2014,Lawyers & Lobbyists,98500,27333,125833
D000610,N00031317,Ted Deutch (D),2014,Transportation,1500,8000,9500
D000610,N00031317,Ted Deutch (D),2014,Misc Business,52430,43000,95430
D000610,N00031317,Ted Deutch (D),2014,Labor,1000,90500,91500
D000610,N00031317,Ted Deutch (D),2014,Ideology/Single-Issue,78670,46700,125370
D000610,N00031317,Ted Deutch (D),2014,Other,58418,1000,59418
G000569,N00031401,Michael Grimm (R),2014,Agribusiness,8000,30527,38527
G000569,N00031401,Michael Grimm (R),2014,Communic/Electronics,17802,27000,44802
G000569,N00031401,Michael Grimm (R),2014,Construction,79575,16000,95575
G000569,N00031401,Michael Grimm (R),2014,Defense,0,5000,5000
G000569,N00031401,Michael Grimm (R),2014,Energy/Nat Resource,31482,18500,49982
G000569,N00031401,Michael Grimm (R),2014,Finance/Insur/RealEst,304376,315000,619376
G000569,N00031401,Michael Grimm (R),2014,Health,35715,39600,75315
G000569,N00031401,Michael Grimm (R),2014,Lawyers & Lobbyists,76530,10900,87430
G000569,N00031401,Michael Grimm (R),2014,Transportation,16450,10000,26450
G000569,N00031401,Michael Grimm (R),2014,Misc Business,102064,64043,166107
G000569,N00031401,Michael Grimm (R),2014,Labor,0,213000,213000
G000569,N00031401,Michael Grimm (R),2014,Ideology/Single-Issue,12310,177750,190060
G000569,N00031401,Michael Grimm (R),2014,Other,50386,0,50386
E000291,N00031513,Renee Ellmers (R),2014,Agribusiness,24400,123900,148300
E000291,N00031513,Renee Ellmers (R),2014,Communic/Electronics,12400,106504,118904
E000291,N00031513,Renee Ellmers (R),2014,Construction,29780,26000,55780
E000291,N00031513,Renee Ellmers (R),2014,Defense,0,29500,29500
E000291,N00031513,Renee Ellmers (R),2014,Energy/Nat Resource,1750,121000,122750
E000291,N00031513,Renee Ellmers (R),2014,Finance/Insur/RealEst,49750,109500,159250
E000291,N00031513,Renee Ellmers (R),2014,Health,24620,405233,429853
E000291,N00031513,Renee Ellmers (R),2014,Lawyers & Lobbyists,55900,33150,89050
E000291,N00031513,Renee Ellmers (R),2014,Transportation,1700,49000,50700
E000291,N00031513,Renee Ellmers (R),2014,Misc Business,39250,121547,160797
E000291,N00031513,Renee Ellmers (R),2014,Labor,0,14000,14000
E000291,N00031513,Renee Ellmers (R),2014,Ideology/Single-Issue,18550,138889,157439
E000291,N00031513,Renee Ellmers (R),2014,Other,43235,5000,48235
B001273,N00031539,Diane Black (R),2014,Agribusiness,15400,31500,46900
B001273,N00031539,Diane Black (R),2014,Communic/Electronics,2500,36500,39000
B001273,N00031539,Diane Black (R),2014,Construction,65575,27500,93075
B001273,N00031539,Diane Black (R),2014,Defense,750,30000,30750
B001273,N00031539,Diane Black (R),2014,Energy/Nat Resource,4125,67000,71125
B001273,N00031539,Diane Black (R),2014,Finance/Insur/RealEst,68550,218489,287039
B001273,N00031539,Diane Black (R),2014,Health,27021,272598,299619
B001273,N00031539,Diane Black (R),2014,Lawyers & Lobbyists,37894,13116,51010
B001273,N00031539,Diane Black (R),2014,Transportation,4000,52500,56500
B001273,N00031539,Diane Black (R),2014,Misc Business,43900,130499,174399
B001273,N00031539,Diane Black (R),2014,Ideology/Single-Issue,2400,33075,35475
B001273,N00031539,Diane Black (R),2014,Other,33850,1000,34850
F000461,N00031545,Bill Flores (R),2014,Agribusiness,17250,55514,72764
F000461,N00031545,Bill Flores (R),2014,Communic/Electronics,9150,24140,33290
F000461,N00031545,Bill Flores (R),2014,Construction,37150,17000,54150
F000461,N00031545,Bill Flores (R),2014,Defense,0,23000,23000
F000461,N00031545,Bill Flores (R),2014,Energy/Nat Resource,118189,155499,273688
F000461,N00031545,Bill Flores (R),2014,Finance/Insur/RealEst,60390,107000,167390
F000461,N00031545,Bill Flores (R),2014,Health,19650,120100,139750
F000461,N00031545,Bill Flores (R),2014,Lawyers & Lobbyists,40950,9500,50450
F000461,N00031545,Bill Flores (R),2014,Transportation,15400,56998,72398
F000461,N00031545,Bill Flores (R),2014,Misc Business,61650,51000,112650
F000461,N00031545,Bill Flores (R),2014,Labor,0,3000,3000
F000461,N00031545,Bill Flores (R),2014,Ideology/Single-Issue,3050,23874,26924
F000461,N00031545,Bill Flores (R),2014,Other,94940,5000,99940
H001064,N00031557,Dennis Heck (D),2014,Agribusiness,15600,8000,23600
H001064,N00031557,Dennis Heck (D),2014,Communic/Electronics,29250,45460,74710
H001064,N00031557,Dennis Heck (D),2014,Construction,15000,13750,28750
H001064,N00031557,Dennis Heck (D),2014,Defense,9400,26000,35400
H001064,N00031557,Dennis Heck (D),2014,Energy/Nat Resource,14750,16099,30849
H001064,N00031557,Dennis Heck (D),2014,Finance/Insur/RealEst,85549,344940,430489
H001064,N00031557,Dennis Heck (D),2014,Health,39601,64000,103601
H001064,N00031557,Dennis Heck (D),2014,Lawyers & Lobbyists,139755,21500,161255
H001064,N00031557,Dennis Heck (D),2014,Transportation,15510,19000,34510
H001064,N00031557,Dennis Heck (D),2014,Misc Business,86163,57499,143662
H001064,N00031557,Dennis Heck (D),2014,Labor,1700,198500,200200
H001064,N00031557,Dennis Heck (D),2014,Ideology/Single-Issue,17350,65500,82850
H001064,N00031557,Dennis Heck (D),2014,Other,140118,0,140118
H001056,N00031559,Jaime Herrera Beutler (R),2014,Agribusiness,35933,38500,74433
H001056,N00031559,Jaime Herrera Beutler (R),2014,Communic/Electronics,28660,27500,56160
H001056,N00031559,Jaime Herrera Beutler (R),2014,Construction,40100,29000,69100
H001056,N00031559,Jaime Herrera Beutler (R),2014,Defense,4400,34000,38400
H001056,N00031559,Jaime Herrera Beutler (R),2014,Energy/Nat Resource,14966,27895,42861
H001056,N00031559,Jaime Herrera Beutler (R),2014,Finance/Insur/RealEst,162850,61500,224350
H001056,N00031559,Jaime Herrera Beutler (R),2014,Health,27100,29000,56100
H001056,N00031559,Jaime Herrera Beutler (R),2014,Lawyers & Lobbyists,23050,12000,35050
H001056,N00031559,Jaime Herrera Beutler (R),2014,Transportation,25800,66500,92300
H001056,N00031559,Jaime Herrera Beutler (R),2014,Misc Business,90840,47350,138190
H001056,N00031559,Jaime Herrera Beutler (R),2014,Labor,0,17000,17000
H001056,N00031559,Jaime Herrera Beutler (R),2014,Ideology/Single-Issue,42950,158957,201907
H001056,N00031559,Jaime Herrera Beutler (R),2014,Other,130625,0,130625
D000612,N00031593,Jeff Denham (R),2014,Agribusiness,385892,269223,655115
D000612,N00031593,Jeff Denham (R),2014,Communic/Electronics,8600,59400,68000
D000612,N00031593,Jeff Denham (R),2014,Construction,86058,68500,154558
D000612,N00031593,Jeff Denham (R),2014,Defense,250,7500,7750
D000612,N00031593,Jeff Denham (R),2014,Energy/Nat Resource,23650,90096,113746
D000612,N00031593,Jeff Denham (R),2014,Finance/Insur/RealEst,126581,143500,270081
D000612,N00031593,Jeff Denham (R),2014,Health,33500,89499,122999
D000612,N00031593,Jeff Denham (R),2014,Lawyers & Lobbyists,84250,29000,113250
D000612,N00031593,Jeff Denham (R),2014,Transportation,69109,182000,251109
D000612,N00031593,Jeff Denham (R),2014,Misc Business,164336,104805,269141
D000612,N00031593,Jeff Denham (R),2014,Labor,0,52000,52000
D000612,N00031593,Jeff Denham (R),2014,Ideology/Single-Issue,48577,302895,351472
D000612,N00031593,Jeff Denham (R),2014,Other,22800,2500,25300
F000460,N00031672,Blake Farenthold (R),2014,Agribusiness,36750,34164,70914
F000460,N00031672,Blake Farenthold (R),2014,Communic/Electronics,12350,67000,79350
F000460,N00031672,Blake Farenthold (R),2014,Construction,52300,22750,75050
F000460,N00031672,Blake Farenthold (R),2014,Defense,0,3000,3000
F000460,N00031672,Blake Farenthold (R),2014,Energy/Nat Resource,55525,52500,108025
F000460,N00031672,Blake Farenthold (R),2014,Finance/Insur/RealEst,77100,54500,131600
F000460,N00031672,Blake Farenthold (R),2014,Health,40298,35000,75298
F000460,N00031672,Blake Farenthold (R),2014,Lawyers & Lobbyists,36808,2000,38808
F000460,N00031672,Blake Farenthold (R),2014,Transportation,22500,102000,124500
F000460,N00031672,Blake Farenthold (R),2014,Misc Business,52450,30399,82849
F000460,N00031672,Blake Farenthold (R),2014,Labor,0,12500,12500
F000460,N00031672,Blake Farenthold (R),2014,Ideology/Single-Issue,13400,16600,30000
F000460,N00031672,Blake Farenthold (R),2014,Other,63760,0,63760
B001277,N00031685,Richard Blumenthal (D),2014,Agribusiness,17000,14000,31000
B001277,N00031685,Richard Blumenthal (D),2014,Communic/Electronics,313249,153250,466499
B001277,N00031685,Richard Blumenthal (D),2014,Construction,110850,2000,112850
B001277,N00031685,Richard Blumenthal (D),2014,Defense,2052,38500,40552
B001277,N00031685,Richard Blumenthal (D),2014,Energy/Nat Resource,67300,16000,83300
B001277,N00031685,Richard Blumenthal (D),2014,Finance/Insur/RealEst,1429677,154740,1584417
B001277,N00031685,Richard Blumenthal (D),2014,Health,265743,228250,493993
B001277,N00031685,Richard Blumenthal (D),2014,Lawyers & Lobbyists,838526,80500,919026
B001277,N00031685,Richard Blumenthal (D),2014,Transportation,47600,29000,76600
B001277,N00031685,Richard Blumenthal (D),2014,Misc Business,398783,125433,524216
B001277,N00031685,Richard Blumenthal (D),2014,Labor,0,321000,321000
B001277,N00031685,Richard Blumenthal (D),2014,Ideology/Single-Issue,173250,300130,473380
B001277,N00031685,Richard Blumenthal (D),2014,Other,995591,1000,996591
H001061,N00031688,John Hoeven (R),2014,Agribusiness,79225,191300,270525
H001061,N00031688,John Hoeven (R),2014,Communic/Electronics,46265,100150,146415
H001061,N00031688,John Hoeven (R),2014,Construction,180885,56500,237385
H001061,N00031688,John Hoeven (R),2014,Defense,4800,37500,42300
H001061,N00031688,John Hoeven (R),2014,Energy/Nat Resource,417296,311373,728669
H001061,N00031688,John Hoeven (R),2014,Finance/Insur/RealEst,409720,257550,667270
H001061,N00031688,John Hoeven (R),2014,Health,100460,170950,271410
H001061,N00031688,John Hoeven (R),2014,Lawyers & Lobbyists,138478,40637,179115
H001061,N00031688,John Hoeven (R),2014,Transportation,43550,89900,133450
H001061,N00031688,John Hoeven (R),2014,Misc Business,290749,179542,470291
H001061,N00031688,John Hoeven (R),2014,Labor,0,21600,21600
H001061,N00031688,John Hoeven (R),2014,Ideology/Single-Issue,66935,271096,338031
H001061,N00031688,John Hoeven (R),2014,Other,277110,2000,279110
C001088,N00031820,Chris Coons (D),2014,Agribusiness,41108,45000,86108
C001088,N00031820,Chris Coons (D),2014,Communic/Electronics,303700,235957,539657
C001088,N00031820,Chris Coons (D),2014,Construction,55900,33000,88900
C001088,N00031820,Chris Coons (D),2014,Defense,1500,69500,71000
C001088,N00031820,Chris Coons (D),2014,Energy/Nat Resource,50873,144750,195623
C001088,N00031820,Chris Coons (D),2014,Finance/Insur/RealEst,906742,565705,1472447
C001088,N00031820,Chris Coons (D),2014,Health,266050,321500,587550
C001088,N00031820,Chris Coons (D),2014,Lawyers & Lobbyists,1938537,212720,2151257
C001088,N00031820,Chris Coons (D),2014,Transportation,24300,90600,114900
C001088,N00031820,Chris Coons (D),2014,Misc Business,397331,279000,676331
C001088,N00031820,Chris Coons (D),2014,Labor,1750,393500,395250
C001088,N00031820,Chris Coons (D),2014,Ideology/Single-Issue,309435,757025,1066460
C001088,N00031820,Chris Coons (D),2014,Other,445835,3000,448835
B001270,N00031877,Karen Bass (D),2014,Agribusiness,3250,8000,11250
B001270,N00031877,Karen Bass (D),2014,Communic/Electronics,123750,104499,228249
B001270,N00031877,Karen Bass (D),2014,Construction,12000,0,12000
B001270,N00031877,Karen Bass (D),2014,Defense,1500,15000,16500
B001270,N00031877,Karen Bass (D),2014,Energy/Nat Resource,2750,20500,23250
B001270,N00031877,Karen Bass (D),2014,Finance/Insur/RealEst,70325,44000,114325
B001270,N00031877,Karen Bass (D),2014,Health,31205,36000,67205
B001270,N00031877,Karen Bass (D),2014,Lawyers & Lobbyists,73650,25000,98650
B001270,N00031877,Karen Bass (D),2014,Transportation,0,18000,18000
B001270,N00031877,Karen Bass (D),2014,Misc Business,53600,47000,100600
B001270,N00031877,Karen Bass (D),2014,Labor,250,141000,141250
B001270,N00031877,Karen Bass (D),2014,Ideology/Single-Issue,2600,3500,6100
B001270,N00031877,Karen Bass (D),2014,Other,69475,1500,70975
B001271,N00031934,Dan Benishek (R),2014,Agribusiness,26155,156458,182613
B001271,N00031934,Dan Benishek (R),2014,Communic/Electronics,9077,26500,35577
B001271,N00031934,Dan Benishek (R),2014,Construction,15950,28000,43950
B001271,N00031934,Dan Benishek (R),2014,Defense,3100,10500,13600
B001271,N00031934,Dan Benishek (R),2014,Energy/Nat Resource,62305,122000,184305
B001271,N00031934,Dan Benishek (R),2014,Finance/Insur/RealEst,114900,88800,203700
B001271,N00031934,Dan Benishek (R),2014,Health,76200,160500,236700
B001271,N00031934,Dan Benishek (R),2014,Lawyers & Lobbyists,33125,21375,54500
B001271,N00031934,Dan Benishek (R),2014,Transportation,35500,38700,74200
B001271,N00031934,Dan Benishek (R),2014,Misc Business,199800,70900,270700
B001271,N00031934,Dan Benishek (R),2014,Labor,0,7000,7000
B001271,N00031934,Dan Benishek (R),2014,Ideology/Single-Issue,38821,294088,332909
B001271,N00031934,Dan Benishek (R),2014,Other,68131,3000,71131
A000367,N00031938,Justin Amash (R),2014,Agribusiness,46400,1000,47400
A000367,N00031938,Justin Amash (R),2014,Communic/Electronics,40500,0,40500
A000367,N00031938,Justin Amash (R),2014,Construction,38460,5000,43460
A000367,N00031938,Justin Amash (R),2014,Defense,700,0,700
A000367,N00031938,Justin Amash (R),2014,Energy/Nat Resource,22750,11000,33750
A000367,N00031938,Justin Amash (R),2014,Finance/Insur/RealEst,147000,4500,151500
A000367,N00031938,Justin Amash (R),2014,Health,62809,2000,64809
A000367,N00031938,Justin Amash (R),2014,Lawyers & Lobbyists,31650,2750,34400
A000367,N00031938,Justin Amash (R),2014,Transportation,38150,4200,42350
A000367,N00031938,Justin Amash (R),2014,Misc Business,200749,1000,201749
A000367,N00031938,Justin Amash (R),2014,Ideology/Single-Issue,261065,91700,352765
A000367,N00031938,Justin Amash (R),2014,Other,103858,0,103858
G000564,N00031998,Chris Gibson (R),2014,Agribusiness,54100,123000,177100
G000564,N00031998,Chris Gibson (R),2014,Communic/Electronics,28765,43750,72515
G000564,N00031998,Chris Gibson (R),2014,Construction,69709,76084,145793
G000564,N00031998,Chris Gibson (R),2014,Defense,1500,114500,116000
G000564,N00031998,Chris Gibson (R),2014,Energy/Nat Resource,28725,48000,76725
G000564,N00031998,Chris Gibson (R),2014,Finance/Insur/RealEst,360024,216500,576524
G000564,N00031998,Chris Gibson (R),2014,Health,40150,135000,175150
G000564,N00031998,Chris Gibson (R),2014,Lawyers & Lobbyists,146878,18599,165477
G000564,N00031998,Chris Gibson (R),2014,Transportation,8159,39000,47159
G000564,N00031998,Chris Gibson (R),2014,Misc Business,105057,127500,232557
G000564,N00031998,Chris Gibson (R),2014,Labor,0,173250,173250
G000564,N00031998,Chris Gibson (R),2014,Ideology/Single-Issue,38600,349333,387933
G000564,N00031998,Chris Gibson (R),2014,Other,176260,4500,180760
C001084,N00032019,David Cicilline (D),2014,Agribusiness,3600,7500,11100
C001084,N00032019,David Cicilline (D),2014,Communic/Electronics,56400,30000,86400
C001084,N00032019,David Cicilline (D),2014,Construction,21450,7000,28450
C001084,N00032019,David Cicilline (D),2014,Defense,5750,18000,23750
C001084,N00032019,David Cicilline (D),2014,Energy/Nat Resource,8500,1000,9500
C001084,N00032019,David Cicilline (D),2014,Finance/Insur/RealEst,134800,28500,163300
C001084,N00032019,David Cicilline (D),2014,Health,34050,16000,50050
C001084,N00032019,David Cicilline (D),2014,Lawyers & Lobbyists,146250,13000,159250
C001084,N00032019,David Cicilline (D),2014,Transportation,17100,3000,20100
C001084,N00032019,David Cicilline (D),2014,Misc Business,107850,44500,152350
C001084,N00032019,David Cicilline (D),2014,Labor,1500,126500,128000
C001084,N00032019,David Cicilline (D),2014,Ideology/Single-Issue,21450,48000,69450
C001084,N00032019,David Cicilline (D),2014,Other,188050,1500,189550
G000568,N00032029,Morgan Griffith (R),2014,Agribusiness,4301,38500,42801
G000568,N00032029,Morgan Griffith (R),2014,Communic/Electronics,3000,64280,67280
G000568,N00032029,Morgan Griffith (R),2014,Construction,10500,11500,22000
G000568,N00032029,Morgan Griffith (R),2014,Defense,0,33000,33000
G000568,N00032029,Morgan Griffith (R),2014,Energy/Nat Resource,15400,151000,166400
G000568,N00032029,Morgan Griffith (R),2014,Finance/Insur/RealEst,18883,23000,41883
G000568,N00032029,Morgan Griffith (R),2014,Health,12300,109500,121800
G000568,N00032029,Morgan Griffith (R),2014,Lawyers & Lobbyists,40050,10253,50303
G000568,N00032029,Morgan Griffith (R),2014,Transportation,4000,35000,39000
G000568,N00032029,Morgan Griffith (R),2014,Misc Business,30743,67000,97743
G000568,N00032029,Morgan Griffith (R),2014,Labor,0,1000,1000
G000568,N00032029,Morgan Griffith (R),2014,Ideology/Single-Issue,4600,26000,30600
G000568,N00032029,Morgan Griffith (R),2014,Other,59178,0,59178
D000618,N00033054,Steven Daines (R),2014,Agribusiness,309300,135200,444500
D000618,N00033054,Steven Daines (R),2014,Communic/Electronics,129176,96690,225866
D000618,N00033054,Steven Daines (R),2014,Construction,263800,79250,343050
D000618,N00033054,Steven Daines (R),2014,Defense,6100,12000,18100
D000618,N00033054,Steven Daines (R),2014,Energy/Nat Resource,355602,290900,646502
D000618,N00033054,Steven Daines (R),2014,Finance/Insur/RealEst,998956,280600,1279556
D000618,N00033054,Steven Daines (R),2014,Health,97250,112166,209416
D000618,N00033054,Steven Daines (R),2014,Lawyers & Lobbyists,181589,21063,202652
D000618,N00033054,Steven Daines (R),2014,Transportation,125725,172055,297780
D000618,N00033054,Steven Daines (R),2014,Misc Business,465668,193929,659597
D000618,N00033054,Steven Daines (R),2014,Labor,0,13500,13500
D000618,N00033054,Steven Daines (R),2014,Ideology/Single-Issue,201253,452626,653879
D000618,N00033054,Steven Daines (R),2014,Other,645511,7000,652511
C001098,N00033085,Ted Cruz (R),2014,Agribusiness,261050,74500,335550
C001098,N00033085,Ted Cruz (R),2014,Communic/Electronics,199400,101549,300949
C001098,N00033085,Ted Cruz (R),2014,Construction,424650,54000,478650
C001098,N00033085,Ted Cruz (R),2014,Defense,9900,30500,40400
C001098,N00033085,Ted Cruz (R),2014,Energy/Nat Resource,1156683,243500,1400183
C001098,N00033085,Ted Cruz (R),2014,Finance/Insur/RealEst,2210639,176678,2387317
C001098,N00033085,Ted Cruz (R),2014,Health,466518,107500,574018
C001098,N00033085,Ted Cruz (R),2014,Lawyers & Lobbyists,1000508,57249,1057757
C001098,N00033085,Ted Cruz (R),2014,Transportation,204314,91500,295814
C001098,N00033085,Ted Cruz (R),2014,Misc Business,1228684,189750,1418434
C001098,N00033085,Ted Cruz (R),2014,Labor,325,1000,1325
C001098,N00033085,Ted Cruz (R),2014,Ideology/Single-Issue,1671288,415526,2086814
C001098,N00033085,Ted Cruz (R),2014,Other,1072388,7500,1079888
E000293,N00033217,Elizabeth Esty (D),2014,Agribusiness,12530,12500,25030
E000293,N00033217,Elizabeth Esty (D),2014,Communic/Electronics,61600,24680,86280
E000293,N00033217,Elizabeth Esty (D),2014,Construction,20050,23000,43050
E000293,N00033217,Elizabeth Esty (D),2014,Defense,1000,3500,4500
E000293,N00033217,Elizabeth Esty (D),2014,Energy/Nat Resource,7166,1000,8166
E000293,N00033217,Elizabeth Esty (D),2014,Finance/Insur/RealEst,261950,71000,332950
E000293,N00033217,Elizabeth Esty (D),2014,Health,70681,92000,162681
E000293,N00033217,Elizabeth Esty (D),2014,Lawyers & Lobbyists,260000,27533,287533
E000293,N00033217,Elizabeth Esty (D),2014,Transportation,8450,89119,97569
E000293,N00033217,Elizabeth Esty (D),2014,Misc Business,121641,44276,165917
E000293,N00033217,Elizabeth Esty (D),2014,Labor,0,252550,252550
E000293,N00033217,Elizabeth Esty (D),2014,Ideology/Single-Issue,229985,335689,565674
E000293,N00033217,Elizabeth Esty (D),2014,Other,319536,1000,320536
G000571,N00033281,Tulsi Gabbard (D),2014,Agribusiness,4600,12000,16600
G000571,N00033281,Tulsi Gabbard (D),2014,Communic/Electronics,69557,23800,93357
G000571,N00033281,Tulsi Gabbard (D),2014,Construction,65152,9000,74152
G000571,N00033281,Tulsi Gabbard (D),2014,Defense,8350,38000,46350
G000571,N00033281,Tulsi Gabbard (D),2014,Energy/Nat Resource,18100,14800,32900
G000571,N00033281,Tulsi Gabbard (D),2014,Finance/Insur/RealEst,159744,36500,196244
G000571,N00033281,Tulsi Gabbard (D),2014,Health,93510,7500,101010
G000571,N00033281,Tulsi Gabbard (D),2014,Lawyers & Lobbyists,59657,14500,74157
G000571,N00033281,Tulsi Gabbard (D),2014,Transportation,35151,34250,69401
G000571,N00033281,Tulsi Gabbard (D),2014,Misc Business,84688,35300,119988
G000571,N00033281,Tulsi Gabbard (D),2014,Labor,0,153000,153000
G000571,N00033281,Tulsi Gabbard (D),2014,Ideology/Single-Issue,76303,56107,132410
G000571,N00033281,Tulsi Gabbard (D),2014,Other,103330,0,103330
C001091,N00033316,Joaquin Castro (D),2014,Agribusiness,11750,23514,35264
C001091,N00033316,Joaquin Castro (D),2014,Communic/Electronics,19600,55385,74985
C001091,N00033316,Joaquin Castro (D),2014,Construction,9400,20000,29400
C001091,N00033316,Joaquin Castro (D),2014,Defense,1000,57500,58500
C001091,N00033316,Joaquin Castro (D),2014,Energy/Nat Resource,20150,52000,72150
C001091,N00033316,Joaquin Castro (D),2014,Finance/Insur/RealEst,67237,94000,161237
C001091,N00033316,Joaquin Castro (D),2014,Health,27150,59000,86150
C001091,N00033316,Joaquin Castro (D),2014,Lawyers & Lobbyists,137750,32000,169750
C001091,N00033316,Joaquin Castro (D),2014,Transportation,6750,52000,58750
C001091,N00033316,Joaquin Castro (D),2014,Misc Business,48029,62100,110129
C001091,N00033316,Joaquin Castro (D),2014,Labor,0,51500,51500
C001091,N00033316,Joaquin Castro (D),2014,Ideology/Single-Issue,17371,20500,37871
C001091,N00033316,Joaquin Castro (D),2014,Other,40050,1000,41050
C001095,N00033363,Tom Cotton (R),2014,Agribusiness,259599,138000,397599
C001095,N00033363,Tom Cotton (R),2014,Communic/Electronics,188496,81700,270196
C001095,N00033363,Tom Cotton (R),2014,Construction,270536,60200,330736
C001095,N00033363,Tom Cotton (R),2014,Defense,15750,51500,67250
C001095,N00033363,Tom Cotton (R),2014,Energy/Nat Resource,503861,137350,641211
C001095,N00033363,Tom Cotton (R),2014,Finance/Insur/RealEst,2034776,438450,2473226
C001095,N00033363,Tom Cotton (R),2014,Health,331292,96666,427958
C001095,N00033363,Tom Cotton (R),2014,Lawyers & Lobbyists,434701,45930,480631
C001095,N00033363,Tom Cotton (R),2014,Transportation,126611,80546,207157
C001095,N00033363,Tom Cotton (R),2014,Misc Business,752644,233700,986344
C001095,N00033363,Tom Cotton (R),2014,Labor,0,5000,5000
C001095,N00033363,Tom Cotton (R),2014,Ideology/Single-Issue,958442,570460,1528902
C001095,N00033363,Tom Cotton (R),2014,Other,1212781,6000,1218781
C001097,N00033373,Tony Cardenas (D),2014,Agribusiness,11950,14547,26497
C001097,N00033373,Tony Cardenas (D),2014,Communic/Electronics,29500,56333,85833
C001097,N00033373,Tony Cardenas (D),2014,Construction,29850,11000,40850
C001097,N00033373,Tony Cardenas (D),2014,Defense,0,7500,7500
C001097,N00033373,Tony Cardenas (D),2014,Energy/Nat Resource,4750,23000,27750
C001097,N00033373,Tony Cardenas (D),2014,Finance/Insur/RealEst,89750,75952,165702
C001097,N00033373,Tony Cardenas (D),2014,Health,27700,70500,98200
C001097,N00033373,Tony Cardenas (D),2014,Lawyers & Lobbyists,44948,7000,51948
C001097,N00033373,Tony Cardenas (D),2014,Transportation,7276,25500,32776
C001097,N00033373,Tony Cardenas (D),2014,Misc Business,140300,43750,184050
C001097,N00033373,Tony Cardenas (D),2014,Labor,0,107500,107500
C001097,N00033373,Tony Cardenas (D),2014,Ideology/Single-Issue,62680,31631,94311
C001097,N00033373,Tony Cardenas (D),2014,Other,18400,1500,19900
B001286,N00033390,Cheri Bustos (D),2014,Agribusiness,16900,112372,129272
B001286,N00033390,Cheri Bustos (D),2014,Communic/Electronics,29950,26200,56150
B001286,N00033390,Cheri Bustos (D),2014,Construction,21300,16625,37925
B001286,N00033390,Cheri Bustos (D),2014,Defense,8700,4000,12700
B001286,N00033390,Cheri Bustos (D),2014,Energy/Nat Resource,8250,57500,65750
B001286,N00033390,Cheri Bustos (D),2014,Finance/Insur/RealEst,143333,115875,259208
B001286,N00033390,Cheri Bustos (D),2014,Health,82059,71500,153559
B001286,N00033390,Cheri Bustos (D),2014,Lawyers & Lobbyists,184801,33000,217801
B001286,N00033390,Cheri Bustos (D),2014,Transportation,18250,133498,151748
B001286,N00033390,Cheri Bustos (D),2014,Misc Business,81399,51500,132899
B001286,N00033390,Cheri Bustos (D),2014,Labor,1550,296400,297950
B001286,N00033390,Cheri Bustos (D),2014,Ideology/Single-Issue,252521,407851,660372
B001286,N00033390,Cheri Bustos (D),2014,Other,196189,7000,203189
H001065,N00033399,George Holding (R),2014,Agribusiness,34950,43227,78177
H001065,N00033399,George Holding (R),2014,Communic/Electronics,13450,95050,108500
H001065,N00033399,George Holding (R),2014,Construction,36900,21000,57900
H001065,N00033399,George Holding (R),2014,Defense,2500,10000,12500
H001065,N00033399,George Holding (R),2014,Energy/Nat Resource,11750,23500,35250
H001065,N00033399,George Holding (R),2014,Finance/Insur/RealEst,113310,110850,224160
H001065,N00033399,George Holding (R),2014,Health,74813,50500,125313
H001065,N00033399,George Holding (R),2014,Lawyers & Lobbyists,124392,22750,147142
H001065,N00033399,George Holding (R),2014,Transportation,32300,21500,53800
H001065,N00033399,George Holding (R),2014,Misc Business,80689,80148,160837
H001065,N00033399,George Holding (R),2014,Labor,0,2500,2500
H001065,N00033399,George Holding (R),2014,Ideology/Single-Issue,4650,57649,62299
H001065,N00033399,George Holding (R),2014,Other,88650,2000,90650
F000463,N00033443,Deb Fischer (R),2014,Agribusiness,300210,189052,489262
F000463,N00033443,Deb Fischer (R),2014,Communic/Electronics,83128,101000,184128
F000463,N00033443,Deb Fischer (R),2014,Construction,144435,65578,210013
F000463,N00033443,Deb Fischer (R),2014,Defense,0,21000,21000
F000463,N00033443,Deb Fischer (R),2014,Energy/Nat Resource,169601,118000,287601
F000463,N00033443,Deb Fischer (R),2014,Finance/Insur/RealEst,437128,248500,685628
F000463,N00033443,Deb Fischer (R),2014,Health,163390,110500,273890
F000463,N00033443,Deb Fischer (R),2014,Lawyers & Lobbyists,149487,43250,192737
F000463,N00033443,Deb Fischer (R),2014,Transportation,86316,95300,181616
F000463,N00033443,Deb Fischer (R),2014,Misc Business,311472,151500,462972
F000463,N00033443,Deb Fischer (R),2014,Labor,0,7000,7000
F000463,N00033443,Deb Fischer (R),2014,Ideology/Single-Issue,215850,357282,573132
F000463,N00033443,Deb Fischer (R),2014,Other,407450,7500,414950
B001278,N00033474,Suzanne Bonamici (D),2014,Agribusiness,2600,35000,37600
B001278,N00033474,Suzanne Bonamici (D),2014,Communic/Electronics,19950,35000,54950
B001278,N00033474,Suzanne Bonamici (D),2014,Construction,4850,16250,21100
B001278,N00033474,Suzanne Bonamici (D),2014,Defense,1000,27000,28000
B001278,N00033474,Suzanne Bonamici (D),2014,Energy/Nat Resource,750,15000,15750
B001278,N00033474,Suzanne Bonamici (D),2014,Finance/Insur/RealEst,26600,38000,64600
B001278,N00033474,Suzanne Bonamici (D),2014,Health,14950,59000,73950
B001278,N00033474,Suzanne Bonamici (D),2014,Lawyers & Lobbyists,93900,18500,112400
B001278,N00033474,Suzanne Bonamici (D),2014,Transportation,14500,25500,40000
B001278,N00033474,Suzanne Bonamici (D),2014,Misc Business,46250,39000,85250
B001278,N00033474,Suzanne Bonamici (D),2014,Labor,0,180250,180250
B001278,N00033474,Suzanne Bonamici (D),2014,Ideology/Single-Issue,18400,28640,47040
B001278,N00033474,Suzanne Bonamici (D),2014,Other,64350,9000,73350
B001284,N00033495,Susan Brooks (R),2014,Agribusiness,8850,21000,29850
B001284,N00033495,Susan Brooks (R),2014,Communic/Electronics,26400,52640,79040
B001284,N00033495,Susan Brooks (R),2014,Construction,48500,29500,78000
B001284,N00033495,Susan Brooks (R),2014,Defense,500,36000,36500
B001284,N00033495,Susan Brooks (R),2014,Energy/Nat Resource,18750,46000,64750
B001284,N00033495,Susan Brooks (R),2014,Finance/Insur/RealEst,110625,157800,268425
B001284,N00033495,Susan Brooks (R),2014,Health,70300,83500,153800
B001284,N00033495,Susan Brooks (R),2014,Lawyers & Lobbyists,107825,30000,137825
B001284,N00033495,Susan Brooks (R),2014,Transportation,17650,30100,47750
B001284,N00033495,Susan Brooks (R),2014,Misc Business,71991,84919,156910
B001284,N00033495,Susan Brooks (R),2014,Labor,0,10500,10500
B001284,N00033495,Susan Brooks (R),2014,Ideology/Single-Issue,24263,109346,133609
B001284,N00033495,Susan Brooks (R),2014,Other,87376,9000,96376
C001093,N00033518,Doug Collins (R),2014,Agribusiness,25800,11000,36800
C001093,N00033518,Doug Collins (R),2014,Communic/Electronics,13500,57500,71000
C001093,N00033518,Doug Collins (R),2014,Construction,22950,20500,43450
C001093,N00033518,Doug Collins (R),2014,Defense,0,18500,18500
C001093,N00033518,Doug Collins (R),2014,Energy/Nat Resource,17250,28500,45750
C001093,N00033518,Doug Collins (R),2014,Finance/Insur/RealEst,53550,62500,116050
C001093,N00033518,Doug Collins (R),2014,Health,23050,43100,66150
C001093,N00033518,Doug Collins (R),2014,Lawyers & Lobbyists,34000,11750,45750
C001093,N00033518,Doug Collins (R),2014,Transportation,11450,33000,44450
C001093,N00033518,Doug Collins (R),2014,Misc Business,36150,75991,112141
C001093,N00033518,Doug Collins (R),2014,Labor,0,2000,2000
C001093,N00033518,Doug Collins (R),2014,Ideology/Single-Issue,11700,39507,51207
C001093,N00033518,Doug Collins (R),2014,Other,32318,0,32318
B001283,N00033532,James Bridenstine (R),2014,Agribusiness,8250,2000,10250
B001283,N00033532,James Bridenstine (R),2014,Communic/Electronics,5000,11000,16000
B001283,N00033532,James Bridenstine (R),2014,Construction,17750,5000,22750
B001283,N00033532,James Bridenstine (R),2014,Defense,7500,71500,79000
B001283,N00033532,James Bridenstine (R),2014,Energy/Nat Resource,29500,45000,74500
B001283,N00033532,James Bridenstine (R),2014,Finance/Insur/RealEst,32650,24000,56650
B001283,N00033532,James Bridenstine (R),2014,Health,39700,25250,64950
B001283,N00033532,James Bridenstine (R),2014,Lawyers & Lobbyists,17050,3903,20953
B001283,N00033532,James Bridenstine (R),2014,Transportation,1750,18500,20250
B001283,N00033532,James Bridenstine (R),2014,Misc Business,30650,7036,37686
B001283,N00033532,James Bridenstine (R),2014,Labor,0,2500,2500
B001283,N00033532,James Bridenstine (R),2014,Ideology/Single-Issue,10750,42738,53488
B001283,N00033532,James Bridenstine (R),2014,Other,66765,0,66765
G000572,N00033541,Pete Gallego (D),2014,Agribusiness,40850,91814,132664
G000572,N00033541,Pete Gallego (D),2014,Communic/Electronics,44000,40360,84360
G000572,N00033541,Pete Gallego (D),2014,Construction,25500,15500,41000
G000572,N00033541,Pete Gallego (D),2014,Defense,2500,56500,59000
G000572,N00033541,Pete Gallego (D),2014,Energy/Nat Resource,20200,68000,88200
G000572,N00033541,Pete Gallego (D),2014,Finance/Insur/RealEst,117421,111750,229171
G000572,N00033541,Pete Gallego (D),2014,Health,66625,66000,132625
G000572,N00033541,Pete Gallego (D),2014,Lawyers & Lobbyists,194748,27100,221848
G000572,N00033541,Pete Gallego (D),2014,Transportation,8550,66999,75549
G000572,N00033541,Pete Gallego (D),2014,Misc Business,143388,59500,202888
G000572,N00033541,Pete Gallego (D),2014,Labor,0,186000,186000
G000572,N00033541,Pete Gallego (D),2014,Ideology/Single-Issue,63140,338815,401955
G000572,N00033541,Pete Gallego (D),2014,Other,87005,0,87005
B001280,N00033625,Kerry Bentivolio (R),2014,Agribusiness,2500,0,2500
B001280,N00033625,Kerry Bentivolio (R),2014,Communic/Electronics,1050,0,1050
B001280,N00033625,Kerry Bentivolio (R),2014,Construction,28650,5000,33650
B001280,N00033625,Kerry Bentivolio (R),2014,Defense,0,3000,3000
B001280,N00033625,Kerry Bentivolio (R),2014,Energy/Nat Resource,2350,16500,18850
B001280,N00033625,Kerry Bentivolio (R),2014,Finance/Insur/RealEst,50500,14500,65000
B001280,N00033625,Kerry Bentivolio (R),2014,Health,12950,0,12950
B001280,N00033625,Kerry Bentivolio (R),2014,Lawyers & Lobbyists,4700,3000,7700
B001280,N00033625,Kerry Bentivolio (R),2014,Transportation,19900,10000,29900
B001280,N00033625,Kerry Bentivolio (R),2014,Misc Business,46300,7500,53800
B001280,N00033625,Kerry Bentivolio (R),2014,Ideology/Single-Issue,28476,82280,110756
B001280,N00033625,Kerry Bentivolio (R),2014,Other,38500,0,38500
A000372,N00033720,Richard W Allen (R),2014,Agribusiness,52650,6000,58650
A000372,N00033720,Richard W Allen (R),2014,Communic/Electronics,6600,4500,11100
A000372,N00033720,Richard W Allen (R),2014,Construction,91425,17500,108925
A000372,N00033720,Richard W Allen (R),2014,Defense,0,2500,2500
A000372,N00033720,Richard W Allen (R),2014,Energy/Nat Resource,33750,12500,46250
A000372,N00033720,Richard W Allen (R),2014,Finance/Insur/RealEst,178715,27500,206215
A000372,N00033720,Richard W Allen (R),2014,Health,108600,2000,110600
A000372,N00033720,Richard W Allen (R),2014,Lawyers & Lobbyists,28700,1000,29700
A000372,N00033720,Richard W Allen (R),2014,Transportation,30650,4500,35150
A000372,N00033720,Richard W Allen (R),2014,Misc Business,67610,10000,77610
A000372,N00033720,Richard W Allen (R),2014,Ideology/Single-Issue,9000,150750,159750
A000372,N00033720,Richard W Allen (R),2014,Other,129970,0,129970
B001294,N00033744,Rod Blum (R),2014,Agribusiness,43880,16000,59880
B001294,N00033744,Rod Blum (R),2014,Communic/Electronics,8191,0,8191
B001294,N00033744,Rod Blum (R),2014,Construction,53350,14000,67350
B001294,N00033744,Rod Blum (R),2014,Energy/Nat Resource,750,13500,14250
B001294,N00033744,Rod Blum (R),2014,Finance/Insur/RealEst,90386,11000,101386
B001294,N00033744,Rod Blum (R),2014,Health,13814,9614,23428
B001294,N00033744,Rod Blum (R),2014,Lawyers & Lobbyists,5650,0,5650
B001294,N00033744,Rod Blum (R),2014,Transportation,32600,5000,37600
B001294,N00033744,Rod Blum (R),2014,Misc Business,51783,8580,60363
B001294,N00033744,Rod Blum (R),2014,Ideology/Single-Issue,13320,147303,160623
B001294,N00033744,Rod Blum (R),2014,Other,81046,0,81046
D000620,N00033897,John K Delaney (D),2014,Agribusiness,7700,12500,20200
D000620,N00033897,John K Delaney (D),2014,Communic/Electronics,18600,7500,26100
D000620,N00033897,John K Delaney (D),2014,Construction,5418,64617,70035
D000620,N00033897,John K Delaney (D),2014,Defense,0,15000,15000
D000620,N00033897,John K Delaney (D),2014,Energy/Nat Resource,17000,32000,49000
D000620,N00033897,John K Delaney (D),2014,Finance/Insur/RealEst,432354,326999,759353
D000620,N00033897,John K Delaney (D),2014,Health,19800,41000,60800
D000620,N00033897,John K Delaney (D),2014,Lawyers & Lobbyists,105500,16500,122000
D000620,N00033897,John K Delaney (D),2014,Transportation,10050,15000,25050
D000620,N00033897,John K Delaney (D),2014,Misc Business,58600,40999,99599
D000620,N00033897,John K Delaney (D),2014,Labor,250,96500,96750
D000620,N00033897,John K Delaney (D),2014,Ideology/Single-Issue,6000,11975,17975
D000620,N00033897,John K Delaney (D),2014,Other,94150,0,94150
B001281,N00033904,Joyce Beatty (D),2014,Agribusiness,2400,9500,11900
B001281,N00033904,Joyce Beatty (D),2014,Communic/Electronics,2400,16000,18400
B001281,N00033904,Joyce Beatty (D),2014,Construction,12250,6000,18250
B001281,N00033904,Joyce Beatty (D),2014,Defense,0,9000,9000
B001281,N00033904,Joyce Beatty (D),2014,Energy/Nat Resource,9100,50000,59100
B001281,N00033904,Joyce Beatty (D),2014,Finance/Insur/RealEst,48100,243350,291450
B001281,N00033904,Joyce Beatty (D),2014,Health,14350,52000,66350
B001281,N00033904,Joyce Beatty (D),2014,Lawyers & Lobbyists,34200,33500,67700
B001281,N00033904,Joyce Beatty (D),2014,Transportation,750,24250,25000
B001281,N00033904,Joyce Beatty (D),2014,Misc Business,25687,62104,87791
B001281,N00033904,Joyce Beatty (D),2014,Labor,1000,110100,111100
B001281,N00033904,Joyce Beatty (D),2014,Ideology/Single-Issue,0,10000,10000
B001281,N00033904,Joyce Beatty (D),2014,Other,33450,1000,34450
B001279,N00033981,Ron Barber (D),2014,Agribusiness,23550,35500,59050
B001279,N00033981,Ron Barber (D),2014,Communic/Electronics,34085,65140,99225
B001279,N00033981,Ron Barber (D),2014,Construction,23380,14000,37380
B001279,N00033981,Ron Barber (D),2014,Defense,11430,89998,101428
B001279,N00033981,Ron Barber (D),2014,Energy/Nat Resource,7400,46500,53900
B001279,N00033981,Ron Barber (D),2014,Finance/Insur/RealEst,126033,114000,240033
B001279,N00033981,Ron Barber (D),2014,Health,45800,176650,222450
B001279,N00033981,Ron Barber (D),2014,Lawyers & Lobbyists,138274,28750,167024
B001279,N00033981,Ron Barber (D),2014,Transportation,3300,9000,12300
B001279,N00033981,Ron Barber (D),2014,Misc Business,165497,42059,207556
B001279,N00033981,Ron Barber (D),2014,Labor,250,275250,275500
B001279,N00033981,Ron Barber (D),2014,Ideology/Single-Issue,118875,551799,670674
B001279,N00033981,Ron Barber (D),2014,Other,382371,2500,384871
A000371,N00033997,Pete Aguilar (D),2014,Agribusiness,1750,6500,8250
A000371,N00033997,Pete Aguilar (D),2014,Communic/Electronics,46675,11640,58315
A000371,N00033997,Pete Aguilar (D),2014,Construction,53725,4000,57725
A000371,N00033997,Pete Aguilar (D),2014,Defense,2600,2000,4600
A000371,N00033997,Pete Aguilar (D),2014,Energy/Nat Resource,5400,3000,8400
A000371,N00033997,Pete Aguilar (D),2014,Finance/Insur/RealEst,158096,47500,205596
A000371,N00033997,Pete Aguilar (D),2014,Health,54799,42500,97299
A000371,N00033997,Pete Aguilar (D),2014,Lawyers & Lobbyists,142719,11250,153969
A000371,N00033997,Pete Aguilar (D),2014,Transportation,7875,23000,30875
A000371,N00033997,Pete Aguilar (D),2014,Misc Business,103055,6034,109089
A000371,N00033997,Pete Aguilar (D),2014,Labor,950,245000,245950
A000371,N00033997,Pete Aguilar (D),2014,Ideology/Single-Issue,150336,277053,427389
A000371,N00033997,Pete Aguilar (D),2014,Other,107506,0,107506
C001090,N00034128,Matt Cartwright (D),2014,Agribusiness,11950,4000,15950
C001090,N00034128,Matt Cartwright (D),2014,Communic/Electronics,3550,13000,16550
C001090,N00034128,Matt Cartwright (D),2014,Construction,23450,2000,25450
C001090,N00034128,Matt Cartwright (D),2014,Defense,500,24750,25250
C001090,N00034128,Matt Cartwright (D),2014,Energy/Nat Resource,0,500,500
C001090,N00034128,Matt Cartwright (D),2014,Finance/Insur/RealEst,39250,10250,49500
C001090,N00034128,Matt Cartwright (D),2014,Health,23600,10750,34350
C001090,N00034128,Matt Cartwright (D),2014,Lawyers & Lobbyists,488240,14000,502240
C001090,N00034128,Matt Cartwright (D),2014,Transportation,6350,4000,10350
C001090,N00034128,Matt Cartwright (D),2014,Misc Business,15650,23104,38754
C001090,N00034128,Matt Cartwright (D),2014,Labor,250,212250,212500
C001090,N00034128,Matt Cartwright (D),2014,Ideology/Single-Issue,5800,22600,28400
C001090,N00034128,Matt Cartwright (D),2014,Other,34670,0,34670
C001094,N00034224,Paul Cook (R),2014,Agribusiness,2500,1650,4150
C001094,N00034224,Paul Cook (R),2014,Communic/Electronics,18000,8000,26000
C001094,N00034224,Paul Cook (R),2014,Construction,32950,48500,81450
C001094,N00034224,Paul Cook (R),2014,Defense,400,59000,59400
C001094,N00034224,Paul Cook (R),2014,Energy/Nat Resource,13700,24000,37700
C001094,N00034224,Paul Cook (R),2014,Finance/Insur/RealEst,39100,30500,69600
C001094,N00034224,Paul Cook (R),2014,Health,13850,41000,54850
C001094,N00034224,Paul Cook (R),2014,Lawyers & Lobbyists,29745,1000,30745
C001094,N00034224,Paul Cook (R),2014,Transportation,4000,26500,30500
C001094,N00034224,Paul Cook (R),2014,Misc Business,98650,8500,107150
C001094,N00034224,Paul Cook (R),2014,Labor,0,107000,107000
C001094,N00034224,Paul Cook (R),2014,Ideology/Single-Issue,7100,87700,94800
C001094,N00034224,Paul Cook (R),2014,Other,21280,0,21280
B001285,N00034254,Julia Brownley (D),2014,Agribusiness,17475,23500,40975
B001285,N00034254,Julia Brownley (D),2014,Communic/Electronics,109875,33000,142875
B001285,N00034254,Julia Brownley (D),2014,Construction,17715,0,17715
B001285,N00034254,Julia Brownley (D),2014,Defense,250,19500,19750
B001285,N00034254,Julia Brownley (D),2014,Energy/Nat Resource,7600,7500,15100
B001285,N00034254,Julia Brownley (D),2014,Finance/Insur/RealEst,147559,44250,191809
B001285,N00034254,Julia Brownley (D),2014,Health,45200,71500,116700
B001285,N00034254,Julia Brownley (D),2014,Lawyers & Lobbyists,156230,15000,171230
B001285,N00034254,Julia Brownley (D),2014,Transportation,5350,8000,13350
B001285,N00034254,Julia Brownley (D),2014,Misc Business,114208,22557,136765
B001285,N00034254,Julia Brownley (D),2014,Labor,0,314700,314700
B001285,N00034254,Julia Brownley (D),2014,Ideology/Single-Issue,411061,534484,945545
B001285,N00034254,Julia Brownley (D),2014,Other,336780,6750,343530
D000621,N00034746,Ron DeSantis (R),2014,Agribusiness,5600,23625,29225
D000621,N00034746,Ron DeSantis (R),2014,Communic/Electronics,6000,82000,88000
D000621,N00034746,Ron DeSantis (R),2014,Construction,32650,16000,48650
D000621,N00034746,Ron DeSantis (R),2014,Defense,9050,33600,42650
D000621,N00034746,Ron DeSantis (R),2014,Energy/Nat Resource,9500,34900,44400
D000621,N00034746,Ron DeSantis (R),2014,Finance/Insur/RealEst,134650,96640,231290
D000621,N00034746,Ron DeSantis (R),2014,Health,50250,20000,70250
D000621,N00034746,Ron DeSantis (R),2014,Lawyers & Lobbyists,52772,8250,61022
D000621,N00034746,Ron DeSantis (R),2014,Transportation,8700,25000,33700
D000621,N00034746,Ron DeSantis (R),2014,Misc Business,75673,60150,135823
D000621,N00034746,Ron DeSantis (R),2014,Labor,0,1000,1000
D000621,N00034746,Ron DeSantis (R),2014,Ideology/Single-Issue,18050,52675,70725
D000621,N00034746,Ron DeSantis (R),2014,Other,97575,2000,99575
D000619,N00034784,Rodney Davis (R),2014,Agribusiness,88139,264147,352286
D000619,N00034784,Rodney Davis (R),2014,Communic/Electronics,10350,48500,58850
D000619,N00034784,Rodney Davis (R),2014,Construction,90806,90000,180806
D000619,N00034784,Rodney Davis (R),2014,Defense,1250,1000,2250
D000619,N00034784,Rodney Davis (R),2014,Energy/Nat Resource,99885,172272,272157
D000619,N00034784,Rodney Davis (R),2014,Finance/Insur/RealEst,213380,227900,441280
D000619,N00034784,Rodney Davis (R),2014,Health,70490,149250,219740
D000619,N00034784,Rodney Davis (R),2014,Lawyers & Lobbyists,114081,34500,148581
D000619,N00034784,Rodney Davis (R),2014,Transportation,46165,204381,250546
D000619,N00034784,Rodney Davis (R),2014,Misc Business,148732,194075,342807
D000619,N00034784,Rodney Davis (R),2014,Labor,0,132500,132500
D000619,N00034784,Rodney Davis (R),2014,Ideology/Single-Issue,28276,379936,408212
D000619,N00034784,Rodney Davis (R),2014,Other,94875,8000,102875
E000292,N00034884,William Enyart (D),2014,Agribusiness,5950,54000,59950
E000292,N00034884,William Enyart (D),2014,Communic/Electronics,10700,22000,32700
E000292,N00034884,William Enyart (D),2014,Construction,28900,0,28900
E000292,N00034884,William Enyart (D),2014,Defense,0,69498,69498
E000292,N00034884,William Enyart (D),2014,Energy/Nat Resource,12200,39750,51950
E000292,N00034884,William Enyart (D),2014,Finance/Insur/RealEst,64950,59250,124200
E000292,N00034884,William Enyart (D),2014,Health,6650,50500,57150
E000292,N00034884,William Enyart (D),2014,Lawyers & Lobbyists,282544,28000,310544
E000292,N00034884,William Enyart (D),2014,Transportation,7050,41000,48050
E000292,N00034884,William Enyart (D),2014,Misc Business,40055,23000,63055
E000292,N00034884,William Enyart (D),2014,Labor,3750,277500,281250
E000292,N00034884,William Enyart (D),2014,Ideology/Single-Issue,56855,314986,371841
E000292,N00034884,William Enyart (D),2014,Other,86223,0,86223
B001288,N00035267,Cory Booker (D),2014,Agribusiness,174100,15500,189600
B001288,N00035267,Cory Booker (D),2014,Communic/Electronics,1418880,165700,1584580
B001288,N00035267,Cory Booker (D),2014,Construction,269900,28600,298500
B001288,N00035267,Cory Booker (D),2014,Defense,1300,19500,20800
B001288,N00035267,Cory Booker (D),2014,Energy/Nat Resource,136050,109848,245898
B001288,N00035267,Cory Booker (D),2014,Finance/Insur/RealEst,4164834,288000,4452834
B001288,N00035267,Cory Booker (D),2014,Health,574971,254900,829871
B001288,N00035267,Cory Booker (D),2014,Lawyers & Lobbyists,2436319,160691,2597010
B001288,N00035267,Cory Booker (D),2014,Transportation,157100,136227,293327
B001288,N00035267,Cory Booker (D),2014,Misc Business,1440338,151100,1591438
B001288,N00035267,Cory Booker (D),2014,Labor,5750,257600,263350
B001288,N00035267,Cory Booker (D),2014,Ideology/Single-Issue,754584,279932,1034516
B001288,N00035267,Cory Booker (D),2014,Other,1040461,6000,1046461
C001101,N00035278,Katherine Clark (D),2014,Agribusiness,1250,500,1750
C001101,N00035278,Katherine Clark (D),2014,Communic/Electronics,88150,9300,97450
C001101,N00035278,Katherine Clark (D),2014,Construction,15500,5500,21000
C001101,N00035278,Katherine Clark (D),2014,Defense,3600,18000,21600
C001101,N00035278,Katherine Clark (D),2014,Energy/Nat Resource,15350,11000,26350
C001101,N00035278,Katherine Clark (D),2014,Finance/Insur/RealEst,230478,23750,254228
C001101,N00035278,Katherine Clark (D),2014,Health,80478,65600,146078
C001101,N00035278,Katherine Clark (D),2014,Lawyers & Lobbyists,220045,22614,242659
C001101,N00035278,Katherine Clark (D),2014,Transportation,2500,6500,9000
C001101,N00035278,Katherine Clark (D),2014,Misc Business,106399,16856,123255
C001101,N00035278,Katherine Clark (D),2014,Labor,750,167750,168500
C001101,N00035278,Katherine Clark (D),2014,Ideology/Single-Issue,170325,77350,247675
C001101,N00035278,Katherine Clark (D),2014,Other,222164,1000,223164
B001296,N00035307,Brendan Boyle (D),2014,Agribusiness,1472,6500,7972
B001296,N00035307,Brendan Boyle (D),2014,Communic/Electronics,9738,10500,20238
B001296,N00035307,Brendan Boyle (D),2014,Construction,17650,20500,38150
B001296,N00035307,Brendan Boyle (D),2014,Defense,0,5000,5000
B001296,N00035307,Brendan Boyle (D),2014,Energy/Nat Resource,3250,23300,26550
B001296,N00035307,Brendan Boyle (D),2014,Finance/Insur/RealEst,52800,52300,105100
B001296,N00035307,Brendan Boyle (D),2014,Health,24890,54750,79640
B001296,N00035307,Brendan Boyle (D),2014,Lawyers & Lobbyists,84441,28613,113054
B001296,N00035307,Brendan Boyle (D),2014,Transportation,1250,18000,19250
B001296,N00035307,Brendan Boyle (D),2014,Misc Business,57613,25000,82613
B001296,N00035307,Brendan Boyle (D),2014,Labor,2000,217875,219875
B001296,N00035307,Brendan Boyle (D),2014,Ideology/Single-Issue,23529,98840,122369
B001296,N00035307,Brendan Boyle (D),2014,Other,76938,0,76938
C001103,N00035346,Buddy Carter (R),2014,Agribusiness,11350,39500,50850
C001103,N00035346,Buddy Carter (R),2014,Communic/Electronics,12550,7500,20050
C001103,N00035346,Buddy Carter (R),2014,Construction,23450,17500,40950
C001103,N00035346,Buddy Carter (R),2014,Defense,0,10000,10000
C001103,N00035346,Buddy Carter (R),2014,Energy/Nat Resource,34333,21500,55833
C001103,N00035346,Buddy Carter (R),2014,Finance/Insur/RealEst,50693,70500,121193
C001103,N00035346,Buddy Carter (R),2014,Health,94200,119000,213200
C001103,N00035346,Buddy Carter (R),2014,Lawyers & Lobbyists,41216,7500,48716
C001103,N00035346,Buddy Carter (R),2014,Transportation,23350,31100,54450
C001103,N00035346,Buddy Carter (R),2014,Misc Business,166234,46634,212868
C001103,N00035346,Buddy Carter (R),2014,Ideology/Single-Issue,0,64992,64992
C001103,N00035346,Buddy Carter (R),2014,Other,63192,0,63192
B001289,N00035380,Bradley Byrne (R),2014,Agribusiness,27584,86000,113584
B001289,N00035380,Bradley Byrne (R),2014,Communic/Electronics,4000,19500,23500
B001289,N00035380,Bradley Byrne (R),2014,Construction,65125,60800,125925
B001289,N00035380,Bradley Byrne (R),2014,Defense,8500,78500,87000
B001289,N00035380,Bradley Byrne (R),2014,Energy/Nat Resource,10950,94500,105450
B001289,N00035380,Bradley Byrne (R),2014,Finance/Insur/RealEst,115300,153100,268400
B001289,N00035380,Bradley Byrne (R),2014,Health,51150,69500,120650
B001289,N00035380,Bradley Byrne (R),2014,Lawyers & Lobbyists,140750,38000,178750
B001289,N00035380,Bradley Byrne (R),2014,Transportation,20700,58500,79200
B001289,N00035380,Bradley Byrne (R),2014,Misc Business,56608,131000,187608
B001289,N00035380,Bradley Byrne (R),2014,Labor,0,2000,2000
B001289,N00035380,Bradley Byrne (R),2014,Ideology/Single-Issue,16250,191500,207750
B001289,N00035380,Bradley Byrne (R),2014,Other,123582,4500,128082
C001107,N00035403,Carlos Curbelo (R),2014,Agribusiness,31550,24500,56050
C001107,N00035403,Carlos Curbelo (R),2014,Communic/Electronics,20200,6000,26200
C001107,N00035403,Carlos Curbelo (R),2014,Construction,133805,14500,148305
C001107,N00035403,Carlos Curbelo (R),2014,Defense,0,5000,5000
C001107,N00035403,Carlos Curbelo (R),2014,Energy/Nat Resource,9000,12000,21000
C001107,N00035403,Carlos Curbelo (R),2014,Finance/Insur/RealEst,252378,17500,269878
C001107,N00035403,Carlos Curbelo (R),2014,Health,98941,10500,109441
C001107,N00035403,Carlos Curbelo (R),2014,Lawyers & Lobbyists,142607,2000,144607
C001107,N00035403,Carlos Curbelo (R),2014,Transportation,37850,8500,46350
C001107,N00035403,Carlos Curbelo (R),2014,Misc Business,174900,28000,202900
C001107,N00035403,Carlos Curbelo (R),2014,Labor,0,5000,5000
C001107,N00035403,Carlos Curbelo (R),2014,Ideology/Single-Issue,203100,337750,540850
C001107,N00035403,Carlos Curbelo (R),2014,Other,220850,0,220850
B001295,N00035420,Mike Bost (R),2014,Agribusiness,40964,16250,57214
B001295,N00035420,Mike Bost (R),2014,Communic/Electronics,8800,8500,17300
B001295,N00035420,Mike Bost (R),2014,Construction,15750,30500,46250
B001295,N00035420,Mike Bost (R),2014,Energy/Nat Resource,38400,26500,64900
B001295,N00035420,Mike Bost (R),2014,Finance/Insur/RealEst,94750,17000,111750
B001295,N00035420,Mike Bost (R),2014,Health,37650,25750,63400
B001295,N00035420,Mike Bost (R),2014,Lawyers & Lobbyists,28675,500,29175
B001295,N00035420,Mike Bost (R),2014,Transportation,14250,7400,21650
B001295,N00035420,Mike Bost (R),2014,Misc Business,82934,23499,106433
B001295,N00035420,Mike Bost (R),2014,Labor,0,11000,11000
B001295,N00035420,Mike Bost (R),2014,Ideology/Single-Issue,10750,284809,295559
B001295,N00035420,Mike Bost (R),2014,Other,79630,1000,80630
E000294,N00035440,Tom Emmer (R),2014,Agribusiness,57783,19000,76783
E000294,N00035440,Tom Emmer (R),2014,Communic/Electronics,40550,5000,45550
E000294,N00035440,Tom Emmer (R),2014,Construction,33300,8400,41700
E000294,N00035440,Tom Emmer (R),2014,Defense,0,2000,2000
E000294,N00035440,Tom Emmer (R),2014,Energy/Nat Resource,36500,11000,47500
E000294,N00035440,Tom Emmer (R),2014,Finance/Insur/RealEst,140139,45200,185339
E000294,N00035440,Tom Emmer (R),2014,Health,43665,26000,69665
E000294,N00035440,Tom Emmer (R),2014,Lawyers & Lobbyists,32587,14500,47087
E000294,N00035440,Tom Emmer (R),2014,Transportation,44700,23500,68200
E000294,N00035440,Tom Emmer (R),2014,Misc Business,85900,27000,112900
E000294,N00035440,Tom Emmer (R),2014,Labor,0,1000,1000
E000294,N00035440,Tom Emmer (R),2014,Ideology/Single-Issue,112686,95500,208186
E000294,N00035440,Tom Emmer (R),2014,Other,210887,0,210887
A000370,N00035451,Alma Adams (D),2014,Agribusiness,2500,1000,3500
A000370,N00035451,Alma Adams (D),2014,Communic/Electronics,7743,5000,12743
A000370,N00035451,Alma Adams (D),2014,Construction,4100,0,4100
A000370,N00035451,Alma Adams (D),2014,Defense,0,6500,6500
A000370,N00035451,Alma Adams (D),2014,Energy/Nat Resource,500,9000,9500
A000370,N00035451,Alma Adams (D),2014,Finance/Insur/RealEst,6650,14000,20650
A000370,N00035451,Alma Adams (D),2014,Health,29850,55500,85350
A000370,N00035451,Alma Adams (D),2014,Lawyers & Lobbyists,11186,7500,18686
A000370,N00035451,Alma Adams (D),2014,Transportation,750,2000,2750
A000370,N00035451,Alma Adams (D),2014,Misc Business,15150,10500,25650
A000370,N00035451,Alma Adams (D),2014,Labor,1000,86000,87000
A000370,N00035451,Alma Adams (D),2014,Ideology/Single-Issue,55246,100090,155336
A000370,N00035451,Alma Adams (D),2014,Other,59421,3000,62421
E000295,N00035483,Joni Ernst (R),2014,Agribusiness,64560,128950,193510
E000295,N00035483,Joni Ernst (R),2014,Communic/Electronics,16900,35100,52000
E000295,N00035483,Joni Ernst (R),2014,Construction,34300,55600,89900
E000295,N00035483,Joni Ernst (R),2014,Defense,1550,6000,7550
E000295,N00035483,Joni Ernst (R),2014,Energy/Nat Resource,57255,178500,235755
E000295,N00035483,Joni Ernst (R),2014,Finance/Insur/RealEst,280358,155500,435858
E000295,N00035483,Joni Ernst (R),2014,Health,44015,34500,78515
E000295,N00035483,Joni Ernst (R),2014,Lawyers & Lobbyists,53815,23000,76815
E000295,N00035483,Joni Ernst (R),2014,Transportation,20800,77546,98346
E000295,N00035483,Joni Ernst (R),2014,Misc Business,124400,213599,337999
E000295,N00035483,Joni Ernst (R),2014,Ideology/Single-Issue,127225,529468,656693
E000295,N00035483,Joni Ernst (R),2014,Other,211317,4250,215567
G000575,N00035688,Gwen Graham (D),2014,Agribusiness,38350,2500,40850
G000575,N00035688,Gwen Graham (D),2014,Communic/Electronics,59676,3000,62676
G000575,N00035688,Gwen Graham (D),2014,Construction,15200,8000,23200
G000575,N00035688,Gwen Graham (D),2014,Defense,8200,0,8200
G000575,N00035688,Gwen Graham (D),2014,Energy/Nat Resource,37100,0,37100
G000575,N00035688,Gwen Graham (D),2014,Finance/Insur/RealEst,300162,15000,315162
G000575,N00035688,Gwen Graham (D),2014,Health,43200,31000,74200
G000575,N00035688,Gwen Graham (D),2014,Lawyers & Lobbyists,462880,12341,475221
G000575,N00035688,Gwen Graham (D),2014,Transportation,20850,0,20850
G000575,N00035688,Gwen Graham (D),2014,Misc Business,98504,3500,102004
G000575,N00035688,Gwen Graham (D),2014,Labor,250,233500,233750
G000575,N00035688,Gwen Graham (D),2014,Ideology/Single-Issue,313565,376587,690152
G000575,N00035688,Gwen Graham (D),2014,Other,512963,13000,525963
C001102,N00035854,Curt Clawson (R),2014,Agribusiness,2000,2000,4000
C001102,N00035854,Curt Clawson (R),2014,Communic/Electronics,4600,0,4600
C001102,N00035854,Curt Clawson (R),2014,Construction,12148,0,12148
C001102,N00035854,Curt Clawson (R),2014,Energy/Nat Resource,1750,0,1750
C001102,N00035854,Curt Clawson (R),2014,Finance/Insur/RealEst,82993,4000,86993
C001102,N00035854,Curt Clawson (R),2014,Health,20710,0,20710
C001102,N00035854,Curt Clawson (R),2014,Lawyers & Lobbyists,56518,0,56518
C001102,N00035854,Curt Clawson (R),2014,Transportation,9021,0,9021
C001102,N00035854,Curt Clawson (R),2014,Misc Business,38800,0,38800
C001102,N00035854,Curt Clawson (R),2014,Ideology/Single-Issue,34246,36500,70746
C001102,N00035854,Curt Clawson (R),2014,Other,180327,0,180327
B001290,N00036013,Dave Brat (R),2014,Agribusiness,10498,12250,22748
B001290,N00036013,Dave Brat (R),2014,Communic/Electronics,12050,4500,16550
B001290,N00036013,Dave Brat (R),2014,Construction,35741,6500,42241
B001290,N00036013,Dave Brat (R),2014,Defense,4200,0,4200
B001290,N00036013,Dave Brat (R),2014,Energy/Nat Resource,20700,10500,31200
B001290,N00036013,Dave Brat (R),2014,Finance/Insur/RealEst,102640,15500,118140
B001290,N00036013,Dave Brat (R),2014,Health,21500,8500,30000
B001290,N00036013,Dave Brat (R),2014,Lawyers & Lobbyists,23250,1360,24610
B001290,N00036013,Dave Brat (R),2014,Transportation,9800,9000,18800
B001290,N00036013,Dave Brat (R),2014,Misc Business,39145,3500,42645
B001290,N00036013,Dave Brat (R),2014,Ideology/Single-Issue,74022,110041,184063
B001290,N00036013,Dave Brat (R),2014,Other,221050,0,221050
B001292,N00036018,Don Beyer (D),2014,Agribusiness,5600,14500,20100
B001292,N00036018,Don Beyer (D),2014,Communic/Electronics,91820,37504,129324
B001292,N00036018,Don Beyer (D),2014,Construction,28318,14500,42818
B001292,N00036018,Don Beyer (D),2014,Defense,12350,73500,85850
B001292,N00036018,Don Beyer (D),2014,Energy/Nat Resource,11850,14500,26350
B001292,N00036018,Don Beyer (D),2014,Finance/Insur/RealEst,251540,80500,332040
B001292,N00036018,Don Beyer (D),2014,Health,38000,26500,64500
B001292,N00036018,Don Beyer (D),2014,Lawyers & Lobbyists,243544,26484,270028
B001292,N00036018,Don Beyer (D),2014,Transportation,95436,48000,143436
B001292,N00036018,Don Beyer (D),2014,Misc Business,91900,48500,140400
B001292,N00036018,Don Beyer (D),2014,Labor,1000,126000,127000
B001292,N00036018,Don Beyer (D),2014,Ideology/Single-Issue,87904,99933,187837
B001292,N00036018,Don Beyer (D),2014,Other,326989,1250,328239
C001105,N00036023,Barbara Comstock (R),2014,Agribusiness,30650,30000,60650
C001105,N00036023,Barbara Comstock (R),2014,Communic/Electronics,83669,27000,110669
C001105,N00036023,Barbara Comstock (R),2014,Construction,80632,41500,122132
C001105,N00036023,Barbara Comstock (R),2014,Defense,25850,19000,44850
C001105,N00036023,Barbara Comstock (R),2014,Energy/Nat Resource,48105,55500,103605
C001105,N00036023,Barbara Comstock (R),2014,Finance/Insur/RealEst,349174,127500,476674
C001105,N00036023,Barbara Comstock (R),2014,Health,52183,19000,71183
C001105,N00036023,Barbara Comstock (R),2014,Lawyers & Lobbyists,346311,26506,372817
C001105,N00036023,Barbara Comstock (R),2014,Transportation,34599,44000,78599
C001105,N00036023,Barbara Comstock (R),2014,Misc Business,260256,102672,362928
C001105,N00036023,Barbara Comstock (R),2014,Labor,250,11262,11512
C001105,N00036023,Barbara Comstock (R),2014,Ideology/Single-Issue,120785,384000,504785
C001105,N00036023,Barbara Comstock (R),2014,Other,266968,5000,271968
G000574,N00036097,Ruben Gallego (D),2014,Agribusiness,5500,2007,7507
G000574,N00036097,Ruben Gallego (D),2014,Communic/Electronics,8900,18500,27400
G000574,N00036097,Ruben Gallego (D),2014,Construction,2600,2500,5100
G000574,N00036097,Ruben Gallego (D),2014,Defense,1750,7000,8750
G000574,N00036097,Ruben Gallego (D),2014,Energy/Nat Resource,3050,22000,25050
G000574,N00036097,Ruben Gallego (D),2014,Finance/Insur/RealEst,77900,27000,104900
G000574,N00036097,Ruben Gallego (D),2014,Health,12785,11500,24285
G000574,N00036097,Ruben Gallego (D),2014,Lawyers & Lobbyists,96491,6000,102491
G000574,N00036097,Ruben Gallego (D),2014,Transportation,3250,14500,17750
G000574,N00036097,Ruben Gallego (D),2014,Misc Business,60382,14500,74882
G000574,N00036097,Ruben Gallego (D),2014,Labor,500,117900,118400
G000574,N00036097,Ruben Gallego (D),2014,Ideology/Single-Issue,4252,111553,115805
G000574,N00036097,Ruben Gallego (D),2014,Other,48195,3500,51695
G000577,N00036135,Garret Graves (R),2014,Agribusiness,15800,22000,37800
G000577,N00036135,Garret Graves (R),2014,Communic/Electronics,27100,13000,40100
G000577,N00036135,Garret Graves (R),2014,Construction,216455,34459,250914
G000577,N00036135,Garret Graves (R),2014,Defense,250,5000,5250
G000577,N00036135,Garret Graves (R),2014,Energy/Nat Resource,63135,84100,147235
G000577,N00036135,Garret Graves (R),2014,Finance/Insur/RealEst,116588,53000,169588
G000577,N00036135,Garret Graves (R),2014,Health,67450,37200,104650
G000577,N00036135,Garret Graves (R),2014,Lawyers & Lobbyists,144888,36500,181388
G000577,N00036135,Garret Graves (R),2014,Transportation,72750,48700,121450
G000577,N00036135,Garret Graves (R),2014,Misc Business,139004,47500,186504
G000577,N00036135,Garret Graves (R),2014,Labor,0,10000,10000
G000577,N00036135,Garret Graves (R),2014,Ideology/Single-Issue,32800,97750,130550
G000577,N00036135,Garret Graves (R),2014,Other,96768,1000,97768
D000624,N00036149,Debbie Dingell (D),2014,Agribusiness,5100,17985,23085
D000624,N00036149,Debbie Dingell (D),2014,Communic/Electronics,39366,51000,90366
D000624,N00036149,Debbie Dingell (D),2014,Construction,16200,3500,19700
D000624,N00036149,Debbie Dingell (D),2014,Defense,3850,17000,20850
D000624,N00036149,Debbie Dingell (D),2014,Energy/Nat Resource,10750,54748,65498
D000624,N00036149,Debbie Dingell (D),2014,Finance/Insur/RealEst,104380,57000,161380
D000624,N00036149,Debbie Dingell (D),2014,Health,41389,41000,82389
D000624,N00036149,Debbie Dingell (D),2014,Lawyers & Lobbyists,126684,23608,150292
D000624,N00036149,Debbie Dingell (D),2014,Transportation,53750,57241,110991
D000624,N00036149,Debbie Dingell (D),2014,Misc Business,82377,75000,157377
D000624,N00036149,Debbie Dingell (D),2014,Labor,550,134500,135050
D000624,N00036149,Debbie Dingell (D),2014,Ideology/Single-Issue,65500,95877,161377
D000624,N00036149,Debbie Dingell (D),2014,Other,181898,707,182605
G000576,N00036409,Glenn S Grothman (R),2014,Agribusiness,24700,5000,29700
G000576,N00036409,Glenn S Grothman (R),2014,Communic/Electronics,500,3500,4000
G000576,N00036409,Glenn S Grothman (R),2014,Construction,40450,21100,61550
G000576,N00036409,Glenn S Grothman (R),2014,Defense,0,1000,1000
G000576,N00036409,Glenn S Grothman (R),2014,Energy/Nat Resource,3250,13000,16250
G000576,N00036409,Glenn S Grothman (R),2014,Finance/Insur/RealEst,64383,30500,94883
G000576,N00036409,Glenn S Grothman (R),2014,Health,11950,5600,17550
G000576,N00036409,Glenn S Grothman (R),2014,Lawyers & Lobbyists,11650,1000,12650
G000576,N00036409,Glenn S Grothman (R),2014,Transportation,3800,21000,24800
G000576,N00036409,Glenn S Grothman (R),2014,Misc Business,47050,19500,66550
G000576,N00036409,Glenn S Grothman (R),2014,Labor,0,1000,1000
G000576,N00036409,Glenn S Grothman (R),2014,Ideology/Single-Issue,13700,162450,176150
G000576,N00036409,Glenn S Grothman (R),2014,Other,123453,0,123453
B001293,N00036449,Mike Bishop (R),2014,Agribusiness,9700,11500,21200
B001293,N00036449,Mike Bishop (R),2014,Communic/Electronics,26400,11000,37400
B001293,N00036449,Mike Bishop (R),2014,Construction,20500,13500,34000
B001293,N00036449,Mike Bishop (R),2014,Defense,6100,5500,11600
B001293,N00036449,Mike Bishop (R),2014,Energy/Nat Resource,9200,53499,62699
B001293,N00036449,Mike Bishop (R),2014,Finance/Insur/RealEst,124600,92100,216700
B001293,N00036449,Mike Bishop (R),2014,Health,11400,54750,66150
B001293,N00036449,Mike Bishop (R),2014,Lawyers & Lobbyists,30572,8200,38772
B001293,N00036449,Mike Bishop (R),2014,Transportation,50500,44750,95250
B001293,N00036449,Mike Bishop (R),2014,Misc Business,73300,55500,128800
B001293,N00036449,Mike Bishop (R),2014,Ideology/Single-Issue,33875,148100,181975
B001293,N00036449,Mike Bishop (R),2014,Other,24625,0,24625
A000374,N00036633,Ralph Abraham (R),2014,Agribusiness,71850,16500,88350
A000374,N00036633,Ralph Abraham (R),2014,Communic/Electronics,1500,5500,7000
A000374,N00036633,Ralph Abraham (R),2014,Construction,25350,1000,26350
A000374,N00036633,Ralph Abraham (R),2014,Energy/Nat Resource,15453,13000,28453
A000374,N00036633,Ralph Abraham (R),2014,Finance/Insur/RealEst,39387,7500,46887
A000374,N00036633,Ralph Abraham (R),2014,Health,118000,16600,134600
A000374,N00036633,Ralph Abraham (R),2014,Lawyers & Lobbyists,13150,1000,14150
A000374,N00036633,Ralph Abraham (R),2014,Transportation,14150,6000,20150
A000374,N00036633,Ralph Abraham (R),2014,Misc Business,41400,3500,44900
A000374,N00036633,Ralph Abraham (R),2014,Ideology/Single-Issue,500,75000,75500
A000374,N00036633,Ralph Abraham (R),2014,Other,56714,0,56714
C001037,N00000267,Michael E Capuano (D),2016,Agribusiness,0,1000,1000
C001037,N00000267,Michael E Capuano (D),2016,Communic/Electronics,6950,12000,18950
C001037,N00000267,Michael E Capuano (D),2016,Construction,12800,33500,46300
C001037,N00000267,Michael E Capuano (D),2016,Defense,0,1000,1000
C001037,N00000267,Michael E Capuano (D),2016,Energy/Nat Resource,28000,2000,30000
C001037,N00000267,Michael E Capuano (D),2016,Finance/Insur/RealEst,36850,188250,225100
C001037,N00000267,Michael E Capuano (D),2016,Health,21300,40500,61800
C001037,N00000267,Michael E Capuano (D),2016,Lawyers & Lobbyists,26100,16250,42350
C001037,N00000267,Michael E Capuano (D),2016,Transportation,1850,71500,73350
C001037,N00000267,Michael E Capuano (D),2016,Misc Business,9450,14500,23950
C001037,N00000267,Michael E Capuano (D),2016,Labor,0,128500,128500
C001037,N00000267,Michael E Capuano (D),2016,Ideology/Single-Issue,2800,10000,12800
C001037,N00000267,Michael E Capuano (D),2016,Other,19250,0,19250
C001035,N00000491,Susan Collins (R),2016,Agribusiness,46000,123290,169290
C001035,N00000491,Susan Collins (R),2016,Communic/Electronics,120550,181000,301550
C001035,N00000491,Susan Collins (R),2016,Construction,71250,108000,179250
C001035,N00000491,Susan Collins (R),2016,Defense,72300,139500,211800
C001035,N00000491,Susan Collins (R),2016,Energy/Nat Resource,83830,103333,187163
C001035,N00000491,Susan Collins (R),2016,Finance/Insur/RealEst,613925,438100,1052025
C001035,N00000491,Susan Collins (R),2016,Health,118250,454673,572923
C001035,N00000491,Susan Collins (R),2016,Lawyers & Lobbyists,526169,140250,666419
C001035,N00000491,Susan Collins (R),2016,Transportation,59533,164000,223533
C001035,N00000491,Susan Collins (R),2016,Misc Business,280000,314500,594500
C001035,N00000491,Susan Collins (R),2016,Labor,0,122600,122600
C001035,N00000491,Susan Collins (R),2016,Ideology/Single-Issue,142335,462311,604646
C001035,N00000491,Susan Collins (R),2016,Other,514260,9000,523260
D000216,N00000615,Rosa L DeLauro (D),2016,Agribusiness,1500,31250,32750
D000216,N00000615,Rosa L DeLauro (D),2016,Communic/Electronics,4059,12590,16649
D000216,N00000615,Rosa L DeLauro (D),2016,Construction,6200,5000,11200
D000216,N00000615,Rosa L DeLauro (D),2016,Defense,0,46000,46000
D000216,N00000615,Rosa L DeLauro (D),2016,Energy/Nat Resource,5225,12000,17225
D000216,N00000615,Rosa L DeLauro (D),2016,Finance/Insur/RealEst,48600,22500,71100
D000216,N00000615,Rosa L DeLauro (D),2016,Health,43993,118000,161993
D000216,N00000615,Rosa L DeLauro (D),2016,Lawyers & Lobbyists,111585,32263,143848
D000216,N00000615,Rosa L DeLauro (D),2016,Transportation,13550,5000,18550
D000216,N00000615,Rosa L DeLauro (D),2016,Misc Business,37228,22000,59228
D000216,N00000615,Rosa L DeLauro (D),2016,Labor,500,231000,231500
D000216,N00000615,Rosa L DeLauro (D),2016,Ideology/Single-Issue,37565,39466,77031
D000216,N00000615,Rosa L DeLauro (D),2016,Other,105386,9000,114386
F000372,N00000684,Rodney Frelinghuysen (R),2016,Agribusiness,17450,24500,41950
F000372,N00000684,Rodney Frelinghuysen (R),2016,Communic/Electronics,46050,53000,99050
F000372,N00000684,Rodney Frelinghuysen (R),2016,Construction,38050,60500,98550
F000372,N00000684,Rodney Frelinghuysen (R),2016,Defense,147100,163500,310600
F000372,N00000684,Rodney Frelinghuysen (R),2016,Energy/Nat Resource,3300,103778,107078
F000372,N00000684,Rodney Frelinghuysen (R),2016,Finance/Insur/RealEst,180325,104500,284825
F000372,N00000684,Rodney Frelinghuysen (R),2016,Health,59450,132250,191700
F000372,N00000684,Rodney Frelinghuysen (R),2016,Lawyers & Lobbyists,137068,40721,177789
F000372,N00000684,Rodney Frelinghuysen (R),2016,Transportation,11900,79350,91250
F000372,N00000684,Rodney Frelinghuysen (R),2016,Misc Business,50890,113000,163890
F000372,N00000684,Rodney Frelinghuysen (R),2016,Labor,0,16500,16500
F000372,N00000684,Rodney Frelinghuysen (R),2016,Ideology/Single-Issue,21050,33500,54550
F000372,N00000684,Rodney Frelinghuysen (R),2016,Other,117664,0,117664
G000548,N00000743,Scott Garrett (R),2016,Agribusiness,12640,3000,15640
G000548,N00000743,Scott Garrett (R),2016,Communic/Electronics,35410,2090,37500
G000548,N00000743,Scott Garrett (R),2016,Construction,22050,10000,32050
G000548,N00000743,Scott Garrett (R),2016,Defense,0,16000,16000
G000548,N00000743,Scott Garrett (R),2016,Energy/Nat Resource,21550,24500,46050
G000548,N00000743,Scott Garrett (R),2016,Finance/Insur/RealEst,380048,329800,709848
G000548,N00000743,Scott Garrett (R),2016,Health,54110,6000,60110
G000548,N00000743,Scott Garrett (R),2016,Lawyers & Lobbyists,85535,10450,95985
G000548,N00000743,Scott Garrett (R),2016,Transportation,17225,10000,27225
G000548,N00000743,Scott Garrett (R),2016,Misc Business,62949,7095,70044
G000548,N00000743,Scott Garrett (R),2016,Labor,0,5000,5000
G000548,N00000743,Scott Garrett (R),2016,Ideology/Single-Issue,135258,262497,397755
G000548,N00000743,Scott Garrett (R),2016,Other,259543,0,259543
E000179,N00001003,Eliot L Engel (D),2016,Agribusiness,30750,14000,44750
E000179,N00001003,Eliot L Engel (D),2016,Communic/Electronics,16950,61500,78450
E000179,N00001003,Eliot L Engel (D),2016,Construction,29950,5000,34950
E000179,N00001003,Eliot L Engel (D),2016,Defense,0,40000,40000
E000179,N00001003,Eliot L Engel (D),2016,Energy/Nat Resource,12700,31000,43700
E000179,N00001003,Eliot L Engel (D),2016,Finance/Insur/RealEst,243450,24500,267950
E000179,N00001003,Eliot L Engel (D),2016,Health,110625,100500,211125
E000179,N00001003,Eliot L Engel (D),2016,Lawyers & Lobbyists,96886,19500,116386
E000179,N00001003,Eliot L Engel (D),2016,Transportation,5700,12000,17700
E000179,N00001003,Eliot L Engel (D),2016,Misc Business,82250,22000,104250
E000179,N00001003,Eliot L Engel (D),2016,Labor,0,102500,102500
E000179,N00001003,Eliot L Engel (D),2016,Ideology/Single-Issue,158150,69200,227350
E000179,N00001003,Eliot L Engel (D),2016,Other,156725,1000,157725
C001038,N00001127,Joseph Crowley (D),2016,Agribusiness,11350,29000,40350
C001038,N00001127,Joseph Crowley (D),2016,Communic/Electronics,43685,129800,173485
C001038,N00001127,Joseph Crowley (D),2016,Construction,30600,22500,53100
C001038,N00001127,Joseph Crowley (D),2016,Defense,0,42500,42500
C001038,N00001127,Joseph Crowley (D),2016,Energy/Nat Resource,8500,72000,80500
C001038,N00001127,Joseph Crowley (D),2016,Finance/Insur/RealEst,443923,647000,1090923
C001038,N00001127,Joseph Crowley (D),2016,Health,66575,250300,316875
C001038,N00001127,Joseph Crowley (D),2016,Lawyers & Lobbyists,198046,53700,251746
C001038,N00001127,Joseph Crowley (D),2016,Transportation,17951,77200,95151
C001038,N00001127,Joseph Crowley (D),2016,Misc Business,145490,144752,290242
C001038,N00001127,Joseph Crowley (D),2016,Labor,1090,164640,165730
C001038,N00001127,Joseph Crowley (D),2016,Ideology/Single-Issue,135540,27745,163285
C001038,N00001127,Joseph Crowley (D),2016,Other,54346,2500,56846
C001092,N00001285,Chris Collins (R),2016,Agribusiness,14780,31750,46530
C001092,N00001285,Chris Collins (R),2016,Communic/Electronics,5505,104500,110005
C001092,N00001285,Chris Collins (R),2016,Construction,18085,27000,45085
C001092,N00001285,Chris Collins (R),2016,Defense,0,21500,21500
C001092,N00001285,Chris Collins (R),2016,Energy/Nat Resource,17155,98200,115355
C001092,N00001285,Chris Collins (R),2016,Finance/Insur/RealEst,31260,55000,86260
C001092,N00001285,Chris Collins (R),2016,Health,53400,216900,270300
C001092,N00001285,Chris Collins (R),2016,Lawyers & Lobbyists,37470,9750,47220
C001092,N00001285,Chris Collins (R),2016,Transportation,2880,40500,43380
C001092,N00001285,Chris Collins (R),2016,Misc Business,42770,75000,117770
C001092,N00001285,Chris Collins (R),2016,Labor,0,25000,25000
C001092,N00001285,Chris Collins (R),2016,Ideology/Single-Issue,3050,49271,52321
C001092,N00001285,Chris Collins (R),2016,Other,28810,0,28810
D000482,N00001373,Mike Doyle (D),2016,Agribusiness,0,25000,25000
D000482,N00001373,Mike Doyle (D),2016,Communic/Electronics,1775,74000,75775
D000482,N00001373,Mike Doyle (D),2016,Construction,14060,5500,19560
D000482,N00001373,Mike Doyle (D),2016,Defense,1000,15500,16500
D000482,N00001373,Mike Doyle (D),2016,Energy/Nat Resource,1000,124500,125500
D000482,N00001373,Mike Doyle (D),2016,Finance/Insur/RealEst,32150,53000,85150
D000482,N00001373,Mike Doyle (D),2016,Health,2535,41500,44035
D000482,N00001373,Mike Doyle (D),2016,Lawyers & Lobbyists,28700,23000,51700
D000482,N00001373,Mike Doyle (D),2016,Transportation,1750,34011,35761
D000482,N00001373,Mike Doyle (D),2016,Misc Business,9500,65500,75000
D000482,N00001373,Mike Doyle (D),2016,Labor,0,193000,193000
D000482,N00001373,Mike Doyle (D),2016,Ideology/Single-Issue,16200,13956,30156
D000482,N00001373,Mike Doyle (D),2016,Other,14302,1500,15802
B001227,N00001619,Robert A Brady (D),2016,Agribusiness,6100,0,6100
B001227,N00001619,Robert A Brady (D),2016,Communic/Electronics,30150,26000,56150
B001227,N00001619,Robert A Brady (D),2016,Construction,37950,6000,43950
B001227,N00001619,Robert A Brady (D),2016,Defense,0,10000,10000
B001227,N00001619,Robert A Brady (D),2016,Energy/Nat Resource,20875,13000,33875
B001227,N00001619,Robert A Brady (D),2016,Finance/Insur/RealEst,41000,17200,58200
B001227,N00001619,Robert A Brady (D),2016,Health,9950,12000,21950
B001227,N00001619,Robert A Brady (D),2016,Lawyers & Lobbyists,66800,25500,92300
B001227,N00001619,Robert A Brady (D),2016,Transportation,5400,17000,22400
B001227,N00001619,Robert A Brady (D),2016,Misc Business,33500,9500,43000
B001227,N00001619,Robert A Brady (D),2016,Labor,0,222700,222700
B001227,N00001619,Robert A Brady (D),2016,Ideology/Single-Issue,0,0,0
B001227,N00001619,Robert A Brady (D),2016,Other,22250,0,22250
F000043,N00001746,Chaka Fattah (D),2016,Agribusiness,2700,500,3200
F000043,N00001746,Chaka Fattah (D),2016,Communic/Electronics,0,0,0
F000043,N00001746,Chaka Fattah (D),2016,Construction,1250,0,1250
F000043,N00001746,Chaka Fattah (D),2016,Defense,0,3000,3000
F000043,N00001746,Chaka Fattah (D),2016,Energy/Nat Resource,0,1000,1000
F000043,N00001746,Chaka Fattah (D),2016,Finance/Insur/RealEst,18300,3500,21800
F000043,N00001746,Chaka Fattah (D),2016,Health,0,2500,2500
F000043,N00001746,Chaka Fattah (D),2016,Lawyers & Lobbyists,7900,5000,12900
F000043,N00001746,Chaka Fattah (D),2016,Transportation,2000,1500,3500
F000043,N00001746,Chaka Fattah (D),2016,Misc Business,10300,4500,14800
F000043,N00001746,Chaka Fattah (D),2016,Labor,500,53500,54000
F000043,N00001746,Chaka Fattah (D),2016,Ideology/Single-Issue,500,31000,31500
F000043,N00001746,Chaka Fattah (D),2016,Other,13200,0,13200
G000386,N00001758,Chuck Grassley (R),2016,Agribusiness,321927,333119,655046
G000386,N00001758,Chuck Grassley (R),2016,Communic/Electronics,142450,285100,427550
G000386,N00001758,Chuck Grassley (R),2016,Construction,163426,80500,243926
G000386,N00001758,Chuck Grassley (R),2016,Defense,1820,41500,43320
G000386,N00001758,Chuck Grassley (R),2016,Energy/Nat Resource,176500,237750,414250
G000386,N00001758,Chuck Grassley (R),2016,Finance/Insur/RealEst,1056732,492300,1549032
G000386,N00001758,Chuck Grassley (R),2016,Health,234694,508814,743508
G000386,N00001758,Chuck Grassley (R),2016,Lawyers & Lobbyists,623117,146437,769554
G000386,N00001758,Chuck Grassley (R),2016,Transportation,92465,137199,229664
G000386,N00001758,Chuck Grassley (R),2016,Misc Business,412257,381699,793956
G000386,N00001758,Chuck Grassley (R),2016,Labor,0,12000,12000
G000386,N00001758,Chuck Grassley (R),2016,Ideology/Single-Issue,390470,558999,949469
G000386,N00001758,Chuck Grassley (R),2016,Other,990580,19000,1009580
H000874,N00001821,Steny H Hoyer (D),2016,Agribusiness,19050,80500,99550
H000874,N00001821,Steny H Hoyer (D),2016,Communic/Electronics,85500,163500,249000
H000874,N00001821,Steny H Hoyer (D),2016,Construction,7500,73500,81000
H000874,N00001821,Steny H Hoyer (D),2016,Defense,21564,112500,134064
H000874,N00001821,Steny H Hoyer (D),2016,Energy/Nat Resource,31200,241000,272200
H000874,N00001821,Steny H Hoyer (D),2016,Finance/Insur/RealEst,204726,606750,811476
H000874,N00001821,Steny H Hoyer (D),2016,Health,94770,414250,509020
H000874,N00001821,Steny H Hoyer (D),2016,Lawyers & Lobbyists,190121,47500,237621
H000874,N00001821,Steny H Hoyer (D),2016,Transportation,16450,142000,158450
H000874,N00001821,Steny H Hoyer (D),2016,Misc Business,58290,271500,329790
H000874,N00001821,Steny H Hoyer (D),2016,Labor,2500,305550,308050
H000874,N00001821,Steny H Hoyer (D),2016,Ideology/Single-Issue,84391,63738,148129
H000874,N00001821,Steny H Hoyer (D),2016,Other,129600,11000,140600
C000141,N00001955,Ben Cardin (D),2016,Agribusiness,23650,37500,61150
C000141,N00001955,Ben Cardin (D),2016,Communic/Electronics,207005,118446,325451
C000141,N00001955,Ben Cardin (D),2016,Construction,80172,136500,216672
C000141,N00001955,Ben Cardin (D),2016,Defense,7550,65500,73050
C000141,N00001955,Ben Cardin (D),2016,Energy/Nat Resource,65150,117250,182400
C000141,N00001955,Ben Cardin (D),2016,Finance/Insur/RealEst,752454,643999,1396453
C000141,N00001955,Ben Cardin (D),2016,Health,270849,583369,854218
C000141,N00001955,Ben Cardin (D),2016,Lawyers & Lobbyists,560511,127366,687877
C000141,N00001955,Ben Cardin (D),2016,Transportation,31250,88500,119750
C000141,N00001955,Ben Cardin (D),2016,Misc Business,255629,246041,501670
C000141,N00001955,Ben Cardin (D),2016,Labor,1500,288500,290000
C000141,N00001955,Ben Cardin (D),2016,Ideology/Single-Issue,236481,304280,540761
C000141,N00001955,Ben Cardin (D),2016,Other,398733,13000,411733
C000984,N00001971,Elijah E Cummings (D),2016,Agribusiness,1000,13500,14500
C000984,N00001971,Elijah E Cummings (D),2016,Communic/Electronics,8500,33500,42000
C000984,N00001971,Elijah E Cummings (D),2016,Construction,17550,12500,30050
C000984,N00001971,Elijah E Cummings (D),2016,Defense,0,4500,4500
C000984,N00001971,Elijah E Cummings (D),2016,Energy/Nat Resource,33000,12000,45000
C000984,N00001971,Elijah E Cummings (D),2016,Finance/Insur/RealEst,65150,57000,122150
C000984,N00001971,Elijah E Cummings (D),2016,Health,31225,40300,71525
C000984,N00001971,Elijah E Cummings (D),2016,Lawyers & Lobbyists,43100,25500,68600
C000984,N00001971,Elijah E Cummings (D),2016,Transportation,7000,94500,101500
C000984,N00001971,Elijah E Cummings (D),2016,Misc Business,26500,44700,71200
C000984,N00001971,Elijah E Cummings (D),2016,Labor,750,247000,247750
C000984,N00001971,Elijah E Cummings (D),2016,Ideology/Single-Issue,24510,13052,37562
C000984,N00001971,Elijah E Cummings (D),2016,Other,52060,1500,53560
B001135,N00002221,Richard Burr (R),2016,Agribusiness,361000,308700,669700
B001135,N00002221,Richard Burr (R),2016,Communic/Electronics,141090,204500,345590
B001135,N00002221,Richard Burr (R),2016,Construction,233276,123000,356276
B001135,N00002221,Richard Burr (R),2016,Defense,51700,111500,163200
B001135,N00002221,Richard Burr (R),2016,Energy/Nat Resource,326232,385800,712032
B001135,N00002221,Richard Burr (R),2016,Finance/Insur/RealEst,1743946,727200,2471146
B001135,N00002221,Richard Burr (R),2016,Health,481100,917802,1398902
B001135,N00002221,Richard Burr (R),2016,Lawyers & Lobbyists,773187,162972,936159
B001135,N00002221,Richard Burr (R),2016,Transportation,159100,186000,345100
B001135,N00002221,Richard Burr (R),2016,Misc Business,791883,544900,1336783
B001135,N00002221,Richard Burr (R),2016,Labor,0,8500,8500
B001135,N00002221,Richard Burr (R),2016,Ideology/Single-Issue,227961,653111,881072
B001135,N00002221,Richard Burr (R),2016,Other,1197421,45000,1242421
C000537,N00002408,James E Clyburn (D),2016,Agribusiness,4800,89000,93800
C000537,N00002408,James E Clyburn (D),2016,Communic/Electronics,7800,180000,187800
C000537,N00002408,James E Clyburn (D),2016,Construction,10570,92499,103069
C000537,N00002408,James E Clyburn (D),2016,Defense,0,50500,50500
C000537,N00002408,James E Clyburn (D),2016,Energy/Nat Resource,10030,145000,155030
C000537,N00002408,James E Clyburn (D),2016,Finance/Insur/RealEst,15275,359750,375025
C000537,N00002408,James E Clyburn (D),2016,Health,19910,243762,263672
C000537,N00002408,James E Clyburn (D),2016,Lawyers & Lobbyists,80360,48500,128860
C000537,N00002408,James E Clyburn (D),2016,Transportation,1100,95000,96100
C000537,N00002408,James E Clyburn (D),2016,Misc Business,14021,170983,185004
C000537,N00002408,James E Clyburn (D),2016,Labor,0,262340,262340
C000537,N00002408,James E Clyburn (D),2016,Ideology/Single-Issue,6210,19200,25410
C000537,N00002408,James E Clyburn (D),2016,Other,50908,1000,51908
B000490,N00002674,Sanford Bishop (D),2016,Agribusiness,19584,160000,179584
B000490,N00002674,Sanford Bishop (D),2016,Communic/Electronics,4000,50230,54230
B000490,N00002674,Sanford Bishop (D),2016,Construction,8250,12500,20750
B000490,N00002674,Sanford Bishop (D),2016,Defense,500,45500,46000
B000490,N00002674,Sanford Bishop (D),2016,Energy/Nat Resource,0,53000,53000
B000490,N00002674,Sanford Bishop (D),2016,Finance/Insur/RealEst,24752,97000,121752
B000490,N00002674,Sanford Bishop (D),2016,Health,15150,56000,71150
B000490,N00002674,Sanford Bishop (D),2016,Lawyers & Lobbyists,40484,24750,65234
B000490,N00002674,Sanford Bishop (D),2016,Transportation,7500,38500,46000
B000490,N00002674,Sanford Bishop (D),2016,Misc Business,43850,96400,140250
B000490,N00002674,Sanford Bishop (D),2016,Labor,0,135000,135000
B000490,N00002674,Sanford Bishop (D),2016,Ideology/Single-Issue,8530,40520,49050
B000490,N00002674,Sanford Bishop (D),2016,Other,37100,0,37100
B000911,N00002713,Corrine Brown (D),2016,Agribusiness,5000,2000,7000
B000911,N00002713,Corrine Brown (D),2016,Communic/Electronics,750,15000,15750
B000911,N00002713,Corrine Brown (D),2016,Construction,5000,4000,9000
B000911,N00002713,Corrine Brown (D),2016,Defense,0,3500,3500
B000911,N00002713,Corrine Brown (D),2016,Energy/Nat Resource,1000,0,1000
B000911,N00002713,Corrine Brown (D),2016,Finance/Insur/RealEst,23900,15500,39400
B000911,N00002713,Corrine Brown (D),2016,Health,250,13500,13750
B000911,N00002713,Corrine Brown (D),2016,Lawyers & Lobbyists,11700,16000,27700
B000911,N00002713,Corrine Brown (D),2016,Transportation,14300,91000,105300
B000911,N00002713,Corrine Brown (D),2016,Misc Business,2000,23900,25900
B000911,N00002713,Corrine Brown (D),2016,Labor,0,86500,86500
B000911,N00002713,Corrine Brown (D),2016,Ideology/Single-Issue,0,71500,71500
B000911,N00002713,Corrine Brown (D),2016,Other,13475,0,13475
H000324,N00002884,Alcee L Hastings (D),2016,Agribusiness,15250,23500,38750
H000324,N00002884,Alcee L Hastings (D),2016,Communic/Electronics,3000,41000,44000
H000324,N00002884,Alcee L Hastings (D),2016,Construction,14500,0,14500
H000324,N00002884,Alcee L Hastings (D),2016,Defense,0,5000,5000
H000324,N00002884,Alcee L Hastings (D),2016,Energy/Nat Resource,5000,6000,11000
H000324,N00002884,Alcee L Hastings (D),2016,Finance/Insur/RealEst,53600,48250,101850
H000324,N00002884,Alcee L Hastings (D),2016,Health,11300,10000,21300
H000324,N00002884,Alcee L Hastings (D),2016,Lawyers & Lobbyists,88850,13000,101850
H000324,N00002884,Alcee L Hastings (D),2016,Transportation,6250,23000,29250
H000324,N00002884,Alcee L Hastings (D),2016,Misc Business,31901,6000,37901
H000324,N00002884,Alcee L Hastings (D),2016,Labor,0,120250,120250
H000324,N00002884,Alcee L Hastings (D),2016,Ideology/Single-Issue,69950,55981,125931
H000324,N00002884,Alcee L Hastings (D),2016,Other,64985,19900,84885
F000462,N00002893,Lois J Frankel (D),2016,Agribusiness,21002,18000,39002
F000462,N00002893,Lois J Frankel (D),2016,Communic/Electronics,6549,18000,24549
F000462,N00002893,Lois J Frankel (D),2016,Construction,15127,9500,24627
F000462,N00002893,Lois J Frankel (D),2016,Defense,5650,3250,8900
F000462,N00002893,Lois J Frankel (D),2016,Energy/Nat Resource,1000,7500,8500
F000462,N00002893,Lois J Frankel (D),2016,Finance/Insur/RealEst,266270,27500,293770
F000462,N00002893,Lois J Frankel (D),2016,Health,45717,70000,115717
F000462,N00002893,Lois J Frankel (D),2016,Lawyers & Lobbyists,103214,18500,121714
F000462,N00002893,Lois J Frankel (D),2016,Transportation,1725,86500,88225
F000462,N00002893,Lois J Frankel (D),2016,Misc Business,85604,61247,146851
F000462,N00002893,Lois J Frankel (D),2016,Labor,10,195000,195010
F000462,N00002893,Lois J Frankel (D),2016,Ideology/Single-Issue,83750,46499,130249
F000462,N00002893,Lois J Frankel (D),2016,Other,146456,0,146456
C001111,N00002942,Charlie Crist (D),2016,Agribusiness,15850,1000,16850
C001111,N00002942,Charlie Crist (D),2016,Communic/Electronics,36100,8000,44100
C001111,N00002942,Charlie Crist (D),2016,Construction,40906,0,40906
C001111,N00002942,Charlie Crist (D),2016,Defense,0,4500,4500
C001111,N00002942,Charlie Crist (D),2016,Energy/Nat Resource,16202,0,16202
C001111,N00002942,Charlie Crist (D),2016,Finance/Insur/RealEst,185531,22000,207531
C001111,N00002942,Charlie Crist (D),2016,Health,72755,15000,87755
C001111,N00002942,Charlie Crist (D),2016,Lawyers & Lobbyists,384261,16500,400761
C001111,N00002942,Charlie Crist (D),2016,Transportation,1750,5000,6750
C001111,N00002942,Charlie Crist (D),2016,Misc Business,130446,11000,141446
C001111,N00002942,Charlie Crist (D),2016,Labor,250,200500,200750
C001111,N00002942,Charlie Crist (D),2016,Ideology/Single-Issue,46195,189768,235963
C001111,N00002942,Charlie Crist (D),2016,Other,117067,1000,118067
A000055,N00003028,Robert B Aderholt (R),2016,Agribusiness,29537,294000,323537
A000055,N00003028,Robert B Aderholt (R),2016,Communic/Electronics,22300,29000,51300
A000055,N00003028,Robert B Aderholt (R),2016,Construction,54850,37000,91850
A000055,N00003028,Robert B Aderholt (R),2016,Defense,35351,128877,164228
A000055,N00003028,Robert B Aderholt (R),2016,Energy/Nat Resource,11850,52000,63850
A000055,N00003028,Robert B Aderholt (R),2016,Finance/Insur/RealEst,29334,118450,147784
A000055,N00003028,Robert B Aderholt (R),2016,Health,32404,54932,87336
A000055,N00003028,Robert B Aderholt (R),2016,Lawyers & Lobbyists,59853,46130,105983
A000055,N00003028,Robert B Aderholt (R),2016,Transportation,17401,43500,60901
A000055,N00003028,Robert B Aderholt (R),2016,Misc Business,44829,94500,139329
A000055,N00003028,Robert B Aderholt (R),2016,Labor,0,13500,13500
A000055,N00003028,Robert B Aderholt (R),2016,Ideology/Single-Issue,2500,27500,30000
A000055,N00003028,Robert B Aderholt (R),2016,Other,14811,1000,15811
B001243,N00003105,Marsha Blackburn (R),2016,Agribusiness,6800,26000,32800
B001243,N00003105,Marsha Blackburn (R),2016,Communic/Electronics,20650,162000,182650
B001243,N00003105,Marsha Blackburn (R),2016,Construction,19900,32500,52400
B001243,N00003105,Marsha Blackburn (R),2016,Defense,3700,22000,25700
B001243,N00003105,Marsha Blackburn (R),2016,Energy/Nat Resource,17900,103500,121400
B001243,N00003105,Marsha Blackburn (R),2016,Finance/Insur/RealEst,109900,183500,293400
B001243,N00003105,Marsha Blackburn (R),2016,Health,72555,451349,523904
B001243,N00003105,Marsha Blackburn (R),2016,Lawyers & Lobbyists,51696,40500,92196
B001243,N00003105,Marsha Blackburn (R),2016,Transportation,34600,60500,95100
B001243,N00003105,Marsha Blackburn (R),2016,Misc Business,112350,158846,271196
B001243,N00003105,Marsha Blackburn (R),2016,Labor,0,8000,8000
B001243,N00003105,Marsha Blackburn (R),2016,Ideology/Single-Issue,10950,35730,46680
B001243,N00003105,Marsha Blackburn (R),2016,Other,89170,3000,92170
C000754,N00003132,Jim Cooper (D),2016,Agribusiness,1500,11500,13000
C000754,N00003132,Jim Cooper (D),2016,Communic/Electronics,8250,9500,17750
C000754,N00003132,Jim Cooper (D),2016,Construction,4000,20000,24000
C000754,N00003132,Jim Cooper (D),2016,Defense,0,58500,58500
C000754,N00003132,Jim Cooper (D),2016,Energy/Nat Resource,6150,8000,14150
C000754,N00003132,Jim Cooper (D),2016,Finance/Insur/RealEst,41430,76500,117930
C000754,N00003132,Jim Cooper (D),2016,Health,21230,20000,41230
C000754,N00003132,Jim Cooper (D),2016,Lawyers & Lobbyists,42300,15500,57800
C000754,N00003132,Jim Cooper (D),2016,Transportation,2750,31500,34250
C000754,N00003132,Jim Cooper (D),2016,Misc Business,23100,46500,69600
C000754,N00003132,Jim Cooper (D),2016,Labor,0,23500,23500
C000754,N00003132,Jim Cooper (D),2016,Ideology/Single-Issue,3625,27000,30625
C000754,N00003132,Jim Cooper (D),2016,Other,58200,1000,59200
D000533,N00003209,John J Duncan Jr (R),2016,Agribusiness,0,6000,6000
D000533,N00003209,John J Duncan Jr (R),2016,Communic/Electronics,0,3000,3000
D000533,N00003209,John J Duncan Jr (R),2016,Construction,5250,53500,58750
D000533,N00003209,John J Duncan Jr (R),2016,Defense,0,1500,1500
D000533,N00003209,John J Duncan Jr (R),2016,Energy/Nat Resource,1250,13500,14750
D000533,N00003209,John J Duncan Jr (R),2016,Finance/Insur/RealEst,5750,12500,18250
D000533,N00003209,John J Duncan Jr (R),2016,Health,16050,2100,18150
D000533,N00003209,John J Duncan Jr (R),2016,Lawyers & Lobbyists,28950,19500,48450
D000533,N00003209,John J Duncan Jr (R),2016,Transportation,4750,114131,118881
D000533,N00003209,John J Duncan Jr (R),2016,Misc Business,2500,10000,12500
D000533,N00003209,John J Duncan Jr (R),2016,Labor,0,16500,16500
D000533,N00003209,John J Duncan Jr (R),2016,Ideology/Single-Issue,2000,7130,9130
D000533,N00003209,John J Duncan Jr (R),2016,Other,3300,3000,6300
C001068,N00003225,Steve Cohen (D),2016,Agribusiness,2250,20500,22750
C001068,N00003225,Steve Cohen (D),2016,Communic/Electronics,1000,48000,49000
C001068,N00003225,Steve Cohen (D),2016,Construction,8600,4500,13100
C001068,N00003225,Steve Cohen (D),2016,Energy/Nat Resource,0,3000,3000
C001068,N00003225,Steve Cohen (D),2016,Finance/Insur/RealEst,51650,24000,75650
C001068,N00003225,Steve Cohen (D),2016,Health,7250,27000,34250
C001068,N00003225,Steve Cohen (D),2016,Lawyers & Lobbyists,22920,19750,42670
C001068,N00003225,Steve Cohen (D),2016,Transportation,7450,88000,95450
C001068,N00003225,Steve Cohen (D),2016,Misc Business,15450,55500,70950
C001068,N00003225,Steve Cohen (D),2016,Labor,0,125500,125500
C001068,N00003225,Steve Cohen (D),2016,Ideology/Single-Issue,3200,23002,26202
C001068,N00003225,Steve Cohen (D),2016,Other,12400,1500,13900
C000567,N00003328,Thad Cochran (R),2016,Agribusiness,447979,751787,1199766
C000567,N00003328,Thad Cochran (R),2016,Communic/Electronics,111450,164600,276050
C000567,N00003328,Thad Cochran (R),2016,Construction,192900,112700,305600
C000567,N00003328,Thad Cochran (R),2016,Defense,140350,376600,516950
C000567,N00003328,Thad Cochran (R),2016,Energy/Nat Resource,187755,293000,480755
C000567,N00003328,Thad Cochran (R),2016,Finance/Insur/RealEst,370239,381300,751539
C000567,N00003328,Thad Cochran (R),2016,Health,118968,260900,379868
C000567,N00003328,Thad Cochran (R),2016,Lawyers & Lobbyists,449775,165251,615026
C000567,N00003328,Thad Cochran (R),2016,Transportation,162850,203800,366650
C000567,N00003328,Thad Cochran (R),2016,Misc Business,263852,241191,505043
C000567,N00003328,Thad Cochran (R),2016,Labor,0,53000,53000
C000567,N00003328,Thad Cochran (R),2016,Ideology/Single-Issue,95500,610350,705850
C000567,N00003328,Thad Cochran (R),2016,Other,297492,8500,305992
B000944,N00003535,Sherrod Brown (D),2016,Agribusiness,145173,103000,248173
B000944,N00003535,Sherrod Brown (D),2016,Communic/Electronics,502212,133500,635712
B000944,N00003535,Sherrod Brown (D),2016,Construction,206143,92800,298943
B000944,N00003535,Sherrod Brown (D),2016,Defense,18590,77000,95590
B000944,N00003535,Sherrod Brown (D),2016,Energy/Nat Resource,127985,135600,263585
B000944,N00003535,Sherrod Brown (D),2016,Finance/Insur/RealEst,1406308,784350,2190658
B000944,N00003535,Sherrod Brown (D),2016,Health,868849,395550,1264399
B000944,N00003535,Sherrod Brown (D),2016,Lawyers & Lobbyists,2357013,239723,2596736
B000944,N00003535,Sherrod Brown (D),2016,Transportation,115163,70500,185663
B000944,N00003535,Sherrod Brown (D),2016,Misc Business,810838,301400,1112238
B000944,N00003535,Sherrod Brown (D),2016,Labor,32296,419050,451346
B000944,N00003535,Sherrod Brown (D),2016,Ideology/Single-Issue,1560844,583523,2144367
B000944,N00003535,Sherrod Brown (D),2016,Other,2454517,20650,2475167
B000589,N00003675,John Boehner (R),2016,Agribusiness,171590,0,171590
B000589,N00003675,John Boehner (R),2016,Communic/Electronics,36198,-5000,31198
B000589,N00003675,John Boehner (R),2016,Construction,158400,0,158400
B000589,N00003675,John Boehner (R),2016,Defense,5350,0,5350
B000589,N00003675,John Boehner (R),2016,Energy/Nat Resource,232800,-5000,227800
B000589,N00003675,John Boehner (R),2016,Finance/Insur/RealEst,654390,0,654390
B000589,N00003675,John Boehner (R),2016,Health,205225,-5000,200225
B000589,N00003675,John Boehner (R),2016,Lawyers & Lobbyists,295300,0,295300
B000589,N00003675,John Boehner (R),2016,Transportation,81650,0,81650
B000589,N00003675,John Boehner (R),2016,Misc Business,320735,0,320735
B000589,N00003675,John Boehner (R),2016,Ideology/Single-Issue,32975,0,32975
B000589,N00003675,John Boehner (R),2016,Other,399718,0,399718
C000266,N00003689,Steve Chabot (R),2016,Agribusiness,22600,21500,44100
C000266,N00003689,Steve Chabot (R),2016,Communic/Electronics,11950,63500,75450
C000266,N00003689,Steve Chabot (R),2016,Construction,21850,35700,57550
C000266,N00003689,Steve Chabot (R),2016,Defense,0,20000,20000
C000266,N00003689,Steve Chabot (R),2016,Energy/Nat Resource,2200,25000,27200
C000266,N00003689,Steve Chabot (R),2016,Finance/Insur/RealEst,82811,120750,203561
C000266,N00003689,Steve Chabot (R),2016,Health,24250,13500,37750
C000266,N00003689,Steve Chabot (R),2016,Lawyers & Lobbyists,41300,16500,57800
C000266,N00003689,Steve Chabot (R),2016,Transportation,17650,41177,58827
C000266,N00003689,Steve Chabot (R),2016,Misc Business,107800,117500,225300
C000266,N00003689,Steve Chabot (R),2016,Ideology/Single-Issue,2250,39897,42147
C000266,N00003689,Steve Chabot (R),2016,Other,50190,0,50190
C000542,N00003845,Dan Coats (R),2016,Agribusiness,11750,13600,25350
C000542,N00003845,Dan Coats (R),2016,Communic/Electronics,26900,38100,65000
C000542,N00003845,Dan Coats (R),2016,Construction,14050,21000,35050
C000542,N00003845,Dan Coats (R),2016,Defense,500,64050,64550
C000542,N00003845,Dan Coats (R),2016,Energy/Nat Resource,38050,74750,112800
C000542,N00003845,Dan Coats (R),2016,Finance/Insur/RealEst,113250,71000,184250
C000542,N00003845,Dan Coats (R),2016,Health,47900,79950,127850
C000542,N00003845,Dan Coats (R),2016,Lawyers & Lobbyists,75750,29850,105600
C000542,N00003845,Dan Coats (R),2016,Transportation,11550,67500,79050
C000542,N00003845,Dan Coats (R),2016,Misc Business,62850,70000,132850
C000542,N00003845,Dan Coats (R),2016,Labor,0,6500,6500
C000542,N00003845,Dan Coats (R),2016,Ideology/Single-Issue,2600,69500,72100
C000542,N00003845,Dan Coats (R),2016,Other,54350,3500,57850
C000714,N00004029,John Conyers Jr (D),2016,Agribusiness,25,1000,1025
C000714,N00004029,John Conyers Jr (D),2016,Communic/Electronics,9913,119396,129309
C000714,N00004029,John Conyers Jr (D),2016,Construction,1000,0,1000
C000714,N00004029,John Conyers Jr (D),2016,Energy/Nat Resource,0,10000,10000
C000714,N00004029,John Conyers Jr (D),2016,Finance/Insur/RealEst,9625,3500,13125
C000714,N00004029,John Conyers Jr (D),2016,Health,3670,33600,37270
C000714,N00004029,John Conyers Jr (D),2016,Lawyers & Lobbyists,47128,15000,62128
C000714,N00004029,John Conyers Jr (D),2016,Transportation,2255,14000,16255
C000714,N00004029,John Conyers Jr (D),2016,Misc Business,13360,32000,45360
C000714,N00004029,John Conyers Jr (D),2016,Labor,0,119000,119000
C000714,N00004029,John Conyers Jr (D),2016,Ideology/Single-Issue,13280,6000,19280
C000714,N00004029,John Conyers Jr (D),2016,Other,13968,3000,16968
B001230,N00004367,Tammy Baldwin (D),2016,Agribusiness,77545,48000,125545
B001230,N00004367,Tammy Baldwin (D),2016,Communic/Electronics,442955,51000,493955
B001230,N00004367,Tammy Baldwin (D),2016,Construction,65228,15600,80828
B001230,N00004367,Tammy Baldwin (D),2016,Defense,5664,8500,14164
B001230,N00004367,Tammy Baldwin (D),2016,Energy/Nat Resource,49647,70250,119897
B001230,N00004367,Tammy Baldwin (D),2016,Finance/Insur/RealEst,486884,100500,587384
B001230,N00004367,Tammy Baldwin (D),2016,Health,395488,147761,543249
B001230,N00004367,Tammy Baldwin (D),2016,Lawyers & Lobbyists,869208,46709,915917
B001230,N00004367,Tammy Baldwin (D),2016,Transportation,25598,37250,62848
B001230,N00004367,Tammy Baldwin (D),2016,Misc Business,473883,84000,557883
B001230,N00004367,Tammy Baldwin (D),2016,Labor,26047,424750,450797
B001230,N00004367,Tammy Baldwin (D),2016,Ideology/Single-Issue,1910092,735435,2645527
B001230,N00004367,Tammy Baldwin (D),2016,Other,1882402,7250,1889652
C001096,N00004614,Kevin Cramer (R),2016,Agribusiness,47100,100500,147600
C001096,N00004614,Kevin Cramer (R),2016,Communic/Electronics,9525,117000,126525
C001096,N00004614,Kevin Cramer (R),2016,Construction,22600,34000,56600
C001096,N00004614,Kevin Cramer (R),2016,Defense,0,27000,27000
C001096,N00004614,Kevin Cramer (R),2016,Energy/Nat Resource,57900,275800,333700
C001096,N00004614,Kevin Cramer (R),2016,Finance/Insur/RealEst,34750,55500,90250
C001096,N00004614,Kevin Cramer (R),2016,Health,5100,83500,88600
C001096,N00004614,Kevin Cramer (R),2016,Lawyers & Lobbyists,32643,7250,39893
C001096,N00004614,Kevin Cramer (R),2016,Transportation,1750,37000,38750
C001096,N00004614,Kevin Cramer (R),2016,Misc Business,34750,59500,94250
C001096,N00004614,Kevin Cramer (R),2016,Labor,0,12000,12000
C001096,N00004614,Kevin Cramer (R),2016,Ideology/Single-Issue,21450,20100,41550
C001096,N00004614,Kevin Cramer (R),2016,Other,48650,0,48650
G000535,N00004874,Luis V Gutierrez (D),2016,Agribusiness,250,3500,3750
G000535,N00004874,Luis V Gutierrez (D),2016,Communic/Electronics,0,38000,38000
G000535,N00004874,Luis V Gutierrez (D),2016,Construction,4750,8500,13250
G000535,N00004874,Luis V Gutierrez (D),2016,Defense,0,5000,5000
G000535,N00004874,Luis V Gutierrez (D),2016,Energy/Nat Resource,2700,1000,3700
G000535,N00004874,Luis V Gutierrez (D),2016,Finance/Insur/RealEst,16950,54500,71450
G000535,N00004874,Luis V Gutierrez (D),2016,Health,2250,15500,17750
G000535,N00004874,Luis V Gutierrez (D),2016,Lawyers & Lobbyists,23650,7250,30900
G000535,N00004874,Luis V Gutierrez (D),2016,Transportation,286,1000,1286
G000535,N00004874,Luis V Gutierrez (D),2016,Misc Business,30276,9500,39776
G000535,N00004874,Luis V Gutierrez (D),2016,Labor,0,99500,99500
G000535,N00004874,Luis V Gutierrez (D),2016,Ideology/Single-Issue,7090,71367,78457
G000535,N00004874,Luis V Gutierrez (D),2016,Other,19225,0,19225
D000096,N00004884,Danny K Davis (D),2016,Agribusiness,0,27000,27000
D000096,N00004884,Danny K Davis (D),2016,Communic/Electronics,500,18500,19000
D000096,N00004884,Danny K Davis (D),2016,Construction,550,6500,7050
D000096,N00004884,Danny K Davis (D),2016,Defense,50,5000,5050
D000096,N00004884,Danny K Davis (D),2016,Energy/Nat Resource,500,28500,29000
D000096,N00004884,Danny K Davis (D),2016,Finance/Insur/RealEst,500,97500,98000
D000096,N00004884,Danny K Davis (D),2016,Health,5526,80000,85526
D000096,N00004884,Danny K Davis (D),2016,Lawyers & Lobbyists,8700,16250,24950
D000096,N00004884,Danny K Davis (D),2016,Transportation,0,23100,23100
D000096,N00004884,Danny K Davis (D),2016,Misc Business,3350,81750,85100
D000096,N00004884,Danny K Davis (D),2016,Labor,0,134000,134000
D000096,N00004884,Danny K Davis (D),2016,Ideology/Single-Issue,2350,17250,19600
D000096,N00004884,Danny K Davis (D),2016,Other,3700,1000,4700
D000563,N00004981,Dick Durbin (D),2016,Agribusiness,47480,96250,143730
D000563,N00004981,Dick Durbin (D),2016,Communic/Electronics,179420,140550,319970
D000563,N00004981,Dick Durbin (D),2016,Construction,116065,64450,180515
D000563,N00004981,Dick Durbin (D),2016,Defense,254803,131999,386802
D000563,N00004981,Dick Durbin (D),2016,Energy/Nat Resource,64674,107100,171774
D000563,N00004981,Dick Durbin (D),2016,Finance/Insur/RealEst,816014,241340,1057354
D000563,N00004981,Dick Durbin (D),2016,Health,252652,343960,596612
D000563,N00004981,Dick Durbin (D),2016,Lawyers & Lobbyists,1510983,125170,1636153
D000563,N00004981,Dick Durbin (D),2016,Transportation,122183,175509,297692
D000563,N00004981,Dick Durbin (D),2016,Misc Business,346002,374805,720807
D000563,N00004981,Dick Durbin (D),2016,Labor,24055,278000,302055
D000563,N00004981,Dick Durbin (D),2016,Ideology/Single-Issue,319435,268169,587604
D000563,N00004981,Dick Durbin (D),2016,Other,697754,6000,703754
B000575,N00005195,Roy Blunt (R),2016,Agribusiness,489994,443648,933642
B000575,N00005195,Roy Blunt (R),2016,Communic/Electronics,256150,403900,660050
B000575,N00005195,Roy Blunt (R),2016,Construction,317126,179900,497026
B000575,N00005195,Roy Blunt (R),2016,Defense,60566,170500,231066
B000575,N00005195,Roy Blunt (R),2016,Energy/Nat Resource,366153,425800,791953
B000575,N00005195,Roy Blunt (R),2016,Finance/Insur/RealEst,1971837,852300,2824137
B000575,N00005195,Roy Blunt (R),2016,Health,654338,699500,1353838
B000575,N00005195,Roy Blunt (R),2016,Lawyers & Lobbyists,955103,219288,1174391
B000575,N00005195,Roy Blunt (R),2016,Transportation,452683,378600,831283
B000575,N00005195,Roy Blunt (R),2016,Misc Business,1082657,714500,1797157
B000575,N00005195,Roy Blunt (R),2016,Labor,500,74500,75000
B000575,N00005195,Roy Blunt (R),2016,Ideology/Single-Issue,428487,801543,1230030
B000575,N00005195,Roy Blunt (R),2016,Other,997273,45000,1042273
A000373,N00005293,Brad Ashford (D),2016,Agribusiness,14300,139250,153550
A000373,N00005293,Brad Ashford (D),2016,Communic/Electronics,20030,57630,77660
A000373,N00005293,Brad Ashford (D),2016,Construction,10445,27500,37945
A000373,N00005293,Brad Ashford (D),2016,Defense,10,36000,36010
A000373,N00005293,Brad Ashford (D),2016,Energy/Nat Resource,17450,54000,71450
A000373,N00005293,Brad Ashford (D),2016,Finance/Insur/RealEst,191065,204000,395065
A000373,N00005293,Brad Ashford (D),2016,Health,70359,98250,168609
A000373,N00005293,Brad Ashford (D),2016,Lawyers & Lobbyists,129285,20750,150035
A000373,N00005293,Brad Ashford (D),2016,Transportation,13265,50500,63765
A000373,N00005293,Brad Ashford (D),2016,Misc Business,85167,96000,181167
A000373,N00005293,Brad Ashford (D),2016,Labor,500,64500,65000
A000373,N00005293,Brad Ashford (D),2016,Ideology/Single-Issue,87985,392317,480302
A000373,N00005293,Brad Ashford (D),2016,Other,174840,1000,175840
B000213,N00005656,Joe Barton (R),2016,Agribusiness,6700,16829,23529
B000213,N00005656,Joe Barton (R),2016,Communic/Electronics,29950,78640,108590
B000213,N00005656,Joe Barton (R),2016,Construction,15250,28200,43450
B000213,N00005656,Joe Barton (R),2016,Defense,0,26500,26500
B000213,N00005656,Joe Barton (R),2016,Energy/Nat Resource,96900,239150,336050
B000213,N00005656,Joe Barton (R),2016,Finance/Insur/RealEst,77337,33100,110437
B000213,N00005656,Joe Barton (R),2016,Health,11530,100750,112280
B000213,N00005656,Joe Barton (R),2016,Lawyers & Lobbyists,42150,16500,58650
B000213,N00005656,Joe Barton (R),2016,Transportation,6600,48750,55350
B000213,N00005656,Joe Barton (R),2016,Misc Business,77624,88500,166124
B000213,N00005656,Joe Barton (R),2016,Labor,0,3000,3000
B000213,N00005656,Joe Barton (R),2016,Ideology/Single-Issue,10050,34100,44150
B000213,N00005656,Joe Barton (R),2016,Other,37690,0,37690
B001291,N00005736,Brian Babin (R),2016,Agribusiness,18150,34010,52160
B001291,N00005736,Brian Babin (R),2016,Communic/Electronics,9575,20000,29575
B001291,N00005736,Brian Babin (R),2016,Construction,29264,32500,61764
B001291,N00005736,Brian Babin (R),2016,Defense,2250,20000,22250
B001291,N00005736,Brian Babin (R),2016,Energy/Nat Resource,14500,53200,67700
B001291,N00005736,Brian Babin (R),2016,Finance/Insur/RealEst,64675,26250,90925
B001291,N00005736,Brian Babin (R),2016,Health,118640,88000,206640
B001291,N00005736,Brian Babin (R),2016,Lawyers & Lobbyists,28950,10750,39700
B001291,N00005736,Brian Babin (R),2016,Transportation,22650,124749,147399
B001291,N00005736,Brian Babin (R),2016,Misc Business,40600,63698,104298
B001291,N00005736,Brian Babin (R),2016,Labor,0,20500,20500
B001291,N00005736,Brian Babin (R),2016,Ideology/Single-Issue,9600,46993,56593
B001291,N00005736,Brian Babin (R),2016,Other,59207,0,59207
G000410,N00005870,Gene Green (D),2016,Agribusiness,500,6000,6500
G000410,N00005870,Gene Green (D),2016,Communic/Electronics,24800,109850,134650
G000410,N00005870,Gene Green (D),2016,Construction,18200,20000,38200
G000410,N00005870,Gene Green (D),2016,Defense,0,15500,15500
G000410,N00005870,Gene Green (D),2016,Energy/Nat Resource,12450,193250,205700
G000410,N00005870,Gene Green (D),2016,Finance/Insur/RealEst,56450,67000,123450
G000410,N00005870,Gene Green (D),2016,Health,54025,383802,437827
G000410,N00005870,Gene Green (D),2016,Lawyers & Lobbyists,110945,40499,151444
G000410,N00005870,Gene Green (D),2016,Transportation,18400,65000,83400
G000410,N00005870,Gene Green (D),2016,Misc Business,42148,122500,164648
G000410,N00005870,Gene Green (D),2016,Labor,0,187000,187000
G000410,N00005870,Gene Green (D),2016,Ideology/Single-Issue,38450,61700,100150
G000410,N00005870,Gene Green (D),2016,Other,30750,0,30750
B000755,N00005883,Kevin Brady (R),2016,Agribusiness,32675,194229,226904
B000755,N00005883,Kevin Brady (R),2016,Communic/Electronics,19600,194584,214184
B000755,N00005883,Kevin Brady (R),2016,Construction,52850,139000,191850
B000755,N00005883,Kevin Brady (R),2016,Defense,0,51000,51000
B000755,N00005883,Kevin Brady (R),2016,Energy/Nat Resource,190200,351600,541800
B000755,N00005883,Kevin Brady (R),2016,Finance/Insur/RealEst,347600,657750,1005350
B000755,N00005883,Kevin Brady (R),2016,Health,234600,731600,966200
B000755,N00005883,Kevin Brady (R),2016,Lawyers & Lobbyists,241259,128000,369259
B000755,N00005883,Kevin Brady (R),2016,Transportation,40170,145870,186040
B000755,N00005883,Kevin Brady (R),2016,Misc Business,157510,377681,535191
B000755,N00005883,Kevin Brady (R),2016,Labor,0,15000,15000
B000755,N00005883,Kevin Brady (R),2016,Ideology/Single-Issue,112450,60547,172997
B000755,N00005883,Kevin Brady (R),2016,Other,61190,9000,70190
H000636,N00006008,Ruben Hinojosa (D),2016,Agribusiness,1500,500,2000
H000636,N00006008,Ruben Hinojosa (D),2016,Communic/Electronics,2700,3000,5700
H000636,N00006008,Ruben Hinojosa (D),2016,Construction,5200,0,5200
H000636,N00006008,Ruben Hinojosa (D),2016,Defense,0,1000,1000
H000636,N00006008,Ruben Hinojosa (D),2016,Energy/Nat Resource,0,1500,1500
H000636,N00006008,Ruben Hinojosa (D),2016,Finance/Insur/RealEst,5200,10000,15200
H000636,N00006008,Ruben Hinojosa (D),2016,Health,76200,7000,83200
H000636,N00006008,Ruben Hinojosa (D),2016,Lawyers & Lobbyists,2600,6000,8600
H000636,N00006008,Ruben Hinojosa (D),2016,Transportation,0,3500,3500
H000636,N00006008,Ruben Hinojosa (D),2016,Misc Business,2600,5000,7600
H000636,N00006008,Ruben Hinojosa (D),2016,Labor,0,6000,6000
D000399,N00006023,Lloyd Doggett (D),2016,Agribusiness,19900,3500,23400
D000399,N00006023,Lloyd Doggett (D),2016,Communic/Electronics,29675,8000,37675
D000399,N00006023,Lloyd Doggett (D),2016,Construction,15875,3000,18875
D000399,N00006023,Lloyd Doggett (D),2016,Defense,100,0,100
D000399,N00006023,Lloyd Doggett (D),2016,Energy/Nat Resource,8850,3000,11850
D000399,N00006023,Lloyd Doggett (D),2016,Finance/Insur/RealEst,65325,38000,103325
D000399,N00006023,Lloyd Doggett (D),2016,Health,28800,53500,82300
D000399,N00006023,Lloyd Doggett (D),2016,Lawyers & Lobbyists,132531,21500,154031
D000399,N00006023,Lloyd Doggett (D),2016,Transportation,300,11000,11300
D000399,N00006023,Lloyd Doggett (D),2016,Misc Business,35075,13500,48575
D000399,N00006023,Lloyd Doggett (D),2016,Labor,0,172500,172500
D000399,N00006023,Lloyd Doggett (D),2016,Ideology/Single-Issue,9503,10150,19653
D000399,N00006023,Lloyd Doggett (D),2016,Other,140098,0,140098
D000197,N00006134,Diana DeGette (D),2016,Agribusiness,7950,13000,20950
D000197,N00006134,Diana DeGette (D),2016,Communic/Electronics,20550,97800,118350
D000197,N00006134,Diana DeGette (D),2016,Construction,5500,2000,7500
D000197,N00006134,Diana DeGette (D),2016,Defense,0,11500,11500
D000197,N00006134,Diana DeGette (D),2016,Energy/Nat Resource,1000,15000,16000
D000197,N00006134,Diana DeGette (D),2016,Finance/Insur/RealEst,80900,52500,133400
D000197,N00006134,Diana DeGette (D),2016,Health,19601,291062,310663
D000197,N00006134,Diana DeGette (D),2016,Lawyers & Lobbyists,57912,40375,98287
D000197,N00006134,Diana DeGette (D),2016,Transportation,250,10500,10750
D000197,N00006134,Diana DeGette (D),2016,Misc Business,29950,50986,80936
D000197,N00006134,Diana DeGette (D),2016,Labor,0,112350,112350
D000197,N00006134,Diana DeGette (D),2016,Ideology/Single-Issue,170625,30014,200639
D000197,N00006134,Diana DeGette (D),2016,Other,73953,0,73953
B001261,N00006236,John A Barrasso (R),2016,Agribusiness,36800,96500,133300
B001261,N00006236,John A Barrasso (R),2016,Communic/Electronics,65300,168000,233300
B001261,N00006236,John A Barrasso (R),2016,Construction,117083,127750,244833
B001261,N00006236,John A Barrasso (R),2016,Defense,10000,80000,90000
B001261,N00006236,John A Barrasso (R),2016,Energy/Nat Resource,415472,576150,991622
B001261,N00006236,John A Barrasso (R),2016,Finance/Insur/RealEst,410401,358445,768846
B001261,N00006236,John A Barrasso (R),2016,Health,476976,539350,1016326
B001261,N00006236,John A Barrasso (R),2016,Lawyers & Lobbyists,291955,78750,370705
B001261,N00006236,John A Barrasso (R),2016,Transportation,55666,135530,191196
B001261,N00006236,John A Barrasso (R),2016,Misc Business,217992,267498,485490
B001261,N00006236,John A Barrasso (R),2016,Labor,0,24000,24000
B001261,N00006236,John A Barrasso (R),2016,Ideology/Single-Issue,66459,316236,382695
B001261,N00006236,John A Barrasso (R),2016,Other,160549,12000,172549
E000285,N00006249,Mike Enzi (R),2016,Agribusiness,53250,62937,116187
E000285,N00006249,Mike Enzi (R),2016,Communic/Electronics,34300,103000,137300
E000285,N00006249,Mike Enzi (R),2016,Construction,26150,74000,100150
E000285,N00006249,Mike Enzi (R),2016,Defense,0,47000,47000
E000285,N00006249,Mike Enzi (R),2016,Energy/Nat Resource,87450,263833,351283
E000285,N00006249,Mike Enzi (R),2016,Finance/Insur/RealEst,201000,414994,615994
E000285,N00006249,Mike Enzi (R),2016,Health,91925,472000,563925
E000285,N00006249,Mike Enzi (R),2016,Lawyers & Lobbyists,123442,36927,160369
E000285,N00006249,Mike Enzi (R),2016,Transportation,8500,103500,112000
E000285,N00006249,Mike Enzi (R),2016,Misc Business,106550,277000,383550
E000285,N00006249,Mike Enzi (R),2016,Labor,0,17500,17500
E000285,N00006249,Mike Enzi (R),2016,Ideology/Single-Issue,50025,339522,389547
E000285,N00006249,Mike Enzi (R),2016,Other,91834,14900,106734
C000880,N00006267,Mike Crapo (R),2016,Agribusiness,98196,157049,255245
C000880,N00006267,Mike Crapo (R),2016,Communic/Electronics,56250,98790,155040
C000880,N00006267,Mike Crapo (R),2016,Construction,75116,144500,219616
C000880,N00006267,Mike Crapo (R),2016,Defense,0,48000,48000
C000880,N00006267,Mike Crapo (R),2016,Energy/Nat Resource,90126,201612,291738
C000880,N00006267,Mike Crapo (R),2016,Finance/Insur/RealEst,1085752,1373270,2459022
C000880,N00006267,Mike Crapo (R),2016,Health,209594,415471,625065
C000880,N00006267,Mike Crapo (R),2016,Lawyers & Lobbyists,317156,90600,407756
C000880,N00006267,Mike Crapo (R),2016,Transportation,72170,91100,163270
C000880,N00006267,Mike Crapo (R),2016,Misc Business,209150,246516,455666
C000880,N00006267,Mike Crapo (R),2016,Labor,0,6500,6500
C000880,N00006267,Mike Crapo (R),2016,Ideology/Single-Issue,172220,469831,642051
C000880,N00006267,Mike Crapo (R),2016,Other,198865,0,198865
F000448,N00006423,Trent Franks (R),2016,Agribusiness,12050,2500,14550
F000448,N00006423,Trent Franks (R),2016,Communic/Electronics,10800,36000,46800
F000448,N00006423,Trent Franks (R),2016,Construction,12000,11000,23000
F000448,N00006423,Trent Franks (R),2016,Defense,0,53500,53500
F000448,N00006423,Trent Franks (R),2016,Energy/Nat Resource,2750,28500,31250
F000448,N00006423,Trent Franks (R),2016,Finance/Insur/RealEst,9400,9500,18900
F000448,N00006423,Trent Franks (R),2016,Health,800,10500,11300
F000448,N00006423,Trent Franks (R),2016,Lawyers & Lobbyists,17500,5750,23250
F000448,N00006423,Trent Franks (R),2016,Transportation,11350,3500,14850
F000448,N00006423,Trent Franks (R),2016,Misc Business,23450,3500,26950
F000448,N00006423,Trent Franks (R),2016,Labor,0,7500,7500
F000448,N00006423,Trent Franks (R),2016,Ideology/Single-Issue,6435,46770,53205
F000448,N00006423,Trent Franks (R),2016,Other,13900,1500,15400
B000711,N00006692,Barbara Boxer (D),2016,Agribusiness,3000,1000,4000
B000711,N00006692,Barbara Boxer (D),2016,Communic/Electronics,66100,4500,70600
B000711,N00006692,Barbara Boxer (D),2016,Construction,3750,19500,23250
B000711,N00006692,Barbara Boxer (D),2016,Defense,1000,0,1000
B000711,N00006692,Barbara Boxer (D),2016,Energy/Nat Resource,250,4000,4250
B000711,N00006692,Barbara Boxer (D),2016,Finance/Insur/RealEst,27350,3010,30360
B000711,N00006692,Barbara Boxer (D),2016,Health,10250,4000,14250
B000711,N00006692,Barbara Boxer (D),2016,Lawyers & Lobbyists,39492,2500,41992
B000711,N00006692,Barbara Boxer (D),2016,Transportation,1000,26500,27500
B000711,N00006692,Barbara Boxer (D),2016,Misc Business,40275,10902,51177
B000711,N00006692,Barbara Boxer (D),2016,Labor,0,16000,16000
B000711,N00006692,Barbara Boxer (D),2016,Ideology/Single-Issue,13947,9278,23225
B000711,N00006692,Barbara Boxer (D),2016,Other,43625,0,43625
H001063,N00006806,Janice Hahn (D),2016,Transportation,0,-1000,-1000
H001063,N00006806,Janice Hahn (D),2016,Labor,0,-5000,-5000
H001063,N00006806,Janice Hahn (D),2016,Ideology/Single-Issue,0,1000,1000
C000059,N00007099,Ken Calvert (R),2016,Agribusiness,29844,77456,107300
C000059,N00007099,Ken Calvert (R),2016,Communic/Electronics,10075,29000,39075
C000059,N00007099,Ken Calvert (R),2016,Construction,62450,64750,127200
C000059,N00007099,Ken Calvert (R),2016,Defense,12500,105500,118000
C000059,N00007099,Ken Calvert (R),2016,Energy/Nat Resource,22300,130000,152300
C000059,N00007099,Ken Calvert (R),2016,Finance/Insur/RealEst,85466,66250,151716
C000059,N00007099,Ken Calvert (R),2016,Health,24200,17600,41800
C000059,N00007099,Ken Calvert (R),2016,Lawyers & Lobbyists,86493,25039,111532
C000059,N00007099,Ken Calvert (R),2016,Transportation,17600,47500,65100
C000059,N00007099,Ken Calvert (R),2016,Misc Business,140150,94011,234161
C000059,N00007099,Ken Calvert (R),2016,Labor,0,7000,7000
C000059,N00007099,Ken Calvert (R),2016,Ideology/Single-Issue,25466,53025,78491
C000059,N00007099,Ken Calvert (R),2016,Other,33150,6000,39150
C001036,N00007232,Lois Capps (D),2016,Communic/Electronics,0,-1000,-1000
C001036,N00007232,Lois Capps (D),2016,Defense,0,3500,3500
C001036,N00007232,Lois Capps (D),2016,Finance/Insur/RealEst,1500,0,1500
C001036,N00007232,Lois Capps (D),2016,Health,0,11000,11000
C001036,N00007232,Lois Capps (D),2016,Lawyers & Lobbyists,500,1000,1500
C001036,N00007232,Lois Capps (D),2016,Misc Business,0,2500,2500
C001036,N00007232,Lois Capps (D),2016,Labor,0,2000,2000
C001036,N00007232,Lois Capps (D),2016,Ideology/Single-Issue,-1475,2000,525
F000030,N00007312,Sam Farr (D),2016,Agribusiness,4500,47450,51950
F000030,N00007312,Sam Farr (D),2016,Communic/Electronics,1000,3500,4500
F000030,N00007312,Sam Farr (D),2016,Construction,250,1000,1250
F000030,N00007312,Sam Farr (D),2016,Defense,0,1000,1000
F000030,N00007312,Sam Farr (D),2016,Energy/Nat Resource,0,6700,6700
F000030,N00007312,Sam Farr (D),2016,Finance/Insur/RealEst,3286,3000,6286
F000030,N00007312,Sam Farr (D),2016,Health,4700,17500,22200
F000030,N00007312,Sam Farr (D),2016,Lawyers & Lobbyists,6700,4000,10700
F000030,N00007312,Sam Farr (D),2016,Transportation,1500,13500,15000
F000030,N00007312,Sam Farr (D),2016,Misc Business,12330,22000,34330
F000030,N00007312,Sam Farr (D),2016,Labor,0,-1500,-1500
F000030,N00007312,Sam Farr (D),2016,Ideology/Single-Issue,2500,1000,3500
F000030,N00007312,Sam Farr (D),2016,Other,11647,0,11647
E000215,N00007335,Anna Eshoo (D),2016,Agribusiness,3250,10000,13250
E000215,N00007335,Anna Eshoo (D),2016,Communic/Electronics,120925,204712,325637
E000215,N00007335,Anna Eshoo (D),2016,Construction,12950,0,12950
E000215,N00007335,Anna Eshoo (D),2016,Defense,0,21000,21000
E000215,N00007335,Anna Eshoo (D),2016,Energy/Nat Resource,10775,8500,19275
E000215,N00007335,Anna Eshoo (D),2016,Finance/Insur/RealEst,108550,67000,175550
E000215,N00007335,Anna Eshoo (D),2016,Health,94231,196790,291021
E000215,N00007335,Anna Eshoo (D),2016,Lawyers & Lobbyists,70173,16000,86173
E000215,N00007335,Anna Eshoo (D),2016,Transportation,5400,26000,31400
E000215,N00007335,Anna Eshoo (D),2016,Misc Business,41950,25500,67450
E000215,N00007335,Anna Eshoo (D),2016,Labor,0,72000,72000
E000215,N00007335,Anna Eshoo (D),2016,Ideology/Single-Issue,22200,11000,33200
E000215,N00007335,Anna Eshoo (D),2016,Other,135175,0,135175
F000062,N00007364,Dianne Feinstein (D),2016,Agribusiness,323483,162234,485717
F000062,N00007364,Dianne Feinstein (D),2016,Communic/Electronics,317991,293289,611280
F000062,N00007364,Dianne Feinstein (D),2016,Construction,97000,59500,156500
F000062,N00007364,Dianne Feinstein (D),2016,Defense,87050,76000,163050
F000062,N00007364,Dianne Feinstein (D),2016,Energy/Nat Resource,244450,175600,420050
F000062,N00007364,Dianne Feinstein (D),2016,Finance/Insur/RealEst,608640,194350,802990
F000062,N00007364,Dianne Feinstein (D),2016,Health,154151,231200,385351
F000062,N00007364,Dianne Feinstein (D),2016,Lawyers & Lobbyists,655547,150151,805698
F000062,N00007364,Dianne Feinstein (D),2016,Transportation,40950,63000,103950
F000062,N00007364,Dianne Feinstein (D),2016,Misc Business,329430,215000,544430
F000062,N00007364,Dianne Feinstein (D),2016,Labor,2500,222500,225000
F000062,N00007364,Dianne Feinstein (D),2016,Ideology/Single-Issue,392425,222321,614746
F000062,N00007364,Dianne Feinstein (D),2016,Other,510510,2000,512510
B000574,N00007727,Earl Blumenauer (D),2016,Agribusiness,10976,21250,32226
B000574,N00007727,Earl Blumenauer (D),2016,Communic/Electronics,15084,37500,52584
B000574,N00007727,Earl Blumenauer (D),2016,Construction,30600,141500,172100
B000574,N00007727,Earl Blumenauer (D),2016,Defense,0,4000,4000
B000574,N00007727,Earl Blumenauer (D),2016,Energy/Nat Resource,10134,26000,36134
B000574,N00007727,Earl Blumenauer (D),2016,Finance/Insur/RealEst,91843,147200,239043
B000574,N00007727,Earl Blumenauer (D),2016,Health,16092,207150,223242
B000574,N00007727,Earl Blumenauer (D),2016,Lawyers & Lobbyists,65719,28000,93719
B000574,N00007727,Earl Blumenauer (D),2016,Transportation,26775,96000,122775
B000574,N00007727,Earl Blumenauer (D),2016,Misc Business,63274,105247,168521
B000574,N00007727,Earl Blumenauer (D),2016,Labor,0,56500,56500
B000574,N00007727,Earl Blumenauer (D),2016,Ideology/Single-Issue,33655,39000,72655
B000574,N00007727,Earl Blumenauer (D),2016,Other,49833,0,49833
D000191,N00007781,Peter DeFazio (D),2016,Agribusiness,19914,31000,50914
D000191,N00007781,Peter DeFazio (D),2016,Communic/Electronics,4066,21000,25066
D000191,N00007781,Peter DeFazio (D),2016,Construction,14874,117000,131874
D000191,N00007781,Peter DeFazio (D),2016,Defense,4,11500,11504
D000191,N00007781,Peter DeFazio (D),2016,Energy/Nat Resource,2524,25000,27524
D000191,N00007781,Peter DeFazio (D),2016,Finance/Insur/RealEst,3366,36000,39366
D000191,N00007781,Peter DeFazio (D),2016,Health,2701,14600,17301
D000191,N00007781,Peter DeFazio (D),2016,Lawyers & Lobbyists,44986,24500,69486
D000191,N00007781,Peter DeFazio (D),2016,Transportation,31380,236500,267880
D000191,N00007781,Peter DeFazio (D),2016,Misc Business,51616,53936,105552
D000191,N00007781,Peter DeFazio (D),2016,Labor,541,243255,243796
D000191,N00007781,Peter DeFazio (D),2016,Ideology/Single-Issue,11393,25232,36625
D000191,N00007781,Peter DeFazio (D),2016,Other,73543,3500,77043
C000127,N00007836,Maria Cantwell (D),2016,Agribusiness,62358,9000,71358
C000127,N00007836,Maria Cantwell (D),2016,Communic/Electronics,428683,10500,439183
C000127,N00007836,Maria Cantwell (D),2016,Construction,85278,3250,88528
C000127,N00007836,Maria Cantwell (D),2016,Defense,37855,1000,38855
C000127,N00007836,Maria Cantwell (D),2016,Energy/Nat Resource,316179,16750,332929
C000127,N00007836,Maria Cantwell (D),2016,Finance/Insur/RealEst,779331,15500,794831
C000127,N00007836,Maria Cantwell (D),2016,Health,348044,16250,364294
C000127,N00007836,Maria Cantwell (D),2016,Lawyers & Lobbyists,1175891,10750,1186641
C000127,N00007836,Maria Cantwell (D),2016,Transportation,141926,23000,164926
C000127,N00007836,Maria Cantwell (D),2016,Misc Business,745721,5000,750721
C000127,N00007836,Maria Cantwell (D),2016,Labor,4966,11200,16166
C000127,N00007836,Maria Cantwell (D),2016,Ideology/Single-Issue,458326,67687,526013
C000127,N00007836,Maria Cantwell (D),2016,Other,1018739,0,1018739
G000377,N00008799,Kay Granger (R),2016,Agribusiness,4135,42310,46445
G000377,N00008799,Kay Granger (R),2016,Communic/Electronics,14150,27000,41150
G000377,N00008799,Kay Granger (R),2016,Construction,21395,36000,57395
G000377,N00008799,Kay Granger (R),2016,Defense,117300,156500,273800
G000377,N00008799,Kay Granger (R),2016,Energy/Nat Resource,60400,40000,100400
G000377,N00008799,Kay Granger (R),2016,Finance/Insur/RealEst,134600,79900,214500
G000377,N00008799,Kay Granger (R),2016,Health,23870,23750,47620
G000377,N00008799,Kay Granger (R),2016,Lawyers & Lobbyists,74244,15661,89905
G000377,N00008799,Kay Granger (R),2016,Transportation,13300,102999,116299
G000377,N00008799,Kay Granger (R),2016,Misc Business,71700,50000,121700
G000377,N00008799,Kay Granger (R),2016,Labor,0,11500,11500
G000377,N00008799,Kay Granger (R),2016,Ideology/Single-Issue,22085,54950,77035
G000377,N00008799,Kay Granger (R),2016,Other,76170,7500,83670
G000289,N00009154,Bob Goodlatte (R),2016,Agribusiness,19503,103700,123203
G000289,N00009154,Bob Goodlatte (R),2016,Communic/Electronics,75900,260833,336733
G000289,N00009154,Bob Goodlatte (R),2016,Construction,21150,25500,46650
G000289,N00009154,Bob Goodlatte (R),2016,Defense,0,15500,15500
G000289,N00009154,Bob Goodlatte (R),2016,Energy/Nat Resource,13700,56000,69700
G000289,N00009154,Bob Goodlatte (R),2016,Finance/Insur/RealEst,94400,174500,268900
G000289,N00009154,Bob Goodlatte (R),2016,Health,18850,78750,97600
G000289,N00009154,Bob Goodlatte (R),2016,Lawyers & Lobbyists,117508,42500,160008
G000289,N00009154,Bob Goodlatte (R),2016,Transportation,12650,69000,81650
G000289,N00009154,Bob Goodlatte (R),2016,Misc Business,77139,109500,186639
G000289,N00009154,Bob Goodlatte (R),2016,Labor,0,11000,11000
G000289,N00009154,Bob Goodlatte (R),2016,Ideology/Single-Issue,5800,40050,45850
G000289,N00009154,Bob Goodlatte (R),2016,Other,105575,1000,106575
F000444,N00009573,Jeff Flake (R),2016,Agribusiness,218927,113500,332427
F000444,N00009573,Jeff Flake (R),2016,Communic/Electronics,118195,177650,295845
F000444,N00009573,Jeff Flake (R),2016,Construction,219400,83000,302400
F000444,N00009573,Jeff Flake (R),2016,Defense,5650,31500,37150
F000444,N00009573,Jeff Flake (R),2016,Energy/Nat Resource,297484,245000,542484
F000444,N00009573,Jeff Flake (R),2016,Finance/Insur/RealEst,1182816,209500,1392316
F000444,N00009573,Jeff Flake (R),2016,Health,332242,210500,542742
F000444,N00009573,Jeff Flake (R),2016,Lawyers & Lobbyists,352082,69450,421532
F000444,N00009573,Jeff Flake (R),2016,Transportation,265600,122000,387600
F000444,N00009573,Jeff Flake (R),2016,Misc Business,598730,252500,851230
F000444,N00009573,Jeff Flake (R),2016,Labor,0,3500,3500
F000444,N00009573,Jeff Flake (R),2016,Ideology/Single-Issue,1444727,506646,1951373
F000444,N00009573,Jeff Flake (R),2016,Other,833989,32500,866489
D000598,N00009604,Susan A Davis (D),2016,Agribusiness,8400,18200,26600
D000598,N00009604,Susan A Davis (D),2016,Communic/Electronics,4460,20500,24960
D000598,N00009604,Susan A Davis (D),2016,Construction,0,2000,2000
D000598,N00009604,Susan A Davis (D),2016,Defense,10900,95500,106400
D000598,N00009604,Susan A Davis (D),2016,Energy/Nat Resource,0,7500,7500
D000598,N00009604,Susan A Davis (D),2016,Finance/Insur/RealEst,16850,49000,65850
D000598,N00009604,Susan A Davis (D),2016,Health,4500,52500,57000
D000598,N00009604,Susan A Davis (D),2016,Lawyers & Lobbyists,7450,10000,17450
D000598,N00009604,Susan A Davis (D),2016,Transportation,250,11500,11750
D000598,N00009604,Susan A Davis (D),2016,Misc Business,7300,17500,24800
D000598,N00009604,Susan A Davis (D),2016,Labor,0,27750,27750
D000598,N00009604,Susan A Davis (D),2016,Ideology/Single-Issue,22550,20336,42886
D000598,N00009604,Susan A Davis (D),2016,Other,27975,4000,31975
C001048,N00009738,John Culberson (R),2016,Agribusiness,3800,28129,31929
C001048,N00009738,John Culberson (R),2016,Communic/Electronics,18350,13500,31850
C001048,N00009738,John Culberson (R),2016,Construction,42625,24500,67125
C001048,N00009738,John Culberson (R),2016,Defense,2250,90000,92250
C001048,N00009738,John Culberson (R),2016,Energy/Nat Resource,58600,74500,133100
C001048,N00009738,John Culberson (R),2016,Finance/Insur/RealEst,147509,55000,202509
C001048,N00009738,John Culberson (R),2016,Health,12785,20500,33285
C001048,N00009738,John Culberson (R),2016,Lawyers & Lobbyists,59049,20841,79890
C001048,N00009738,John Culberson (R),2016,Transportation,25700,48500,74200
C001048,N00009738,John Culberson (R),2016,Misc Business,75850,64700,140550
C001048,N00009738,John Culberson (R),2016,Labor,0,24500,24500
C001048,N00009738,John Culberson (R),2016,Ideology/Single-Issue,12650,105050,117700
C001048,N00009738,John Culberson (R),2016,Other,91400,0,91400
C001047,N00009771,Shelley Moore Capito (R),2016,Agribusiness,53450,131000,184450
C001047,N00009771,Shelley Moore Capito (R),2016,Communic/Electronics,61950,74500,136450
C001047,N00009771,Shelley Moore Capito (R),2016,Construction,222333,121500,343833
C001047,N00009771,Shelley Moore Capito (R),2016,Defense,3050,9500,12550
C001047,N00009771,Shelley Moore Capito (R),2016,Energy/Nat Resource,427840,315375,743215
C001047,N00009771,Shelley Moore Capito (R),2016,Finance/Insur/RealEst,840656,560700,1401356
C001047,N00009771,Shelley Moore Capito (R),2016,Health,192557,221350,413907
C001047,N00009771,Shelley Moore Capito (R),2016,Lawyers & Lobbyists,394924,54263,449187
C001047,N00009771,Shelley Moore Capito (R),2016,Transportation,79000,185499,264499
C001047,N00009771,Shelley Moore Capito (R),2016,Misc Business,292999,279450,572449
C001047,N00009771,Shelley Moore Capito (R),2016,Labor,0,88000,88000
C001047,N00009771,Shelley Moore Capito (R),2016,Ideology/Single-Issue,105575,430250,535825
C001047,N00009771,Shelley Moore Capito (R),2016,Other,498419,20500,518919
B000287,N00009774,Xavier Becerra (D),2016,Agribusiness,1500,22000,23500
B000287,N00009774,Xavier Becerra (D),2016,Communic/Electronics,61375,98000,159375
B000287,N00009774,Xavier Becerra (D),2016,Construction,13800,20900,34700
B000287,N00009774,Xavier Becerra (D),2016,Defense,510,25000,25510
B000287,N00009774,Xavier Becerra (D),2016,Energy/Nat Resource,250,40700,40950
B000287,N00009774,Xavier Becerra (D),2016,Finance/Insur/RealEst,158112,288000,446112
B000287,N00009774,Xavier Becerra (D),2016,Health,55054,274200,329254
B000287,N00009774,Xavier Becerra (D),2016,Lawyers & Lobbyists,92057,36100,128157
B000287,N00009774,Xavier Becerra (D),2016,Transportation,1000,41000,42000
B000287,N00009774,Xavier Becerra (D),2016,Misc Business,98910,107000,205910
B000287,N00009774,Xavier Becerra (D),2016,Labor,250,147500,147750
B000287,N00009774,Xavier Becerra (D),2016,Ideology/Single-Issue,34896,18249,53145
B000287,N00009774,Xavier Becerra (D),2016,Other,30120,0,30120
H000338,N00009869,Orrin G Hatch (R),2016,Agribusiness,103633,197500,301133
H000338,N00009869,Orrin G Hatch (R),2016,Communic/Electronics,368381,356631,725012
H000338,N00009869,Orrin G Hatch (R),2016,Construction,153636,146250,299886
H000338,N00009869,Orrin G Hatch (R),2016,Defense,10250,100000,110250
H000338,N00009869,Orrin G Hatch (R),2016,Energy/Nat Resource,317718,520000,837718
H000338,N00009869,Orrin G Hatch (R),2016,Finance/Insur/RealEst,2110583,1059145,3169728
H000338,N00009869,Orrin G Hatch (R),2016,Health,904315,1318575,2222890
H000338,N00009869,Orrin G Hatch (R),2016,Lawyers & Lobbyists,895272,252543,1147815
H000338,N00009869,Orrin G Hatch (R),2016,Transportation,65766,192500,258266
H000338,N00009869,Orrin G Hatch (R),2016,Misc Business,693901,560644,1254545
H000338,N00009869,Orrin G Hatch (R),2016,Labor,0,32000,32000
H000338,N00009869,Orrin G Hatch (R),2016,Ideology/Single-Issue,144050,480878,624928
H000338,N00009869,Orrin G Hatch (R),2016,Other,338840,14500,353340
A000360,N00009888,Lamar Alexander (R),2016,Agribusiness,102000,156936,258936
A000360,N00009888,Lamar Alexander (R),2016,Communic/Electronics,96750,128000,224750
A000360,N00009888,Lamar Alexander (R),2016,Construction,184567,91950,276517
A000360,N00009888,Lamar Alexander (R),2016,Defense,13450,100500,113950
A000360,N00009888,Lamar Alexander (R),2016,Energy/Nat Resource,150710,299183,449893
A000360,N00009888,Lamar Alexander (R),2016,Finance/Insur/RealEst,611850,420000,1031850
A000360,N00009888,Lamar Alexander (R),2016,Health,251150,721967,973117
A000360,N00009888,Lamar Alexander (R),2016,Lawyers & Lobbyists,252875,114988,367863
A000360,N00009888,Lamar Alexander (R),2016,Transportation,75583,178000,253583
A000360,N00009888,Lamar Alexander (R),2016,Misc Business,310010,361728,671738
A000360,N00009888,Lamar Alexander (R),2016,Labor,0,8500,8500
A000360,N00009888,Lamar Alexander (R),2016,Ideology/Single-Issue,60600,362515,423115
A000360,N00009888,Lamar Alexander (R),2016,Other,374153,55000,429153
G000359,N00009975,Lindsey Graham (R),2016,Agribusiness,182701,148787,331488
G000359,N00009975,Lindsey Graham (R),2016,Communic/Electronics,170497,178376,348873
G000359,N00009975,Lindsey Graham (R),2016,Construction,286285,92850,379135
G000359,N00009975,Lindsey Graham (R),2016,Defense,76593,172200,248793
G000359,N00009975,Lindsey Graham (R),2016,Energy/Nat Resource,285641,182000,467641
G000359,N00009975,Lindsey Graham (R),2016,Finance/Insur/RealEst,1771281,266732,2038013
G000359,N00009975,Lindsey Graham (R),2016,Health,400447,113750,514197
G000359,N00009975,Lindsey Graham (R),2016,Lawyers & Lobbyists,1079627,91750,1171377
G000359,N00009975,Lindsey Graham (R),2016,Transportation,204500,170600,375100
G000359,N00009975,Lindsey Graham (R),2016,Misc Business,760386,288700,1049086
G000359,N00009975,Lindsey Graham (R),2016,Labor,0,14000,14000
G000359,N00009975,Lindsey Graham (R),2016,Ideology/Single-Issue,340288,416641,756929
G000359,N00009975,Lindsey Graham (R),2016,Other,793226,4000,797226
C001049,N00012460,William L Clay Jr (D),2016,Agribusiness,3350,6500,9850
C001049,N00012460,William L Clay Jr (D),2016,Communic/Electronics,0,34000,34000
C001049,N00012460,William L Clay Jr (D),2016,Construction,1000,1000,2000
C001049,N00012460,William L Clay Jr (D),2016,Defense,250,14500,14750
C001049,N00012460,William L Clay Jr (D),2016,Energy/Nat Resource,0,20500,20500
C001049,N00012460,William L Clay Jr (D),2016,Finance/Insur/RealEst,2773,191100,193873
C001049,N00012460,William L Clay Jr (D),2016,Health,2750,60000,62750
C001049,N00012460,William L Clay Jr (D),2016,Lawyers & Lobbyists,16710,23248,39958
C001049,N00012460,William L Clay Jr (D),2016,Transportation,250,26000,26250
C001049,N00012460,William L Clay Jr (D),2016,Misc Business,9050,39000,48050
C001049,N00012460,William L Clay Jr (D),2016,Labor,0,165075,165075
C001049,N00012460,William L Clay Jr (D),2016,Ideology/Single-Issue,300,23500,23800
C001049,N00012460,William L Clay Jr (D),2016,Other,11250,1000,12250
C000174,N00012508,Tom Carper (D),2016,Agribusiness,17985,77500,95485
C000174,N00012508,Tom Carper (D),2016,Communic/Electronics,66016,216004,282020
C000174,N00012508,Tom Carper (D),2016,Construction,14760,70830,85590
C000174,N00012508,Tom Carper (D),2016,Defense,1000,69160,70160
C000174,N00012508,Tom Carper (D),2016,Energy/Nat Resource,23219,160030,183249
C000174,N00012508,Tom Carper (D),2016,Finance/Insur/RealEst,438205,824970,1263175
C000174,N00012508,Tom Carper (D),2016,Health,77176,455060,532236
C000174,N00012508,Tom Carper (D),2016,Lawyers & Lobbyists,349032,127151,476183
C000174,N00012508,Tom Carper (D),2016,Transportation,10850,84940,95790
C000174,N00012508,Tom Carper (D),2016,Misc Business,181502,347030,528532
C000174,N00012508,Tom Carper (D),2016,Labor,0,169410,169410
C000174,N00012508,Tom Carper (D),2016,Ideology/Single-Issue,53500,210299,263799
C000174,N00012508,Tom Carper (D),2016,Other,178969,12000,190969
H001034,N00012611,Mike Honda (D),2016,Agribusiness,27601,14700,42301
H001034,N00012611,Mike Honda (D),2016,Communic/Electronics,100698,46840,147538
H001034,N00012611,Mike Honda (D),2016,Construction,20010,1000,21010
H001034,N00012611,Mike Honda (D),2016,Defense,350,21000,21350
H001034,N00012611,Mike Honda (D),2016,Energy/Nat Resource,23410,9000,32410
H001034,N00012611,Mike Honda (D),2016,Finance/Insur/RealEst,220874,19000,239874
H001034,N00012611,Mike Honda (D),2016,Health,71716,52000,123716
H001034,N00012611,Mike Honda (D),2016,Lawyers & Lobbyists,152735,15250,167985
H001034,N00012611,Mike Honda (D),2016,Transportation,10777,10500,21277
H001034,N00012611,Mike Honda (D),2016,Misc Business,161663,21000,182663
H001034,N00012611,Mike Honda (D),2016,Labor,1185,254517,255702
H001034,N00012611,Mike Honda (D),2016,Ideology/Single-Issue,227312,270756,498068
H001034,N00012611,Mike Honda (D),2016,Other,339235,2000,341235
C001045,N00012739,Ander Crenshaw (R),2016,Agribusiness,7400,25500,32900
C001045,N00012739,Ander Crenshaw (R),2016,Communic/Electronics,7450,77637,85087
C001045,N00012739,Ander Crenshaw (R),2016,Construction,8000,18500,26500
C001045,N00012739,Ander Crenshaw (R),2016,Defense,11454,89000,100454
C001045,N00012739,Ander Crenshaw (R),2016,Energy/Nat Resource,1000,16500,17500
C001045,N00012739,Ander Crenshaw (R),2016,Finance/Insur/RealEst,48300,284750,333050
C001045,N00012739,Ander Crenshaw (R),2016,Health,3800,15500,19300
C001045,N00012739,Ander Crenshaw (R),2016,Lawyers & Lobbyists,55825,28209,84034
C001045,N00012739,Ander Crenshaw (R),2016,Transportation,10952,38200,49152
C001045,N00012739,Ander Crenshaw (R),2016,Misc Business,6000,81650,87650
C001045,N00012739,Ander Crenshaw (R),2016,Labor,0,1000,1000
C001045,N00012739,Ander Crenshaw (R),2016,Ideology/Single-Issue,89500,11000,100500
C001045,N00012739,Ander Crenshaw (R),2016,Other,32225,1000,33225
G000546,N00013323,Sam Graves (R),2016,Agribusiness,21200,94921,116121
G000546,N00013323,Sam Graves (R),2016,Communic/Electronics,8700,65000,73700
G000546,N00013323,Sam Graves (R),2016,Construction,28400,145250,173650
G000546,N00013323,Sam Graves (R),2016,Defense,0,111000,111000
G000546,N00013323,Sam Graves (R),2016,Energy/Nat Resource,3000,54000,57000
G000546,N00013323,Sam Graves (R),2016,Finance/Insur/RealEst,9150,78000,87150
G000546,N00013323,Sam Graves (R),2016,Health,5900,64000,69900
G000546,N00013323,Sam Graves (R),2016,Lawyers & Lobbyists,40050,18000,58050
G000546,N00013323,Sam Graves (R),2016,Transportation,37352,267400,304752
G000546,N00013323,Sam Graves (R),2016,Misc Business,39081,128500,167581
G000546,N00013323,Sam Graves (R),2016,Labor,0,114500,114500
G000546,N00013323,Sam Graves (R),2016,Ideology/Single-Issue,6250,46500,52750
G000546,N00013323,Sam Graves (R),2016,Other,18400,6000,24400
F000445,N00013799,Randy Forbes (R),2016,Agribusiness,17950,23000,40950
F000445,N00013799,Randy Forbes (R),2016,Communic/Electronics,11767,44680,56447
F000445,N00013799,Randy Forbes (R),2016,Construction,40870,17500,58370
F000445,N00013799,Randy Forbes (R),2016,Defense,77145,131200,208345
F000445,N00013799,Randy Forbes (R),2016,Energy/Nat Resource,20431,11000,31431
F000445,N00013799,Randy Forbes (R),2016,Finance/Insur/RealEst,117299,33500,150799
F000445,N00013799,Randy Forbes (R),2016,Health,26400,9000,35400
F000445,N00013799,Randy Forbes (R),2016,Lawyers & Lobbyists,73159,11662,84821
F000445,N00013799,Randy Forbes (R),2016,Transportation,47050,35000,82050
F000445,N00013799,Randy Forbes (R),2016,Misc Business,52450,39500,91950
F000445,N00013799,Randy Forbes (R),2016,Labor,0,11000,11000
F000445,N00013799,Randy Forbes (R),2016,Ideology/Single-Issue,6990,43400,50390
F000445,N00013799,Randy Forbes (R),2016,Other,127594,0,127594
B001236,N00013873,John Boozman (R),2016,Agribusiness,148608,335937,484545
B001236,N00013873,John Boozman (R),2016,Communic/Electronics,34350,151000,185350
B001236,N00013873,John Boozman (R),2016,Construction,72249,65500,137749
B001236,N00013873,John Boozman (R),2016,Defense,0,79500,79500
B001236,N00013873,John Boozman (R),2016,Energy/Nat Resource,81430,160000,241430
B001236,N00013873,John Boozman (R),2016,Finance/Insur/RealEst,529340,409807,939147
B001236,N00013873,John Boozman (R),2016,Health,261489,176250,437739
B001236,N00013873,John Boozman (R),2016,Lawyers & Lobbyists,179984,42116,222100
B001236,N00013873,John Boozman (R),2016,Transportation,62075,136500,198575
B001236,N00013873,John Boozman (R),2016,Misc Business,202325,231375,433700
B001236,N00013873,John Boozman (R),2016,Labor,0,17500,17500
B001236,N00013873,John Boozman (R),2016,Ideology/Single-Issue,100600,377673,478273
B001236,N00013873,John Boozman (R),2016,Other,382759,9000,391759
C001077,N00024753,Mike Coffman (R),2016,Agribusiness,38559,27000,65559
C001077,N00024753,Mike Coffman (R),2016,Communic/Electronics,78645,27000,105645
C001077,N00024753,Mike Coffman (R),2016,Construction,47048,47000,94048
C001077,N00024753,Mike Coffman (R),2016,Defense,850,59000,59850
C001077,N00024753,Mike Coffman (R),2016,Energy/Nat Resource,117294,111000,228294
C001077,N00024753,Mike Coffman (R),2016,Finance/Insur/RealEst,404468,193200,597668
C001077,N00024753,Mike Coffman (R),2016,Health,65635,67500,133135
C001077,N00024753,Mike Coffman (R),2016,Lawyers & Lobbyists,87785,14000,101785
C001077,N00024753,Mike Coffman (R),2016,Transportation,71325,41495,112820
C001077,N00024753,Mike Coffman (R),2016,Misc Business,126129,114700,240829
C001077,N00024753,Mike Coffman (R),2016,Labor,0,7500,7500
C001077,N00024753,Mike Coffman (R),2016,Ideology/Single-Issue,95400,478433,573833
C001077,N00024753,Mike Coffman (R),2016,Other,477044,7500,484544
C001069,N00024842,Joe Courtney (D),2016,Agribusiness,4725,32250,36975
C001069,N00024842,Joe Courtney (D),2016,Communic/Electronics,5000,14500,19500
C001069,N00024842,Joe Courtney (D),2016,Construction,7250,24000,31250
C001069,N00024842,Joe Courtney (D),2016,Defense,18000,114000,132000
C001069,N00024842,Joe Courtney (D),2016,Energy/Nat Resource,250,20500,20750
C001069,N00024842,Joe Courtney (D),2016,Finance/Insur/RealEst,30550,134500,165050
C001069,N00024842,Joe Courtney (D),2016,Health,26475,111150,137625
C001069,N00024842,Joe Courtney (D),2016,Lawyers & Lobbyists,47225,18000,65225
C001069,N00024842,Joe Courtney (D),2016,Transportation,8950,14000,22950
C001069,N00024842,Joe Courtney (D),2016,Misc Business,40600,12500,53100
C001069,N00024842,Joe Courtney (D),2016,Labor,0,197000,197000
C001069,N00024842,Joe Courtney (D),2016,Ideology/Single-Issue,28280,20000,48280
C001069,N00024842,Joe Courtney (D),2016,Other,61680,500,62180
C001056,N00024852,John Cornyn (R),2016,Agribusiness,306484,207139,513623
C001056,N00024852,John Cornyn (R),2016,Communic/Electronics,280448,315593,596041
C001056,N00024852,John Cornyn (R),2016,Construction,351275,166650,517925
C001056,N00024852,John Cornyn (R),2016,Defense,33300,156000,189300
C001056,N00024852,John Cornyn (R),2016,Energy/Nat Resource,1087656,451000,1538656
C001056,N00024852,John Cornyn (R),2016,Finance/Insur/RealEst,2258582,787364,3045946
C001056,N00024852,John Cornyn (R),2016,Health,898321,717899,1616220
C001056,N00024852,John Cornyn (R),2016,Lawyers & Lobbyists,740506,196050,936556
C001056,N00024852,John Cornyn (R),2016,Transportation,198970,267000,465970
C001056,N00024852,John Cornyn (R),2016,Misc Business,810360,556125,1366485
C001056,N00024852,John Cornyn (R),2016,Labor,0,14500,14500
C001056,N00024852,John Cornyn (R),2016,Ideology/Single-Issue,289924,426941,716865
C001056,N00024852,John Cornyn (R),2016,Other,696074,3500,699574
B001245,N00024866,Madeleine Z Bordallo (D),2016,Agribusiness,5300,0,5300
B001245,N00024866,Madeleine Z Bordallo (D),2016,Communic/Electronics,0,2500,2500
B001245,N00024866,Madeleine Z Bordallo (D),2016,Construction,1500,0,1500
B001245,N00024866,Madeleine Z Bordallo (D),2016,Defense,7000,18500,25500
B001245,N00024866,Madeleine Z Bordallo (D),2016,Finance/Insur/RealEst,22300,3000,25300
B001245,N00024866,Madeleine Z Bordallo (D),2016,Health,750,0,750
B001245,N00024866,Madeleine Z Bordallo (D),2016,Lawyers & Lobbyists,6650,2000,8650
B001245,N00024866,Madeleine Z Bordallo (D),2016,Transportation,2250,7500,9750
B001245,N00024866,Madeleine Z Bordallo (D),2016,Misc Business,26500,0,26500
B001245,N00024866,Madeleine Z Bordallo (D),2016,Labor,0,8250,8250
B001245,N00024866,Madeleine Z Bordallo (D),2016,Ideology/Single-Issue,0,11000,11000
B001245,N00024866,Madeleine Z Bordallo (D),2016,Other,8085,0,8085
H001036,N00024922,Jeb Hensarling (R),2016,Agribusiness,10950,17810,28760
H001036,N00024922,Jeb Hensarling (R),2016,Communic/Electronics,21369,43500,64869
H001036,N00024922,Jeb Hensarling (R),2016,Construction,20000,17500,37500
H001036,N00024922,Jeb Hensarling (R),2016,Defense,250,7500,7750
H001036,N00024922,Jeb Hensarling (R),2016,Energy/Nat Resource,18400,56000,74400
H001036,N00024922,Jeb Hensarling (R),2016,Finance/Insur/RealEst,365145,916100,1281245
H001036,N00024922,Jeb Hensarling (R),2016,Health,22200,25750,47950
H001036,N00024922,Jeb Hensarling (R),2016,Lawyers & Lobbyists,95650,40650,136300
H001036,N00024922,Jeb Hensarling (R),2016,Transportation,23650,55000,78650
H001036,N00024922,Jeb Hensarling (R),2016,Misc Business,71706,55000,126706
H001036,N00024922,Jeb Hensarling (R),2016,Labor,0,2000,2000
H001036,N00024922,Jeb Hensarling (R),2016,Ideology/Single-Issue,2600,10648,13248
H001036,N00024922,Jeb Hensarling (R),2016,Other,108961,0,108961
C001063,N00024978,Henry Cuellar (D),2016,Agribusiness,37100,127629,164729
C001063,N00024978,Henry Cuellar (D),2016,Communic/Electronics,6400,37000,43400
C001063,N00024978,Henry Cuellar (D),2016,Construction,39650,59000,98650
C001063,N00024978,Henry Cuellar (D),2016,Defense,1000,35000,36000
C001063,N00024978,Henry Cuellar (D),2016,Energy/Nat Resource,27300,154202,181502
C001063,N00024978,Henry Cuellar (D),2016,Finance/Insur/RealEst,74650,145200,219850
C001063,N00024978,Henry Cuellar (D),2016,Health,44497,51000,95497
C001063,N00024978,Henry Cuellar (D),2016,Lawyers & Lobbyists,85933,22450,108383
C001063,N00024978,Henry Cuellar (D),2016,Transportation,25650,106617,132267
C001063,N00024978,Henry Cuellar (D),2016,Misc Business,95278,148190,243468
C001063,N00024978,Henry Cuellar (D),2016,Labor,0,30500,30500
C001063,N00024978,Henry Cuellar (D),2016,Ideology/Single-Issue,6599,34500,41099
C001063,N00024978,Henry Cuellar (D),2016,Other,32825,5000,37825
C001051,N00025095,John Carter (R),2016,Agribusiness,19262,61629,80891
C001051,N00025095,John Carter (R),2016,Communic/Electronics,0,43516,43516
C001051,N00025095,John Carter (R),2016,Construction,14241,48500,62741
C001051,N00025095,John Carter (R),2016,Defense,6250,144500,150750
C001051,N00025095,John Carter (R),2016,Energy/Nat Resource,31900,32000,63900
C001051,N00025095,John Carter (R),2016,Finance/Insur/RealEst,67544,50500,118044
C001051,N00025095,John Carter (R),2016,Health,19074,12750,31824
C001051,N00025095,John Carter (R),2016,Lawyers & Lobbyists,62206,15249,77455
C001051,N00025095,John Carter (R),2016,Transportation,50349,93500,143849
C001051,N00025095,John Carter (R),2016,Misc Business,28100,60077,88177
C001051,N00025095,John Carter (R),2016,Labor,0,11500,11500
C001051,N00025095,John Carter (R),2016,Ideology/Single-Issue,4000,29300,33300
C001051,N00025095,John Carter (R),2016,Other,28612,1000,29612
B001248,N00025219,Michael Burgess (R),2016,Agribusiness,8000,16529,24529
B001248,N00025219,Michael Burgess (R),2016,Communic/Electronics,2500,95500,98000
B001248,N00025219,Michael Burgess (R),2016,Construction,5400,11000,16400
B001248,N00025219,Michael Burgess (R),2016,Defense,0,18500,18500
B001248,N00025219,Michael Burgess (R),2016,Energy/Nat Resource,8100,51500,59600
B001248,N00025219,Michael Burgess (R),2016,Finance/Insur/RealEst,24594,98500,123094
B001248,N00025219,Michael Burgess (R),2016,Health,105265,486516,591781
B001248,N00025219,Michael Burgess (R),2016,Lawyers & Lobbyists,50379,23500,73879
B001248,N00025219,Michael Burgess (R),2016,Transportation,1725,68000,69725
B001248,N00025219,Michael Burgess (R),2016,Misc Business,10675,88000,98675
B001248,N00025219,Michael Burgess (R),2016,Labor,0,7000,7000
B001248,N00025219,Michael Burgess (R),2016,Ideology/Single-Issue,10350,21500,31850
B001248,N00025219,Michael Burgess (R),2016,Other,33550,0,33550
G000551,N00025284,Raul M Grijalva (D),2016,Agribusiness,4256,12000,16256
G000551,N00025284,Raul M Grijalva (D),2016,Communic/Electronics,2518,6000,8518
G000551,N00025284,Raul M Grijalva (D),2016,Construction,258,6500,6758
G000551,N00025284,Raul M Grijalva (D),2016,Defense,675,0,675
G000551,N00025284,Raul M Grijalva (D),2016,Energy/Nat Resource,3,11000,11003
G000551,N00025284,Raul M Grijalva (D),2016,Finance/Insur/RealEst,2629,7500,10129
G000551,N00025284,Raul M Grijalva (D),2016,Health,2984,20700,23684
G000551,N00025284,Raul M Grijalva (D),2016,Lawyers & Lobbyists,23414,19050,42464
G000551,N00025284,Raul M Grijalva (D),2016,Transportation,7,5500,5507
G000551,N00025284,Raul M Grijalva (D),2016,Misc Business,57681,3500,61181
G000551,N00025284,Raul M Grijalva (D),2016,Labor,1,166750,166751
G000551,N00025284,Raul M Grijalva (D),2016,Ideology/Single-Issue,27446,45553,72999
G000551,N00025284,Raul M Grijalva (D),2016,Other,28569,1000,29569
B001250,N00025292,Rob Bishop (R),2016,Agribusiness,29000,57898,86898
B001250,N00025292,Rob Bishop (R),2016,Communic/Electronics,2000,14140,16140
B001250,N00025292,Rob Bishop (R),2016,Construction,11000,20000,31000
B001250,N00025292,Rob Bishop (R),2016,Defense,0,56500,56500
B001250,N00025292,Rob Bishop (R),2016,Energy/Nat Resource,24266,226000,250266
B001250,N00025292,Rob Bishop (R),2016,Finance/Insur/RealEst,41050,37500,78550
B001250,N00025292,Rob Bishop (R),2016,Health,4500,21100,25600
B001250,N00025292,Rob Bishop (R),2016,Lawyers & Lobbyists,73799,39250,113049
B001250,N00025292,Rob Bishop (R),2016,Transportation,2000,30000,32000
B001250,N00025292,Rob Bishop (R),2016,Misc Business,105678,56500,162178
B001250,N00025292,Rob Bishop (R),2016,Labor,0,3000,3000
B001250,N00025292,Rob Bishop (R),2016,Ideology/Single-Issue,19000,45835,64835
B001250,N00025292,Rob Bishop (R),2016,Other,30150,1000,31150
D000600,N00025337,Mario Diaz-Balart (R),2016,Agribusiness,21512,38150,59662
D000600,N00025337,Mario Diaz-Balart (R),2016,Communic/Electronics,7900,49200,57100
D000600,N00025337,Mario Diaz-Balart (R),2016,Construction,16600,70000,86600
D000600,N00025337,Mario Diaz-Balart (R),2016,Defense,0,89000,89000
D000600,N00025337,Mario Diaz-Balart (R),2016,Energy/Nat Resource,0,40000,40000
D000600,N00025337,Mario Diaz-Balart (R),2016,Finance/Insur/RealEst,68250,98000,166250
D000600,N00025337,Mario Diaz-Balart (R),2016,Health,1000,31000,32000
D000600,N00025337,Mario Diaz-Balart (R),2016,Lawyers & Lobbyists,83150,39500,122650
D000600,N00025337,Mario Diaz-Balart (R),2016,Transportation,55665,165500,221165
D000600,N00025337,Mario Diaz-Balart (R),2016,Misc Business,27500,98210,125710
D000600,N00025337,Mario Diaz-Balart (R),2016,Labor,0,134625,134625
D000600,N00025337,Mario Diaz-Balart (R),2016,Ideology/Single-Issue,15950,83671,99621
D000600,N00025337,Mario Diaz-Balart (R),2016,Other,22250,0,22250
B001269,N00025495,Lou Barletta (R),2016,Agribusiness,5025,17149,22174
B001269,N00025495,Lou Barletta (R),2016,Communic/Electronics,5950,30000,35950
B001269,N00025495,Lou Barletta (R),2016,Construction,51099,101000,152099
B001269,N00025495,Lou Barletta (R),2016,Defense,0,1000,1000
B001269,N00025495,Lou Barletta (R),2016,Energy/Nat Resource,4100,59000,63100
B001269,N00025495,Lou Barletta (R),2016,Finance/Insur/RealEst,39345,79550,118895
B001269,N00025495,Lou Barletta (R),2016,Health,15806,40050,55856
B001269,N00025495,Lou Barletta (R),2016,Lawyers & Lobbyists,44083,12000,56083
B001269,N00025495,Lou Barletta (R),2016,Transportation,25516,155775,181291
B001269,N00025495,Lou Barletta (R),2016,Misc Business,30810,82343,113153
B001269,N00025495,Lou Barletta (R),2016,Labor,0,62500,62500
B001269,N00025495,Lou Barletta (R),2016,Ideology/Single-Issue,11247,52271,63518
B001269,N00025495,Lou Barletta (R),2016,Other,53165,13751,66916
C001053,N00025726,Tom Cole (R),2016,Agribusiness,15000,85148,100148
C001053,N00025726,Tom Cole (R),2016,Communic/Electronics,7650,22000,29650
C001053,N00025726,Tom Cole (R),2016,Construction,19300,32000,51300
C001053,N00025726,Tom Cole (R),2016,Defense,1000,104000,105000
C001053,N00025726,Tom Cole (R),2016,Energy/Nat Resource,44800,114700,159500
C001053,N00025726,Tom Cole (R),2016,Finance/Insur/RealEst,94707,143100,237807
C001053,N00025726,Tom Cole (R),2016,Health,22022,131250,153272
C001053,N00025726,Tom Cole (R),2016,Lawyers & Lobbyists,110374,33669,144043
C001053,N00025726,Tom Cole (R),2016,Transportation,25150,50936,76086
C001053,N00025726,Tom Cole (R),2016,Misc Business,48535,146000,194535
C001053,N00025726,Tom Cole (R),2016,Labor,0,24000,24000
C001053,N00025726,Tom Cole (R),2016,Ideology/Single-Issue,172600,53693,226293
C001053,N00025726,Tom Cole (R),2016,Other,85755,14500,100255
H001050,N00025881,Colleen Hanabusa (D),2016,Agribusiness,8400,2000,10400
H001050,N00025881,Colleen Hanabusa (D),2016,Communic/Electronics,3500,7500,11000
H001050,N00025881,Colleen Hanabusa (D),2016,Construction,78000,3000,81000
H001050,N00025881,Colleen Hanabusa (D),2016,Defense,12200,5000,17200
H001050,N00025881,Colleen Hanabusa (D),2016,Energy/Nat Resource,21125,1000,22125
H001050,N00025881,Colleen Hanabusa (D),2016,Finance/Insur/RealEst,115500,33600,149100
H001050,N00025881,Colleen Hanabusa (D),2016,Health,14450,14500,28950
H001050,N00025881,Colleen Hanabusa (D),2016,Lawyers & Lobbyists,27750,6000,33750
H001050,N00025881,Colleen Hanabusa (D),2016,Transportation,14700,27500,42200
H001050,N00025881,Colleen Hanabusa (D),2016,Misc Business,36599,6000,42599
H001050,N00025881,Colleen Hanabusa (D),2016,Labor,0,118000,118000
H001050,N00025881,Colleen Hanabusa (D),2016,Ideology/Single-Issue,20775,68500,89275
H001050,N00025881,Colleen Hanabusa (D),2016,Other,104100,0,104100
C001062,N00026041,Mike Conaway (R),2016,Agribusiness,171020,525360,696380
C001062,N00026041,Mike Conaway (R),2016,Communic/Electronics,250,52500,52750
C001062,N00026041,Mike Conaway (R),2016,Construction,19500,43000,62500
C001062,N00026041,Mike Conaway (R),2016,Defense,0,56500,56500
C001062,N00026041,Mike Conaway (R),2016,Energy/Nat Resource,71074,104333,175407
C001062,N00026041,Mike Conaway (R),2016,Finance/Insur/RealEst,103900,258000,361900
C001062,N00026041,Mike Conaway (R),2016,Health,36125,11500,47625
C001062,N00026041,Mike Conaway (R),2016,Lawyers & Lobbyists,58838,13200,72038
C001062,N00026041,Mike Conaway (R),2016,Transportation,18550,26500,45050
C001062,N00026041,Mike Conaway (R),2016,Misc Business,25780,89500,115280
C001062,N00026041,Mike Conaway (R),2016,Labor,0,1000,1000
C001062,N00026041,Mike Conaway (R),2016,Ideology/Single-Issue,14050,25100,39150
C001062,N00026041,Mike Conaway (R),2016,Other,50320,2000,52320
G000552,N00026148,Louis B Gohmert Jr (R),2016,Agribusiness,20050,21029,41079
G000552,N00026148,Louis B Gohmert Jr (R),2016,Communic/Electronics,6200,9000,15200
G000552,N00026148,Louis B Gohmert Jr (R),2016,Construction,20750,1000,21750
G000552,N00026148,Louis B Gohmert Jr (R),2016,Defense,228,5000,5228
G000552,N00026148,Louis B Gohmert Jr (R),2016,Energy/Nat Resource,22550,16500,39050
G000552,N00026148,Louis B Gohmert Jr (R),2016,Finance/Insur/RealEst,76515,9000,85515
G000552,N00026148,Louis B Gohmert Jr (R),2016,Health,34675,750,35425
G000552,N00026148,Louis B Gohmert Jr (R),2016,Lawyers & Lobbyists,9355,1250,10605
G000552,N00026148,Louis B Gohmert Jr (R),2016,Transportation,6150,14000,20150
G000552,N00026148,Louis B Gohmert Jr (R),2016,Misc Business,16700,1000,17700
G000552,N00026148,Louis B Gohmert Jr (R),2016,Labor,0,0,0
G000552,N00026148,Louis B Gohmert Jr (R),2016,Ideology/Single-Issue,16575,26934,43509
G000552,N00026148,Louis B Gohmert Jr (R),2016,Other,119703,0,119703
F000450,N00026166,Virginia Foxx (R),2016,Agribusiness,23150,55500,78650
F000450,N00026166,Virginia Foxx (R),2016,Communic/Electronics,24530,33500,58030
F000450,N00026166,Virginia Foxx (R),2016,Construction,26050,37500,63550
F000450,N00026166,Virginia Foxx (R),2016,Defense,0,10000,10000
F000450,N00026166,Virginia Foxx (R),2016,Energy/Nat Resource,2173,39500,41673
F000450,N00026166,Virginia Foxx (R),2016,Finance/Insur/RealEst,78600,140400,219000
F000450,N00026166,Virginia Foxx (R),2016,Health,45068,67600,112668
F000450,N00026166,Virginia Foxx (R),2016,Lawyers & Lobbyists,57300,32750,90050
F000450,N00026166,Virginia Foxx (R),2016,Transportation,13900,36500,50400
F000450,N00026166,Virginia Foxx (R),2016,Misc Business,112050,127000,239050
F000450,N00026166,Virginia Foxx (R),2016,Labor,0,1000,1000
F000450,N00026166,Virginia Foxx (R),2016,Ideology/Single-Issue,21940,60196,82136
F000450,N00026166,Virginia Foxx (R),2016,Other,255520,38000,293520
D000604,N00026171,Charlie Dent (R),2016,Agribusiness,11950,15904,27854
D000604,N00026171,Charlie Dent (R),2016,Communic/Electronics,14449,52500,66949
D000604,N00026171,Charlie Dent (R),2016,Construction,24700,98000,122700
D000604,N00026171,Charlie Dent (R),2016,Defense,0,50000,50000
D000604,N00026171,Charlie Dent (R),2016,Energy/Nat Resource,8400,78000,86400
D000604,N00026171,Charlie Dent (R),2016,Finance/Insur/RealEst,63415,107300,170715
D000604,N00026171,Charlie Dent (R),2016,Health,49200,266650,315850
D000604,N00026171,Charlie Dent (R),2016,Lawyers & Lobbyists,79450,26750,106200
D000604,N00026171,Charlie Dent (R),2016,Transportation,30750,59250,90000
D000604,N00026171,Charlie Dent (R),2016,Misc Business,67740,157500,225240
D000604,N00026171,Charlie Dent (R),2016,Labor,0,52500,52500
D000604,N00026171,Charlie Dent (R),2016,Ideology/Single-Issue,25800,78631,104431
D000604,N00026171,Charlie Dent (R),2016,Other,77575,3000,80575
C001059,N00026341,Jim Costa (D),2016,Agribusiness,191224,278500,469724
C001059,N00026341,Jim Costa (D),2016,Communic/Electronics,22300,52000,74300
C001059,N00026341,Jim Costa (D),2016,Construction,42550,24500,67050
C001059,N00026341,Jim Costa (D),2016,Defense,1500,4000,5500
C001059,N00026341,Jim Costa (D),2016,Energy/Nat Resource,13050,153275,166325
C001059,N00026341,Jim Costa (D),2016,Finance/Insur/RealEst,82333,69500,151833
C001059,N00026341,Jim Costa (D),2016,Health,53550,43000,96550
C001059,N00026341,Jim Costa (D),2016,Lawyers & Lobbyists,54350,13000,67350
C001059,N00026341,Jim Costa (D),2016,Transportation,13100,43500,56600
C001059,N00026341,Jim Costa (D),2016,Misc Business,88070,77500,165570
C001059,N00026341,Jim Costa (D),2016,Labor,250,38000,38250
C001059,N00026341,Jim Costa (D),2016,Ideology/Single-Issue,75550,103450,179000
C001059,N00026341,Jim Costa (D),2016,Other,44330,1000,45330
D000607,N00026586,Joe Donnelly (D),2016,Agribusiness,73091,186650,259741
D000607,N00026586,Joe Donnelly (D),2016,Communic/Electronics,143916,31250,175166
D000607,N00026586,Joe Donnelly (D),2016,Construction,169528,34500,204028
D000607,N00026586,Joe Donnelly (D),2016,Defense,37233,65000,102233
D000607,N00026586,Joe Donnelly (D),2016,Energy/Nat Resource,62650,103750,166400
D000607,N00026586,Joe Donnelly (D),2016,Finance/Insur/RealEst,535986,582360,1118346
D000607,N00026586,Joe Donnelly (D),2016,Health,288335,219071,507406
D000607,N00026586,Joe Donnelly (D),2016,Lawyers & Lobbyists,992649,110094,1102743
D000607,N00026586,Joe Donnelly (D),2016,Transportation,40050,97629,137679
D000607,N00026586,Joe Donnelly (D),2016,Misc Business,370766,171500,542266
D000607,N00026586,Joe Donnelly (D),2016,Labor,6313,387750,394063
D000607,N00026586,Joe Donnelly (D),2016,Ideology/Single-Issue,181561,570972,752533
D000607,N00026586,Joe Donnelly (D),2016,Other,575114,5500,580614
B001255,N00026595,Charles W Boustany Jr (R),2016,Agribusiness,211804,117250,329054
B001255,N00026595,Charles W Boustany Jr (R),2016,Communic/Electronics,39500,62636,102136
B001255,N00026595,Charles W Boustany Jr (R),2016,Construction,175917,59500,235417
B001255,N00026595,Charles W Boustany Jr (R),2016,Defense,2000,46500,48500
B001255,N00026595,Charles W Boustany Jr (R),2016,Energy/Nat Resource,269537,243000,512537
B001255,N00026595,Charles W Boustany Jr (R),2016,Finance/Insur/RealEst,432845,430402,863247
B001255,N00026595,Charles W Boustany Jr (R),2016,Health,400142,387252,787394
B001255,N00026595,Charles W Boustany Jr (R),2016,Lawyers & Lobbyists,393287,70163,463450
B001255,N00026595,Charles W Boustany Jr (R),2016,Transportation,127850,119150,247000
B001255,N00026595,Charles W Boustany Jr (R),2016,Misc Business,363613,203894,567507
B001255,N00026595,Charles W Boustany Jr (R),2016,Labor,0,1000,1000
B001255,N00026595,Charles W Boustany Jr (R),2016,Ideology/Single-Issue,84065,179949,264014
B001255,N00026595,Charles W Boustany Jr (R),2016,Other,213150,-50,213100
F000449,N00026631,Jeff Fortenberry (R),2016,Agribusiness,9700,52500,62200
F000449,N00026631,Jeff Fortenberry (R),2016,Communic/Electronics,19500,3500,23000
F000449,N00026631,Jeff Fortenberry (R),2016,Construction,3550,15500,19050
F000449,N00026631,Jeff Fortenberry (R),2016,Defense,0,35000,35000
F000449,N00026631,Jeff Fortenberry (R),2016,Energy/Nat Resource,2000,12500,14500
F000449,N00026631,Jeff Fortenberry (R),2016,Finance/Insur/RealEst,68390,93500,161890
F000449,N00026631,Jeff Fortenberry (R),2016,Health,80550,15000,95550
F000449,N00026631,Jeff Fortenberry (R),2016,Lawyers & Lobbyists,21950,14000,35950
F000449,N00026631,Jeff Fortenberry (R),2016,Transportation,2000,28000,30000
F000449,N00026631,Jeff Fortenberry (R),2016,Misc Business,50700,20500,71200
F000449,N00026631,Jeff Fortenberry (R),2016,Labor,0,17000,17000
F000449,N00026631,Jeff Fortenberry (R),2016,Ideology/Single-Issue,7400,40000,47400
F000449,N00026631,Jeff Fortenberry (R),2016,Other,26850,0,26850
G000553,N00026686,Al Green (D),2016,Agribusiness,6100,2000,8100
G000553,N00026686,Al Green (D),2016,Communic/Electronics,5882,7000,12882
G000553,N00026686,Al Green (D),2016,Construction,40050,4200,44250
G000553,N00026686,Al Green (D),2016,Defense,0,1000,1000
G000553,N00026686,Al Green (D),2016,Energy/Nat Resource,17300,8500,25800
G000553,N00026686,Al Green (D),2016,Finance/Insur/RealEst,96607,28000,124607
G000553,N00026686,Al Green (D),2016,Health,38450,2000,40450
G000553,N00026686,Al Green (D),2016,Lawyers & Lobbyists,88436,13100,101536
G000553,N00026686,Al Green (D),2016,Transportation,6700,7000,13700
G000553,N00026686,Al Green (D),2016,Misc Business,24000,6000,30000
G000553,N00026686,Al Green (D),2016,Labor,0,125500,125500
G000553,N00026686,Al Green (D),2016,Ideology/Single-Issue,1200,10500,11700
G000553,N00026686,Al Green (D),2016,Other,37492,0,37492
C001061,N00026790,Emanuel Cleaver (D),2016,Agribusiness,500,26500,27000
C001061,N00026790,Emanuel Cleaver (D),2016,Communic/Electronics,8975,40000,48975
C001061,N00026790,Emanuel Cleaver (D),2016,Construction,4700,24950,29650
C001061,N00026790,Emanuel Cleaver (D),2016,Defense,0,18000,18000
C001061,N00026790,Emanuel Cleaver (D),2016,Energy/Nat Resource,2600,11000,13600
C001061,N00026790,Emanuel Cleaver (D),2016,Finance/Insur/RealEst,52275,410450,462725
C001061,N00026790,Emanuel Cleaver (D),2016,Health,12650,46000,58650
C001061,N00026790,Emanuel Cleaver (D),2016,Lawyers & Lobbyists,49100,28500,77600
C001061,N00026790,Emanuel Cleaver (D),2016,Transportation,1000,19717,20717
C001061,N00026790,Emanuel Cleaver (D),2016,Misc Business,17550,41000,58550
C001061,N00026790,Emanuel Cleaver (D),2016,Labor,1000,162000,163000
C001061,N00026790,Emanuel Cleaver (D),2016,Ideology/Single-Issue,12800,46558,59358
C001061,N00026790,Emanuel Cleaver (D),2016,Other,16110,0,16110
C001067,N00026961,Yvette D Clarke (D),2016,Agribusiness,3100,1500,4600
C001067,N00026961,Yvette D Clarke (D),2016,Communic/Electronics,16000,117231,133231
C001067,N00026961,Yvette D Clarke (D),2016,Construction,7350,3500,10850
C001067,N00026961,Yvette D Clarke (D),2016,Defense,0,8000,8000
C001067,N00026961,Yvette D Clarke (D),2016,Energy/Nat Resource,3500,25000,28500
C001067,N00026961,Yvette D Clarke (D),2016,Finance/Insur/RealEst,11525,41500,53025
C001067,N00026961,Yvette D Clarke (D),2016,Health,22750,66000,88750
C001067,N00026961,Yvette D Clarke (D),2016,Lawyers & Lobbyists,13350,13000,26350
C001067,N00026961,Yvette D Clarke (D),2016,Transportation,0,18500,18500
C001067,N00026961,Yvette D Clarke (D),2016,Misc Business,9850,22500,32350
C001067,N00026961,Yvette D Clarke (D),2016,Labor,0,137500,137500
C001067,N00026961,Yvette D Clarke (D),2016,Ideology/Single-Issue,1250,23500,24750
C001067,N00026961,Yvette D Clarke (D),2016,Other,27180,0,27180
B001251,N00027035,G K Butterfield (D),2016,Agribusiness,4500,91181,95681
B001251,N00027035,G K Butterfield (D),2016,Communic/Electronics,11400,135000,146400
B001251,N00027035,G K Butterfield (D),2016,Construction,3500,1500,5000
B001251,N00027035,G K Butterfield (D),2016,Defense,0,25000,25000
B001251,N00027035,G K Butterfield (D),2016,Energy/Nat Resource,3500,43000,46500
B001251,N00027035,G K Butterfield (D),2016,Finance/Insur/RealEst,8300,87000,95300
B001251,N00027035,G K Butterfield (D),2016,Health,22200,227460,249660
B001251,N00027035,G K Butterfield (D),2016,Lawyers & Lobbyists,38550,28500,67050
B001251,N00027035,G K Butterfield (D),2016,Transportation,1000,55000,56000
B001251,N00027035,G K Butterfield (D),2016,Misc Business,8500,99902,108402
B001251,N00027035,G K Butterfield (D),2016,Labor,0,113200,113200
B001251,N00027035,G K Butterfield (D),2016,Ideology/Single-Issue,11700,16500,28200
B001251,N00027035,G K Butterfield (D),2016,Other,26450,0,26450
H001038,N00027060,Brian M Higgins (D),2016,Agribusiness,100,7000,7100
H001038,N00027060,Brian M Higgins (D),2016,Communic/Electronics,0,7500,7500
H001038,N00027060,Brian M Higgins (D),2016,Construction,37760,5000,42760
H001038,N00027060,Brian M Higgins (D),2016,Defense,0,16500,16500
H001038,N00027060,Brian M Higgins (D),2016,Energy/Nat Resource,1050,14350,15400
H001038,N00027060,Brian M Higgins (D),2016,Finance/Insur/RealEst,56435,30000,86435
H001038,N00027060,Brian M Higgins (D),2016,Health,19819,10250,30069
H001038,N00027060,Brian M Higgins (D),2016,Lawyers & Lobbyists,71852,8250,80102
H001038,N00027060,Brian M Higgins (D),2016,Transportation,3700,20500,24200
H001038,N00027060,Brian M Higgins (D),2016,Misc Business,31610,24500,56110
H001038,N00027060,Brian M Higgins (D),2016,Labor,0,162575,162575
H001038,N00027060,Brian M Higgins (D),2016,Ideology/Single-Issue,2720,3500,6220
H001038,N00027060,Brian M Higgins (D),2016,Other,33585,0,33585
F000451,N00027229,Michael G Fitzpatrick (R),2016,Communic/Electronics,0,2000,2000
F000451,N00027229,Michael G Fitzpatrick (R),2016,Construction,0,5150,5150
F000451,N00027229,Michael G Fitzpatrick (R),2016,Energy/Nat Resource,0,3000,3000
F000451,N00027229,Michael G Fitzpatrick (R),2016,Finance/Insur/RealEst,0,0,0
F000451,N00027229,Michael G Fitzpatrick (R),2016,Health,0,1000,1000
F000451,N00027229,Michael G Fitzpatrick (R),2016,Lawyers & Lobbyists,0,2000,2000
F000451,N00027229,Michael G Fitzpatrick (R),2016,Misc Business,0,4000,4000
F000451,N00027229,Michael G Fitzpatrick (R),2016,Labor,0,-3500,-3500
F000451,N00027229,Michael G Fitzpatrick (R),2016,Ideology/Single-Issue,0,11250,11250
C001071,N00027441,Bob Corker (R),2016,Agribusiness,174536,106500,281036
C001071,N00027441,Bob Corker (R),2016,Communic/Electronics,196960,118251,315211
C001071,N00027441,Bob Corker (R),2016,Construction,433974,54500,488474
C001071,N00027441,Bob Corker (R),2016,Defense,6260,46500,52760
C001071,N00027441,Bob Corker (R),2016,Energy/Nat Resource,261153,230561,491714
C001071,N00027441,Bob Corker (R),2016,Finance/Insur/RealEst,2197287,748270,2945557
C001071,N00027441,Bob Corker (R),2016,Health,603950,267688,871638
C001071,N00027441,Bob Corker (R),2016,Lawyers & Lobbyists,568455,111500,679955
C001071,N00027441,Bob Corker (R),2016,Transportation,236805,82000,318805
C001071,N00027441,Bob Corker (R),2016,Misc Business,819897,274345,1094242
C001071,N00027441,Bob Corker (R),2016,Labor,0,12000,12000
C001071,N00027441,Bob Corker (R),2016,Ideology/Single-Issue,117940,339250,457190
C001071,N00027441,Bob Corker (R),2016,Other,659252,3500,662752
B001257,N00027462,Gus Bilirakis (R),2016,Agribusiness,7500,12000,19500
B001257,N00027462,Gus Bilirakis (R),2016,Communic/Electronics,2950,90000,92950
B001257,N00027462,Gus Bilirakis (R),2016,Construction,18750,16000,34750
B001257,N00027462,Gus Bilirakis (R),2016,Defense,0,20000,20000
B001257,N00027462,Gus Bilirakis (R),2016,Energy/Nat Resource,3200,66000,69200
B001257,N00027462,Gus Bilirakis (R),2016,Finance/Insur/RealEst,89131,75500,164631
B001257,N00027462,Gus Bilirakis (R),2016,Health,64574,318100,382674
B001257,N00027462,Gus Bilirakis (R),2016,Lawyers & Lobbyists,62159,21750,83909
B001257,N00027462,Gus Bilirakis (R),2016,Transportation,8300,34500,42800
B001257,N00027462,Gus Bilirakis (R),2016,Misc Business,81617,111250,192867
B001257,N00027462,Gus Bilirakis (R),2016,Ideology/Single-Issue,8950,16600,25550
B001257,N00027462,Gus Bilirakis (R),2016,Other,81155,1000,82155
C001070,N00027503,Bob Casey (D),2016,Agribusiness,79051,202750,281801
C001070,N00027503,Bob Casey (D),2016,Communic/Electronics,237389,179250,416639
C001070,N00027503,Bob Casey (D),2016,Construction,188556,57250,245806
C001070,N00027503,Bob Casey (D),2016,Defense,29376,104500,133876
C001070,N00027503,Bob Casey (D),2016,Energy/Nat Resource,189100,153850,342950
C001070,N00027503,Bob Casey (D),2016,Finance/Insur/RealEst,1076763,581850,1658613
C001070,N00027503,Bob Casey (D),2016,Health,700959,774079,1475038
C001070,N00027503,Bob Casey (D),2016,Lawyers & Lobbyists,2135031,219533,2354564
C001070,N00027503,Bob Casey (D),2016,Transportation,87056,132500,219556
C001070,N00027503,Bob Casey (D),2016,Misc Business,565577,272728,838305
C001070,N00027503,Bob Casey (D),2016,Labor,46429,388949,435378
C001070,N00027503,Bob Casey (D),2016,Ideology/Single-Issue,195746,530334,726080
C001070,N00027503,Bob Casey (D),2016,Other,797125,16000,813125
C001066,N00027514,Kathy Castor (D),2016,Agribusiness,7750,10900,18650
C001066,N00027514,Kathy Castor (D),2016,Communic/Electronics,3600,61000,64600
C001066,N00027514,Kathy Castor (D),2016,Construction,6024,16500,22524
C001066,N00027514,Kathy Castor (D),2016,Defense,0,3000,3000
C001066,N00027514,Kathy Castor (D),2016,Energy/Nat Resource,0,6500,6500
C001066,N00027514,Kathy Castor (D),2016,Finance/Insur/RealEst,33900,41000,74900
C001066,N00027514,Kathy Castor (D),2016,Health,20975,102500,123475
C001066,N00027514,Kathy Castor (D),2016,Lawyers & Lobbyists,52448,19250,71698
C001066,N00027514,Kathy Castor (D),2016,Transportation,9850,14500,24350
C001066,N00027514,Kathy Castor (D),2016,Misc Business,14950,50500,65450
C001066,N00027514,Kathy Castor (D),2016,Labor,0,78000,78000
C001066,N00027514,Kathy Castor (D),2016,Ideology/Single-Issue,11371,24500,35871
C001066,N00027514,Kathy Castor (D),2016,Other,22175,2000,24175
H001041,N00027522,Dean Heller (R),2016,Agribusiness,63540,127500,191040
H001041,N00027522,Dean Heller (R),2016,Communic/Electronics,173550,345000,518550
H001041,N00027522,Dean Heller (R),2016,Construction,265307,131500,396807
H001041,N00027522,Dean Heller (R),2016,Defense,8850,30500,39350
H001041,N00027522,Dean Heller (R),2016,Energy/Nat Resource,312639,449575,762214
H001041,N00027522,Dean Heller (R),2016,Finance/Insur/RealEst,1043103,878850,1921953
H001041,N00027522,Dean Heller (R),2016,Health,242140,371350,613490
H001041,N00027522,Dean Heller (R),2016,Lawyers & Lobbyists,415334,95859,511193
H001041,N00027522,Dean Heller (R),2016,Transportation,170610,228499,399109
H001041,N00027522,Dean Heller (R),2016,Misc Business,852562,497424,1349986
H001041,N00027522,Dean Heller (R),2016,Labor,0,15000,15000
H001041,N00027522,Dean Heller (R),2016,Ideology/Single-Issue,263829,618983,882812
H001041,N00027522,Dean Heller (R),2016,Other,655818,12000,667818
B001260,N00027626,Vernon Buchanan (R),2016,Agribusiness,30800,38798,69598
B001260,N00027626,Vernon Buchanan (R),2016,Communic/Electronics,16400,24000,40400
B001260,N00027626,Vernon Buchanan (R),2016,Construction,45300,28500,73800
B001260,N00027626,Vernon Buchanan (R),2016,Defense,0,6000,6000
B001260,N00027626,Vernon Buchanan (R),2016,Energy/Nat Resource,5000,24500,29500
B001260,N00027626,Vernon Buchanan (R),2016,Finance/Insur/RealEst,123050,173675,296725
B001260,N00027626,Vernon Buchanan (R),2016,Health,137615,212500,350115
B001260,N00027626,Vernon Buchanan (R),2016,Lawyers & Lobbyists,46400,18514,64914
B001260,N00027626,Vernon Buchanan (R),2016,Transportation,29350,76995,106345
B001260,N00027626,Vernon Buchanan (R),2016,Misc Business,79542,82500,162042
B001260,N00027626,Vernon Buchanan (R),2016,Labor,0,5500,5500
B001260,N00027626,Vernon Buchanan (R),2016,Ideology/Single-Issue,86000,29500,115500
B001260,N00027626,Vernon Buchanan (R),2016,Other,129175,0,129175
H001057,N00027649,Tim Huelskamp (R),2016,Agribusiness,39001,8000,47001
H001057,N00027649,Tim Huelskamp (R),2016,Communic/Electronics,7450,7000,14450
H001057,N00027649,Tim Huelskamp (R),2016,Construction,41046,5000,46046
H001057,N00027649,Tim Huelskamp (R),2016,Defense,125,5000,5125
H001057,N00027649,Tim Huelskamp (R),2016,Energy/Nat Resource,36797,14500,51297
H001057,N00027649,Tim Huelskamp (R),2016,Finance/Insur/RealEst,82985,24500,107485
H001057,N00027649,Tim Huelskamp (R),2016,Health,19825,6500,26325
H001057,N00027649,Tim Huelskamp (R),2016,Lawyers & Lobbyists,12222,0,12222
H001057,N00027649,Tim Huelskamp (R),2016,Transportation,10585,6500,17085
H001057,N00027649,Tim Huelskamp (R),2016,Misc Business,110327,1000,111327
H001057,N00027649,Tim Huelskamp (R),2016,Labor,0,1000,1000
H001057,N00027649,Tim Huelskamp (R),2016,Ideology/Single-Issue,36829,103882,140711
H001057,N00027649,Tim Huelskamp (R),2016,Other,65016,0,65016
G000555,N00027658,Kirsten Gillibrand (D),2016,Agribusiness,84532,142700,227232
G000555,N00027658,Kirsten Gillibrand (D),2016,Communic/Electronics,1008720,216313,1225033
G000555,N00027658,Kirsten Gillibrand (D),2016,Construction,160828,82000,242828
G000555,N00027658,Kirsten Gillibrand (D),2016,Defense,42547,153000,195547
G000555,N00027658,Kirsten Gillibrand (D),2016,Energy/Nat Resource,112860,134950,247810
G000555,N00027658,Kirsten Gillibrand (D),2016,Finance/Insur/RealEst,2930653,647616,3578269
G000555,N00027658,Kirsten Gillibrand (D),2016,Health,410414,328360,738774
G000555,N00027658,Kirsten Gillibrand (D),2016,Lawyers & Lobbyists,2683182,192545,2875727
G000555,N00027658,Kirsten Gillibrand (D),2016,Transportation,69882,141500,211382
G000555,N00027658,Kirsten Gillibrand (D),2016,Misc Business,1118843,298960,1417803
G000555,N00027658,Kirsten Gillibrand (D),2016,Labor,839,280750,281589
G000555,N00027658,Kirsten Gillibrand (D),2016,Ideology/Single-Issue,1085613,254874,1340487
G000555,N00027658,Kirsten Gillibrand (D),2016,Other,1268680,17500,1286180
D000622,N00027860,Tammy Duckworth (D),2016,Agribusiness,49948,46000,95948
D000622,N00027860,Tammy Duckworth (D),2016,Communic/Electronics,436384,20000,456384
D000622,N00027860,Tammy Duckworth (D),2016,Construction,86720,1000,87720
D000622,N00027860,Tammy Duckworth (D),2016,Defense,22122,69000,91122
D000622,N00027860,Tammy Duckworth (D),2016,Energy/Nat Resource,49580,30500,80080
D000622,N00027860,Tammy Duckworth (D),2016,Finance/Insur/RealEst,985913,78500,1064413
D000622,N00027860,Tammy Duckworth (D),2016,Health,290077,129100,419177
D000622,N00027860,Tammy Duckworth (D),2016,Lawyers & Lobbyists,1360217,25900,1386117
D000622,N00027860,Tammy Duckworth (D),2016,Transportation,22493,35500,57993
D000622,N00027860,Tammy Duckworth (D),2016,Misc Business,516359,44000,560359
D000622,N00027860,Tammy Duckworth (D),2016,Labor,6662,393500,400162
D000622,N00027860,Tammy Duckworth (D),2016,Ideology/Single-Issue,2904797,610195,3514992
D000622,N00027860,Tammy Duckworth (D),2016,Other,1762428,10000,1772428
H001042,N00028139,Mazie K Hirono (D),2016,Agribusiness,21250,15500,36750
H001042,N00028139,Mazie K Hirono (D),2016,Communic/Electronics,143573,71700,215273
H001042,N00028139,Mazie K Hirono (D),2016,Construction,173725,29500,203225
H001042,N00028139,Mazie K Hirono (D),2016,Defense,38500,46500,85000
H001042,N00028139,Mazie K Hirono (D),2016,Energy/Nat Resource,43875,30500,74375
H001042,N00028139,Mazie K Hirono (D),2016,Finance/Insur/RealEst,401366,117700,519066
H001042,N00028139,Mazie K Hirono (D),2016,Health,107127,64300,171427
H001042,N00028139,Mazie K Hirono (D),2016,Lawyers & Lobbyists,913995,71500,985495
H001042,N00028139,Mazie K Hirono (D),2016,Transportation,118912,148552,267464
H001042,N00028139,Mazie K Hirono (D),2016,Misc Business,299185,53500,352685
H001042,N00028139,Mazie K Hirono (D),2016,Labor,1700,435775,437475
H001042,N00028139,Mazie K Hirono (D),2016,Ideology/Single-Issue,551420,397869,949289
H001042,N00028139,Mazie K Hirono (D),2016,Other,439364,6000,445364
E000290,N00028249,Donna Edwards (D),2016,Agribusiness,11762,0,11762
E000290,N00028249,Donna Edwards (D),2016,Communic/Electronics,118066,0,118066
E000290,N00028249,Donna Edwards (D),2016,Construction,34470,2500,36970
E000290,N00028249,Donna Edwards (D),2016,Defense,3135,5500,8635
E000290,N00028249,Donna Edwards (D),2016,Energy/Nat Resource,15279,3000,18279
E000290,N00028249,Donna Edwards (D),2016,Finance/Insur/RealEst,156077,3000,159077
E000290,N00028249,Donna Edwards (D),2016,Health,56364,0,56364
E000290,N00028249,Donna Edwards (D),2016,Lawyers & Lobbyists,121619,1000,122619
E000290,N00028249,Donna Edwards (D),2016,Transportation,7770,6000,13770
E000290,N00028249,Donna Edwards (D),2016,Misc Business,125737,2000,127737
E000290,N00028249,Donna Edwards (D),2016,Labor,11210,64140,75350
E000290,N00028249,Donna Edwards (D),2016,Ideology/Single-Issue,724689,139273,863962
E000290,N00028249,Donna Edwards (D),2016,Other,378587,0,378587
E000288,N00028257,Keith Ellison (D),2016,Agribusiness,5189,20000,25189
E000288,N00028257,Keith Ellison (D),2016,Communic/Electronics,37145,0,37145
E000288,N00028257,Keith Ellison (D),2016,Construction,18958,1000,19958
E000288,N00028257,Keith Ellison (D),2016,Defense,4560,1000,5560
E000288,N00028257,Keith Ellison (D),2016,Energy/Nat Resource,7320,2000,9320
E000288,N00028257,Keith Ellison (D),2016,Finance/Insur/RealEst,105979,44250,150229
E000288,N00028257,Keith Ellison (D),2016,Health,218838,14000,232838
E000288,N00028257,Keith Ellison (D),2016,Lawyers & Lobbyists,40569,24066,64635
E000288,N00028257,Keith Ellison (D),2016,Transportation,5785,2000,7785
E000288,N00028257,Keith Ellison (D),2016,Misc Business,67687,11500,79187
E000288,N00028257,Keith Ellison (D),2016,Labor,3355,182250,185605
E000288,N00028257,Keith Ellison (D),2016,Ideology/Single-Issue,173652,51017,224669
E000288,N00028257,Keith Ellison (D),2016,Other,201482,0,201482
C001076,N00028958,Jason Chaffetz (R),2016,Agribusiness,2000,14000,16000
C001076,N00028958,Jason Chaffetz (R),2016,Communic/Electronics,64700,129500,194200
C001076,N00028958,Jason Chaffetz (R),2016,Construction,5400,26000,31400
C001076,N00028958,Jason Chaffetz (R),2016,Defense,0,34500,34500
C001076,N00028958,Jason Chaffetz (R),2016,Energy/Nat Resource,20500,62900,83400
C001076,N00028958,Jason Chaffetz (R),2016,Finance/Insur/RealEst,99100,156550,255650
C001076,N00028958,Jason Chaffetz (R),2016,Health,43950,88500,132450
C001076,N00028958,Jason Chaffetz (R),2016,Lawyers & Lobbyists,99100,29291,128391
C001076,N00028958,Jason Chaffetz (R),2016,Transportation,20150,51000,71150
C001076,N00028958,Jason Chaffetz (R),2016,Misc Business,73550,141000,214550
C001076,N00028958,Jason Chaffetz (R),2016,Labor,0,19000,19000
C001076,N00028958,Jason Chaffetz (R),2016,Ideology/Single-Issue,16400,37513,53913
C001076,N00028958,Jason Chaffetz (R),2016,Other,25000,0,25000
F000457,N00029016,Al Franken (D),2016,Agribusiness,90127,107749,197876
F000457,N00029016,Al Franken (D),2016,Communic/Electronics,1032334,140754,1173088
F000457,N00029016,Al Franken (D),2016,Construction,72047,15950,87997
F000457,N00029016,Al Franken (D),2016,Defense,10265,16500,26765
F000457,N00029016,Al Franken (D),2016,Energy/Nat Resource,50849,102250,153099
F000457,N00029016,Al Franken (D),2016,Finance/Insur/RealEst,921386,100110,1021496
F000457,N00029016,Al Franken (D),2016,Health,325271,202648,527919
F000457,N00029016,Al Franken (D),2016,Lawyers & Lobbyists,1353660,104738,1458398
F000457,N00029016,Al Franken (D),2016,Transportation,39422,13000,52422
F000457,N00029016,Al Franken (D),2016,Misc Business,670373,94464,764837
F000457,N00029016,Al Franken (D),2016,Labor,1755,317250,319005
F000457,N00029016,Al Franken (D),2016,Ideology/Single-Issue,494182,521688,1015870
F000457,N00029016,Al Franken (D),2016,Other,1981018,13000,1994018
H001047,N00029070,Jim Himes (D),2016,Agribusiness,3900,8500,12400
H001047,N00029070,Jim Himes (D),2016,Communic/Electronics,28882,57000,85882
H001047,N00029070,Jim Himes (D),2016,Construction,3350,9500,12850
H001047,N00029070,Jim Himes (D),2016,Defense,0,43000,43000
H001047,N00029070,Jim Himes (D),2016,Energy/Nat Resource,2600,17500,20100
H001047,N00029070,Jim Himes (D),2016,Finance/Insur/RealEst,344435,653400,997835
H001047,N00029070,Jim Himes (D),2016,Health,9827,69000,78827
H001047,N00029070,Jim Himes (D),2016,Lawyers & Lobbyists,69960,16250,86210
H001047,N00029070,Jim Himes (D),2016,Transportation,5400,9402,14802
H001047,N00029070,Jim Himes (D),2016,Misc Business,105205,86055,191260
H001047,N00029070,Jim Himes (D),2016,Labor,0,19500,19500
H001047,N00029070,Jim Himes (D),2016,Ideology/Single-Issue,51141,18009,69150
H001047,N00029070,Jim Himes (D),2016,Other,203215,500,203715
F000454,N00029139,Bill Foster (D),2016,Agribusiness,250,16000,16250
F000454,N00029139,Bill Foster (D),2016,Communic/Electronics,81085,25500,106585
F000454,N00029139,Bill Foster (D),2016,Construction,14705,1000,15705
F000454,N00029139,Bill Foster (D),2016,Defense,16962,9000,25962
F000454,N00029139,Bill Foster (D),2016,Energy/Nat Resource,33900,15500,49400
F000454,N00029139,Bill Foster (D),2016,Finance/Insur/RealEst,184150,387700,571850
F000454,N00029139,Bill Foster (D),2016,Health,80695,32000,112695
F000454,N00029139,Bill Foster (D),2016,Lawyers & Lobbyists,158510,26998,185508
F000454,N00029139,Bill Foster (D),2016,Transportation,2500,19000,21500
F000454,N00029139,Bill Foster (D),2016,Misc Business,66285,33000,99285
F000454,N00029139,Bill Foster (D),2016,Labor,0,182200,182200
F000454,N00029139,Bill Foster (D),2016,Ideology/Single-Issue,330681,20950,351631
F000454,N00029139,Bill Foster (D),2016,Other,825301,500,825801
H001052,N00029147,Andy Harris (R),2016,Agribusiness,28786,75807,104593
H001052,N00029147,Andy Harris (R),2016,Communic/Electronics,3350,4000,7350
H001052,N00029147,Andy Harris (R),2016,Construction,23150,26000,49150
H001052,N00029147,Andy Harris (R),2016,Defense,6100,38000,44100
H001052,N00029147,Andy Harris (R),2016,Energy/Nat Resource,1625,37000,38625
H001052,N00029147,Andy Harris (R),2016,Finance/Insur/RealEst,59068,21500,80568
H001052,N00029147,Andy Harris (R),2016,Health,153527,149700,303227
H001052,N00029147,Andy Harris (R),2016,Lawyers & Lobbyists,35982,3000,38982
H001052,N00029147,Andy Harris (R),2016,Transportation,14750,27000,41750
H001052,N00029147,Andy Harris (R),2016,Misc Business,61100,59839,120939
H001052,N00029147,Andy Harris (R),2016,Labor,0,6500,6500
H001052,N00029147,Andy Harris (R),2016,Ideology/Single-Issue,16308,35835,52143
H001052,N00029147,Andy Harris (R),2016,Other,102832,1000,103832
H001048,N00029258,Duncan D Hunter (R),2016,Agribusiness,250,31511,31761
H001048,N00029258,Duncan D Hunter (R),2016,Communic/Electronics,19400,29500,48900
H001048,N00029258,Duncan D Hunter (R),2016,Construction,500,58000,58500
H001048,N00029258,Duncan D Hunter (R),2016,Defense,12250,190027,202277
H001048,N00029258,Duncan D Hunter (R),2016,Energy/Nat Resource,33050,22000,55050
H001048,N00029258,Duncan D Hunter (R),2016,Finance/Insur/RealEst,4503,74500,79003
H001048,N00029258,Duncan D Hunter (R),2016,Health,1800,26000,27800
H001048,N00029258,Duncan D Hunter (R),2016,Lawyers & Lobbyists,48500,21226,69726
H001048,N00029258,Duncan D Hunter (R),2016,Transportation,33600,156250,189850
H001048,N00029258,Duncan D Hunter (R),2016,Misc Business,31575,70000,101575
H001048,N00029258,Duncan D Hunter (R),2016,Labor,0,52500,52500
H001048,N00029258,Duncan D Hunter (R),2016,Ideology/Single-Issue,9250,28921,38171
H001048,N00029258,Duncan D Hunter (R),2016,Other,20000,15000,35000
C001072,N00029513,Andre Carson (D),2016,Agribusiness,3250,13000,16250
C001072,N00029513,Andre Carson (D),2016,Communic/Electronics,3350,18000,21350
C001072,N00029513,Andre Carson (D),2016,Construction,37766,10750,48516
C001072,N00029513,Andre Carson (D),2016,Defense,0,28000,28000
C001072,N00029513,Andre Carson (D),2016,Energy/Nat Resource,1250,6000,7250
C001072,N00029513,Andre Carson (D),2016,Finance/Insur/RealEst,45849,69200,115049
C001072,N00029513,Andre Carson (D),2016,Health,105778,39500,145278
C001072,N00029513,Andre Carson (D),2016,Lawyers & Lobbyists,86022,22000,108022
C001072,N00029513,Andre Carson (D),2016,Transportation,1600,108000,109600
C001072,N00029513,Andre Carson (D),2016,Misc Business,27788,23879,51667
C001072,N00029513,Andre Carson (D),2016,Labor,500,211500,212000
C001072,N00029513,Andre Carson (D),2016,Ideology/Single-Issue,575,31500,32075
C001072,N00029513,Andre Carson (D),2016,Other,43158,2500,45658
H001045,N00029632,Gregg Harper (R),2016,Agribusiness,22500,48000,70500
H001045,N00029632,Gregg Harper (R),2016,Communic/Electronics,6850,48500,55350
H001045,N00029632,Gregg Harper (R),2016,Construction,16200,18500,34700
H001045,N00029632,Gregg Harper (R),2016,Defense,5000,50000,55000
H001045,N00029632,Gregg Harper (R),2016,Energy/Nat Resource,23050,96500,119550
H001045,N00029632,Gregg Harper (R),2016,Finance/Insur/RealEst,52950,66500,119450
H001045,N00029632,Gregg Harper (R),2016,Health,30700,94000,124700
H001045,N00029632,Gregg Harper (R),2016,Lawyers & Lobbyists,52300,18500,70800
H001045,N00029632,Gregg Harper (R),2016,Transportation,29200,34000,63200
H001045,N00029632,Gregg Harper (R),2016,Misc Business,31000,25500,56500
H001045,N00029632,Gregg Harper (R),2016,Ideology/Single-Issue,2000,36600,38600
H001045,N00029632,Gregg Harper (R),2016,Other,25900,0,25900
G000558,N00029675,Brett Guthrie (R),2016,Agribusiness,15350,47500,62850
G000558,N00029675,Brett Guthrie (R),2016,Communic/Electronics,3500,142750,146250
G000558,N00029675,Brett Guthrie (R),2016,Construction,16550,73000,89550
G000558,N00029675,Brett Guthrie (R),2016,Defense,0,21500,21500
G000558,N00029675,Brett Guthrie (R),2016,Energy/Nat Resource,6200,115000,121200
G000558,N00029675,Brett Guthrie (R),2016,Finance/Insur/RealEst,18000,211000,229000
G000558,N00029675,Brett Guthrie (R),2016,Health,26700,562972,589672
G000558,N00029675,Brett Guthrie (R),2016,Lawyers & Lobbyists,62089,21000,83089
G000558,N00029675,Brett Guthrie (R),2016,Transportation,4700,64500,69200
G000558,N00029675,Brett Guthrie (R),2016,Misc Business,15200,146755,161955
G000558,N00029675,Brett Guthrie (R),2016,Labor,0,9500,9500
G000558,N00029675,Brett Guthrie (R),2016,Ideology/Single-Issue,0,26767,26767
G000558,N00029675,Brett Guthrie (R),2016,Other,16150,15000,31150
F000456,N00029679,John Fleming (R),2016,Agribusiness,55392,21500,76892
F000456,N00029679,John Fleming (R),2016,Communic/Electronics,41000,5000,46000
F000456,N00029679,John Fleming (R),2016,Construction,103250,11500,114750
F000456,N00029679,John Fleming (R),2016,Defense,0,22500,22500
F000456,N00029679,John Fleming (R),2016,Energy/Nat Resource,174280,17500,191780
F000456,N00029679,John Fleming (R),2016,Finance/Insur/RealEst,277995,6000,283995
F000456,N00029679,John Fleming (R),2016,Health,280435,41500,321935
F000456,N00029679,John Fleming (R),2016,Lawyers & Lobbyists,62335,3500,65835
F000456,N00029679,John Fleming (R),2016,Transportation,71854,27400,99254
F000456,N00029679,John Fleming (R),2016,Misc Business,149574,13000,162574
F000456,N00029679,John Fleming (R),2016,Ideology/Single-Issue,460350,82000,542350
F000456,N00029679,John Fleming (R),2016,Other,210190,0,210190
H001046,N00029835,Martin Heinrich (D),2016,Agribusiness,60621,40750,101371
H001046,N00029835,Martin Heinrich (D),2016,Communic/Electronics,195594,101250,296844
H001046,N00029835,Martin Heinrich (D),2016,Construction,85922,16000,101922
H001046,N00029835,Martin Heinrich (D),2016,Defense,25760,86000,111760
H001046,N00029835,Martin Heinrich (D),2016,Energy/Nat Resource,142173,178500,320673
H001046,N00029835,Martin Heinrich (D),2016,Finance/Insur/RealEst,365935,165760,531695
H001046,N00029835,Martin Heinrich (D),2016,Health,233831,279500,513331
H001046,N00029835,Martin Heinrich (D),2016,Lawyers & Lobbyists,1084779,95699,1180478
H001046,N00029835,Martin Heinrich (D),2016,Transportation,12050,30000,42050
H001046,N00029835,Martin Heinrich (D),2016,Misc Business,512050,90750,602800
H001046,N00029835,Martin Heinrich (D),2016,Labor,2297,335500,337797
H001046,N00029835,Martin Heinrich (D),2016,Ideology/Single-Issue,596120,422899,1019019
H001046,N00029835,Martin Heinrich (D),2016,Other,972232,17000,989232
C001078,N00029891,Gerry Connolly (D),2016,Agribusiness,0,23000,23000
C001078,N00029891,Gerry Connolly (D),2016,Communic/Electronics,63729,164200,227929
C001078,N00029891,Gerry Connolly (D),2016,Construction,19939,58250,78189
C001078,N00029891,Gerry Connolly (D),2016,Defense,17140,117000,134140
C001078,N00029891,Gerry Connolly (D),2016,Energy/Nat Resource,4900,16250,21150
C001078,N00029891,Gerry Connolly (D),2016,Finance/Insur/RealEst,91644,131000,222644
C001078,N00029891,Gerry Connolly (D),2016,Health,26067,61500,87567
C001078,N00029891,Gerry Connolly (D),2016,Lawyers & Lobbyists,127940,27250,155190
C001078,N00029891,Gerry Connolly (D),2016,Transportation,14320,48500,62820
C001078,N00029891,Gerry Connolly (D),2016,Misc Business,65177,61750,126927
C001078,N00029891,Gerry Connolly (D),2016,Labor,1100,150313,151413
C001078,N00029891,Gerry Connolly (D),2016,Ideology/Single-Issue,74529,38500,113029
C001078,N00029891,Gerry Connolly (D),2016,Other,167909,1000,168909
G000573,N00029908,Joe Garcia (D),2016,Agribusiness,26800,500,27300
G000573,N00029908,Joe Garcia (D),2016,Communic/Electronics,22475,0,22475
G000573,N00029908,Joe Garcia (D),2016,Construction,68101,0,68101
G000573,N00029908,Joe Garcia (D),2016,Defense,500,0,500
G000573,N00029908,Joe Garcia (D),2016,Energy/Nat Resource,8390,0,8390
G000573,N00029908,Joe Garcia (D),2016,Finance/Insur/RealEst,140448,-1000,139448
G000573,N00029908,Joe Garcia (D),2016,Health,36937,10000,46937
G000573,N00029908,Joe Garcia (D),2016,Lawyers & Lobbyists,194836,1000,195836
G000573,N00029908,Joe Garcia (D),2016,Transportation,4815,0,4815
G000573,N00029908,Joe Garcia (D),2016,Misc Business,93051,0,93051
G000573,N00029908,Joe Garcia (D),2016,Labor,0,49500,49500
G000573,N00029908,Joe Garcia (D),2016,Ideology/Single-Issue,88714,213588,302302
G000573,N00029908,Joe Garcia (D),2016,Other,91112,0,91112
H001051,N00030197,Richard Hanna (R),2016,Agribusiness,0,10750,10750
H001051,N00030197,Richard Hanna (R),2016,Communic/Electronics,0,5500,5500
H001051,N00030197,Richard Hanna (R),2016,Construction,1000,53000,54000
H001051,N00030197,Richard Hanna (R),2016,Defense,0,2000,2000
H001051,N00030197,Richard Hanna (R),2016,Energy/Nat Resource,0,4000,4000
H001051,N00030197,Richard Hanna (R),2016,Finance/Insur/RealEst,20400,19000,39400
H001051,N00030197,Richard Hanna (R),2016,Health,1000,20500,21500
H001051,N00030197,Richard Hanna (R),2016,Lawyers & Lobbyists,10200,2000,12200
H001051,N00030197,Richard Hanna (R),2016,Transportation,500,47000,47500
H001051,N00030197,Richard Hanna (R),2016,Misc Business,3950,19500,23450
H001051,N00030197,Richard Hanna (R),2016,Labor,0,37000,37000
H001051,N00030197,Richard Hanna (R),2016,Ideology/Single-Issue,2950,22750,25700
H001051,N00030197,Richard Hanna (R),2016,Other,750,1000,1750
C001075,N00030245,Bill Cassidy (R),2016,Agribusiness,263025,111300,374325
C001075,N00030245,Bill Cassidy (R),2016,Communic/Electronics,212774,47750,260524
C001075,N00030245,Bill Cassidy (R),2016,Construction,507825,50300,558125
C001075,N00030245,Bill Cassidy (R),2016,Defense,4600,4500,9100
C001075,N00030245,Bill Cassidy (R),2016,Energy/Nat Resource,968420,208500,1176920
C001075,N00030245,Bill Cassidy (R),2016,Finance/Insur/RealEst,2064530,154175,2218705
C001075,N00030245,Bill Cassidy (R),2016,Health,1240190,638206,1878396
C001075,N00030245,Bill Cassidy (R),2016,Lawyers & Lobbyists,427473,30500,457973
C001075,N00030245,Bill Cassidy (R),2016,Transportation,441890,124250,566140
C001075,N00030245,Bill Cassidy (R),2016,Misc Business,997386,171100,1168486
C001075,N00030245,Bill Cassidy (R),2016,Labor,0,10918,10918
C001075,N00030245,Bill Cassidy (R),2016,Ideology/Single-Issue,377355,793299,1170654
C001075,N00030245,Bill Cassidy (R),2016,Other,1300613,6500,1307113
F000455,N00030490,Marcia L Fudge (D),2016,Agribusiness,4500,99500,104000
F000455,N00030490,Marcia L Fudge (D),2016,Communic/Electronics,0,27000,27000
F000455,N00030490,Marcia L Fudge (D),2016,Construction,5200,2500,7700
F000455,N00030490,Marcia L Fudge (D),2016,Defense,0,8000,8000
F000455,N00030490,Marcia L Fudge (D),2016,Energy/Nat Resource,-1600,43000,41400
F000455,N00030490,Marcia L Fudge (D),2016,Finance/Insur/RealEst,2250,83500,85750
F000455,N00030490,Marcia L Fudge (D),2016,Health,1300,34000,35300
F000455,N00030490,Marcia L Fudge (D),2016,Lawyers & Lobbyists,14281,23000,37281
F000455,N00030490,Marcia L Fudge (D),2016,Transportation,0,25000,25000
F000455,N00030490,Marcia L Fudge (D),2016,Misc Business,4350,67884,72234
F000455,N00030490,Marcia L Fudge (D),2016,Labor,7000,180750,187750
F000455,N00030490,Marcia L Fudge (D),2016,Ideology/Single-Issue,576,30881,31457
F000455,N00030490,Marcia L Fudge (D),2016,Other,8902,5000,13902
C001080,N00030600,Judy Chu (D),2016,Agribusiness,11350,14200,25550
C001080,N00030600,Judy Chu (D),2016,Communic/Electronics,37257,68200,105457
C001080,N00030600,Judy Chu (D),2016,Construction,6750,4750,11500
C001080,N00030600,Judy Chu (D),2016,Defense,0,6000,6000
C001080,N00030600,Judy Chu (D),2016,Energy/Nat Resource,9050,2000,11050
C001080,N00030600,Judy Chu (D),2016,Finance/Insur/RealEst,87550,33500,121050
C001080,N00030600,Judy Chu (D),2016,Health,40800,47000,87800
C001080,N00030600,Judy Chu (D),2016,Lawyers & Lobbyists,52050,16000,68050
C001080,N00030600,Judy Chu (D),2016,Transportation,4150,3500,7650
C001080,N00030600,Judy Chu (D),2016,Misc Business,42380,28000,70380
C001080,N00030600,Judy Chu (D),2016,Labor,0,173500,173500
C001080,N00030600,Judy Chu (D),2016,Ideology/Single-Issue,27251,16450,43701
C001080,N00030600,Judy Chu (D),2016,Other,53000,500,53500
B001267,N00030608,Michael F Bennet (D),2016,Agribusiness,173711,242500,416211
B001267,N00030608,Michael F Bennet (D),2016,Communic/Electronics,974751,240700,1215451
B001267,N00030608,Michael F Bennet (D),2016,Construction,195963,65000,260963
B001267,N00030608,Michael F Bennet (D),2016,Defense,12606,82000,94606
B001267,N00030608,Michael F Bennet (D),2016,Energy/Nat Resource,185978,244400,430378
B001267,N00030608,Michael F Bennet (D),2016,Finance/Insur/RealEst,3383269,810356,4193625
B001267,N00030608,Michael F Bennet (D),2016,Health,716101,735400,1451501
B001267,N00030608,Michael F Bennet (D),2016,Lawyers & Lobbyists,2190217,253912,2444129
B001267,N00030608,Michael F Bennet (D),2016,Transportation,46871,66000,112871
B001267,N00030608,Michael F Bennet (D),2016,Misc Business,885103,301650,1186753
B001267,N00030608,Michael F Bennet (D),2016,Labor,3652,166350,170002
B001267,N00030608,Michael F Bennet (D),2016,Ideology/Single-Issue,1804905,594831,2399736
B001267,N00030608,Michael F Bennet (D),2016,Other,1961223,37500,1998723
H001058,N00030673,Bill Huizenga (R),2016,Agribusiness,6100,16500,22600
H001058,N00030673,Bill Huizenga (R),2016,Communic/Electronics,2000,13000,15000
H001058,N00030673,Bill Huizenga (R),2016,Construction,6450,30250,36700
H001058,N00030673,Bill Huizenga (R),2016,Defense,0,10000,10000
H001058,N00030673,Bill Huizenga (R),2016,Energy/Nat Resource,1300,40500,41800
H001058,N00030673,Bill Huizenga (R),2016,Finance/Insur/RealEst,106100,545500,651600
H001058,N00030673,Bill Huizenga (R),2016,Health,6045,17600,23645
H001058,N00030673,Bill Huizenga (R),2016,Lawyers & Lobbyists,28000,29750,57750
H001058,N00030673,Bill Huizenga (R),2016,Transportation,8700,29200,37900
H001058,N00030673,Bill Huizenga (R),2016,Misc Business,89750,37551,127301
H001058,N00030673,Bill Huizenga (R),2016,Labor,0,2000,2000
H001058,N00030673,Bill Huizenga (R),2016,Ideology/Single-Issue,13900,34927,48827
H001058,N00030673,Bill Huizenga (R),2016,Other,30475,0,30475
D000617,N00030693,Suzan DelBene (D),2016,Agribusiness,3175,119000,122175
D000617,N00030693,Suzan DelBene (D),2016,Communic/Electronics,140357,154284,294641
D000617,N00030693,Suzan DelBene (D),2016,Construction,18905,10702,29607
D000617,N00030693,Suzan DelBene (D),2016,Defense,1566,30500,32066
D000617,N00030693,Suzan DelBene (D),2016,Energy/Nat Resource,12590,29000,41590
D000617,N00030693,Suzan DelBene (D),2016,Finance/Insur/RealEst,54105,143000,197105
D000617,N00030693,Suzan DelBene (D),2016,Health,26874,81236,108110
D000617,N00030693,Suzan DelBene (D),2016,Lawyers & Lobbyists,77498,23000,100498
D000617,N00030693,Suzan DelBene (D),2016,Transportation,1782,37000,38782
D000617,N00030693,Suzan DelBene (D),2016,Misc Business,111974,113600,225574
D000617,N00030693,Suzan DelBene (D),2016,Labor,0,68500,68500
D000617,N00030693,Suzan DelBene (D),2016,Ideology/Single-Issue,182253,82887,265140
D000617,N00030693,Suzan DelBene (D),2016,Other,152688,0,152688
D000623,N00030709,Mark Desaulnier (D),2016,Agribusiness,1000,18000,19000
D000623,N00030709,Mark Desaulnier (D),2016,Communic/Electronics,2725,9000,11725
D000623,N00030709,Mark Desaulnier (D),2016,Construction,38355,8500,46855
D000623,N00030709,Mark Desaulnier (D),2016,Defense,0,7500,7500
D000623,N00030709,Mark Desaulnier (D),2016,Energy/Nat Resource,410,10000,10410
D000623,N00030709,Mark Desaulnier (D),2016,Finance/Insur/RealEst,61540,17500,79040
D000623,N00030709,Mark Desaulnier (D),2016,Health,5629,6500,12129
D000623,N00030709,Mark Desaulnier (D),2016,Lawyers & Lobbyists,38505,8500,47005
D000623,N00030709,Mark Desaulnier (D),2016,Transportation,125,12500,12625
D000623,N00030709,Mark Desaulnier (D),2016,Misc Business,16750,10500,27250
D000623,N00030709,Mark Desaulnier (D),2016,Labor,0,170625,170625
D000623,N00030709,Mark Desaulnier (D),2016,Ideology/Single-Issue,24920,19750,44670
D000623,N00030709,Mark Desaulnier (D),2016,Other,38188,2500,40688
B001287,N00030717,Ami Bera (D),2016,Agribusiness,25317,85500,110817
B001287,N00030717,Ami Bera (D),2016,Communic/Electronics,116784,80135,196919
B001287,N00030717,Ami Bera (D),2016,Construction,35032,9000,44032
B001287,N00030717,Ami Bera (D),2016,Defense,9700,29500,39200
B001287,N00030717,Ami Bera (D),2016,Energy/Nat Resource,26050,12700,38750
B001287,N00030717,Ami Bera (D),2016,Finance/Insur/RealEst,319345,168000,487345
B001287,N00030717,Ami Bera (D),2016,Health,178440,392400,570840
B001287,N00030717,Ami Bera (D),2016,Lawyers & Lobbyists,153730,17685,171415
B001287,N00030717,Ami Bera (D),2016,Transportation,2911,20000,22911
B001287,N00030717,Ami Bera (D),2016,Misc Business,120983,107500,228483
B001287,N00030717,Ami Bera (D),2016,Labor,15,37351,37366
B001287,N00030717,Ami Bera (D),2016,Ideology/Single-Issue,472667,422866,895533
B001287,N00030717,Ami Bera (D),2016,Other,529863,1500,531363
C001083,N00030736,John Carney (D),2016,Agribusiness,250,1200,1450
C001083,N00030736,John Carney (D),2016,Communic/Electronics,0,1000,1000
C001083,N00030736,John Carney (D),2016,Construction,1000,0,1000
C001083,N00030736,John Carney (D),2016,Defense,0,1000,1000
C001083,N00030736,John Carney (D),2016,Energy/Nat Resource,0,5000,5000
C001083,N00030736,John Carney (D),2016,Finance/Insur/RealEst,10050,154500,164550
C001083,N00030736,John Carney (D),2016,Health,1250,24500,25750
C001083,N00030736,John Carney (D),2016,Lawyers & Lobbyists,16400,6000,22400
C001083,N00030736,John Carney (D),2016,Transportation,250,1000,1250
C001083,N00030736,John Carney (D),2016,Misc Business,3000,5234,8234
C001083,N00030736,John Carney (D),2016,Labor,0,5000,5000
C001083,N00030736,John Carney (D),2016,Ideology/Single-Issue,500,13000,13500
C001083,N00030736,John Carney (D),2016,Other,5250,0,5250
D000615,N00030752,Jeff Duncan (R),2016,Agribusiness,3814,17000,20814
D000615,N00030752,Jeff Duncan (R),2016,Communic/Electronics,6510,11500,18010
D000615,N00030752,Jeff Duncan (R),2016,Construction,2264,8000,10264
D000615,N00030752,Jeff Duncan (R),2016,Defense,0,10000,10000
D000615,N00030752,Jeff Duncan (R),2016,Energy/Nat Resource,5730,69500,75230
D000615,N00030752,Jeff Duncan (R),2016,Finance/Insur/RealEst,38828,43000,81828
D000615,N00030752,Jeff Duncan (R),2016,Health,6002,48200,54202
D000615,N00030752,Jeff Duncan (R),2016,Lawyers & Lobbyists,12750,13750,26500
D000615,N00030752,Jeff Duncan (R),2016,Transportation,600,14000,14600
D000615,N00030752,Jeff Duncan (R),2016,Misc Business,8492,30750,39242
D000615,N00030752,Jeff Duncan (R),2016,Ideology/Single-Issue,16500,77165,93665
D000615,N00030752,Jeff Duncan (R),2016,Other,45347,0,45347
C001087,N00030770,Rick Crawford (R),2016,Agribusiness,77250,172500,249750
C001087,N00030770,Rick Crawford (R),2016,Communic/Electronics,250,16000,16250
C001087,N00030770,Rick Crawford (R),2016,Construction,19800,22500,42300
C001087,N00030770,Rick Crawford (R),2016,Defense,0,1000,1000
C001087,N00030770,Rick Crawford (R),2016,Energy/Nat Resource,2250,12000,14250
C001087,N00030770,Rick Crawford (R),2016,Finance/Insur/RealEst,18700,34000,52700
C001087,N00030770,Rick Crawford (R),2016,Health,20400,21500,41900
C001087,N00030770,Rick Crawford (R),2016,Lawyers & Lobbyists,7700,4000,11700
C001087,N00030770,Rick Crawford (R),2016,Transportation,6500,54500,61000
C001087,N00030770,Rick Crawford (R),2016,Misc Business,13100,32000,45100
C001087,N00030770,Rick Crawford (R),2016,Ideology/Single-Issue,0,23100,23100
C001087,N00030770,Rick Crawford (R),2016,Other,21049,500,21549
G000565,N00030771,Paul Gosar (R),2016,Agribusiness,12699,11764,24463
G000565,N00030771,Paul Gosar (R),2016,Communic/Electronics,3000,5000,8000
G000565,N00030771,Paul Gosar (R),2016,Construction,11900,12000,23900
G000565,N00030771,Paul Gosar (R),2016,Defense,0,1000,1000
G000565,N00030771,Paul Gosar (R),2016,Energy/Nat Resource,9800,67500,77300
G000565,N00030771,Paul Gosar (R),2016,Finance/Insur/RealEst,21100,7000,28100
G000565,N00030771,Paul Gosar (R),2016,Health,112650,80813,193463
G000565,N00030771,Paul Gosar (R),2016,Lawyers & Lobbyists,25950,3250,29200
G000565,N00030771,Paul Gosar (R),2016,Transportation,17600,13500,31100
G000565,N00030771,Paul Gosar (R),2016,Misc Business,28750,5500,34250
G000565,N00030771,Paul Gosar (R),2016,Labor,0,1000,1000
G000565,N00030771,Paul Gosar (R),2016,Ideology/Single-Issue,22532,58134,80666
G000565,N00030771,Paul Gosar (R),2016,Other,32150,0,32150
G000562,N00030780,Cory Gardner (R),2016,Agribusiness,357582,251800,609382
G000562,N00030780,Cory Gardner (R),2016,Communic/Electronics,212398,269200,481598
G000562,N00030780,Cory Gardner (R),2016,Construction,289722,89600,379322
G000562,N00030780,Cory Gardner (R),2016,Defense,17900,36000,53900
G000562,N00030780,Cory Gardner (R),2016,Energy/Nat Resource,721413,483450,1204863
G000562,N00030780,Cory Gardner (R),2016,Finance/Insur/RealEst,1868108,244100,2112208
G000562,N00030780,Cory Gardner (R),2016,Health,234258,246500,480758
G000562,N00030780,Cory Gardner (R),2016,Lawyers & Lobbyists,427798,40440,468238
G000562,N00030780,Cory Gardner (R),2016,Transportation,157790,93000,250790
G000562,N00030780,Cory Gardner (R),2016,Misc Business,755671,324207,1079878
G000562,N00030780,Cory Gardner (R),2016,Labor,0,14500,14500
G000562,N00030780,Cory Gardner (R),2016,Ideology/Single-Issue,415659,550579,966238
G000562,N00030780,Cory Gardner (R),2016,Other,1584616,32500,1617116
G000560,N00030788,Tom Graves (R),2016,Agribusiness,9400,59000,68400
G000560,N00030788,Tom Graves (R),2016,Communic/Electronics,3000,62930,65930
G000560,N00030788,Tom Graves (R),2016,Construction,19800,30500,50300
G000560,N00030788,Tom Graves (R),2016,Defense,7400,77000,84400
G000560,N00030788,Tom Graves (R),2016,Energy/Nat Resource,14300,35000,49300
G000560,N00030788,Tom Graves (R),2016,Finance/Insur/RealEst,68600,292999,361599
G000560,N00030788,Tom Graves (R),2016,Health,19850,22000,41850
G000560,N00030788,Tom Graves (R),2016,Lawyers & Lobbyists,65374,18750,84124
G000560,N00030788,Tom Graves (R),2016,Transportation,26600,41000,67600
G000560,N00030788,Tom Graves (R),2016,Misc Business,106900,110726,217626
G000560,N00030788,Tom Graves (R),2016,Labor,0,5000,5000
G000560,N00030788,Tom Graves (R),2016,Ideology/Single-Issue,9850,50648,60498
G000560,N00030788,Tom Graves (R),2016,Other,33348,0,33348
G000570,N00030801,Frank Guinta (R),2016,Agribusiness,6200,2000,8200
G000570,N00030801,Frank Guinta (R),2016,Communic/Electronics,7800,20000,27800
G000570,N00030801,Frank Guinta (R),2016,Construction,23250,28000,51250
G000570,N00030801,Frank Guinta (R),2016,Defense,1000,17000,18000
G000570,N00030801,Frank Guinta (R),2016,Energy/Nat Resource,16100,33000,49100
G000570,N00030801,Frank Guinta (R),2016,Finance/Insur/RealEst,186675,254952,441627
G000570,N00030801,Frank Guinta (R),2016,Health,13050,9600,22650
G000570,N00030801,Frank Guinta (R),2016,Lawyers & Lobbyists,33060,4000,37060
G000570,N00030801,Frank Guinta (R),2016,Transportation,15250,30000,45250
G000570,N00030801,Frank Guinta (R),2016,Misc Business,118295,47498,165793
G000570,N00030801,Frank Guinta (R),2016,Labor,0,3000,3000
G000570,N00030801,Frank Guinta (R),2016,Ideology/Single-Issue,35460,324606,360066
G000570,N00030801,Frank Guinta (R),2016,Other,75630,0,75630
F000459,N00030815,Chuck Fleischmann (R),2016,Agribusiness,33500,41700,75200
F000459,N00030815,Chuck Fleischmann (R),2016,Communic/Electronics,15450,16500,31950
F000459,N00030815,Chuck Fleischmann (R),2016,Construction,96350,57000,153350
F000459,N00030815,Chuck Fleischmann (R),2016,Defense,5750,47500,53250
F000459,N00030815,Chuck Fleischmann (R),2016,Energy/Nat Resource,18500,59500,78000
F000459,N00030815,Chuck Fleischmann (R),2016,Finance/Insur/RealEst,157750,90000,247750
F000459,N00030815,Chuck Fleischmann (R),2016,Health,77150,85000,162150
F000459,N00030815,Chuck Fleischmann (R),2016,Lawyers & Lobbyists,44150,13250,57400
F000459,N00030815,Chuck Fleischmann (R),2016,Transportation,16200,60000,76200
F000459,N00030815,Chuck Fleischmann (R),2016,Misc Business,91550,62800,154350
F000459,N00030815,Chuck Fleischmann (R),2016,Labor,0,14000,14000
F000459,N00030815,Chuck Fleischmann (R),2016,Ideology/Single-Issue,3700,94300,98000
F000459,N00030815,Chuck Fleischmann (R),2016,Other,69300,2000,71300
B001297,N00030829,Kenneth R Buck (R),2016,Agribusiness,27450,27901,55351
B001297,N00030829,Kenneth R Buck (R),2016,Communic/Electronics,14250,47500,61750
B001297,N00030829,Kenneth R Buck (R),2016,Construction,27450,16000,43450
B001297,N00030829,Kenneth R Buck (R),2016,Defense,0,10000,10000
B001297,N00030829,Kenneth R Buck (R),2016,Energy/Nat Resource,20900,61500,82400
B001297,N00030829,Kenneth R Buck (R),2016,Finance/Insur/RealEst,85267,25000,110267
B001297,N00030829,Kenneth R Buck (R),2016,Health,7700,4500,12200
B001297,N00030829,Kenneth R Buck (R),2016,Lawyers & Lobbyists,21800,5000,26800
B001297,N00030829,Kenneth R Buck (R),2016,Transportation,16500,26500,43000
B001297,N00030829,Kenneth R Buck (R),2016,Misc Business,31375,33998,65373
B001297,N00030829,Kenneth R Buck (R),2016,Ideology/Single-Issue,26066,45241,71307
B001297,N00030829,Kenneth R Buck (R),2016,Other,67276,0,67276
G000559,N00030856,John Garamendi (D),2016,Agribusiness,47555,52433,99988
G000559,N00030856,John Garamendi (D),2016,Communic/Electronics,16420,20000,36420
G000559,N00030856,John Garamendi (D),2016,Construction,12800,14750,27550
G000559,N00030856,John Garamendi (D),2016,Defense,0,54000,54000
G000559,N00030856,John Garamendi (D),2016,Energy/Nat Resource,8270,15500,23770
G000559,N00030856,John Garamendi (D),2016,Finance/Insur/RealEst,66667,52000,118667
G000559,N00030856,John Garamendi (D),2016,Health,17460,14500,31960
G000559,N00030856,John Garamendi (D),2016,Lawyers & Lobbyists,45962,30500,76462
G000559,N00030856,John Garamendi (D),2016,Transportation,6570,84000,90570
G000559,N00030856,John Garamendi (D),2016,Misc Business,37720,32600,70320
G000559,N00030856,John Garamendi (D),2016,Labor,1080,236550,237630
G000559,N00030856,John Garamendi (D),2016,Ideology/Single-Issue,30864,29617,60481
G000559,N00030856,John Garamendi (D),2016,Other,35254,5000,40254
G000566,N00030880,Trey Gowdy (R),2016,Agribusiness,5175,5500,10675
G000566,N00030880,Trey Gowdy (R),2016,Communic/Electronics,14900,29710,44610
G000566,N00030880,Trey Gowdy (R),2016,Construction,18185,13000,31185
G000566,N00030880,Trey Gowdy (R),2016,Defense,2150,4000,6150
G000566,N00030880,Trey Gowdy (R),2016,Energy/Nat Resource,16600,27000,43600
G000566,N00030880,Trey Gowdy (R),2016,Finance/Insur/RealEst,78585,99900,178485
G000566,N00030880,Trey Gowdy (R),2016,Health,37941,14000,51941
G000566,N00030880,Trey Gowdy (R),2016,Lawyers & Lobbyists,44845,4000,48845
G000566,N00030880,Trey Gowdy (R),2016,Transportation,18600,18500,37100
G000566,N00030880,Trey Gowdy (R),2016,Misc Business,49450,46700,96150
G000566,N00030880,Trey Gowdy (R),2016,Labor,0,1000,1000
G000566,N00030880,Trey Gowdy (R),2016,Ideology/Single-Issue,79111,53793,132904
G000566,N00030880,Trey Gowdy (R),2016,Other,180446,100,180546
B001274,N00030910,Mo Brooks (R),2016,Agribusiness,7250,25500,32750
B001274,N00030910,Mo Brooks (R),2016,Communic/Electronics,16500,4000,20500
B001274,N00030910,Mo Brooks (R),2016,Construction,11900,10000,21900
B001274,N00030910,Mo Brooks (R),2016,Defense,24250,87533,111783
B001274,N00030910,Mo Brooks (R),2016,Energy/Nat Resource,0,8500,8500
B001274,N00030910,Mo Brooks (R),2016,Finance/Insur/RealEst,37750,35000,72750
B001274,N00030910,Mo Brooks (R),2016,Health,17350,21000,38350
B001274,N00030910,Mo Brooks (R),2016,Lawyers & Lobbyists,9200,14000,23200
B001274,N00030910,Mo Brooks (R),2016,Transportation,1300,8500,9800
B001274,N00030910,Mo Brooks (R),2016,Misc Business,14350,15000,29350
B001274,N00030910,Mo Brooks (R),2016,Labor,0,3000,3000
B001274,N00030910,Mo Brooks (R),2016,Ideology/Single-Issue,0,19800,19800
B001274,N00030910,Mo Brooks (R),2016,Other,19826,1000,20826
D000616,N00030957,Scott Desjarlais (R),2016,Agribusiness,26450,29000,55450
D000616,N00030957,Scott Desjarlais (R),2016,Communic/Electronics,3900,4000,7900
D000616,N00030957,Scott Desjarlais (R),2016,Construction,16350,2500,18850
D000616,N00030957,Scott Desjarlais (R),2016,Defense,1000,0,1000
D000616,N00030957,Scott Desjarlais (R),2016,Energy/Nat Resource,8450,3000,11450
D000616,N00030957,Scott Desjarlais (R),2016,Finance/Insur/RealEst,58500,18500,77000
D000616,N00030957,Scott Desjarlais (R),2016,Health,51600,15000,66600
D000616,N00030957,Scott Desjarlais (R),2016,Lawyers & Lobbyists,29650,0,29650
D000616,N00030957,Scott Desjarlais (R),2016,Transportation,8400,17250,25650
D000616,N00030957,Scott Desjarlais (R),2016,Misc Business,47650,17984,65634
D000616,N00030957,Scott Desjarlais (R),2016,Labor,0,1000,1000
D000616,N00030957,Scott Desjarlais (R),2016,Ideology/Single-Issue,10500,85100,95600
D000616,N00030957,Scott Desjarlais (R),2016,Other,53384,0,53384
D000614,N00030967,Sean P Duffy (R),2016,Agribusiness,39345,51750,91095
D000614,N00030967,Sean P Duffy (R),2016,Communic/Electronics,26400,42500,68900
D000614,N00030967,Sean P Duffy (R),2016,Construction,21500,25000,46500
D000614,N00030967,Sean P Duffy (R),2016,Defense,1000,8000,9000
D000614,N00030967,Sean P Duffy (R),2016,Energy/Nat Resource,14895,59000,73895
D000614,N00030967,Sean P Duffy (R),2016,Finance/Insur/RealEst,205127,686894,892021
D000614,N00030967,Sean P Duffy (R),2016,Health,28750,57050,85800
D000614,N00030967,Sean P Duffy (R),2016,Lawyers & Lobbyists,63369,24750,88119
D000614,N00030967,Sean P Duffy (R),2016,Transportation,21000,55500,76500
D000614,N00030967,Sean P Duffy (R),2016,Misc Business,115565,74500,190065
D000614,N00030967,Sean P Duffy (R),2016,Labor,0,30500,30500
D000614,N00030967,Sean P Duffy (R),2016,Ideology/Single-Issue,60543,71445,131988
D000614,N00030967,Sean P Duffy (R),2016,Other,183304,0,183304
A000368,N00030980,Kelly Ayotte (R),2016,Agribusiness,186532,146147,332679
A000368,N00030980,Kelly Ayotte (R),2016,Communic/Electronics,392400,468544,860944
A000368,N00030980,Kelly Ayotte (R),2016,Construction,238218,126750,364968
A000368,N00030980,Kelly Ayotte (R),2016,Defense,96240,257400,353640
A000368,N00030980,Kelly Ayotte (R),2016,Energy/Nat Resource,302917,368000,670917
A000368,N00030980,Kelly Ayotte (R),2016,Finance/Insur/RealEst,2795481,735140,3530621
A000368,N00030980,Kelly Ayotte (R),2016,Health,412556,564999,977555
A000368,N00030980,Kelly Ayotte (R),2016,Lawyers & Lobbyists,883581,195811,1079392
A000368,N00030980,Kelly Ayotte (R),2016,Transportation,382395,452599,834994
A000368,N00030980,Kelly Ayotte (R),2016,Misc Business,1035333,564099,1599432
A000368,N00030980,Kelly Ayotte (R),2016,Labor,0,91625,91625
A000368,N00030980,Kelly Ayotte (R),2016,Ideology/Single-Issue,852658,845082,1697740
A000368,N00030980,Kelly Ayotte (R),2016,Other,2275284,14000,2289284
H001053,N00031005,Vicky Hartzler (R),2016,Agribusiness,42175,118700,160875
H001053,N00031005,Vicky Hartzler (R),2016,Communic/Electronics,8000,14500,22500
H001053,N00031005,Vicky Hartzler (R),2016,Construction,25350,13000,38350
H001053,N00031005,Vicky Hartzler (R),2016,Defense,5000,82500,87500
H001053,N00031005,Vicky Hartzler (R),2016,Energy/Nat Resource,8400,29000,37400
H001053,N00031005,Vicky Hartzler (R),2016,Finance/Insur/RealEst,70050,36500,106550
H001053,N00031005,Vicky Hartzler (R),2016,Health,34960,22000,56960
H001053,N00031005,Vicky Hartzler (R),2016,Lawyers & Lobbyists,28830,8750,37580
H001053,N00031005,Vicky Hartzler (R),2016,Transportation,9350,17500,26850
H001053,N00031005,Vicky Hartzler (R),2016,Misc Business,61350,27000,88350
H001053,N00031005,Vicky Hartzler (R),2016,Ideology/Single-Issue,9999,52429,62428
H001053,N00031005,Vicky Hartzler (R),2016,Other,74994,0,74994
C001106,N00031064,Ryan Costello (R),2016,Agribusiness,17150,20500,37650
C001106,N00031064,Ryan Costello (R),2016,Communic/Electronics,21550,58500,80050
C001106,N00031064,Ryan Costello (R),2016,Construction,61040,73442,134482
C001106,N00031064,Ryan Costello (R),2016,Defense,0,5000,5000
C001106,N00031064,Ryan Costello (R),2016,Energy/Nat Resource,9750,84000,93750
C001106,N00031064,Ryan Costello (R),2016,Finance/Insur/RealEst,162040,161950,323990
C001106,N00031064,Ryan Costello (R),2016,Health,64300,262600,326900
C001106,N00031064,Ryan Costello (R),2016,Lawyers & Lobbyists,136664,35733,172397
C001106,N00031064,Ryan Costello (R),2016,Transportation,40450,128998,169448
C001106,N00031064,Ryan Costello (R),2016,Misc Business,53950,150367,204317
C001106,N00031064,Ryan Costello (R),2016,Labor,0,102239,102239
C001106,N00031064,Ryan Costello (R),2016,Ideology/Single-Issue,47950,323452,371402
C001106,N00031064,Ryan Costello (R),2016,Other,82050,0,82050
D000613,N00031103,Bob Dold (R),2016,Agribusiness,28165,48885,77050
D000613,N00031103,Bob Dold (R),2016,Communic/Electronics,36950,70000,106950
D000613,N00031103,Bob Dold (R),2016,Construction,49425,89000,138425
D000613,N00031103,Bob Dold (R),2016,Defense,30860,34500,65360
D000613,N00031103,Bob Dold (R),2016,Energy/Nat Resource,26850,99250,126100
D000613,N00031103,Bob Dold (R),2016,Finance/Insur/RealEst,845841,601191,1447032
D000613,N00031103,Bob Dold (R),2016,Health,133774,287450,421224
D000613,N00031103,Bob Dold (R),2016,Lawyers & Lobbyists,299590,31000,330590
D000613,N00031103,Bob Dold (R),2016,Transportation,39925,99495,139420
D000613,N00031103,Bob Dold (R),2016,Misc Business,303028,275504,578532
D000613,N00031103,Bob Dold (R),2016,Labor,0,71500,71500
D000613,N00031103,Bob Dold (R),2016,Ideology/Single-Issue,172735,557921,730656
D000613,N00031103,Bob Dold (R),2016,Other,493737,4700,498437
H001059,N00031104,Randy Hultgren (R),2016,Agribusiness,12250,32907,45157
H001059,N00031104,Randy Hultgren (R),2016,Communic/Electronics,2935,14100,17035
H001059,N00031104,Randy Hultgren (R),2016,Construction,13050,39000,52050
H001059,N00031104,Randy Hultgren (R),2016,Defense,0,29000,29000
H001059,N00031104,Randy Hultgren (R),2016,Energy/Nat Resource,10000,40500,50500
H001059,N00031104,Randy Hultgren (R),2016,Finance/Insur/RealEst,71050,466000,537050
H001059,N00031104,Randy Hultgren (R),2016,Health,6250,32600,38850
H001059,N00031104,Randy Hultgren (R),2016,Lawyers & Lobbyists,25320,6750,32070
H001059,N00031104,Randy Hultgren (R),2016,Transportation,1500,32200,33700
H001059,N00031104,Randy Hultgren (R),2016,Misc Business,35200,50000,85200
H001059,N00031104,Randy Hultgren (R),2016,Labor,0,26000,26000
H001059,N00031104,Randy Hultgren (R),2016,Ideology/Single-Issue,10260,102950,113210
H001059,N00031104,Randy Hultgren (R),2016,Other,28575,0,28575
G000563,N00031128,Bob Gibbs (R),2016,Agribusiness,13650,119000,132650
G000563,N00031128,Bob Gibbs (R),2016,Communic/Electronics,23100,9500,32600
G000563,N00031128,Bob Gibbs (R),2016,Construction,30350,75000,105350
G000563,N00031128,Bob Gibbs (R),2016,Energy/Nat Resource,5700,80750,86450
G000563,N00031128,Bob Gibbs (R),2016,Finance/Insur/RealEst,14950,45700,60650
G000563,N00031128,Bob Gibbs (R),2016,Health,9900,9500,19400
G000563,N00031128,Bob Gibbs (R),2016,Lawyers & Lobbyists,15487,13000,28487
G000563,N00031128,Bob Gibbs (R),2016,Transportation,17850,103999,121849
G000563,N00031128,Bob Gibbs (R),2016,Misc Business,41888,71500,113388
G000563,N00031128,Bob Gibbs (R),2016,Labor,0,43000,43000
G000563,N00031128,Bob Gibbs (R),2016,Ideology/Single-Issue,2750,42691,45441
G000563,N00031128,Bob Gibbs (R),2016,Other,17700,1000,18700
F000458,N00031141,Steve Fincher (R),2016,Agribusiness,0,64500,64500
F000458,N00031141,Steve Fincher (R),2016,Communic/Electronics,2500,7500,10000
F000458,N00031141,Steve Fincher (R),2016,Construction,0,10000,10000
F000458,N00031141,Steve Fincher (R),2016,Defense,0,15500,15500
F000458,N00031141,Steve Fincher (R),2016,Energy/Nat Resource,0,21500,21500
F000458,N00031141,Steve Fincher (R),2016,Finance/Insur/RealEst,7400,232952,240352
F000458,N00031141,Steve Fincher (R),2016,Health,0,15500,15500
F000458,N00031141,Steve Fincher (R),2016,Lawyers & Lobbyists,6500,4000,10500
F000458,N00031141,Steve Fincher (R),2016,Transportation,5400,6000,11400
F000458,N00031141,Steve Fincher (R),2016,Misc Business,2000,38158,40158
F000458,N00031141,Steve Fincher (R),2016,Labor,0,8000,8000
F000458,N00031141,Steve Fincher (R),2016,Ideology/Single-Issue,0,30500,30500
F000458,N00031141,Steve Fincher (R),2016,Other,500,0,500
A000369,N00031177,Mark Amodei (R),2016,Agribusiness,8700,23569,32269
A000369,N00031177,Mark Amodei (R),2016,Communic/Electronics,15850,28135,43985
A000369,N00031177,Mark Amodei (R),2016,Construction,23350,35000,58350
A000369,N00031177,Mark Amodei (R),2016,Defense,400,32000,32400
A000369,N00031177,Mark Amodei (R),2016,Energy/Nat Resource,4000,49200,53200
A000369,N00031177,Mark Amodei (R),2016,Finance/Insur/RealEst,28500,42000,70500
A000369,N00031177,Mark Amodei (R),2016,Health,20250,30600,50850
A000369,N00031177,Mark Amodei (R),2016,Lawyers & Lobbyists,40200,13750,53950
A000369,N00031177,Mark Amodei (R),2016,Transportation,17450,38250,55700
A000369,N00031177,Mark Amodei (R),2016,Misc Business,49950,69550,119500
A000369,N00031177,Mark Amodei (R),2016,Labor,0,6000,6000
A000369,N00031177,Mark Amodei (R),2016,Ideology/Single-Issue,21200,28849,50049
A000369,N00031177,Mark Amodei (R),2016,Other,64800,0,64800
B001275,N00031227,Larry Bucshon (R),2016,Agribusiness,6050,37700,43750
B001275,N00031227,Larry Bucshon (R),2016,Communic/Electronics,1600,46500,48100
B001275,N00031227,Larry Bucshon (R),2016,Construction,21850,18000,39850
B001275,N00031227,Larry Bucshon (R),2016,Defense,5200,13500,18700
B001275,N00031227,Larry Bucshon (R),2016,Energy/Nat Resource,20300,70399,90699
B001275,N00031227,Larry Bucshon (R),2016,Finance/Insur/RealEst,27500,42800,70300
B001275,N00031227,Larry Bucshon (R),2016,Health,67175,274825,342000
B001275,N00031227,Larry Bucshon (R),2016,Lawyers & Lobbyists,30164,16500,46664
B001275,N00031227,Larry Bucshon (R),2016,Transportation,2879,38500,41379
B001275,N00031227,Larry Bucshon (R),2016,Misc Business,51275,38500,89775
B001275,N00031227,Larry Bucshon (R),2016,Labor,0,1000,1000
B001275,N00031227,Larry Bucshon (R),2016,Ideology/Single-Issue,2100,42600,44700
B001275,N00031227,Larry Bucshon (R),2016,Other,20250,0,20250
B001282,N00031233,Andy Barr (R),2016,Agribusiness,136287,32000,168287
B001282,N00031233,Andy Barr (R),2016,Communic/Electronics,6500,26000,32500
B001282,N00031233,Andy Barr (R),2016,Construction,69850,45250,115100
B001282,N00031233,Andy Barr (R),2016,Defense,0,13000,13000
B001282,N00031233,Andy Barr (R),2016,Energy/Nat Resource,88850,80000,168850
B001282,N00031233,Andy Barr (R),2016,Finance/Insur/RealEst,251611,545810,797421
B001282,N00031233,Andy Barr (R),2016,Health,44600,115900,160500
B001282,N00031233,Andy Barr (R),2016,Lawyers & Lobbyists,96669,9000,105669
B001282,N00031233,Andy Barr (R),2016,Transportation,38000,48000,86000
B001282,N00031233,Andy Barr (R),2016,Misc Business,96950,99788,196738
B001282,N00031233,Andy Barr (R),2016,Labor,0,7500,7500
B001282,N00031233,Andy Barr (R),2016,Ideology/Single-Issue,73800,97423,171223
B001282,N00031233,Andy Barr (R),2016,Other,144753,1000,145753
H001055,N00031244,Joe Heck (R),2016,Agribusiness,141849,57000,198849
H001055,N00031244,Joe Heck (R),2016,Communic/Electronics,222083,60000,282083
H001055,N00031244,Joe Heck (R),2016,Construction,248568,86500,335068
H001055,N00031244,Joe Heck (R),2016,Defense,55330,104000,159330
H001055,N00031244,Joe Heck (R),2016,Energy/Nat Resource,217632,239166,456798
H001055,N00031244,Joe Heck (R),2016,Finance/Insur/RealEst,1914116,300300,2214416
H001055,N00031244,Joe Heck (R),2016,Health,470236,318750,788986
H001055,N00031244,Joe Heck (R),2016,Lawyers & Lobbyists,335627,24250,359877
H001055,N00031244,Joe Heck (R),2016,Transportation,135291,75000,210291
H001055,N00031244,Joe Heck (R),2016,Misc Business,906146,308000,1214146
H001055,N00031244,Joe Heck (R),2016,Labor,0,17000,17000
H001055,N00031244,Joe Heck (R),2016,Ideology/Single-Issue,561684,771712,1333396
H001055,N00031244,Joe Heck (R),2016,Other,1496616,27500,1524116
H001060,N00031265,Robert Hurt (R),2016,Agribusiness,1850,8000,9850
H001060,N00031265,Robert Hurt (R),2016,Communic/Electronics,0,10000,10000
H001060,N00031265,Robert Hurt (R),2016,Construction,4400,3500,7900
H001060,N00031265,Robert Hurt (R),2016,Defense,200,12000,12200
H001060,N00031265,Robert Hurt (R),2016,Energy/Nat Resource,0,26000,26000
H001060,N00031265,Robert Hurt (R),2016,Finance/Insur/RealEst,21900,219500,241400
H001060,N00031265,Robert Hurt (R),2016,Health,3500,13500,17000
H001060,N00031265,Robert Hurt (R),2016,Lawyers & Lobbyists,19500,8500,28000
H001060,N00031265,Robert Hurt (R),2016,Transportation,3000,7000,10000
H001060,N00031265,Robert Hurt (R),2016,Misc Business,1800,8000,9800
H001060,N00031265,Robert Hurt (R),2016,Labor,0,2000,2000
H001060,N00031265,Robert Hurt (R),2016,Ideology/Single-Issue,0,10500,10500
H001060,N00031265,Robert Hurt (R),2016,Other,21027,1000,22027
D000610,N00031317,Ted Deutch (D),2016,Agribusiness,9600,5000,14600
D000610,N00031317,Ted Deutch (D),2016,Communic/Electronics,33122,86000,119122
D000610,N00031317,Ted Deutch (D),2016,Construction,16475,4000,20475
D000610,N00031317,Ted Deutch (D),2016,Defense,0,6500,6500
D000610,N00031317,Ted Deutch (D),2016,Energy/Nat Resource,6500,5000,11500
D000610,N00031317,Ted Deutch (D),2016,Finance/Insur/RealEst,346030,40500,386530
D000610,N00031317,Ted Deutch (D),2016,Health,38845,34000,72845
D000610,N00031317,Ted Deutch (D),2016,Lawyers & Lobbyists,127410,28000,155410
D000610,N00031317,Ted Deutch (D),2016,Transportation,7900,10500,18400
D000610,N00031317,Ted Deutch (D),2016,Misc Business,90775,40500,131275
D000610,N00031317,Ted Deutch (D),2016,Labor,0,87500,87500
D000610,N00031317,Ted Deutch (D),2016,Ideology/Single-Issue,128080,67700,195780
D000610,N00031317,Ted Deutch (D),2016,Other,86967,-500,86467
E000291,N00031513,Renee Ellmers (R),2016,Agribusiness,10750,64000,74750
E000291,N00031513,Renee Ellmers (R),2016,Communic/Electronics,6811,81199,88010
E000291,N00031513,Renee Ellmers (R),2016,Construction,26439,18000,44439
E000291,N00031513,Renee Ellmers (R),2016,Defense,0,23000,23000
E000291,N00031513,Renee Ellmers (R),2016,Energy/Nat Resource,3500,88000,91500
E000291,N00031513,Renee Ellmers (R),2016,Finance/Insur/RealEst,22750,111000,133750
E000291,N00031513,Renee Ellmers (R),2016,Health,20925,400299,421224
E000291,N00031513,Renee Ellmers (R),2016,Lawyers & Lobbyists,43848,19500,63348
E000291,N00031513,Renee Ellmers (R),2016,Transportation,3950,30250,34200
E000291,N00031513,Renee Ellmers (R),2016,Misc Business,21350,89254,110604
E000291,N00031513,Renee Ellmers (R),2016,Labor,0,14000,14000
E000291,N00031513,Renee Ellmers (R),2016,Ideology/Single-Issue,7845,80900,88745
E000291,N00031513,Renee Ellmers (R),2016,Other,24345,2000,26345
B001273,N00031539,Diane Black (R),2016,Agribusiness,14300,33000,47300
B001273,N00031539,Diane Black (R),2016,Communic/Electronics,1500,43500,45000
B001273,N00031539,Diane Black (R),2016,Construction,101550,39000,140550
B001273,N00031539,Diane Black (R),2016,Defense,250,20000,20250
B001273,N00031539,Diane Black (R),2016,Energy/Nat Resource,2000,48750,50750
B001273,N00031539,Diane Black (R),2016,Finance/Insur/RealEst,128550,283750,412300
B001273,N00031539,Diane Black (R),2016,Health,37260,304039,341299
B001273,N00031539,Diane Black (R),2016,Lawyers & Lobbyists,43600,14150,57750
B001273,N00031539,Diane Black (R),2016,Transportation,23450,62500,85950
B001273,N00031539,Diane Black (R),2016,Misc Business,60789,119445,180234
B001273,N00031539,Diane Black (R),2016,Labor,0,1000,1000
B001273,N00031539,Diane Black (R),2016,Ideology/Single-Issue,121710,115456,237166
B001273,N00031539,Diane Black (R),2016,Other,89700,1000,90700
F000461,N00031545,Bill Flores (R),2016,Agribusiness,17750,65829,83579
F000461,N00031545,Bill Flores (R),2016,Communic/Electronics,27200,100000,127200
F000461,N00031545,Bill Flores (R),2016,Construction,23500,26750,50250
F000461,N00031545,Bill Flores (R),2016,Defense,250,30500,30750
F000461,N00031545,Bill Flores (R),2016,Energy/Nat Resource,83550,196809,280359
F000461,N00031545,Bill Flores (R),2016,Finance/Insur/RealEst,95900,192000,287900
F000461,N00031545,Bill Flores (R),2016,Health,18450,190000,208450
F000461,N00031545,Bill Flores (R),2016,Lawyers & Lobbyists,63250,14750,78000
F000461,N00031545,Bill Flores (R),2016,Transportation,13121,95000,108121
F000461,N00031545,Bill Flores (R),2016,Misc Business,46950,109000,155950
F000461,N00031545,Bill Flores (R),2016,Labor,0,11500,11500
F000461,N00031545,Bill Flores (R),2016,Ideology/Single-Issue,7100,61648,68748
F000461,N00031545,Bill Flores (R),2016,Other,82661,2000,84661
H001064,N00031557,Dennis Heck (D),2016,Agribusiness,11650,19500,31150
H001064,N00031557,Dennis Heck (D),2016,Communic/Electronics,18100,25250,43350
H001064,N00031557,Dennis Heck (D),2016,Construction,15800,14000,29800
H001064,N00031557,Dennis Heck (D),2016,Defense,12000,23500,35500
H001064,N00031557,Dennis Heck (D),2016,Energy/Nat Resource,7250,12500,19750
H001064,N00031557,Dennis Heck (D),2016,Finance/Insur/RealEst,52913,384000,436913
H001064,N00031557,Dennis Heck (D),2016,Health,35900,58500,94400
H001064,N00031557,Dennis Heck (D),2016,Lawyers & Lobbyists,86314,14750,101064
H001064,N00031557,Dennis Heck (D),2016,Transportation,5400,32000,37400
H001064,N00031557,Dennis Heck (D),2016,Misc Business,121207,48500,169707
H001064,N00031557,Dennis Heck (D),2016,Labor,370,142000,142370
H001064,N00031557,Dennis Heck (D),2016,Ideology/Single-Issue,82763,27000,109763
H001064,N00031557,Dennis Heck (D),2016,Other,82054,0,82054
H001056,N00031559,Jaime Herrera Beutler (R),2016,Agribusiness,39100,46000,85100
H001056,N00031559,Jaime Herrera Beutler (R),2016,Communic/Electronics,15250,28000,43250
H001056,N00031559,Jaime Herrera Beutler (R),2016,Construction,22325,27500,49825
H001056,N00031559,Jaime Herrera Beutler (R),2016,Defense,500,31500,32000
H001056,N00031559,Jaime Herrera Beutler (R),2016,Energy/Nat Resource,4405,25550,29955
H001056,N00031559,Jaime Herrera Beutler (R),2016,Finance/Insur/RealEst,130827,77000,207827
H001056,N00031559,Jaime Herrera Beutler (R),2016,Health,15511,30000,45511
H001056,N00031559,Jaime Herrera Beutler (R),2016,Lawyers & Lobbyists,23225,7000,30225
H001056,N00031559,Jaime Herrera Beutler (R),2016,Transportation,14325,40000,54325
H001056,N00031559,Jaime Herrera Beutler (R),2016,Misc Business,85251,44500,129751
H001056,N00031559,Jaime Herrera Beutler (R),2016,Labor,0,15000,15000
H001056,N00031559,Jaime Herrera Beutler (R),2016,Ideology/Single-Issue,32250,51900,84150
H001056,N00031559,Jaime Herrera Beutler (R),2016,Other,152730,0,152730
D000612,N00031593,Jeff Denham (R),2016,Agribusiness,311841,267581,579422
D000612,N00031593,Jeff Denham (R),2016,Communic/Electronics,7500,77490,84990
D000612,N00031593,Jeff Denham (R),2016,Construction,69425,92200,161625
D000612,N00031593,Jeff Denham (R),2016,Defense,0,4000,4000
D000612,N00031593,Jeff Denham (R),2016,Energy/Nat Resource,19100,235899,254999
D000612,N00031593,Jeff Denham (R),2016,Finance/Insur/RealEst,93885,202000,295885
D000612,N00031593,Jeff Denham (R),2016,Health,22900,88500,111400
D000612,N00031593,Jeff Denham (R),2016,Lawyers & Lobbyists,72736,27411,100147
D000612,N00031593,Jeff Denham (R),2016,Transportation,122692,291695,414387
D000612,N00031593,Jeff Denham (R),2016,Misc Business,200326,161499,361825
D000612,N00031593,Jeff Denham (R),2016,Labor,0,122500,122500
D000612,N00031593,Jeff Denham (R),2016,Ideology/Single-Issue,58631,482708,541339
D000612,N00031593,Jeff Denham (R),2016,Other,37775,500,38275
F000460,N00031672,Blake Farenthold (R),2016,Agribusiness,20650,51379,72029
F000460,N00031672,Blake Farenthold (R),2016,Communic/Electronics,12750,90150,102900
F000460,N00031672,Blake Farenthold (R),2016,Construction,71025,33700,104725
F000460,N00031672,Blake Farenthold (R),2016,Defense,0,1000,1000
F000460,N00031672,Blake Farenthold (R),2016,Energy/Nat Resource,29050,62000,91050
F000460,N00031672,Blake Farenthold (R),2016,Finance/Insur/RealEst,59950,28200,88150
F000460,N00031672,Blake Farenthold (R),2016,Health,39450,22200,61650
F000460,N00031672,Blake Farenthold (R),2016,Lawyers & Lobbyists,41674,4250,45924
F000460,N00031672,Blake Farenthold (R),2016,Transportation,5975,102999,108974
F000460,N00031672,Blake Farenthold (R),2016,Misc Business,53050,32370,85420
F000460,N00031672,Blake Farenthold (R),2016,Labor,0,17000,17000
F000460,N00031672,Blake Farenthold (R),2016,Ideology/Single-Issue,9600,56600,66200
F000460,N00031672,Blake Farenthold (R),2016,Other,77966,1000,78966
B001277,N00031685,Richard Blumenthal (D),2016,Agribusiness,27393,7000,34393
B001277,N00031685,Richard Blumenthal (D),2016,Communic/Electronics,475276,301850,777126
B001277,N00031685,Richard Blumenthal (D),2016,Construction,88608,6000,94608
B001277,N00031685,Richard Blumenthal (D),2016,Defense,50535,112000,162535
B001277,N00031685,Richard Blumenthal (D),2016,Energy/Nat Resource,78032,50600,128632
B001277,N00031685,Richard Blumenthal (D),2016,Finance/Insur/RealEst,1521434,294200,1815634
B001277,N00031685,Richard Blumenthal (D),2016,Health,263454,329900,593354
B001277,N00031685,Richard Blumenthal (D),2016,Lawyers & Lobbyists,1439952,154391,1594343
B001277,N00031685,Richard Blumenthal (D),2016,Transportation,76552,59000,135552
B001277,N00031685,Richard Blumenthal (D),2016,Misc Business,439822,247034,686856
B001277,N00031685,Richard Blumenthal (D),2016,Labor,100,272700,272800
B001277,N00031685,Richard Blumenthal (D),2016,Ideology/Single-Issue,487139,421603,908742
B001277,N00031685,Richard Blumenthal (D),2016,Other,672766,500,673266
H001061,N00031688,John Hoeven (R),2016,Agribusiness,47753,251400,299153
H001061,N00031688,John Hoeven (R),2016,Communic/Electronics,40580,90980,131560
H001061,N00031688,John Hoeven (R),2016,Construction,103680,61000,164680
H001061,N00031688,John Hoeven (R),2016,Defense,0,109000,109000
H001061,N00031688,John Hoeven (R),2016,Energy/Nat Resource,288078,392773,680851
H001061,N00031688,John Hoeven (R),2016,Finance/Insur/RealEst,264525,211500,476025
H001061,N00031688,John Hoeven (R),2016,Health,44220,102700,146920
H001061,N00031688,John Hoeven (R),2016,Lawyers & Lobbyists,128530,41750,170280
H001061,N00031688,John Hoeven (R),2016,Transportation,66265,96000,162265
H001061,N00031688,John Hoeven (R),2016,Misc Business,168926,131500,300426
H001061,N00031688,John Hoeven (R),2016,Labor,0,20625,20625
H001061,N00031688,John Hoeven (R),2016,Ideology/Single-Issue,56750,351077,407827
H001061,N00031688,John Hoeven (R),2016,Other,119472,4500,123972
C001088,N00031820,Chris Coons (D),2016,Agribusiness,20159,40500,60659
C001088,N00031820,Chris Coons (D),2016,Communic/Electronics,191334,240457,431791
C001088,N00031820,Chris Coons (D),2016,Construction,36127,27000,63127
C001088,N00031820,Chris Coons (D),2016,Defense,501,58000,58501
C001088,N00031820,Chris Coons (D),2016,Energy/Nat Resource,39924,146250,186174
C001088,N00031820,Chris Coons (D),2016,Finance/Insur/RealEst,667506,480705,1148211
C001088,N00031820,Chris Coons (D),2016,Health,134876,278000,412876
C001088,N00031820,Chris Coons (D),2016,Lawyers & Lobbyists,1247180,174419,1421599
C001088,N00031820,Chris Coons (D),2016,Transportation,13206,86600,99806
C001088,N00031820,Chris Coons (D),2016,Misc Business,245939,257000,502939
C001088,N00031820,Chris Coons (D),2016,Labor,1025,158500,159525
C001088,N00031820,Chris Coons (D),2016,Ideology/Single-Issue,198258,392617,590875
C001088,N00031820,Chris Coons (D),2016,Other,171423,3000,174423
B001270,N00031877,Karen Bass (D),2016,Agribusiness,8900,1500,10400
B001270,N00031877,Karen Bass (D),2016,Communic/Electronics,53800,82400,136200
B001270,N00031877,Karen Bass (D),2016,Construction,8700,0,8700
B001270,N00031877,Karen Bass (D),2016,Defense,2000,11000,13000
B001270,N00031877,Karen Bass (D),2016,Energy/Nat Resource,1000,20500,21500
B001270,N00031877,Karen Bass (D),2016,Finance/Insur/RealEst,6750,40000,46750
B001270,N00031877,Karen Bass (D),2016,Health,173,33500,33673
B001270,N00031877,Karen Bass (D),2016,Lawyers & Lobbyists,26414,13500,39914
B001270,N00031877,Karen Bass (D),2016,Transportation,0,17970,17970
B001270,N00031877,Karen Bass (D),2016,Misc Business,22300,41000,63300
B001270,N00031877,Karen Bass (D),2016,Labor,-250,103500,103250
B001270,N00031877,Karen Bass (D),2016,Ideology/Single-Issue,22768,8500,31268
B001270,N00031877,Karen Bass (D),2016,Other,40943,1000,41943
B001271,N00031934,Dan Benishek (R),2016,Agribusiness,4100,50160,54260
B001271,N00031934,Dan Benishek (R),2016,Communic/Electronics,1000,6500,7500
B001271,N00031934,Dan Benishek (R),2016,Construction,1500,9500,11000
B001271,N00031934,Dan Benishek (R),2016,Defense,0,3000,3000
B001271,N00031934,Dan Benishek (R),2016,Energy/Nat Resource,5975,34750,40725
B001271,N00031934,Dan Benishek (R),2016,Finance/Insur/RealEst,10000,35000,45000
B001271,N00031934,Dan Benishek (R),2016,Health,16950,76500,93450
B001271,N00031934,Dan Benishek (R),2016,Lawyers & Lobbyists,6500,5750,12250
B001271,N00031934,Dan Benishek (R),2016,Transportation,10000,8500,18500
B001271,N00031934,Dan Benishek (R),2016,Misc Business,33050,5000,38050
B001271,N00031934,Dan Benishek (R),2016,Labor,0,1000,1000
B001271,N00031934,Dan Benishek (R),2016,Ideology/Single-Issue,11195,93500,104695
B001271,N00031934,Dan Benishek (R),2016,Other,15284,0,15284
A000367,N00031938,Justin Amash (R),2016,Agribusiness,44500,0,44500
A000367,N00031938,Justin Amash (R),2016,Communic/Electronics,23200,0,23200
A000367,N00031938,Justin Amash (R),2016,Construction,20741,1000,21741
A000367,N00031938,Justin Amash (R),2016,Energy/Nat Resource,14400,10000,24400
A000367,N00031938,Justin Amash (R),2016,Finance/Insur/RealEst,101861,4000,105861
A000367,N00031938,Justin Amash (R),2016,Health,29036,1500,30536
A000367,N00031938,Justin Amash (R),2016,Lawyers & Lobbyists,10200,0,10200
A000367,N00031938,Justin Amash (R),2016,Transportation,20200,1000,21200
A000367,N00031938,Justin Amash (R),2016,Misc Business,113405,1000,114405
A000367,N00031938,Justin Amash (R),2016,Ideology/Single-Issue,36765,12797,49562
A000367,N00031938,Justin Amash (R),2016,Other,43180,0,43180
G000564,N00031998,Chris Gibson (R),2016,Agribusiness,0,-2000,-2000
G000564,N00031998,Chris Gibson (R),2016,Health,0,2500,2500
G000564,N00031998,Chris Gibson (R),2016,Labor,0,4000,4000
G000564,N00031998,Chris Gibson (R),2016,Ideology/Single-Issue,0,2000,2000
C001084,N00032019,David Cicilline (D),2016,Agribusiness,1250,1000,2250
C001084,N00032019,David Cicilline (D),2016,Communic/Electronics,48615,48500,97115
C001084,N00032019,David Cicilline (D),2016,Construction,27653,3000,30653
C001084,N00032019,David Cicilline (D),2016,Defense,1250,13000,14250
C001084,N00032019,David Cicilline (D),2016,Energy/Nat Resource,2500,500,3000
C001084,N00032019,David Cicilline (D),2016,Finance/Insur/RealEst,162520,43000,205520
C001084,N00032019,David Cicilline (D),2016,Health,39943,22500,62443
C001084,N00032019,David Cicilline (D),2016,Lawyers & Lobbyists,128931,22500,151431
C001084,N00032019,David Cicilline (D),2016,Transportation,17750,5500,23250
C001084,N00032019,David Cicilline (D),2016,Misc Business,106420,40000,146420
C001084,N00032019,David Cicilline (D),2016,Labor,600,189500,190100
C001084,N00032019,David Cicilline (D),2016,Ideology/Single-Issue,42282,32500,74782
C001084,N00032019,David Cicilline (D),2016,Other,220232,4500,224732
G000568,N00032029,Morgan Griffith (R),2016,Agribusiness,4350,45500,49850
G000568,N00032029,Morgan Griffith (R),2016,Communic/Electronics,4400,53815,58215
G000568,N00032029,Morgan Griffith (R),2016,Construction,14000,19500,33500
G000568,N00032029,Morgan Griffith (R),2016,Defense,0,18000,18000
G000568,N00032029,Morgan Griffith (R),2016,Energy/Nat Resource,11100,120568,131668
G000568,N00032029,Morgan Griffith (R),2016,Finance/Insur/RealEst,18800,34500,53300
G000568,N00032029,Morgan Griffith (R),2016,Health,14650,126500,141150
G000568,N00032029,Morgan Griffith (R),2016,Lawyers & Lobbyists,28500,14000,42500
G000568,N00032029,Morgan Griffith (R),2016,Transportation,1000,28500,29500
G000568,N00032029,Morgan Griffith (R),2016,Misc Business,31300,52500,83800
G000568,N00032029,Morgan Griffith (R),2016,Labor,0,1000,1000
G000568,N00032029,Morgan Griffith (R),2016,Ideology/Single-Issue,6013,25000,31013
G000568,N00032029,Morgan Griffith (R),2016,Other,49080,1000,50080
D000618,N00033054,Steven Daines (R),2016,Agribusiness,318450,151200,469650
D000618,N00033054,Steven Daines (R),2016,Communic/Electronics,144276,131440,275716
D000618,N00033054,Steven Daines (R),2016,Construction,281542,80250,361792
D000618,N00033054,Steven Daines (R),2016,Defense,6100,21000,27100
D000618,N00033054,Steven Daines (R),2016,Energy/Nat Resource,373589,314000,687589
D000618,N00033054,Steven Daines (R),2016,Finance/Insur/RealEst,1057181,315100,1372281
D000618,N00033054,Steven Daines (R),2016,Health,100250,124166,224416
D000618,N00033054,Steven Daines (R),2016,Lawyers & Lobbyists,214316,26563,240879
D000618,N00033054,Steven Daines (R),2016,Transportation,130675,193055,323730
D000618,N00033054,Steven Daines (R),2016,Misc Business,495668,205429,701097
D000618,N00033054,Steven Daines (R),2016,Labor,0,26500,26500
D000618,N00033054,Steven Daines (R),2016,Ideology/Single-Issue,201253,459838,661091
D000618,N00033054,Steven Daines (R),2016,Other,687636,8000,695636
C001098,N00033085,Ted Cruz (R),2016,Agribusiness,444635,74500,519135
C001098,N00033085,Ted Cruz (R),2016,Communic/Electronics,357852,101549,459401
C001098,N00033085,Ted Cruz (R),2016,Construction,673993,54000,727993
C001098,N00033085,Ted Cruz (R),2016,Defense,18640,40500,59140
C001098,N00033085,Ted Cruz (R),2016,Energy/Nat Resource,1712252,243500,1955752
C001098,N00033085,Ted Cruz (R),2016,Finance/Insur/RealEst,3451870,183178,3635048
C001098,N00033085,Ted Cruz (R),2016,Health,842944,117500,960444
C001098,N00033085,Ted Cruz (R),2016,Lawyers & Lobbyists,1356875,57249,1414124
C001098,N00033085,Ted Cruz (R),2016,Transportation,301172,92000,393172
C001098,N00033085,Ted Cruz (R),2016,Misc Business,1911205,189750,2100955
C001098,N00033085,Ted Cruz (R),2016,Labor,2625,1000,3625
C001098,N00033085,Ted Cruz (R),2016,Ideology/Single-Issue,2223705,441600,2665305
C001098,N00033085,Ted Cruz (R),2016,Other,2490014,7500,2497514
E000293,N00033217,Elizabeth Esty (D),2016,Agribusiness,4955,4750,9705
E000293,N00033217,Elizabeth Esty (D),2016,Communic/Electronics,54044,26010,80054
E000293,N00033217,Elizabeth Esty (D),2016,Construction,25017,27500,52517
E000293,N00033217,Elizabeth Esty (D),2016,Defense,856,3500,4356
E000293,N00033217,Elizabeth Esty (D),2016,Energy/Nat Resource,5528,13000,18528
E000293,N00033217,Elizabeth Esty (D),2016,Finance/Insur/RealEst,174079,89500,263579
E000293,N00033217,Elizabeth Esty (D),2016,Health,52372,60500,112872
E000293,N00033217,Elizabeth Esty (D),2016,Lawyers & Lobbyists,170160,17000,187160
E000293,N00033217,Elizabeth Esty (D),2016,Transportation,13367,81000,94367
E000293,N00033217,Elizabeth Esty (D),2016,Misc Business,88523,47491,136014
E000293,N00033217,Elizabeth Esty (D),2016,Labor,2000,175000,177000
E000293,N00033217,Elizabeth Esty (D),2016,Ideology/Single-Issue,177312,102843,280155
E000293,N00033217,Elizabeth Esty (D),2016,Other,257279,2500,259779
G000571,N00033281,Tulsi Gabbard (D),2016,Agribusiness,5192,19500,24692
G000571,N00033281,Tulsi Gabbard (D),2016,Communic/Electronics,78906,10000,88906
G000571,N00033281,Tulsi Gabbard (D),2016,Construction,14917,5000,19917
G000571,N00033281,Tulsi Gabbard (D),2016,Defense,13462,63500,76962
G000571,N00033281,Tulsi Gabbard (D),2016,Energy/Nat Resource,13845,17250,31095
G000571,N00033281,Tulsi Gabbard (D),2016,Finance/Insur/RealEst,108087,51700,159787
G000571,N00033281,Tulsi Gabbard (D),2016,Health,101485,22000,123485
G000571,N00033281,Tulsi Gabbard (D),2016,Lawyers & Lobbyists,43917,9000,52917
G000571,N00033281,Tulsi Gabbard (D),2016,Transportation,29370,42200,71570
G000571,N00033281,Tulsi Gabbard (D),2016,Misc Business,90822,16000,106822
G000571,N00033281,Tulsi Gabbard (D),2016,Labor,146,144000,144146
G000571,N00033281,Tulsi Gabbard (D),2016,Ideology/Single-Issue,107793,65252,173045
G000571,N00033281,Tulsi Gabbard (D),2016,Other,96817,500,97317
C001091,N00033316,Joaquin Castro (D),2016,Agribusiness,9700,28500,38200
C001091,N00033316,Joaquin Castro (D),2016,Communic/Electronics,15150,53710,68860
C001091,N00033316,Joaquin Castro (D),2016,Construction,20800,13250,34050
C001091,N00033316,Joaquin Castro (D),2016,Defense,0,65500,65500
C001091,N00033316,Joaquin Castro (D),2016,Energy/Nat Resource,7550,26500,34050
C001091,N00033316,Joaquin Castro (D),2016,Finance/Insur/RealEst,60117,101750,161867
C001091,N00033316,Joaquin Castro (D),2016,Health,38947,67500,106447
C001091,N00033316,Joaquin Castro (D),2016,Lawyers & Lobbyists,112744,33582,146326
C001091,N00033316,Joaquin Castro (D),2016,Transportation,2500,43000,45500
C001091,N00033316,Joaquin Castro (D),2016,Misc Business,41725,49785,91510
C001091,N00033316,Joaquin Castro (D),2016,Labor,0,135500,135500
C001091,N00033316,Joaquin Castro (D),2016,Ideology/Single-Issue,21912,23000,44912
C001091,N00033316,Joaquin Castro (D),2016,Other,45353,0,45353
C001095,N00033363,Tom Cotton (R),2016,Agribusiness,277424,148000,425424
C001095,N00033363,Tom Cotton (R),2016,Communic/Electronics,199771,86200,285971
C001095,N00033363,Tom Cotton (R),2016,Construction,289371,61200,350571
C001095,N00033363,Tom Cotton (R),2016,Defense,15750,68500,84250
C001095,N00033363,Tom Cotton (R),2016,Energy/Nat Resource,523861,136350,660211
C001095,N00033363,Tom Cotton (R),2016,Finance/Insur/RealEst,2243801,509700,2753501
C001095,N00033363,Tom Cotton (R),2016,Health,413267,117166,530433
C001095,N00033363,Tom Cotton (R),2016,Lawyers & Lobbyists,485001,56430,541431
C001095,N00033363,Tom Cotton (R),2016,Transportation,146236,99546,245782
C001095,N00033363,Tom Cotton (R),2016,Misc Business,802019,241700,1043719
C001095,N00033363,Tom Cotton (R),2016,Labor,0,5500,5500
C001095,N00033363,Tom Cotton (R),2016,Ideology/Single-Issue,1007027,599410,1606437
C001095,N00033363,Tom Cotton (R),2016,Other,1346569,6000,1352569
C001097,N00033373,Tony Cardenas (D),2016,Agribusiness,2700,25200,27900
C001097,N00033373,Tony Cardenas (D),2016,Communic/Electronics,38510,123000,161510
C001097,N00033373,Tony Cardenas (D),2016,Construction,10406,10000,20406
C001097,N00033373,Tony Cardenas (D),2016,Defense,5,15500,15505
C001097,N00033373,Tony Cardenas (D),2016,Energy/Nat Resource,9050,63000,72050
C001097,N00033373,Tony Cardenas (D),2016,Finance/Insur/RealEst,107650,193000,300650
C001097,N00033373,Tony Cardenas (D),2016,Health,61484,217350,278834
C001097,N00033373,Tony Cardenas (D),2016,Lawyers & Lobbyists,70900,16000,86900
C001097,N00033373,Tony Cardenas (D),2016,Transportation,19000,34823,53823
C001097,N00033373,Tony Cardenas (D),2016,Misc Business,102460,101000,203460
C001097,N00033373,Tony Cardenas (D),2016,Labor,0,107500,107500
C001097,N00033373,Tony Cardenas (D),2016,Ideology/Single-Issue,66056,72500,138556
C001097,N00033373,Tony Cardenas (D),2016,Other,36126,1500,37626
B001286,N00033390,Cheri Bustos (D),2016,Agribusiness,17073,132417,149490
B001286,N00033390,Cheri Bustos (D),2016,Communic/Electronics,27968,43000,70968
B001286,N00033390,Cheri Bustos (D),2016,Construction,25110,25250,50360
B001286,N00033390,Cheri Bustos (D),2016,Defense,2887,3500,6387
B001286,N00033390,Cheri Bustos (D),2016,Energy/Nat Resource,37090,69000,106090
B001286,N00033390,Cheri Bustos (D),2016,Finance/Insur/RealEst,122405,175000,297405
B001286,N00033390,Cheri Bustos (D),2016,Health,79272,116500,195772
B001286,N00033390,Cheri Bustos (D),2016,Lawyers & Lobbyists,208732,15750,224482
B001286,N00033390,Cheri Bustos (D),2016,Transportation,17824,125250,143074
B001286,N00033390,Cheri Bustos (D),2016,Misc Business,83007,74000,157007
B001286,N00033390,Cheri Bustos (D),2016,Labor,2315,235500,237815
B001286,N00033390,Cheri Bustos (D),2016,Ideology/Single-Issue,410926,325900,736826
B001286,N00033390,Cheri Bustos (D),2016,Other,256950,7000,263950
H001065,N00033399,George Holding (R),2016,Agribusiness,48800,87550,136350
H001065,N00033399,George Holding (R),2016,Communic/Electronics,56150,89000,145150
H001065,N00033399,George Holding (R),2016,Construction,58250,31000,89250
H001065,N00033399,George Holding (R),2016,Defense,4000,28500,32500
H001065,N00033399,George Holding (R),2016,Energy/Nat Resource,18849,91333,110182
H001065,N00033399,George Holding (R),2016,Finance/Insur/RealEst,223895,456300,680195
H001065,N00033399,George Holding (R),2016,Health,78901,228700,307601
H001065,N00033399,George Holding (R),2016,Lawyers & Lobbyists,272305,38250,310555
H001065,N00033399,George Holding (R),2016,Transportation,28087,45500,73587
H001065,N00033399,George Holding (R),2016,Misc Business,104797,172467,277264
H001065,N00033399,George Holding (R),2016,Labor,0,1000,1000
H001065,N00033399,George Holding (R),2016,Ideology/Single-Issue,15248,209758,225006
H001065,N00033399,George Holding (R),2016,Other,79877,6500,86377
F000463,N00033443,Deb Fischer (R),2016,Agribusiness,329745,294552,624297
F000463,N00033443,Deb Fischer (R),2016,Communic/Electronics,96528,191050,287578
F000463,N00033443,Deb Fischer (R),2016,Construction,179910,75578,255488
F000463,N00033443,Deb Fischer (R),2016,Defense,250,51000,51250
F000463,N00033443,Deb Fischer (R),2016,Energy/Nat Resource,182551,194150,376701
F000463,N00033443,Deb Fischer (R),2016,Finance/Insur/RealEst,488088,336670,824758
F000463,N00033443,Deb Fischer (R),2016,Health,177790,137500,315290
F000463,N00033443,Deb Fischer (R),2016,Lawyers & Lobbyists,205987,78250,284237
F000463,N00033443,Deb Fischer (R),2016,Transportation,162016,214300,376316
F000463,N00033443,Deb Fischer (R),2016,Misc Business,345997,174500,520497
F000463,N00033443,Deb Fischer (R),2016,Labor,0,35000,35000
F000463,N00033443,Deb Fischer (R),2016,Ideology/Single-Issue,224400,509482,733882
F000463,N00033443,Deb Fischer (R),2016,Other,432470,8500,440970
D000627,N00033449,Val Demings (D),2016,Agribusiness,10900,11000,21900
D000627,N00033449,Val Demings (D),2016,Communic/Electronics,33080,0,33080
D000627,N00033449,Val Demings (D),2016,Construction,5861,0,5861
D000627,N00033449,Val Demings (D),2016,Defense,1340,0,1340
D000627,N00033449,Val Demings (D),2016,Energy/Nat Resource,1100,2000,3100
D000627,N00033449,Val Demings (D),2016,Finance/Insur/RealEst,87350,17500,104850
D000627,N00033449,Val Demings (D),2016,Health,35679,4000,39679
D000627,N00033449,Val Demings (D),2016,Lawyers & Lobbyists,77411,0,77411
D000627,N00033449,Val Demings (D),2016,Transportation,7000,5000,12000
D000627,N00033449,Val Demings (D),2016,Misc Business,69647,3500,73147
D000627,N00033449,Val Demings (D),2016,Labor,0,91500,91500
D000627,N00033449,Val Demings (D),2016,Ideology/Single-Issue,134077,113205,247282
D000627,N00033449,Val Demings (D),2016,Other,105291,0,105291
B001278,N00033474,Suzanne Bonamici (D),2016,Agribusiness,6245,38000,44245
B001278,N00033474,Suzanne Bonamici (D),2016,Communic/Electronics,13622,32500,46122
B001278,N00033474,Suzanne Bonamici (D),2016,Construction,4200,20500,24700
B001278,N00033474,Suzanne Bonamici (D),2016,Defense,1005,32000,33005
B001278,N00033474,Suzanne Bonamici (D),2016,Energy/Nat Resource,10150,18500,28650
B001278,N00033474,Suzanne Bonamici (D),2016,Finance/Insur/RealEst,32862,74000,106862
B001278,N00033474,Suzanne Bonamici (D),2016,Health,20501,65000,85501
B001278,N00033474,Suzanne Bonamici (D),2016,Lawyers & Lobbyists,87080,17000,104080
B001278,N00033474,Suzanne Bonamici (D),2016,Transportation,9150,36500,45650
B001278,N00033474,Suzanne Bonamici (D),2016,Misc Business,51972,62500,114472
B001278,N00033474,Suzanne Bonamici (D),2016,Labor,0,60500,60500
B001278,N00033474,Suzanne Bonamici (D),2016,Ideology/Single-Issue,8630,36058,44688
B001278,N00033474,Suzanne Bonamici (D),2016,Other,52747,11500,64247
B001284,N00033495,Susan Brooks (R),2016,Agribusiness,12550,25000,37550
B001284,N00033495,Susan Brooks (R),2016,Communic/Electronics,16550,87800,104350
B001284,N00033495,Susan Brooks (R),2016,Construction,52025,26000,78025
B001284,N00033495,Susan Brooks (R),2016,Defense,0,33500,33500
B001284,N00033495,Susan Brooks (R),2016,Energy/Nat Resource,13673,82000,95673
B001284,N00033495,Susan Brooks (R),2016,Finance/Insur/RealEst,143350,135900,279250
B001284,N00033495,Susan Brooks (R),2016,Health,69328,226000,295328
B001284,N00033495,Susan Brooks (R),2016,Lawyers & Lobbyists,104954,21500,126454
B001284,N00033495,Susan Brooks (R),2016,Transportation,17600,56000,73600
B001284,N00033495,Susan Brooks (R),2016,Misc Business,64350,89500,153850
B001284,N00033495,Susan Brooks (R),2016,Labor,0,7000,7000
B001284,N00033495,Susan Brooks (R),2016,Ideology/Single-Issue,7540,72302,79842
B001284,N00033495,Susan Brooks (R),2016,Other,85350,15000,100350
C001093,N00033518,Doug Collins (R),2016,Agribusiness,27050,25500,52550
C001093,N00033518,Doug Collins (R),2016,Communic/Electronics,27200,130700,157900
C001093,N00033518,Doug Collins (R),2016,Construction,22900,20000,42900
C001093,N00033518,Doug Collins (R),2016,Defense,100,21000,21100
C001093,N00033518,Doug Collins (R),2016,Energy/Nat Resource,15650,28500,44150
C001093,N00033518,Doug Collins (R),2016,Finance/Insur/RealEst,41785,87500,129285
C001093,N00033518,Doug Collins (R),2016,Health,25950,75200,101150
C001093,N00033518,Doug Collins (R),2016,Lawyers & Lobbyists,69403,26000,95403
C001093,N00033518,Doug Collins (R),2016,Transportation,5750,34500,40250
C001093,N00033518,Doug Collins (R),2016,Misc Business,58796,79385,138181
C001093,N00033518,Doug Collins (R),2016,Labor,0,2500,2500
C001093,N00033518,Doug Collins (R),2016,Ideology/Single-Issue,13011,157148,170159
C001093,N00033518,Doug Collins (R),2016,Other,33047,2000,35047
B001283,N00033532,James Bridenstine (R),2016,Agribusiness,1800,0,1800
B001283,N00033532,James Bridenstine (R),2016,Communic/Electronics,4500,21000,25500
B001283,N00033532,James Bridenstine (R),2016,Construction,27000,4500,31500
B001283,N00033532,James Bridenstine (R),2016,Defense,1500,85500,87000
B001283,N00033532,James Bridenstine (R),2016,Energy/Nat Resource,18350,34500,52850
B001283,N00033532,James Bridenstine (R),2016,Finance/Insur/RealEst,61150,11250,72400
B001283,N00033532,James Bridenstine (R),2016,Health,57127,19500,76627
B001283,N00033532,James Bridenstine (R),2016,Lawyers & Lobbyists,25250,4000,29250
B001283,N00033532,James Bridenstine (R),2016,Transportation,23350,25000,48350
B001283,N00033532,James Bridenstine (R),2016,Misc Business,37942,1000,38942
B001283,N00033532,James Bridenstine (R),2016,Labor,0,6500,6500
B001283,N00033532,James Bridenstine (R),2016,Ideology/Single-Issue,28240,55180,83420
B001283,N00033532,James Bridenstine (R),2016,Other,95991,0,95991
G000572,N00033541,Pete Gallego (D),2016,Agribusiness,30901,1000,31901
G000572,N00033541,Pete Gallego (D),2016,Communic/Electronics,55611,0,55611
G000572,N00033541,Pete Gallego (D),2016,Construction,36803,0,36803
G000572,N00033541,Pete Gallego (D),2016,Defense,2950,1000,3950
G000572,N00033541,Pete Gallego (D),2016,Energy/Nat Resource,19119,0,19119
G000572,N00033541,Pete Gallego (D),2016,Finance/Insur/RealEst,139887,3000,142887
G000572,N00033541,Pete Gallego (D),2016,Health,63297,17000,80297
G000572,N00033541,Pete Gallego (D),2016,Lawyers & Lobbyists,317039,11000,328039
G000572,N00033541,Pete Gallego (D),2016,Transportation,3525,0,3525
G000572,N00033541,Pete Gallego (D),2016,Misc Business,118812,0,118812
G000572,N00033541,Pete Gallego (D),2016,Labor,750,169500,170250
G000572,N00033541,Pete Gallego (D),2016,Ideology/Single-Issue,157770,358605,516375
G000572,N00033541,Pete Gallego (D),2016,Other,150743,0,150743
B001280,N00033625,Kerry Bentivolio (I),2016,Communic/Electronics,2700,0,2700
B001280,N00033625,Kerry Bentivolio (I),2016,Health,12536,0,12536
B001280,N00033625,Kerry Bentivolio (I),2016,Transportation,0,-1000,-1000
B001280,N00033625,Kerry Bentivolio (I),2016,Misc Business,23100,0,23100
B001280,N00033625,Kerry Bentivolio (I),2016,Ideology/Single-Issue,0,1234,1234
A000372,N00033720,Richard W Allen (R),2016,Agribusiness,42372,109027,151399
A000372,N00033720,Richard W Allen (R),2016,Communic/Electronics,2500,21000,23500
A000372,N00033720,Richard W Allen (R),2016,Construction,46400,35500,81900
A000372,N00033720,Richard W Allen (R),2016,Defense,0,12000,12000
A000372,N00033720,Richard W Allen (R),2016,Energy/Nat Resource,9750,21000,30750
A000372,N00033720,Richard W Allen (R),2016,Finance/Insur/RealEst,86975,92500,179475
A000372,N00033720,Richard W Allen (R),2016,Health,51650,27000,78650
A000372,N00033720,Richard W Allen (R),2016,Lawyers & Lobbyists,27700,2250,29950
A000372,N00033720,Richard W Allen (R),2016,Transportation,15200,28500,43700
A000372,N00033720,Richard W Allen (R),2016,Misc Business,36650,59498,96148
A000372,N00033720,Richard W Allen (R),2016,Labor,0,4000,4000
A000372,N00033720,Richard W Allen (R),2016,Ideology/Single-Issue,10030,72000,82030
A000372,N00033720,Richard W Allen (R),2016,Other,101800,3500,105300
B001294,N00033744,Rod Blum (R),2016,Agribusiness,53045,78512,131557
B001294,N00033744,Rod Blum (R),2016,Communic/Electronics,18705,12000,30705
B001294,N00033744,Rod Blum (R),2016,Construction,50350,30500,80850
B001294,N00033744,Rod Blum (R),2016,Defense,2350,20000,22350
B001294,N00033744,Rod Blum (R),2016,Energy/Nat Resource,850,50000,50850
B001294,N00033744,Rod Blum (R),2016,Finance/Insur/RealEst,131445,74800,206245
B001294,N00033744,Rod Blum (R),2016,Health,31948,42272,74220
B001294,N00033744,Rod Blum (R),2016,Lawyers & Lobbyists,10380,2000,12380
B001294,N00033744,Rod Blum (R),2016,Transportation,48300,21300,69600
B001294,N00033744,Rod Blum (R),2016,Misc Business,60320,54498,114818
B001294,N00033744,Rod Blum (R),2016,Ideology/Single-Issue,151308,273339,424647
B001294,N00033744,Rod Blum (R),2016,Other,146389,0,146389
D000620,N00033897,John K Delaney (D),2016,Agribusiness,2700,9000,11700
D000620,N00033897,John K Delaney (D),2016,Communic/Electronics,27250,28500,55750
D000620,N00033897,John K Delaney (D),2016,Construction,2000,49250,51250
D000620,N00033897,John K Delaney (D),2016,Defense,0,23500,23500
D000620,N00033897,John K Delaney (D),2016,Energy/Nat Resource,750,23500,24250
D000620,N00033897,John K Delaney (D),2016,Finance/Insur/RealEst,338225,336500,674725
D000620,N00033897,John K Delaney (D),2016,Health,32850,47500,80350
D000620,N00033897,John K Delaney (D),2016,Lawyers & Lobbyists,133600,21000,154600
D000620,N00033897,John K Delaney (D),2016,Transportation,4750,19000,23750
D000620,N00033897,John K Delaney (D),2016,Misc Business,73625,46000,119625
D000620,N00033897,John K Delaney (D),2016,Labor,0,44750,44750
D000620,N00033897,John K Delaney (D),2016,Ideology/Single-Issue,20235,18538,38773
D000620,N00033897,John K Delaney (D),2016,Other,89025,0,89025
B001281,N00033904,Joyce Beatty (D),2016,Agribusiness,750,2250,3000
B001281,N00033904,Joyce Beatty (D),2016,Communic/Electronics,1900,28300,30200
B001281,N00033904,Joyce Beatty (D),2016,Construction,10800,0,10800
B001281,N00033904,Joyce Beatty (D),2016,Defense,0,11000,11000
B001281,N00033904,Joyce Beatty (D),2016,Energy/Nat Resource,2800,47500,50300
B001281,N00033904,Joyce Beatty (D),2016,Finance/Insur/RealEst,59250,378900,438150
B001281,N00033904,Joyce Beatty (D),2016,Health,14910,71500,86410
B001281,N00033904,Joyce Beatty (D),2016,Lawyers & Lobbyists,40302,29250,69552
B001281,N00033904,Joyce Beatty (D),2016,Transportation,7050,28750,35800
B001281,N00033904,Joyce Beatty (D),2016,Misc Business,23910,65500,89410
B001281,N00033904,Joyce Beatty (D),2016,Labor,6500,157500,164000
B001281,N00033904,Joyce Beatty (D),2016,Ideology/Single-Issue,3000,25025,28025
B001281,N00033904,Joyce Beatty (D),2016,Other,46168,5000,51168
A000371,N00033997,Pete Aguilar (D),2016,Agribusiness,607,28600,29207
A000371,N00033997,Pete Aguilar (D),2016,Communic/Electronics,52665,49090,101755
A000371,N00033997,Pete Aguilar (D),2016,Construction,57215,16500,73715
A000371,N00033997,Pete Aguilar (D),2016,Defense,872,86499,87371
A000371,N00033997,Pete Aguilar (D),2016,Energy/Nat Resource,16308,13000,29308
A000371,N00033997,Pete Aguilar (D),2016,Finance/Insur/RealEst,183238,180000,363238
A000371,N00033997,Pete Aguilar (D),2016,Health,79633,97100,176733
A000371,N00033997,Pete Aguilar (D),2016,Lawyers & Lobbyists,144488,23500,167988
A000371,N00033997,Pete Aguilar (D),2016,Transportation,8445,31587,40032
A000371,N00033997,Pete Aguilar (D),2016,Misc Business,90967,49700,140667
A000371,N00033997,Pete Aguilar (D),2016,Labor,470,219000,219470
A000371,N00033997,Pete Aguilar (D),2016,Ideology/Single-Issue,292732,313026,605758
A000371,N00033997,Pete Aguilar (D),2016,Other,159949,1000,160949
C001090,N00034128,Matt Cartwright (D),2016,Agribusiness,12600,1000,13600
C001090,N00034128,Matt Cartwright (D),2016,Communic/Electronics,2280,20000,22280
C001090,N00034128,Matt Cartwright (D),2016,Construction,28285,2000,30285
C001090,N00034128,Matt Cartwright (D),2016,Defense,250,28000,28250
C001090,N00034128,Matt Cartwright (D),2016,Energy/Nat Resource,750,11500,12250
C001090,N00034128,Matt Cartwright (D),2016,Finance/Insur/RealEst,12576,19000,31576
C001090,N00034128,Matt Cartwright (D),2016,Health,3565,29600,33165
C001090,N00034128,Matt Cartwright (D),2016,Lawyers & Lobbyists,259756,14000,273756
C001090,N00034128,Matt Cartwright (D),2016,Transportation,3150,21000,24150
C001090,N00034128,Matt Cartwright (D),2016,Misc Business,20670,23500,44170
C001090,N00034128,Matt Cartwright (D),2016,Labor,1350,237750,239100
C001090,N00034128,Matt Cartwright (D),2016,Ideology/Single-Issue,11375,19571,30946
C001090,N00034128,Matt Cartwright (D),2016,Other,21892,1500,23392
C001094,N00034224,Paul Cook (R),2016,Agribusiness,1000,12000,13000
C001094,N00034224,Paul Cook (R),2016,Communic/Electronics,16300,15210,31510
C001094,N00034224,Paul Cook (R),2016,Construction,35700,45500,81200
C001094,N00034224,Paul Cook (R),2016,Defense,0,94000,94000
C001094,N00034224,Paul Cook (R),2016,Energy/Nat Resource,20300,33500,53800
C001094,N00034224,Paul Cook (R),2016,Finance/Insur/RealEst,30450,33000,63450
C001094,N00034224,Paul Cook (R),2016,Health,10900,18000,28900
C001094,N00034224,Paul Cook (R),2016,Lawyers & Lobbyists,33150,3000,36150
C001094,N00034224,Paul Cook (R),2016,Transportation,1750,30200,31950
C001094,N00034224,Paul Cook (R),2016,Misc Business,96650,16000,112650
C001094,N00034224,Paul Cook (R),2016,Labor,0,162000,162000
C001094,N00034224,Paul Cook (R),2016,Ideology/Single-Issue,8800,135183,143983
C001094,N00034224,Paul Cook (R),2016,Other,16300,0,16300
B001285,N00034254,Julia Brownley (D),2016,Agribusiness,26125,21059,47184
B001285,N00034254,Julia Brownley (D),2016,Communic/Electronics,88332,34000,122332
B001285,N00034254,Julia Brownley (D),2016,Construction,30937,11500,42437
B001285,N00034254,Julia Brownley (D),2016,Defense,881,8000,8881
B001285,N00034254,Julia Brownley (D),2016,Energy/Nat Resource,3713,13000,16713
B001285,N00034254,Julia Brownley (D),2016,Finance/Insur/RealEst,131917,67000,198917
B001285,N00034254,Julia Brownley (D),2016,Health,60860,125500,186360
B001285,N00034254,Julia Brownley (D),2016,Lawyers & Lobbyists,133978,13000,146978
B001285,N00034254,Julia Brownley (D),2016,Transportation,2029,73000,75029
B001285,N00034254,Julia Brownley (D),2016,Misc Business,118832,20000,138832
B001285,N00034254,Julia Brownley (D),2016,Labor,700,303905,304605
B001285,N00034254,Julia Brownley (D),2016,Ideology/Single-Issue,615609,342228,957837
B001285,N00034254,Julia Brownley (D),2016,Other,276190,3500,279690
E000297,N00034549,Adriano Espaillat (D),2016,Agribusiness,26400,0,26400
E000297,N00034549,Adriano Espaillat (D),2016,Communic/Electronics,18500,9500,28000
E000297,N00034549,Adriano Espaillat (D),2016,Construction,10450,0,10450
E000297,N00034549,Adriano Espaillat (D),2016,Finance/Insur/RealEst,71000,12500,83500
E000297,N00034549,Adriano Espaillat (D),2016,Health,59770,11000,70770
E000297,N00034549,Adriano Espaillat (D),2016,Lawyers & Lobbyists,37500,12500,50000
E000297,N00034549,Adriano Espaillat (D),2016,Misc Business,59925,2500,62425
E000297,N00034549,Adriano Espaillat (D),2016,Labor,0,104000,104000
E000297,N00034549,Adriano Espaillat (D),2016,Ideology/Single-Issue,2050,62716,64766
E000297,N00034549,Adriano Espaillat (D),2016,Other,62025,0,62025
D000621,N00034746,Ron DeSantis (R),2016,Agribusiness,57340,17500,74840
D000621,N00034746,Ron DeSantis (R),2016,Communic/Electronics,58045,48500,106545
D000621,N00034746,Ron DeSantis (R),2016,Construction,120602,5000,125602
D000621,N00034746,Ron DeSantis (R),2016,Defense,23490,24500,47990
D000621,N00034746,Ron DeSantis (R),2016,Energy/Nat Resource,47393,30250,77643
D000621,N00034746,Ron DeSantis (R),2016,Finance/Insur/RealEst,678156,49500,727656
D000621,N00034746,Ron DeSantis (R),2016,Health,148157,14000,162157
D000621,N00034746,Ron DeSantis (R),2016,Lawyers & Lobbyists,114333,14000,128333
D000621,N00034746,Ron DeSantis (R),2016,Transportation,65441,16500,81941
D000621,N00034746,Ron DeSantis (R),2016,Misc Business,348200,23000,371200
D000621,N00034746,Ron DeSantis (R),2016,Labor,25,0,25
D000621,N00034746,Ron DeSantis (R),2016,Ideology/Single-Issue,684931,241211,926142
D000621,N00034746,Ron DeSantis (R),2016,Other,863487,2500,865987
D000619,N00034784,Rodney Davis (R),2016,Agribusiness,43905,336806,380711
D000619,N00034784,Rodney Davis (R),2016,Communic/Electronics,3875,54500,58375
D000619,N00034784,Rodney Davis (R),2016,Construction,33850,98750,132600
D000619,N00034784,Rodney Davis (R),2016,Defense,0,1000,1000
D000619,N00034784,Rodney Davis (R),2016,Energy/Nat Resource,2600,123500,126100
D000619,N00034784,Rodney Davis (R),2016,Finance/Insur/RealEst,109371,229500,338871
D000619,N00034784,Rodney Davis (R),2016,Health,31475,131950,163425
D000619,N00034784,Rodney Davis (R),2016,Lawyers & Lobbyists,78557,28500,107057
D000619,N00034784,Rodney Davis (R),2016,Transportation,18450,196499,214949
D000619,N00034784,Rodney Davis (R),2016,Misc Business,79312,187489,266801
D000619,N00034784,Rodney Davis (R),2016,Labor,0,148700,148700
D000619,N00034784,Rodney Davis (R),2016,Ideology/Single-Issue,29923,221876,251799
D000619,N00034784,Rodney Davis (R),2016,Other,52586,5500,58086
B001288,N00035267,Cory Booker (D),2016,Agribusiness,227775,20000,247775
B001288,N00035267,Cory Booker (D),2016,Communic/Electronics,1509048,233200,1742248
B001288,N00035267,Cory Booker (D),2016,Construction,302287,32600,334887
B001288,N00035267,Cory Booker (D),2016,Defense,4272,23500,27772
B001288,N00035267,Cory Booker (D),2016,Energy/Nat Resource,162566,143348,305914
B001288,N00035267,Cory Booker (D),2016,Finance/Insur/RealEst,4580736,335200,4915936
B001288,N00035267,Cory Booker (D),2016,Health,678572,328600,1007172
B001288,N00035267,Cory Booker (D),2016,Lawyers & Lobbyists,2666585,196891,2863476
B001288,N00035267,Cory Booker (D),2016,Transportation,182887,212026,394913
B001288,N00035267,Cory Booker (D),2016,Misc Business,1589496,198229,1787725
B001288,N00035267,Cory Booker (D),2016,Labor,5820,267600,273420
B001288,N00035267,Cory Booker (D),2016,Ideology/Single-Issue,828091,285932,1114023
B001288,N00035267,Cory Booker (D),2016,Other,1227798,6000,1233798
C001101,N00035278,Katherine Clark (D),2016,Agribusiness,6950,15500,22450
C001101,N00035278,Katherine Clark (D),2016,Communic/Electronics,31463,24240,55703
C001101,N00035278,Katherine Clark (D),2016,Construction,10160,9000,19160
C001101,N00035278,Katherine Clark (D),2016,Defense,2500,24000,26500
C001101,N00035278,Katherine Clark (D),2016,Energy/Nat Resource,3303,12500,15803
C001101,N00035278,Katherine Clark (D),2016,Finance/Insur/RealEst,118292,65500,183792
C001101,N00035278,Katherine Clark (D),2016,Health,42228,123750,165978
C001101,N00035278,Katherine Clark (D),2016,Lawyers & Lobbyists,101285,21500,122785
C001101,N00035278,Katherine Clark (D),2016,Transportation,5100,4500,9600
C001101,N00035278,Katherine Clark (D),2016,Misc Business,28516,30156,58672
C001101,N00035278,Katherine Clark (D),2016,Labor,0,193250,193250
C001101,N00035278,Katherine Clark (D),2016,Ideology/Single-Issue,82887,30030,112917
C001101,N00035278,Katherine Clark (D),2016,Other,121836,0,121836
B001296,N00035307,Brendan Boyle (D),2016,Agribusiness,3000,20000,23000
B001296,N00035307,Brendan Boyle (D),2016,Communic/Electronics,12100,34000,46100
B001296,N00035307,Brendan Boyle (D),2016,Construction,3700,22000,25700
B001296,N00035307,Brendan Boyle (D),2016,Defense,0,19000,19000
B001296,N00035307,Brendan Boyle (D),2016,Energy/Nat Resource,750,27000,27750
B001296,N00035307,Brendan Boyle (D),2016,Finance/Insur/RealEst,93350,100500,193850
B001296,N00035307,Brendan Boyle (D),2016,Health,17575,87450,105025
B001296,N00035307,Brendan Boyle (D),2016,Lawyers & Lobbyists,68650,19000,87650
B001296,N00035307,Brendan Boyle (D),2016,Transportation,2000,33500,35500
B001296,N00035307,Brendan Boyle (D),2016,Misc Business,29400,39000,68400
B001296,N00035307,Brendan Boyle (D),2016,Labor,0,216512,216512
B001296,N00035307,Brendan Boyle (D),2016,Ideology/Single-Issue,25050,61999,87049
B001296,N00035307,Brendan Boyle (D),2016,Other,11810,0,11810
C001103,N00035346,Buddy Carter (R),2016,Agribusiness,13525,87498,101023
C001103,N00035346,Buddy Carter (R),2016,Communic/Electronics,4350,24500,28850
C001103,N00035346,Buddy Carter (R),2016,Construction,20550,26000,46550
C001103,N00035346,Buddy Carter (R),2016,Defense,0,35000,35000
C001103,N00035346,Buddy Carter (R),2016,Energy/Nat Resource,14850,26250,41100
C001103,N00035346,Buddy Carter (R),2016,Finance/Insur/RealEst,25774,80000,105774
C001103,N00035346,Buddy Carter (R),2016,Health,75218,191100,266318
C001103,N00035346,Buddy Carter (R),2016,Lawyers & Lobbyists,30612,13500,44112
C001103,N00035346,Buddy Carter (R),2016,Transportation,22250,37000,59250
C001103,N00035346,Buddy Carter (R),2016,Misc Business,104450,96248,200698
C001103,N00035346,Buddy Carter (R),2016,Labor,0,4500,4500
C001103,N00035346,Buddy Carter (R),2016,Ideology/Single-Issue,10725,43648,54373
C001103,N00035346,Buddy Carter (R),2016,Other,51585,3000,54585
B001289,N00035380,Bradley Byrne (R),2016,Agribusiness,40639,112500,153139
B001289,N00035380,Bradley Byrne (R),2016,Communic/Electronics,8700,20000,28700
B001289,N00035380,Bradley Byrne (R),2016,Construction,43850,58000,101850
B001289,N00035380,Bradley Byrne (R),2016,Defense,3750,115300,119050
B001289,N00035380,Bradley Byrne (R),2016,Energy/Nat Resource,12050,60500,72550
B001289,N00035380,Bradley Byrne (R),2016,Finance/Insur/RealEst,59460,149500,208960
B001289,N00035380,Bradley Byrne (R),2016,Health,29222,38200,67422
B001289,N00035380,Bradley Byrne (R),2016,Lawyers & Lobbyists,62250,33750,96000
B001289,N00035380,Bradley Byrne (R),2016,Transportation,25900,47000,72900
B001289,N00035380,Bradley Byrne (R),2016,Misc Business,46983,106600,153583
B001289,N00035380,Bradley Byrne (R),2016,Labor,0,12500,12500
B001289,N00035380,Bradley Byrne (R),2016,Ideology/Single-Issue,3611,67150,70761
B001289,N00035380,Bradley Byrne (R),2016,Other,42975,6500,49475
C001107,N00035403,Carlos Curbelo (R),2016,Agribusiness,80200,69500,149700
C001107,N00035403,Carlos Curbelo (R),2016,Communic/Electronics,14350,75590,89940
C001107,N00035403,Carlos Curbelo (R),2016,Construction,95732,79000,174732
C001107,N00035403,Carlos Curbelo (R),2016,Defense,5400,1000,6400
C001107,N00035403,Carlos Curbelo (R),2016,Energy/Nat Resource,39900,66000,105900
C001107,N00035403,Carlos Curbelo (R),2016,Finance/Insur/RealEst,358300,337700,696000
C001107,N00035403,Carlos Curbelo (R),2016,Health,82825,59000,141825
C001107,N00035403,Carlos Curbelo (R),2016,Lawyers & Lobbyists,149030,30250,179280
C001107,N00035403,Carlos Curbelo (R),2016,Transportation,56300,177495,233795
C001107,N00035403,Carlos Curbelo (R),2016,Misc Business,153550,185193,338743
C001107,N00035403,Carlos Curbelo (R),2016,Labor,2000,100000,102000
C001107,N00035403,Carlos Curbelo (R),2016,Ideology/Single-Issue,276691,646780,923471
C001107,N00035403,Carlos Curbelo (R),2016,Other,242570,10000,252570
B001295,N00035420,Mike Bost (R),2016,Agribusiness,89650,139612,229262
B001295,N00035420,Mike Bost (R),2016,Communic/Electronics,3350,30000,33350
B001295,N00035420,Mike Bost (R),2016,Construction,42170,41100,83270
B001295,N00035420,Mike Bost (R),2016,Defense,0,24000,24000
B001295,N00035420,Mike Bost (R),2016,Energy/Nat Resource,42750,70750,113500
B001295,N00035420,Mike Bost (R),2016,Finance/Insur/RealEst,129485,102700,232185
B001295,N00035420,Mike Bost (R),2016,Health,38245,56250,94495
B001295,N00035420,Mike Bost (R),2016,Lawyers & Lobbyists,55279,15500,70779
B001295,N00035420,Mike Bost (R),2016,Transportation,43000,74900,117900
B001295,N00035420,Mike Bost (R),2016,Misc Business,101119,89998,191117
B001295,N00035420,Mike Bost (R),2016,Labor,200,116500,116700
B001295,N00035420,Mike Bost (R),2016,Ideology/Single-Issue,32450,314516,346966
B001295,N00035420,Mike Bost (R),2016,Other,166066,0,166066
E000294,N00035440,Tom Emmer (R),2016,Agribusiness,54181,113500,167681
E000294,N00035440,Tom Emmer (R),2016,Communic/Electronics,38280,23500,61780
E000294,N00035440,Tom Emmer (R),2016,Construction,42680,24000,66680
E000294,N00035440,Tom Emmer (R),2016,Defense,0,3000,3000
E000294,N00035440,Tom Emmer (R),2016,Energy/Nat Resource,7450,21000,28450
E000294,N00035440,Tom Emmer (R),2016,Finance/Insur/RealEst,124455,362350,486805
E000294,N00035440,Tom Emmer (R),2016,Health,18440,32500,50940
E000294,N00035440,Tom Emmer (R),2016,Lawyers & Lobbyists,40650,23375,64025
E000294,N00035440,Tom Emmer (R),2016,Transportation,34050,31500,65550
E000294,N00035440,Tom Emmer (R),2016,Misc Business,59690,65498,125188
E000294,N00035440,Tom Emmer (R),2016,Labor,0,42000,42000
E000294,N00035440,Tom Emmer (R),2016,Ideology/Single-Issue,81310,58730,140040
E000294,N00035440,Tom Emmer (R),2016,Other,161543,1000,162543
A000370,N00035451,Alma Adams (D),2016,Agribusiness,4510,41000,45510
A000370,N00035451,Alma Adams (D),2016,Communic/Electronics,1930,28500,30430
A000370,N00035451,Alma Adams (D),2016,Construction,3962,0,3962
A000370,N00035451,Alma Adams (D),2016,Defense,0,8000,8000
A000370,N00035451,Alma Adams (D),2016,Energy/Nat Resource,250,11000,11250
A000370,N00035451,Alma Adams (D),2016,Finance/Insur/RealEst,13217,76000,89217
A000370,N00035451,Alma Adams (D),2016,Health,28725,29500,58225
A000370,N00035451,Alma Adams (D),2016,Lawyers & Lobbyists,25965,9500,35465
A000370,N00035451,Alma Adams (D),2016,Transportation,150,24500,24650
A000370,N00035451,Alma Adams (D),2016,Misc Business,18942,27417,46359
A000370,N00035451,Alma Adams (D),2016,Labor,0,190000,190000
A000370,N00035451,Alma Adams (D),2016,Ideology/Single-Issue,35644,165472,201116
A000370,N00035451,Alma Adams (D),2016,Other,55767,2000,57767
E000295,N00035483,Joni Ernst (R),2016,Agribusiness,105043,176200,281243
E000295,N00035483,Joni Ernst (R),2016,Communic/Electronics,27775,55600,83375
E000295,N00035483,Joni Ernst (R),2016,Construction,51950,58100,110050
E000295,N00035483,Joni Ernst (R),2016,Defense,1550,23000,24550
E000295,N00035483,Joni Ernst (R),2016,Energy/Nat Resource,90055,177500,267555
E000295,N00035483,Joni Ernst (R),2016,Finance/Insur/RealEst,450265,184500,634765
E000295,N00035483,Joni Ernst (R),2016,Health,48490,47500,95990
E000295,N00035483,Joni Ernst (R),2016,Lawyers & Lobbyists,78215,27250,105465
E000295,N00035483,Joni Ernst (R),2016,Transportation,50165,91846,142011
E000295,N00035483,Joni Ernst (R),2016,Misc Business,189400,230099,419499
E000295,N00035483,Joni Ernst (R),2016,Labor,0,1500,1500
E000295,N00035483,Joni Ernst (R),2016,Ideology/Single-Issue,131660,541034,672694
E000295,N00035483,Joni Ernst (R),2016,Other,296102,7250,303352
C001109,N00035504,Liz Cheney (R),2016,Agribusiness,28470,25500,53970
C001109,N00035504,Liz Cheney (R),2016,Communic/Electronics,60773,12500,73273
C001109,N00035504,Liz Cheney (R),2016,Construction,48500,12500,61000
C001109,N00035504,Liz Cheney (R),2016,Defense,500,10000,10500
C001109,N00035504,Liz Cheney (R),2016,Energy/Nat Resource,109566,55800,165366
C001109,N00035504,Liz Cheney (R),2016,Finance/Insur/RealEst,415248,26500,441748
C001109,N00035504,Liz Cheney (R),2016,Health,60816,4500,65316
C001109,N00035504,Liz Cheney (R),2016,Lawyers & Lobbyists,84600,3500,88100
C001109,N00035504,Liz Cheney (R),2016,Transportation,27100,15500,42600
C001109,N00035504,Liz Cheney (R),2016,Misc Business,161390,26000,187390
C001109,N00035504,Liz Cheney (R),2016,Ideology/Single-Issue,77318,124250,201568
C001109,N00035504,Liz Cheney (R),2016,Other,352556,0,352556
G000575,N00035688,Gwen Graham (D),2016,Agribusiness,18750,66500,85250
G000575,N00035688,Gwen Graham (D),2016,Communic/Electronics,28542,22275,50817
G000575,N00035688,Gwen Graham (D),2016,Construction,12450,5000,17450
G000575,N00035688,Gwen Graham (D),2016,Defense,6800,46500,53300
G000575,N00035688,Gwen Graham (D),2016,Energy/Nat Resource,22500,26500,49000
G000575,N00035688,Gwen Graham (D),2016,Finance/Insur/RealEst,169680,80000,249680
G000575,N00035688,Gwen Graham (D),2016,Health,28864,105800,134664
G000575,N00035688,Gwen Graham (D),2016,Lawyers & Lobbyists,200475,11000,211475
G000575,N00035688,Gwen Graham (D),2016,Transportation,11000,16500,27500
G000575,N00035688,Gwen Graham (D),2016,Misc Business,47860,51000,98860
G000575,N00035688,Gwen Graham (D),2016,Labor,745,102000,102745
G000575,N00035688,Gwen Graham (D),2016,Ideology/Single-Issue,112361,171397,283758
G000575,N00035688,Gwen Graham (D),2016,Other,152893,5622,158515
C001102,N00035854,Curt Clawson (R),2016,Agribusiness,1000,0,1000
C001102,N00035854,Curt Clawson (R),2016,Communic/Electronics,5250,0,5250
C001102,N00035854,Curt Clawson (R),2016,Construction,4041,0,4041
C001102,N00035854,Curt Clawson (R),2016,Defense,250,0,250
C001102,N00035854,Curt Clawson (R),2016,Energy/Nat Resource,1000,0,1000
C001102,N00035854,Curt Clawson (R),2016,Finance/Insur/RealEst,40473,0,40473
C001102,N00035854,Curt Clawson (R),2016,Health,8500,0,8500
C001102,N00035854,Curt Clawson (R),2016,Lawyers & Lobbyists,25147,0,25147
C001102,N00035854,Curt Clawson (R),2016,Transportation,12966,0,12966
C001102,N00035854,Curt Clawson (R),2016,Misc Business,5790,0,5790
C001102,N00035854,Curt Clawson (R),2016,Ideology/Single-Issue,0,5000,5000
C001102,N00035854,Curt Clawson (R),2016,Other,142337,0,142337
B001290,N00036013,Dave Brat (R),2016,Agribusiness,19375,13002,32377
B001290,N00036013,Dave Brat (R),2016,Communic/Electronics,9923,7000,16923
B001290,N00036013,Dave Brat (R),2016,Construction,27300,8500,35800
B001290,N00036013,Dave Brat (R),2016,Defense,25,5000,5025
B001290,N00036013,Dave Brat (R),2016,Energy/Nat Resource,6074,19000,25074
B001290,N00036013,Dave Brat (R),2016,Finance/Insur/RealEst,200618,20500,221118
B001290,N00036013,Dave Brat (R),2016,Health,40243,10500,50743
B001290,N00036013,Dave Brat (R),2016,Lawyers & Lobbyists,27664,1250,28914
B001290,N00036013,Dave Brat (R),2016,Transportation,21250,28000,49250
B001290,N00036013,Dave Brat (R),2016,Misc Business,60693,8498,69191
B001290,N00036013,Dave Brat (R),2016,Ideology/Single-Issue,89501,43483,132984
B001290,N00036013,Dave Brat (R),2016,Other,176255,1500,177755
B001292,N00036018,Don Beyer (D),2016,Agribusiness,3125,27500,30625
B001292,N00036018,Don Beyer (D),2016,Communic/Electronics,62325,99400,161725
B001292,N00036018,Don Beyer (D),2016,Construction,35950,25500,61450
B001292,N00036018,Don Beyer (D),2016,Defense,16450,116800,133250
B001292,N00036018,Don Beyer (D),2016,Energy/Nat Resource,11150,53900,65050
B001292,N00036018,Don Beyer (D),2016,Finance/Insur/RealEst,166225,149000,315225
B001292,N00036018,Don Beyer (D),2016,Health,21151,87500,108651
B001292,N00036018,Don Beyer (D),2016,Lawyers & Lobbyists,183020,38200,221220
B001292,N00036018,Don Beyer (D),2016,Transportation,68644,81682,150326
B001292,N00036018,Don Beyer (D),2016,Misc Business,78578,78500,157078
B001292,N00036018,Don Beyer (D),2016,Labor,300,72250,72550
B001292,N00036018,Don Beyer (D),2016,Ideology/Single-Issue,70351,40418,110769
B001292,N00036018,Don Beyer (D),2016,Other,231934,1500,233434
C001105,N00036023,Barbara Comstock (R),2016,Agribusiness,53950,88536,142486
C001105,N00036023,Barbara Comstock (R),2016,Communic/Electronics,113181,141383,254564
C001105,N00036023,Barbara Comstock (R),2016,Construction,70590,96000,166590
C001105,N00036023,Barbara Comstock (R),2016,Defense,39875,61602,101477
C001105,N00036023,Barbara Comstock (R),2016,Energy/Nat Resource,35425,95200,130625
C001105,N00036023,Barbara Comstock (R),2016,Finance/Insur/RealEst,603277,242500,845777
C001105,N00036023,Barbara Comstock (R),2016,Health,59426,102000,161426
C001105,N00036023,Barbara Comstock (R),2016,Lawyers & Lobbyists,451565,53763,505328
C001105,N00036023,Barbara Comstock (R),2016,Transportation,58614,194495,253109
C001105,N00036023,Barbara Comstock (R),2016,Misc Business,272475,215148,487623
C001105,N00036023,Barbara Comstock (R),2016,Labor,250,55000,55250
C001105,N00036023,Barbara Comstock (R),2016,Ideology/Single-Issue,167511,555500,723011
C001105,N00036023,Barbara Comstock (R),2016,Other,415217,3500,418717
G000574,N00036097,Ruben Gallego (D),2016,Agribusiness,14450,9500,23950
G000574,N00036097,Ruben Gallego (D),2016,Communic/Electronics,2280,34500,36780
G000574,N00036097,Ruben Gallego (D),2016,Construction,7684,12500,20184
G000574,N00036097,Ruben Gallego (D),2016,Defense,8910,42700,51610
G000574,N00036097,Ruben Gallego (D),2016,Energy/Nat Resource,5031,31000,36031
G000574,N00036097,Ruben Gallego (D),2016,Finance/Insur/RealEst,59435,51000,110435
G000574,N00036097,Ruben Gallego (D),2016,Health,22633,66500,89133
G000574,N00036097,Ruben Gallego (D),2016,Lawyers & Lobbyists,68465,17500,85965
G000574,N00036097,Ruben Gallego (D),2016,Transportation,6700,12000,18700
G000574,N00036097,Ruben Gallego (D),2016,Misc Business,65495,28042,93537
G000574,N00036097,Ruben Gallego (D),2016,Labor,12,159000,159012
G000574,N00036097,Ruben Gallego (D),2016,Ideology/Single-Issue,34061,40000,74061
G000574,N00036097,Ruben Gallego (D),2016,Other,28577,7000,35577
G000577,N00036135,Garret Graves (R),2016,Agribusiness,14090,60000,74090
G000577,N00036135,Garret Graves (R),2016,Communic/Electronics,32150,38000,70150
G000577,N00036135,Garret Graves (R),2016,Construction,100427,69750,170177
G000577,N00036135,Garret Graves (R),2016,Defense,250,3000,3250
G000577,N00036135,Garret Graves (R),2016,Energy/Nat Resource,70116,186183,256299
G000577,N00036135,Garret Graves (R),2016,Finance/Insur/RealEst,83906,82950,166856
G000577,N00036135,Garret Graves (R),2016,Health,32250,45000,77250
G000577,N00036135,Garret Graves (R),2016,Lawyers & Lobbyists,141937,54100,196037
G000577,N00036135,Garret Graves (R),2016,Transportation,71250,160099,231349
G000577,N00036135,Garret Graves (R),2016,Misc Business,109157,86632,195789
G000577,N00036135,Garret Graves (R),2016,Labor,0,41822,41822
G000577,N00036135,Garret Graves (R),2016,Ideology/Single-Issue,36050,42634,78684
G000577,N00036135,Garret Graves (R),2016,Other,40350,1000,41350
D000624,N00036149,Debbie Dingell (D),2016,Agribusiness,7000,24000,31000
D000624,N00036149,Debbie Dingell (D),2016,Communic/Electronics,22250,23000,45250
D000624,N00036149,Debbie Dingell (D),2016,Construction,12454,1000,13454
D000624,N00036149,Debbie Dingell (D),2016,Defense,4000,21000,25000
D000624,N00036149,Debbie Dingell (D),2016,Energy/Nat Resource,10200,63200,73400
D000624,N00036149,Debbie Dingell (D),2016,Finance/Insur/RealEst,58749,58000,116749
D000624,N00036149,Debbie Dingell (D),2016,Health,17000,48000,65000
D000624,N00036149,Debbie Dingell (D),2016,Lawyers & Lobbyists,74375,39600,113975
D000624,N00036149,Debbie Dingell (D),2016,Transportation,20800,50000,70800
D000624,N00036149,Debbie Dingell (D),2016,Misc Business,69214,42700,111914
D000624,N00036149,Debbie Dingell (D),2016,Labor,100,170000,170100
D000624,N00036149,Debbie Dingell (D),2016,Ideology/Single-Issue,9777,37477,47254
D000624,N00036149,Debbie Dingell (D),2016,Other,99950,0,99950
G000576,N00036409,Glenn S Grothman (R),2016,Agribusiness,36400,14500,50900
G000576,N00036409,Glenn S Grothman (R),2016,Communic/Electronics,2550,9750,12300
G000576,N00036409,Glenn S Grothman (R),2016,Construction,33658,16500,50158
G000576,N00036409,Glenn S Grothman (R),2016,Defense,0,7000,7000
G000576,N00036409,Glenn S Grothman (R),2016,Energy/Nat Resource,13485,28500,41985
G000576,N00036409,Glenn S Grothman (R),2016,Finance/Insur/RealEst,74519,48000,122519
G000576,N00036409,Glenn S Grothman (R),2016,Health,19950,9700,29650
G000576,N00036409,Glenn S Grothman (R),2016,Lawyers & Lobbyists,34530,3000,37530
G000576,N00036409,Glenn S Grothman (R),2016,Transportation,7950,51500,59450
G000576,N00036409,Glenn S Grothman (R),2016,Misc Business,64800,48198,112998
G000576,N00036409,Glenn S Grothman (R),2016,Labor,0,1000,1000
G000576,N00036409,Glenn S Grothman (R),2016,Ideology/Single-Issue,13432,40400,53832
G000576,N00036409,Glenn S Grothman (R),2016,Other,147147,2000,149147
B001293,N00036449,Mike Bishop (R),2016,Agribusiness,2470,44500,46970
B001293,N00036449,Mike Bishop (R),2016,Communic/Electronics,11425,74885,86310
B001293,N00036449,Mike Bishop (R),2016,Construction,44000,22500,66500
B001293,N00036449,Mike Bishop (R),2016,Defense,0,17500,17500
B001293,N00036449,Mike Bishop (R),2016,Energy/Nat Resource,9550,58500,68050
B001293,N00036449,Mike Bishop (R),2016,Finance/Insur/RealEst,141475,167200,308675
B001293,N00036449,Mike Bishop (R),2016,Health,20825,76950,97775
B001293,N00036449,Mike Bishop (R),2016,Lawyers & Lobbyists,49325,14500,63825
B001293,N00036449,Mike Bishop (R),2016,Transportation,40750,60750,101500
B001293,N00036449,Mike Bishop (R),2016,Misc Business,114599,115902,230501
B001293,N00036449,Mike Bishop (R),2016,Labor,0,4000,4000
B001293,N00036449,Mike Bishop (R),2016,Ideology/Single-Issue,2600,258750,261350
B001293,N00036449,Mike Bishop (R),2016,Other,39125,250,39375
A000374,N00036633,Ralph Abraham (R),2016,Agribusiness,32971,96250,129221
A000374,N00036633,Ralph Abraham (R),2016,Communic/Electronics,2500,8500,11000
A000374,N00036633,Ralph Abraham (R),2016,Construction,11500,7500,19000
A000374,N00036633,Ralph Abraham (R),2016,Defense,0,8000,8000
A000374,N00036633,Ralph Abraham (R),2016,Energy/Nat Resource,6250,22000,28250
A000374,N00036633,Ralph Abraham (R),2016,Finance/Insur/RealEst,42875,23000,65875
A000374,N00036633,Ralph Abraham (R),2016,Health,32350,35500,67850
A000374,N00036633,Ralph Abraham (R),2016,Lawyers & Lobbyists,13250,9000,22250
A000374,N00036633,Ralph Abraham (R),2016,Transportation,4000,11000,15000
A000374,N00036633,Ralph Abraham (R),2016,Misc Business,31200,13000,44200
A000374,N00036633,Ralph Abraham (R),2016,Labor,0,6500,6500
A000374,N00036633,Ralph Abraham (R),2016,Ideology/Single-Issue,4700,49500,54200
A000374,N00036633,Ralph Abraham (R),2016,Other,14100,1000,15100
D000625,N00036928,Dan Donovan (R),2016,Agribusiness,6700,25000,31700
D000625,N00036928,Dan Donovan (R),2016,Communic/Electronics,6000,38700,44700
D000625,N00036928,Dan Donovan (R),2016,Construction,56489,31500,87989
D000625,N00036928,Dan Donovan (R),2016,Defense,0,5000,5000
D000625,N00036928,Dan Donovan (R),2016,Energy/Nat Resource,18500,21500,40000
D000625,N00036928,Dan Donovan (R),2016,Finance/Insur/RealEst,261103,168500,429603
D000625,N00036928,Dan Donovan (R),2016,Health,61575,16000,77575
D000625,N00036928,Dan Donovan (R),2016,Lawyers & Lobbyists,145979,11750,157729
D000625,N00036928,Dan Donovan (R),2016,Transportation,38150,17500,55650
D000625,N00036928,Dan Donovan (R),2016,Misc Business,89525,35500,125025
D000625,N00036928,Dan Donovan (R),2016,Labor,500,162250,162750
D000625,N00036928,Dan Donovan (R),2016,Ideology/Single-Issue,18725,248933,267658
D000625,N00036928,Dan Donovan (R),2016,Other,93995,0,93995
G000583,N00036944,Josh Gottheimer (D),2016,Agribusiness,13739,1000,14739
G000583,N00036944,Josh Gottheimer (D),2016,Communic/Electronics,290259,18000,308259
G000583,N00036944,Josh Gottheimer (D),2016,Construction,53690,9500,63190
G000583,N00036944,Josh Gottheimer (D),2016,Defense,2761,0,2761
G000583,N00036944,Josh Gottheimer (D),2016,Energy/Nat Resource,54864,10500,65364
G000583,N00036944,Josh Gottheimer (D),2016,Finance/Insur/RealEst,949526,22000,971526
G000583,N00036944,Josh Gottheimer (D),2016,Health,124650,33799,158449
G000583,N00036944,Josh Gottheimer (D),2016,Lawyers & Lobbyists,539322,19000,558322
G000583,N00036944,Josh Gottheimer (D),2016,Transportation,20859,0,20859
G000583,N00036944,Josh Gottheimer (D),2016,Misc Business,274074,10000,284074
G000583,N00036944,Josh Gottheimer (D),2016,Labor,2135,187200,189335
G000583,N00036944,Josh Gottheimer (D),2016,Ideology/Single-Issue,234645,323660,558305
G000583,N00036944,Josh Gottheimer (D),2016,Other,373905,5500,379405
B001304,N00036999,Anthony Brown (D),2016,Agribusiness,4700,9500,14200
B001304,N00036999,Anthony Brown (D),2016,Communic/Electronics,17575,16000,33575
B001304,N00036999,Anthony Brown (D),2016,Construction,21775,5750,27525
B001304,N00036999,Anthony Brown (D),2016,Defense,6185,6500,12685
B001304,N00036999,Anthony Brown (D),2016,Energy/Nat Resource,9150,12000,21150
B001304,N00036999,Anthony Brown (D),2016,Finance/Insur/RealEst,95906,27000,122906
B001304,N00036999,Anthony Brown (D),2016,Health,53175,37500,90675
B001304,N00036999,Anthony Brown (D),2016,Lawyers & Lobbyists,117294,12750,130044
B001304,N00036999,Anthony Brown (D),2016,Transportation,18950,11500,30450
B001304,N00036999,Anthony Brown (D),2016,Misc Business,52843,42000,94843
B001304,N00036999,Anthony Brown (D),2016,Labor,365,143500,143865
B001304,N00036999,Anthony Brown (D),2016,Ideology/Single-Issue,28956,99975,128931
B001304,N00036999,Anthony Brown (D),2016,Other,77891,0,77891
C001112,N00037015,Salud Carbajal (D),2016,Agribusiness,49250,6000,55250
C001112,N00037015,Salud Carbajal (D),2016,Communic/Electronics,119788,4500,124288
C001112,N00037015,Salud Carbajal (D),2016,Construction,92381,2000,94381
C001112,N00037015,Salud Carbajal (D),2016,Defense,375,5000,5375
C001112,N00037015,Salud Carbajal (D),2016,Energy/Nat Resource,2850,2700,5550
C001112,N00037015,Salud Carbajal (D),2016,Finance/Insur/RealEst,255707,18000,273707
C001112,N00037015,Salud Carbajal (D),2016,Health,48095,32000,80095
C001112,N00037015,Salud Carbajal (D),2016,Lawyers & Lobbyists,136980,6000,142980
C001112,N00037015,Salud Carbajal (D),2016,Transportation,9600,2500,12100
C001112,N00037015,Salud Carbajal (D),2016,Misc Business,197567,6000,203567
C001112,N00037015,Salud Carbajal (D),2016,Labor,3600,193000,196600
C001112,N00037015,Salud Carbajal (D),2016,Ideology/Single-Issue,265001,327106,592107
C001112,N00037015,Salud Carbajal (D),2016,Other,665813,0,665813
B001300,N00037019,Nanette Barragan (D),2016,Agribusiness,3495,0,3495
B001300,N00037019,Nanette Barragan (D),2016,Communic/Electronics,52720,7500,60220
B001300,N00037019,Nanette Barragan (D),2016,Construction,19640,500,20140
B001300,N00037019,Nanette Barragan (D),2016,Defense,2183,0,2183
B001300,N00037019,Nanette Barragan (D),2016,Energy/Nat Resource,2703,1000,3703
B001300,N00037019,Nanette Barragan (D),2016,Finance/Insur/RealEst,121677,3500,125177
B001300,N00037019,Nanette Barragan (D),2016,Health,33681,19000,52681
B001300,N00037019,Nanette Barragan (D),2016,Lawyers & Lobbyists,246346,9816,256162
B001300,N00037019,Nanette Barragan (D),2016,Transportation,4460,1000,5460
B001300,N00037019,Nanette Barragan (D),2016,Misc Business,56042,3500,59542
B001300,N00037019,Nanette Barragan (D),2016,Labor,3215,30500,33715
B001300,N00037019,Nanette Barragan (D),2016,Ideology/Single-Issue,367278,165185,532463
B001300,N00037019,Nanette Barragan (D),2016,Other,130628,0,130628
B001298,N00037049,Don Bacon (R),2016,Agribusiness,22300,21500,43800
B001298,N00037049,Don Bacon (R),2016,Communic/Electronics,8600,9500,18100
B001298,N00037049,Don Bacon (R),2016,Construction,26000,13500,39500
B001298,N00037049,Don Bacon (R),2016,Defense,5750,6500,12250
B001298,N00037049,Don Bacon (R),2016,Energy/Nat Resource,32150,7000,39150
B001298,N00037049,Don Bacon (R),2016,Finance/Insur/RealEst,116238,39000,155238
B001298,N00037049,Don Bacon (R),2016,Health,42575,10500,53075
B001298,N00037049,Don Bacon (R),2016,Lawyers & Lobbyists,36482,6000,42482
B001298,N00037049,Don Bacon (R),2016,Transportation,18025,14500,32525
B001298,N00037049,Don Bacon (R),2016,Misc Business,78691,39500,118191
B001298,N00037049,Don Bacon (R),2016,Labor,0,14500,14500
B001298,N00037049,Don Bacon (R),2016,Ideology/Single-Issue,43215,358913,402128
B001298,N00037049,Don Bacon (R),2016,Other,224751,11500,236251
C001113,N00037161,Catherine Cortez Masto (D),2016,Agribusiness,87058,8000,95058
C001113,N00037161,Catherine Cortez Masto (D),2016,Communic/Electronics,618367,1000,619367
C001113,N00037161,Catherine Cortez Masto (D),2016,Construction,138694,5000,143694
C001113,N00037161,Catherine Cortez Masto (D),2016,Defense,22778,8000,30778
C001113,N00037161,Catherine Cortez Masto (D),2016,Energy/Nat Resource,66671,46000,112671
C001113,N00037161,Catherine Cortez Masto (D),2016,Finance/Insur/RealEst,1141921,6000,1147921
C001113,N00037161,Catherine Cortez Masto (D),2016,Health,487403,20000,507403
C001113,N00037161,Catherine Cortez Masto (D),2016,Lawyers & Lobbyists,1487771,23474,1511245
C001113,N00037161,Catherine Cortez Masto (D),2016,Transportation,62675,0,62675
C001113,N00037161,Catherine Cortez Masto (D),2016,Misc Business,730574,64000,794574
C001113,N00037161,Catherine Cortez Masto (D),2016,Labor,9373,330500,339873
C001113,N00037161,Catherine Cortez Masto (D),2016,Ideology/Single-Issue,4568237,640893,5209130
C001113,N00037161,Catherine Cortez Masto (D),2016,Other,1583712,2000,1585712
B001299,N00037185,Jim Banks (R),2016,Agribusiness,16055,21000,37055
B001299,N00037185,Jim Banks (R),2016,Communic/Electronics,6200,12000,18200
B001299,N00037185,Jim Banks (R),2016,Construction,31700,12500,44200
B001299,N00037185,Jim Banks (R),2016,Defense,3000,3500,6500
B001299,N00037185,Jim Banks (R),2016,Energy/Nat Resource,9235,32000,41235
B001299,N00037185,Jim Banks (R),2016,Finance/Insur/RealEst,49285,42700,91985
B001299,N00037185,Jim Banks (R),2016,Health,29575,30000,59575
B001299,N00037185,Jim Banks (R),2016,Lawyers & Lobbyists,19590,5500,25090
B001299,N00037185,Jim Banks (R),2016,Transportation,7046,11500,18546
B001299,N00037185,Jim Banks (R),2016,Misc Business,80233,17250,97483
B001299,N00037185,Jim Banks (R),2016,Ideology/Single-Issue,393466,164291,557757
B001299,N00037185,Jim Banks (R),2016,Other,76873,1000,77873
C001110,N00037260,Lou Correa (D),2016,Agribusiness,750,7500,8250
C001110,N00037260,Lou Correa (D),2016,Communic/Electronics,7450,13000,20450
C001110,N00037260,Lou Correa (D),2016,Construction,13550,10000,23550
C001110,N00037260,Lou Correa (D),2016,Defense,1000,7500,8500
C001110,N00037260,Lou Correa (D),2016,Energy/Nat Resource,8500,25500,34000
C001110,N00037260,Lou Correa (D),2016,Finance/Insur/RealEst,41268,69122,110390
C001110,N00037260,Lou Correa (D),2016,Health,25599,74000,99599
C001110,N00037260,Lou Correa (D),2016,Lawyers & Lobbyists,47075,3000,50075
C001110,N00037260,Lou Correa (D),2016,Transportation,9900,22500,32400
C001110,N00037260,Lou Correa (D),2016,Misc Business,63200,36000,99200
C001110,N00037260,Lou Correa (D),2016,Labor,6000,59500,65500
C001110,N00037260,Lou Correa (D),2016,Ideology/Single-Issue,32400,114800,147200
C001110,N00037260,Lou Correa (D),2016,Other,25500,0,25500
F000464,N00037288,John Faso (R),2016,Agribusiness,48275,4000,52275
F000464,N00037288,John Faso (R),2016,Communic/Electronics,41050,7000,48050
F000464,N00037288,John Faso (R),2016,Construction,72275,25750,98025
F000464,N00037288,John Faso (R),2016,Energy/Nat Resource,44575,27000,71575
F000464,N00037288,John Faso (R),2016,Finance/Insur/RealEst,671765,85000,756765
F000464,N00037288,John Faso (R),2016,Health,40550,35000,75550
F000464,N00037288,John Faso (R),2016,Lawyers & Lobbyists,204190,500,204690
F000464,N00037288,John Faso (R),2016,Transportation,18075,24000,42075
F000464,N00037288,John Faso (R),2016,Misc Business,187804,49500,237304
F000464,N00037288,John Faso (R),2016,Labor,0,5000,5000
F000464,N00037288,John Faso (R),2016,Ideology/Single-Issue,72610,221481,294091
F000464,N00037288,John Faso (R),2016,Other,340220,0,340220
D000628,N00037442,Neal Dunn (R),2016,Agribusiness,36300,22000,58300
D000628,N00037442,Neal Dunn (R),2016,Communic/Electronics,4200,13500,17700
D000628,N00037442,Neal Dunn (R),2016,Construction,41050,6000,47050
D000628,N00037442,Neal Dunn (R),2016,Defense,800,3500,4300
D000628,N00037442,Neal Dunn (R),2016,Energy/Nat Resource,4200,17000,21200
D000628,N00037442,Neal Dunn (R),2016,Finance/Insur/RealEst,108610,50500,159110
D000628,N00037442,Neal Dunn (R),2016,Health,278122,92000,370122
D000628,N00037442,Neal Dunn (R),2016,Lawyers & Lobbyists,51335,6500,57835
D000628,N00037442,Neal Dunn (R),2016,Transportation,26070,26500,52570
D000628,N00037442,Neal Dunn (R),2016,Misc Business,82448,20500,102948
D000628,N00037442,Neal Dunn (R),2016,Ideology/Single-Issue,4600,124550,129150
D000628,N00037442,Neal Dunn (R),2016,Other,143944,0,143944
G000582,N00037615,Jenniffer Gonzalez (3),2016,Communic/Electronics,3000,2500,5500
G000582,N00037615,Jenniffer Gonzalez (3),2016,Construction,21600,0,21600
G000582,N00037615,Jenniffer Gonzalez (3),2016,Defense,3000,0,3000
G000582,N00037615,Jenniffer Gonzalez (3),2016,Energy/Nat Resource,2500,0,2500
G000582,N00037615,Jenniffer Gonzalez (3),2016,Finance/Insur/RealEst,70551,3000,73551
G000582,N00037615,Jenniffer Gonzalez (3),2016,Health,54700,3500,58200
G000582,N00037615,Jenniffer Gonzalez (3),2016,Lawyers & Lobbyists,164828,8748,173576
G000582,N00037615,Jenniffer Gonzalez (3),2016,Transportation,4000,15400,19400
G000582,N00037615,Jenniffer Gonzalez (3),2016,Misc Business,127049,4500,131549
G000582,N00037615,Jenniffer Gonzalez (3),2016,Labor,0,5500,5500
G000582,N00037615,Jenniffer Gonzalez (3),2016,Ideology/Single-Issue,0,8500,8500
G000582,N00037615,Jenniffer Gonzalez (3),2016,Other,44945,0,44945
C001108,N00038260,James Comer (R),2016,Agribusiness,93640,39000,132640
C001108,N00038260,James Comer (R),2016,Communic/Electronics,12650,16500,29150
C001108,N00038260,James Comer (R),2016,Construction,44250,24000,68250
C001108,N00038260,James Comer (R),2016,Defense,0,12500,12500
C001108,N00038260,James Comer (R),2016,Energy/Nat Resource,21151,19500,40651
C001108,N00038260,James Comer (R),2016,Finance/Insur/RealEst,75225,44500,119725
C001108,N00038260,James Comer (R),2016,Health,41166,45500,86666
C001108,N00038260,James Comer (R),2016,Lawyers & Lobbyists,54965,2700,57665
C001108,N00038260,James Comer (R),2016,Transportation,21790,14500,36290
C001108,N00038260,James Comer (R),2016,Misc Business,52793,22132,74925
C001108,N00038260,James Comer (R),2016,Ideology/Single-Issue,1000,91200,92200
C001108,N00038260,James Comer (R),2016,Other,88700,1500,90200
A000375,N00038285,Jodey Arrington (R),2016,Agribusiness,134595,90310,224905
A000375,N00038285,Jodey Arrington (R),2016,Communic/Electronics,13350,15000,28350
A000375,N00038285,Jodey Arrington (R),2016,Construction,30700,10000,40700
A000375,N00038285,Jodey Arrington (R),2016,Defense,1000,6000,7000
A000375,N00038285,Jodey Arrington (R),2016,Energy/Nat Resource,51650,41500,93150
A000375,N00038285,Jodey Arrington (R),2016,Finance/Insur/RealEst,180447,56000,236447
A000375,N00038285,Jodey Arrington (R),2016,Health,64072,22500,86572
A000375,N00038285,Jodey Arrington (R),2016,Lawyers & Lobbyists,71924,5000,76924
A000375,N00038285,Jodey Arrington (R),2016,Transportation,21650,26000,47650
A000375,N00038285,Jodey Arrington (R),2016,Misc Business,48667,20500,69167
A000375,N00038285,Jodey Arrington (R),2016,Ideology/Single-Issue,3751,108000,111751
A000375,N00038285,Jodey Arrington (R),2016,Other,173400,1000,174400
B001303,N00038414,Lisa Blunt Rochester (D),2016,Agribusiness,500,5000,5500
B001303,N00038414,Lisa Blunt Rochester (D),2016,Communic/Electronics,10200,21000,31200
B001303,N00038414,Lisa Blunt Rochester (D),2016,Construction,1700,0,1700
B001303,N00038414,Lisa Blunt Rochester (D),2016,Defense,20,5000,5020
B001303,N00038414,Lisa Blunt Rochester (D),2016,Energy/Nat Resource,450,3500,3950
B001303,N00038414,Lisa Blunt Rochester (D),2016,Finance/Insur/RealEst,52363,53500,105863
B001303,N00038414,Lisa Blunt Rochester (D),2016,Health,14985,22125,37110
B001303,N00038414,Lisa Blunt Rochester (D),2016,Lawyers & Lobbyists,61640,10500,72140
B001303,N00038414,Lisa Blunt Rochester (D),2016,Transportation,2550,7000,9550
B001303,N00038414,Lisa Blunt Rochester (D),2016,Misc Business,51741,17500,69241
B001303,N00038414,Lisa Blunt Rochester (D),2016,Labor,0,106500,106500
B001303,N00038414,Lisa Blunt Rochester (D),2016,Ideology/Single-Issue,125280,118398,243678
B001303,N00038414,Lisa Blunt Rochester (D),2016,Other,108129,0,108129
E000296,N00038450,Dwight Evans (D),2016,Agribusiness,26825,2250,29075
E000296,N00038450,Dwight Evans (D),2016,Communic/Electronics,26525,14750,41275
E000296,N00038450,Dwight Evans (D),2016,Construction,42455,6500,48955
E000296,N00038450,Dwight Evans (D),2016,Defense,1250,5000,6250
E000296,N00038450,Dwight Evans (D),2016,Energy/Nat Resource,15050,4500,19550
E000296,N00038450,Dwight Evans (D),2016,Finance/Insur/RealEst,137766,50000,187766
E000296,N00038450,Dwight Evans (D),2016,Health,31900,16500,48400
E000296,N00038450,Dwight Evans (D),2016,Lawyers & Lobbyists,174998,23324,198322
E000296,N00038450,Dwight Evans (D),2016,Transportation,1500,23500,25000
E000296,N00038450,Dwight Evans (D),2016,Misc Business,63934,5000,68934
E000296,N00038450,Dwight Evans (D),2016,Labor,2425,146500,148925
E000296,N00038450,Dwight Evans (D),2016,Ideology/Single-Issue,37088,40990,78078
E000296,N00038450,Dwight Evans (D),2016,Other,88547,0,88547
D000626,N00038767,Warren Davidson (R),2016,Agribusiness,10616,2000,12616
D000626,N00038767,Warren Davidson (R),2016,Communic/Electronics,7681,0,7681
D000626,N00038767,Warren Davidson (R),2016,Construction,2446,2500,4946
D000626,N00038767,Warren Davidson (R),2016,Defense,1068,0,1068
D000626,N00038767,Warren Davidson (R),2016,Energy/Nat Resource,1488,5000,6488
D000626,N00038767,Warren Davidson (R),2016,Finance/Insur/RealEst,94542,21000,115542
D000626,N00038767,Warren Davidson (R),2016,Health,17340,0,17340
D000626,N00038767,Warren Davidson (R),2016,Lawyers & Lobbyists,9775,2700,12475
D000626,N00038767,Warren Davidson (R),2016,Transportation,3680,7000,10680
D000626,N00038767,Warren Davidson (R),2016,Misc Business,57307,13500,70807
D000626,N00038767,Warren Davidson (R),2016,Ideology/Single-Issue,109192,53642,162834
D000626,N00038767,Warren Davidson (R),2016,Other,65698,0,65698
F000466,N00038779,Brian Fitzpatrick (R),2016,Agribusiness,41750,28250,70000
F000466,N00038779,Brian Fitzpatrick (R),2016,Communic/Electronics,22050,17000,39050
F000466,N00038779,Brian Fitzpatrick (R),2016,Construction,87226,36500,123726
F000466,N00038779,Brian Fitzpatrick (R),2016,Defense,2250,3000,5250
F000466,N00038779,Brian Fitzpatrick (R),2016,Energy/Nat Resource,10500,38000,48500
F000466,N00038779,Brian Fitzpatrick (R),2016,Finance/Insur/RealEst,167375,118900,286275
F000466,N00038779,Brian Fitzpatrick (R),2016,Health,40325,89500,129825
F000466,N00038779,Brian Fitzpatrick (R),2016,Lawyers & Lobbyists,100506,9000,109506
F000466,N00038779,Brian Fitzpatrick (R),2016,Transportation,12250,28500,40750
F000466,N00038779,Brian Fitzpatrick (R),2016,Misc Business,115727,59000,174727
F000466,N00038779,Brian Fitzpatrick (R),2016,Labor,0,60000,60000
F000466,N00038779,Brian Fitzpatrick (R),2016,Ideology/Single-Issue,27347,290250,317597
F000466,N00038779,Brian Fitzpatrick (R),2016,Other,137996,4500,142496
G000581,N00038809,Vicente Gonzalez (D),2016,Agribusiness,10150,26500,36650
G000581,N00038809,Vicente Gonzalez (D),2016,Communic/Electronics,1000,8500,9500
G000581,N00038809,Vicente Gonzalez (D),2016,Construction,18250,7500,25750
G000581,N00038809,Vicente Gonzalez (D),2016,Defense,0,2000,2000
G000581,N00038809,Vicente Gonzalez (D),2016,Energy/Nat Resource,2700,3500,6200
G000581,N00038809,Vicente Gonzalez (D),2016,Finance/Insur/RealEst,21250,25500,46750
G000581,N00038809,Vicente Gonzalez (D),2016,Health,7500,16000,23500
G000581,N00038809,Vicente Gonzalez (D),2016,Lawyers & Lobbyists,66700,5000,71700
G000581,N00038809,Vicente Gonzalez (D),2016,Transportation,0,13500,13500
G000581,N00038809,Vicente Gonzalez (D),2016,Misc Business,23050,11000,34050
G000581,N00038809,Vicente Gonzalez (D),2016,Labor,0,78500,78500
G000581,N00038809,Vicente Gonzalez (D),2016,Ideology/Single-Issue,15650,89774,105424
G000581,N00038809,Vicente Gonzalez (D),2016,Other,9250,0,9250
G000580,N00038847,Tom Garrett (R),2016,Agribusiness,25600,15000,40600
G000580,N00038847,Tom Garrett (R),2016,Communic/Electronics,0,9000,9000
G000580,N00038847,Tom Garrett (R),2016,Construction,6050,11500,17550
G000580,N00038847,Tom Garrett (R),2016,Defense,500,6000,6500
G000580,N00038847,Tom Garrett (R),2016,Energy/Nat Resource,10900,17000,27900
G000580,N00038847,Tom Garrett (R),2016,Finance/Insur/RealEst,16800,18000,34800
G000580,N00038847,Tom Garrett (R),2016,Health,14104,6000,20104
G000580,N00038847,Tom Garrett (R),2016,Lawyers & Lobbyists,20800,500,21300
G000580,N00038847,Tom Garrett (R),2016,Transportation,4750,18500,23250
G000580,N00038847,Tom Garrett (R),2016,Misc Business,35940,30043,65983
G000580,N00038847,Tom Garrett (R),2016,Ideology/Single-Issue,14050,120600,134650
G000580,N00038847,Tom Garrett (R),2016,Other,61210,0,61210
F000465,N00039090,Drew Ferguson (R),2016,Agribusiness,6450,34000,40450
F000465,N00039090,Drew Ferguson (R),2016,Communic/Electronics,11300,21000,32300
F000465,N00039090,Drew Ferguson (R),2016,Construction,42900,28000,70900
F000465,N00039090,Drew Ferguson (R),2016,Defense,0,16500,16500
F000465,N00039090,Drew Ferguson (R),2016,Energy/Nat Resource,11550,13000,24550
F000465,N00039090,Drew Ferguson (R),2016,Finance/Insur/RealEst,74250,75000,149250
F000465,N00039090,Drew Ferguson (R),2016,Health,218080,95000,313080
F000465,N00039090,Drew Ferguson (R),2016,Lawyers & Lobbyists,32934,4000,36934
F000465,N00039090,Drew Ferguson (R),2016,Transportation,11900,29000,40900
F000465,N00039090,Drew Ferguson (R),2016,Misc Business,58050,49000,107050
F000465,N00039090,Drew Ferguson (R),2016,Labor,0,8000,8000
F000465,N00039090,Drew Ferguson (R),2016,Ideology/Single-Issue,9200,145366,154566
F000465,N00039090,Drew Ferguson (R),2016,Other,97705,1000,98705
B001302,N00039293,Andy Biggs (R),2016,Agribusiness,12000,7500,19500
B001302,N00039293,Andy Biggs (R),2016,Communic/Electronics,3700,11500,15200
B001302,N00039293,Andy Biggs (R),2016,Construction,30850,19000,49850
B001302,N00039293,Andy Biggs (R),2016,Defense,0,18500,18500
B001302,N00039293,Andy Biggs (R),2016,Energy/Nat Resource,5100,37000,42100
B001302,N00039293,Andy Biggs (R),2016,Finance/Insur/RealEst,71300,19500,90800
B001302,N00039293,Andy Biggs (R),2016,Health,15427,19000,34427
B001302,N00039293,Andy Biggs (R),2016,Lawyers & Lobbyists,29375,1500,30875
B001302,N00039293,Andy Biggs (R),2016,Transportation,19200,16000,35200
B001302,N00039293,Andy Biggs (R),2016,Misc Business,30200,13000,43200
B001302,N00039293,Andy Biggs (R),2016,Labor,2000,3250,5250
B001302,N00039293,Andy Biggs (R),2016,Ideology/Single-Issue,81672,95650,177322
B001302,N00039293,Andy Biggs (R),2016,Other,61760,5500,67260
G000579,N00039330,Mike Gallagher (R),2016,Agribusiness,73740,24250,97990
G000579,N00039330,Mike Gallagher (R),2016,Communic/Electronics,66175,20000,86175
G000579,N00039330,Mike Gallagher (R),2016,Construction,68684,37400,106084
G000579,N00039330,Mike Gallagher (R),2016,Defense,125,12500,12625
G000579,N00039330,Mike Gallagher (R),2016,Energy/Nat Resource,19950,32000,51950
G000579,N00039330,Mike Gallagher (R),2016,Finance/Insur/RealEst,497697,65850,563547
G000579,N00039330,Mike Gallagher (R),2016,Health,148088,37005,185093
G000579,N00039330,Mike Gallagher (R),2016,Lawyers & Lobbyists,122359,2000,124359
G000579,N00039330,Mike Gallagher (R),2016,Transportation,35335,34995,70330
G000579,N00039330,Mike Gallagher (R),2016,Misc Business,136089,39499,175588
G000579,N00039330,Mike Gallagher (R),2016,Labor,0,100,100
G000579,N00039330,Mike Gallagher (R),2016,Ideology/Single-Issue,72731,297581,370312
G000579,N00039330,Mike Gallagher (R),2016,Other,364037,0,364037
G000578,N00039503,Matt Gaetz (R),2016,Agribusiness,27050,17500,44550
G000578,N00039503,Matt Gaetz (R),2016,Communic/Electronics,8650,8818,17468
G000578,N00039503,Matt Gaetz (R),2016,Construction,17300,7000,24300
G000578,N00039503,Matt Gaetz (R),2016,Defense,5700,16500,22200
G000578,N00039503,Matt Gaetz (R),2016,Energy/Nat Resource,14050,17500,31550
G000578,N00039503,Matt Gaetz (R),2016,Finance/Insur/RealEst,91006,35818,126824
G000578,N00039503,Matt Gaetz (R),2016,Health,53750,19500,73250
G000578,N00039503,Matt Gaetz (R),2016,Lawyers & Lobbyists,40300,3000,43300
G000578,N00039503,Matt Gaetz (R),2016,Transportation,5900,9500,15400
G000578,N00039503,Matt Gaetz (R),2016,Misc Business,121206,16000,137206
G000578,N00039503,Matt Gaetz (R),2016,Ideology/Single-Issue,6400,79250,85650
G000578,N00039503,Matt Gaetz (R),2016,Other,79213,0,79213
B001301,N00039533,John Bergman (R),2016,Agribusiness,6350,13750,20100
B001301,N00039533,John Bergman (R),2016,Communic/Electronics,3500,16500,20000
B001301,N00039533,John Bergman (R),2016,Construction,19150,17500,36650
B001301,N00039533,John Bergman (R),2016,Defense,0,3500,3500
B001301,N00039533,John Bergman (R),2016,Energy/Nat Resource,12400,36500,48900
B001301,N00039533,John Bergman (R),2016,Finance/Insur/RealEst,63800,33000,96800
B001301,N00039533,John Bergman (R),2016,Health,18700,12000,30700
B001301,N00039533,John Bergman (R),2016,Lawyers & Lobbyists,10750,2000,12750
B001301,N00039533,John Bergman (R),2016,Transportation,25850,7995,33845
B001301,N00039533,John Bergman (R),2016,Misc Business,85470,28985,114455
B001301,N00039533,John Bergman (R),2016,Labor,0,12500,12500
B001301,N00039533,John Bergman (R),2016,Ideology/Single-Issue,25875,223047,248922
B001301,N00039533,John Bergman (R),2016,Other,96918,0,96918
B001305,N00039551,Ted Budd (R),2016,Agribusiness,750,10500,11250
B001305,N00039551,Ted Budd (R),2016,Communic/Electronics,1100,10000,11100
B001305,N00039551,Ted Budd (R),2016,Construction,9800,7000,16800
B001305,N00039551,Ted Budd (R),2016,Defense,8100,1000,9100
B001305,N00039551,Ted Budd (R),2016,Energy/Nat Resource,0,1000,1000
B001305,N00039551,Ted Budd (R),2016,Finance/Insur/RealEst,30650,16000,46650
B001305,N00039551,Ted Budd (R),2016,Health,8650,2000,10650
B001305,N00039551,Ted Budd (R),2016,Lawyers & Lobbyists,3000,1259,4259
B001305,N00039551,Ted Budd (R),2016,Transportation,32000,1500,33500
B001305,N00039551,Ted Budd (R),2016,Misc Business,20350,16500,36850
B001305,N00039551,Ted Budd (R),2016,Ideology/Single-Issue,56323,99500,155823
B001305,N00039551,Ted Budd (R),2016,Other,56350,0,56350
